station_id1,station_id2,all,all_reverse,classic,classic_reverse,electric,electric_reverse,classic_ratio,electric_ratio,classic_ratio_reverse,electric_ratio_reverse
SF-M26,SF-M25,3,3,3,2,0,1,1.0,0.0,0.6666666666666666,0.3333333333333333
SF-M26,SF-M26-2,9,8,8,6,1,2,0.8888888888888888,0.1111111111111111,0.75,0.25
SF-M26,SF-K26,9,4,9,4,0,0,1.0,0.0,1.0,0.0
SF-M26,SF-J27,4,1,4,0,0,1,1.0,0.0,0.0,1.0
SF-M26,SF-M30,11,5,4,4,7,1,0.36363636363636365,0.6363636363636364,0.8,0.2
SF-M26,SF-L27-2,2,4,1,2,1,2,0.5,0.5,0.5,0.5
SF-M26,SF-J29-3,1,1,0,1,1,0,0.0,1.0,1.0,0.0
SF-M26,SF-J29,12,23,2,7,10,16,0.16666666666666666,0.8333333333333334,0.30434782608695654,0.6956521739130435
SF-M26,SF-L26,11,6,11,2,0,4,1.0,0.0,0.3333333333333333,0.6666666666666666
SF-M26,SF-M28,15,13,5,3,10,10,0.3333333333333333,0.6666666666666666,0.23076923076923078,0.7692307692307693
SF-M26,SF-M27,1,1,0,0,1,1,0.0,1.0,0.0,1.0
SF-M26,SF-L25,3,6,2,3,1,3,0.6666666666666666,0.3333333333333333,0.5,0.5
SF-M26,SF-N24-2,1,1,1,0,0,1,1.0,0.0,0.0,1.0
SF-M26,SF-K27-2,9,5,7,5,2,0,0.7777777777777778,0.2222222222222222,1.0,0.0
SF-M26,SF-K28-3,1,1,0,1,1,0,0.0,1.0,1.0,0.0
SF-M26,SF-L28,4,2,3,1,1,1,0.75,0.25,0.5,0.5
SF-M26,SF-K28,5,3,2,2,3,1,0.4,0.6,0.6666666666666666,0.3333333333333333
SF-M26,SF-K29-1,9,6,6,4,3,2,0.6666666666666666,0.3333333333333333,0.6666666666666666,0.3333333333333333
SF-M26,SF-J28-2,1,4,1,3,0,1,1.0,0.0,0.75,0.25
SF-M26,SF-K27,2,2,2,1,0,1,1.0,0.0,0.5,0.5
SF-M26,SF-K25,10,7,6,1,4,6,0.6,0.4,0.14285714285714285,0.8571428571428571
SF-M26,SF-J25,8,6,3,3,5,3,0.375,0.625,0.5,0.5
SF-M26,SF-J24,15,4,13,4,2,0,0.8666666666666667,0.13333333333333333,1.0,0.0
SF-M26,SF-J26,1,2,0,1,1,1,0.0,1.0,0.5,0.5
SF-M26,SF-I25,1,3,0,0,1,3,0.0,1.0,0.0,1.0
SF-M26,SF-H26,10,6,10,4,0,2,1.0,0.0,0.6666666666666666,0.3333333333333333
SF-M26,SF-O23,1,1,0,1,1,0,0.0,1.0,1.0,0.0
SF-M26,SF-H27-1,5,5,4,5,1,0,0.8,0.2,1.0,0.0
SF-M26,SF-F28-2,3,2,1,0,2,2,0.3333333333333333,0.6666666666666666,0.0,1.0
SF-M26,SF-G27,5,6,2,1,3,5,0.4,0.6,0.16666666666666666,0.8333333333333334
SF-M26,SF-M22-2,1,3,0,0,1,3,0.0,1.0,0.0,1.0
SF-M26,SF-L22,9,3,4,2,5,1,0.4444444444444444,0.5555555555555556,0.6666666666666666,0.3333333333333333
SF-M26,SF-F27,3,5,0,3,3,2,0.0,1.0,0.6,0.4
SF-M26,SF-N22-2,2,12,1,4,1,8,0.5,0.5,0.3333333333333333,0.6666666666666666
SF-M26,SF-M22-1,15,16,5,5,10,11,0.3333333333333333,0.6666666666666666,0.3125,0.6875
SF-M26,SF-K24,4,1,3,0,1,1,0.75,0.25,0.0,1.0
SF-M26,SF-G23,6,14,0,0,6,14,0.0,1.0,0.0,1.0
SF-M26,SF-G25,3,1,0,0,3,1,0.0,1.0,0.0,1.0
SF-M26,SF-F23,1,4,0,1,1,3,0.0,1.0,0.25,0.75
SF-M26,SF-E23,1,3,0,0,1,3,0.0,1.0,0.0,1.0
SF-M26,SF-D24,2,2,0,2,2,0,0.0,1.0,1.0,0.0
SF-M26,SF-J17,1,1,1,0,0,1,1.0,0.0,0.0,1.0
SF-M26,SF-F30-1,2,2,0,0,2,2,0.0,1.0,0.0,1.0
SF-M26,SF-G29-2,2,3,1,2,1,1,0.5,0.5,0.6666666666666666,0.3333333333333333
SF-M26,SF-G30-1,33,29,24,27,9,2,0.7272727272727273,0.2727272727272727,0.9310344827586207,0.06896551724137931
SF-M26,SF-E28,2,1,2,0,0,1,1.0,0.0,0.0,1.0
SF-M26,SF-C25,1,1,1,0,0,1,1.0,0.0,0.0,1.0
SF-M26,SF-B25,1,1,1,1,0,0,1.0,0.0,1.0,0.0
SF-M26,SF-D27,2,3,1,3,1,0,0.5,0.5,1.0,0.0
SF-M26,SF-H25,1,1,0,1,1,0,0.0,1.0,1.0,0.0
SF-M26,SF-J23-1,9,5,5,3,4,2,0.5555555555555556,0.4444444444444444,0.6,0.4
SF-M26,SF-J22-1,3,1,1,0,2,1,0.3333333333333333,0.6666666666666666,0.0,1.0
SF-M26,SF-J22-2,1,1,1,0,0,1,1.0,0.0,0.0,1.0
SF-M26,SF-J21,1,2,1,1,0,1,1.0,0.0,0.5,0.5
SF-M26,SF-I24,1,1,1,0,0,1,1.0,0.0,0.0,1.0
SF-M26,SF-I23-1,21,13,1,0,20,13,0.047619047619047616,0.9523809523809523,0.0,1.0
SF-M26,SF-F26,2,3,0,0,2,3,0.0,1.0,0.0,1.0
SF-M26,SF-M15,2,1,0,0,2,1,0.0,1.0,0.0,1.0
SF-M26,SF-L20,1,3,1,0,0,3,1.0,0.0,0.0,1.0
SF-M26,SF-N20-1,3,3,0,2,3,1,0.0,1.0,0.6666666666666666,0.3333333333333333
SF-M26,SF-K20,1,1,0,0,1,1,0.0,1.0,0.0,1.0
SF-M26,SF-Q21-1,2,2,0,0,2,2,0.0,1.0,0.0,1.0
SF-M26,SF-P21,2,2,0,0,2,2,0.0,1.0,0.0,1.0
SF-M26,SF-O19,3,5,1,1,2,4,0.3333333333333333,0.6666666666666666,0.2,0.8
SF-M26,SF-O21,2,1,0,0,2,1,0.0,1.0,0.0,1.0
SF-M26,SF-N21,3,1,2,1,1,0,0.6666666666666666,0.3333333333333333,1.0,0.0
SF-M26,SF-N20-2,2,2,0,0,2,2,0.0,1.0,0.0,1.0
SF-M26,SF-M21,6,4,1,1,5,3,0.16666666666666666,0.8333333333333334,0.25,0.75
SF-M26,SF-L21,3,3,1,0,2,3,0.3333333333333333,0.6666666666666666,0.0,1.0
SF-M26,SF-Q30,2,1,1,1,1,0,0.5,0.5,1.0,0.0
SF-M26,SF-P30,3,1,3,0,0,1,1.0,0.0,0.0,1.0
SF-M26,SF-O30,21,17,6,2,15,15,0.2857142857142857,0.7142857142857143,0.11764705882352941,0.8823529411764706
SF-M26,SF-N27,5,4,5,1,0,3,1.0,0.0,0.25,0.75
SF-M26,SF-N29,4,3,2,1,2,2,0.5,0.5,0.3333333333333333,0.6666666666666666
SF-M26,SF-N28,9,4,4,4,5,0,0.4444444444444444,0.5555555555555556,1.0,0.0
SF-M26,SF-L30-1,13,5,10,4,3,1,0.7692307692307693,0.23076923076923078,0.8,0.2
SF-M26,SF-L29,8,14,5,7,3,7,0.625,0.375,0.5,0.5
SF-M26,SF-J29-1,2,2,0,1,2,1,0.0,1.0,0.5,0.5
SF-M26,SF-I30,10,4,6,2,4,2,0.6,0.4,0.5,0.5
SF-M26,SF-I27,3,2,1,0,2,2,0.3333333333333333,0.6666666666666666,0.0,1.0
SF-M26,SF-I30-2,2,2,1,1,1,1,0.5,0.5,0.5,0.5
SF-M26,SF-H28,7,1,7,0,0,1,1.0,0.0,0.0,1.0
SF-M26,SF-R24,4,3,0,0,4,3,0.0,1.0,0.0,1.0
SF-M26,SF-Q26,5,3,3,0,2,3,0.6,0.4,0.0,1.0
SF-M26,SF-P26,8,3,4,0,4,3,0.5,0.5,0.0,1.0
SF-M26,SF-N22-1B,2,2,1,2,1,0,0.5,0.5,1.0,0.0
SF-M26,SF-N26,7,3,4,3,3,0,0.5714285714285714,0.42857142857142855,1.0,0.0
SF-M26,SF-N25,3,1,3,1,0,0,1.0,0.0,1.0,0.0
SF-M26,SF-T22,2,4,1,1,1,3,0.5,0.5,0.25,0.75
SF-M26,SF-S22-1,2,4,2,3,0,1,1.0,0.0,0.75,0.25
SF-M26,SF-Q23-3,1,2,0,1,1,1,0.0,1.0,0.5,0.5
SF-M26,SF-Q22-1,2,2,2,0,0,2,1.0,0.0,0.0,1.0
SF-M26,SF-P22,2,3,0,2,2,1,0.0,1.0,0.6666666666666666,0.3333333333333333
SF-M26,SF-T20,1,1,0,0,1,1,0.0,1.0,0.0,1.0
SF-M26,SF-S21,1,1,1,1,0,0,1.0,0.0,1.0,0.0
SF-M25,SF-M26,3,3,2,3,1,0,0.6666666666666666,0.3333333333333333,1.0,0.0
SF-M25,SF-M26-2,17,13,8,6,9,7,0.47058823529411764,0.5294117647058824,0.46153846153846156,0.5384615384615384
SF-M25,SF-L27,7,8,4,5,3,3,0.5714285714285714,0.42857142857142855,0.625,0.375
SF-M25,SF-K26,34,30,14,14,20,16,0.4117647058823529,0.5882352941176471,0.4666666666666667,0.5333333333333333
SF-M25,SF-J27,10,4,6,3,4,1,0.6,0.4,0.75,0.25
SF-M25,SF-M30,31,14,7,6,24,8,0.22580645161290322,0.7741935483870968,0.42857142857142855,0.5714285714285714
SF-M25,SF-L27-2,4,1,2,1,2,0,0.5,0.5,1.0,0.0
SF-M25,SF-J29-3,2,7,1,5,1,2,0.5,0.5,0.7142857142857143,0.2857142857142857
SF-M25,SF-J29,15,16,5,8,10,8,0.3333333333333333,0.6666666666666666,0.5,0.5
SF-M25,SF-L26,13,17,7,11,6,6,0.5384615384615384,0.46153846153846156,0.6470588235294118,0.35294117647058826
SF-M25,SF-M28,17,13,7,6,10,7,0.4117647058823529,0.5882352941176471,0.46153846153846156,0.5384615384615384
SF-M25,SF-M27,2,2,1,1,1,1,0.5,0.5,0.5,0.5
SF-M25,SF-L25,15,26,3,15,12,11,0.2,0.8,0.5769230769230769,0.4230769230769231
SF-M25,SF-M24,8,13,7,10,1,3,0.875,0.125,0.7692307692307693,0.23076923076923078
SF-M25,SF-L24,26,33,12,21,14,12,0.46153846153846156,0.5384615384615384,0.6363636363636364,0.36363636363636365
SF-M25,SF-N23,4,5,3,3,1,2,0.75,0.25,0.6,0.4
SF-M25,SF-N24-2,8,10,2,6,6,4,0.25,0.75,0.6,0.4
SF-M25,SF-K27-2,42,43,28,34,14,9,0.6666666666666666,0.3333333333333333,0.7906976744186046,0.20930232558139536
SF-M25,SF-J26-2,9,16,4,10,5,6,0.4444444444444444,0.5555555555555556,0.625,0.375
SF-M25,SF-K28-3,2,4,2,2,0,2,1.0,0.0,0.5,0.5
SF-M25,SF-L28,19,11,9,3,10,8,0.47368421052631576,0.5263157894736842,0.2727272727272727,0.7272727272727273
SF-M25,SF-K28,6,3,2,2,4,1,0.3333333333333333,0.6666666666666666,0.6666666666666666,0.3333333333333333
SF-M25,SF-K29-1,8,5,5,2,3,3,0.625,0.375,0.4,0.6
SF-M25,SF-J28-2,8,12,2,8,6,4,0.25,0.75,0.6666666666666666,0.3333333333333333
SF-M25,SF-K27,9,12,5,6,4,6,0.5555555555555556,0.4444444444444444,0.5,0.5
SF-M25,SF-K25,31,34,18,12,13,22,0.5806451612903226,0.41935483870967744,0.35294117647058826,0.6470588235294118
SF-M25,SF-J25,36,37,11,14,25,23,0.3055555555555556,0.6944444444444444,0.3783783783783784,0.6216216216216216
SF-M25,SF-H26-2,3,6,0,1,3,5,0.0,1.0,0.16666666666666666,0.8333333333333334
SF-M25,SF-P24,9,4,2,3,7,1,0.2222222222222222,0.7777777777777778,0.75,0.25
SF-M25,SF-N22-1A,7,10,2,3,5,7,0.2857142857142857,0.7142857142857143,0.3,0.7
SF-M25,SF-J24,28,21,12,8,16,13,0.42857142857142855,0.5714285714285714,0.38095238095238093,0.6190476190476191
SF-M25,SF-O24,5,5,2,2,3,3,0.4,0.6,0.4,0.6
SF-M25,SF-J26,6,5,1,1,5,4,0.16666666666666666,0.8333333333333334,0.2,0.8
SF-M25,SF-I26-,10,10,5,3,5,7,0.5,0.5,0.3,0.7
SF-M25,SF-I25,5,8,3,5,2,3,0.6,0.4,0.625,0.375
SF-M25,SF-K23,5,3,3,1,2,2,0.6,0.4,0.3333333333333333,0.6666666666666666
SF-M25,SF-H26,14,21,5,12,9,9,0.35714285714285715,0.6428571428571429,0.5714285714285714,0.42857142857142855
SF-M25,SF-O23,9,9,6,3,3,6,0.6666666666666666,0.3333333333333333,0.3333333333333333,0.6666666666666666
SF-M25,SF-H27-1,2,2,0,0,2,2,0.0,1.0,0.0,1.0
SF-M25,SF-F28-2,1,3,0,1,1,2,0.0,1.0,0.3333333333333333,0.6666666666666666
SF-M25,SF-G27,13,6,9,5,4,1,0.6923076923076923,0.3076923076923077,0.8333333333333334,0.16666666666666666
SF-M25,SF-M22-2,13,23,3,5,10,18,0.23076923076923078,0.7692307692307693,0.21739130434782608,0.782608695652174
SF-M25,SF-L22,14,14,6,1,8,13,0.42857142857142855,0.5714285714285714,0.07142857142857142,0.9285714285714286
SF-M25,SF-F27,6,6,3,1,3,5,0.5,0.5,0.16666666666666666,0.8333333333333334
SF-M25,SF-N22-2,25,30,13,12,12,18,0.52,0.48,0.4,0.6
SF-M25,SF-M22-1,7,8,1,3,6,5,0.14285714285714285,0.8571428571428571,0.375,0.625
SF-M25,SF-O25-1,6,3,1,0,5,3,0.16666666666666666,0.8333333333333334,0.0,1.0
SF-M25,SF-K22-2,7,12,4,7,3,5,0.5714285714285714,0.42857142857142855,0.5833333333333334,0.4166666666666667
SF-M25,SF-K24,23,30,16,21,7,9,0.6956521739130435,0.30434782608695654,0.7,0.3
SF-M25,SF-J23-2,8,2,6,2,2,0,0.75,0.25,1.0,0.0
SF-M25,SF-G23,6,2,3,0,3,2,0.5,0.5,0.0,1.0
SF-M25,SF-G24,41,15,6,4,35,11,0.14634146341463414,0.8536585365853658,0.26666666666666666,0.7333333333333333
SF-M25,SF-G25,15,5,8,1,7,4,0.5333333333333333,0.4666666666666667,0.2,0.8
SF-M25,SF-F23,6,9,4,1,2,8,0.6666666666666666,0.3333333333333333,0.1111111111111111,0.8888888888888888
SF-M25,SF-E23,8,2,3,0,5,2,0.375,0.625,0.0,1.0
SF-M25,SF-C22,4,3,3,1,1,2,0.75,0.25,0.3333333333333333,0.6666666666666666
SF-M25,SF-B22,2,2,2,1,0,1,1.0,0.0,0.5,0.5
SF-M25,SF-J17,3,8,0,0,3,8,0.0,1.0,0.0,1.0
SF-M25,SF-I19,2,9,1,0,1,9,0.5,0.5,0.0,1.0
SF-M25,SF-I20,6,4,4,2,2,2,0.6666666666666666,0.3333333333333333,0.5,0.5
SF-M25,SF-H20,4,2,1,2,3,0,0.25,0.75,1.0,0.0
SF-M25,SF-H17,1,1,0,0,1,1,0.0,1.0,0.0,1.0
SF-M25,SF-G19,2,3,0,0,2,3,0.0,1.0,0.0,1.0
SF-M25,SF-G18,4,5,2,4,2,1,0.5,0.5,0.8,0.2
SF-M25,SF-G20,1,4,1,1,0,3,1.0,0.0,0.25,0.75
SF-M25,SF-H30,2,4,0,3,2,1,0.0,1.0,0.75,0.25
SF-M25,SF-G30-2,49,14,13,8,36,6,0.2653061224489796,0.7346938775510204,0.5714285714285714,0.42857142857142855
SF-M25,SF-F30-1,1,2,0,1,1,1,0.0,1.0,0.5,0.5
SF-M25,SF-E29-2,3,2,0,0,3,2,0.0,1.0,0.0,1.0
SF-M25,SF-D29,1,1,0,0,1,1,0.0,1.0,0.0,1.0
SF-M25,SF-D28,1,4,0,2,1,2,0.0,1.0,0.5,0.5
SF-M25,SF-G29-2,10,12,5,3,5,9,0.5,0.5,0.25,0.75
SF-M25,SF-G29-1,19,19,16,17,3,2,0.8421052631578947,0.15789473684210525,0.8947368421052632,0.10526315789473684
SF-M25,SF-G30-1,4,4,2,1,2,3,0.5,0.5,0.25,0.75
SF-M25,SF-G29-3,3,2,2,1,1,1,0.6666666666666666,0.3333333333333333,0.5,0.5
SF-M25,SF-F30-2,12,7,9,5,3,2,0.75,0.25,0.7142857142857143,0.2857142857142857
SF-M25,SF-F29,4,1,2,1,2,0,0.5,0.5,1.0,0.0
SF-M25,SF-E28-2,1,1,0,0,1,1,0.0,1.0,0.0,1.0
SF-M25,SF-J12,1,4,0,0,1,4,0.0,1.0,0.0,1.0
SF-M25,SF-I16,1,1,0,0,1,1,0.0,1.0,0.0,1.0
SF-M25,SF-G12,5,2,0,0,5,2,0.0,1.0,0.0,1.0
SF-M25,SF-F16,27,19,18,3,9,16,0.6666666666666666,0.3333333333333333,0.15789473684210525,0.8421052631578947
SF-M25,SF-C25,3,3,0,1,3,2,0.0,1.0,0.3333333333333333,0.6666666666666666
SF-M25,SF-B25,1,2,1,0,0,2,1.0,0.0,0.0,1.0
SF-M25,SF-D27,1,1,0,1,1,0,0.0,1.0,1.0,0.0
SF-M25,SF-H25,2,5,1,1,1,4,0.5,0.5,0.2,0.8
SF-M25,SF-K21,8,13,3,0,5,13,0.375,0.625,0.0,1.0
SF-M25,SF-K22-1,10,19,4,9,6,10,0.4,0.6,0.47368421052631576,0.5263157894736842
SF-M25,SF-J23-1,33,39,15,17,18,22,0.45454545454545453,0.5454545454545454,0.4358974358974359,0.5641025641025641
SF-M25,SF-J22-1,12,14,8,8,4,6,0.6666666666666666,0.3333333333333333,0.5714285714285714,0.42857142857142855
SF-M25,SF-J22-2,10,13,5,6,5,7,0.5,0.5,0.46153846153846156,0.5384615384615384
SF-M25,SF-J21,6,7,3,5,3,2,0.5,0.5,0.7142857142857143,0.2857142857142857
SF-M25,SF-I21,2,1,1,0,1,1,0.5,0.5,0.0,1.0
SF-M25,SF-I22,5,3,1,0,4,3,0.2,0.8,0.0,1.0
SF-M25,SF-I23-2,5,3,1,3,4,0,0.2,0.8,1.0,0.0
SF-M25,SF-I24,8,1,5,1,3,0,0.625,0.375,1.0,0.0
SF-M25,SF-I23-1,4,5,4,4,0,1,1.0,0.0,0.8,0.2
SF-M25,SF-F26,13,9,7,0,6,9,0.5384615384615384,0.46153846153846156,0.0,1.0
SF-M25,SF-M13,2,1,0,0,2,1,0.0,1.0,0.0,1.0
SF-M25,SF-M15,5,6,1,0,4,6,0.2,0.8,0.0,1.0
SF-M25,SF-L19,7,9,2,2,5,7,0.2857142857142857,0.7142857142857143,0.2222222222222222,0.7777777777777778
SF-M25,SF-L20,7,8,3,2,4,6,0.42857142857142855,0.5714285714285714,0.25,0.75
SF-M25,SF-N20-1,13,8,5,3,8,5,0.38461538461538464,0.6153846153846154,0.375,0.625
SF-M25,SF-M20,17,30,4,4,13,26,0.23529411764705882,0.7647058823529411,0.13333333333333333,0.8666666666666667
SF-M25,SF-K17-2,3,5,2,1,1,4,0.6666666666666666,0.3333333333333333,0.2,0.8
SF-M25,SF-K20,13,4,8,0,5,4,0.6153846153846154,0.38461538461538464,0.0,1.0
SF-M25,SF-K15-,5,3,0,1,5,2,0.0,1.0,0.3333333333333333,0.6666666666666666
SF-M25,SF-K19,7,6,2,1,5,5,0.2857142857142857,0.7142857142857143,0.16666666666666666,0.8333333333333334
SF-M25,SF-K18,8,3,2,1,6,2,0.25,0.75,0.3333333333333333,0.6666666666666666
SF-M25,SF-K17,3,3,0,1,3,2,0.0,1.0,0.3333333333333333,0.6666666666666666
SF-M25,SF-J18,1,4,0,0,1,4,0.0,1.0,0.0,1.0
SF-M25,SF-J20,2,6,2,3,0,3,1.0,0.0,0.5,0.5
SF-M25,SF-J19,4,6,2,5,2,1,0.5,0.5,0.8333333333333334,0.16666666666666666
SF-M25,SF-R19,4,8,0,1,4,7,0.0,1.0,0.125,0.875
SF-M25,SF-R20,1,3,0,0,1,3,0.0,1.0,0.0,1.0
SF-M25,SF-Q21-2,5,5,1,0,4,5,0.2,0.8,0.0,1.0
SF-M25,SF-Q21-1,7,4,4,0,3,4,0.5714285714285714,0.42857142857142855,0.0,1.0
SF-M25,SF-P21,13,7,12,0,1,7,0.9230769230769231,0.07692307692307693,0.0,1.0
SF-M25,SF-O18,7,11,3,0,4,11,0.42857142857142855,0.5714285714285714,0.0,1.0
SF-M25,SF-O19,14,19,4,9,10,10,0.2857142857142857,0.7142857142857143,0.47368421052631576,0.5263157894736842
SF-M25,SF-O21,12,26,3,11,9,15,0.25,0.75,0.4230769230769231,0.5769230769230769
SF-M25,SF-O22,20,17,3,6,17,11,0.15,0.85,0.35294117647058826,0.6470588235294118
SF-M25,SF-N21,9,12,6,6,3,6,0.6666666666666666,0.3333333333333333,0.5,0.5
SF-M25,SF-N20-2,3,4,2,1,1,3,0.6666666666666666,0.3333333333333333,0.25,0.75
SF-M25,SF-M21,38,34,8,9,30,25,0.21052631578947367,0.7894736842105263,0.2647058823529412,0.7352941176470589
SF-M25,SF-L21,10,17,3,4,7,13,0.3,0.7,0.23529411764705882,0.7647058823529411
SF-M25,SF-Q30,3,5,3,2,0,3,1.0,0.0,0.4,0.6
SF-M25,SF-P30,7,6,2,5,5,1,0.2857142857142857,0.7142857142857143,0.8333333333333334,0.16666666666666666
SF-M25,SF-O30-2,2,1,1,0,1,1,0.5,0.5,0.0,1.0
SF-M25,SF-O30,17,20,5,9,12,11,0.29411764705882354,0.7058823529411765,0.45,0.55
SF-M25,SF-N27,5,14,1,4,4,10,0.2,0.8,0.2857142857142857,0.7142857142857143
SF-M25,SF-N29,4,1,2,0,2,1,0.5,0.5,0.0,1.0
SF-M25,SF-N28,20,35,15,21,5,14,0.75,0.25,0.6,0.4
SF-M25,SF-L30-1,23,18,15,8,8,10,0.6521739130434783,0.34782608695652173,0.4444444444444444,0.5555555555555556
SF-M25,SF-L31-1,2,3,1,1,1,2,0.5,0.5,0.3333333333333333,0.6666666666666666
SF-M25,SF-K30-2,6,4,4,1,2,3,0.6666666666666666,0.3333333333333333,0.25,0.75
SF-M25,SF-L29,6,10,4,5,2,5,0.6666666666666666,0.3333333333333333,0.5,0.5
SF-M25,SF-J29-1,5,1,3,0,2,1,0.6,0.4,0.0,1.0
SF-M25,SF-I30,14,13,8,9,6,4,0.5714285714285714,0.42857142857142855,0.6923076923076923,0.3076923076923077
SF-M25,SF-I29-2,2,6,1,4,1,2,0.5,0.5,0.6666666666666666,0.3333333333333333
SF-M25,SF-I27,5,2,2,1,3,1,0.4,0.6,0.5,0.5
SF-M25,SF-I30-2,14,1,6,1,8,0,0.42857142857142855,0.5714285714285714,1.0,0.0
SF-M25,SF-H28,12,12,9,7,3,5,0.75,0.25,0.5833333333333334,0.4166666666666667
SF-M25,SF-H29,3,1,3,0,0,1,1.0,0.0,0.0,1.0
SF-M25,SF-S24,9,20,4,2,5,18,0.4444444444444444,0.5555555555555556,0.1,0.9
SF-M25,SF-R24,47,34,13,10,34,24,0.2765957446808511,0.723404255319149,0.29411764705882354,0.7058823529411765
SF-M25,SF-R26,1,4,1,2,0,2,1.0,0.0,0.5,0.5
SF-M25,SF-Q26,5,10,3,3,2,7,0.6,0.4,0.3,0.7
SF-M25,SF-P26,22,8,4,0,18,8,0.18181818181818182,0.8181818181818182,0.0,1.0
SF-M25,SF-O25-2,48,19,42,9,6,10,0.875,0.125,0.47368421052631576,0.5263157894736842
SF-M25,SF-N22-1B,54,83,28,51,26,32,0.5185185185185185,0.48148148148148145,0.6144578313253012,0.3855421686746988
SF-M25,SF-N26,5,7,4,4,1,3,0.8,0.2,0.5714285714285714,0.42857142857142855
SF-M25,SF-N25,8,3,5,1,3,2,0.625,0.375,0.3333333333333333,0.6666666666666666
SF-M25,SF-T22,13,11,7,8,6,3,0.5384615384615384,0.46153846153846156,0.7272727272727273,0.2727272727272727
SF-M25,SF-S22-2,1,6,0,1,1,5,0.0,1.0,0.16666666666666666,0.8333333333333334
SF-M25,SF-S22-1,5,9,1,3,4,6,0.2,0.8,0.3333333333333333,0.6666666666666666
SF-M25,SF-Q23-3,3,5,2,2,1,3,0.6666666666666666,0.3333333333333333,0.4,0.6
SF-M25,SF-Q22-1,14,5,8,1,6,4,0.5714285714285714,0.42857142857142855,0.2,0.8
SF-M25,SF-Q22-2,12,17,5,9,7,8,0.4166666666666667,0.5833333333333334,0.5294117647058824,0.47058823529411764
SF-M25,SF-P22,11,11,4,5,7,6,0.36363636363636365,0.6363636363636364,0.45454545454545453,0.5454545454545454
SF-M25,SF-U21,3,1,2,0,1,1,0.6666666666666666,0.3333333333333333,0.0,1.0
SF-M25,SF-T20,11,10,0,0,11,10,0.0,1.0,0.0,1.0
SF-M25,SF-S21,2,1,0,0,2,1,0.0,1.0,0.0,1.0
SF-M25,SF-X19,2,1,1,0,1,1,0.5,0.5,0.0,1.0
SF-M25,SF-Y25,5,1,5,1,0,0,1.0,0.0,1.0,0.0
SF-M26-2,SF-M26,8,9,6,8,2,1,0.75,0.25,0.8888888888888888,0.1111111111111111
SF-M26-2,SF-M25,13,17,6,8,7,9,0.46153846153846156,0.5384615384615384,0.47058823529411764,0.5294117647058824
SF-M26-2,SF-L27,4,26,3,20,1,6,0.75,0.25,0.7692307692307693,0.23076923076923078
SF-M26-2,SF-K26,19,11,5,8,14,3,0.2631578947368421,0.7368421052631579,0.7272727272727273,0.2727272727272727
SF-M26-2,SF-J27,4,4,1,2,3,2,0.25,0.75,0.5,0.5
SF-M26-2,SF-M30,10,7,6,5,4,2,0.6,0.4,0.7142857142857143,0.2857142857142857
SF-M26-2,SF-L27-2,3,10,1,9,2,1,0.3333333333333333,0.6666666666666666,0.9,0.1
SF-M26-2,SF-J29-3,18,7,10,5,8,2,0.5555555555555556,0.4444444444444444,0.7142857142857143,0.2857142857142857
SF-M26-2,SF-J29,60,82,25,52,35,30,0.4166666666666667,0.5833333333333334,0.6341463414634146,0.36585365853658536
SF-M26-2,SF-L26,14,47,8,46,6,1,0.5714285714285714,0.42857142857142855,0.9787234042553191,0.02127659574468085
SF-M26-2,SF-M28,55,40,39,18,16,22,0.7090909090909091,0.2909090909090909,0.45,0.55
SF-M26-2,SF-M27,3,1,3,1,0,0,1.0,0.0,1.0,0.0
SF-M26-2,SF-L25,15,18,9,15,6,3,0.6,0.4,0.8333333333333334,0.16666666666666666
SF-M26-2,SF-M24,8,7,3,5,5,2,0.375,0.625,0.7142857142857143,0.2857142857142857
SF-M26-2,SF-L24,37,40,19,18,18,22,0.5135135135135135,0.4864864864864865,0.45,0.55
SF-M26-2,SF-N23,7,9,4,6,3,3,0.5714285714285714,0.42857142857142855,0.6666666666666666,0.3333333333333333
SF-M26-2,SF-K27-2,5,3,5,3,0,0,1.0,0.0,1.0,0.0
SF-M26-2,SF-J26-2,4,19,0,2,4,17,0.0,1.0,0.10526315789473684,0.8947368421052632
SF-M26-2,SF-K28-3,1,3,1,2,0,1,1.0,0.0,0.6666666666666666,0.3333333333333333
SF-M26-2,SF-L28,35,46,28,31,7,15,0.8,0.2,0.6739130434782609,0.32608695652173914
SF-M26-2,SF-K28,18,4,14,2,4,2,0.7777777777777778,0.2222222222222222,0.5,0.5
SF-M26-2,SF-K29-1,18,16,3,4,15,12,0.16666666666666666,0.8333333333333334,0.25,0.75
SF-M26-2,SF-J28-2,25,41,12,23,13,18,0.48,0.52,0.5609756097560976,0.43902439024390244
SF-M26-2,SF-K27,1,5,0,3,1,2,0.0,1.0,0.6,0.4
SF-M26-2,SF-K25,8,10,3,9,5,1,0.375,0.625,0.9,0.1
SF-M26-2,SF-J25,45,56,11,10,34,46,0.24444444444444444,0.7555555555555555,0.17857142857142858,0.8214285714285714
SF-M26-2,SF-H26-2,8,9,2,4,6,5,0.25,0.75,0.4444444444444444,0.5555555555555556
SF-M26-2,SF-P24,12,12,5,3,7,9,0.4166666666666667,0.5833333333333334,0.25,0.75
SF-M26-2,SF-J24,25,3,9,2,16,1,0.36,0.64,0.6666666666666666,0.3333333333333333
SF-M26-2,SF-J26,15,9,11,3,4,6,0.7333333333333333,0.26666666666666666,0.3333333333333333,0.6666666666666666
SF-M26-2,SF-I26-,6,2,3,2,3,0,0.5,0.5,1.0,0.0
SF-M26-2,SF-I25,125,10,46,5,79,5,0.368,0.632,0.5,0.5
SF-M26-2,SF-H26,18,17,9,3,9,14,0.5,0.5,0.17647058823529413,0.8235294117647058
SF-M26-2,SF-O23,3,5,2,0,1,5,0.6666666666666666,0.3333333333333333,0.0,1.0
SF-M26-2,SF-H27-1,21,15,19,15,2,0,0.9047619047619048,0.09523809523809523,1.0,0.0
SF-M26-2,SF-F28-2,3,3,2,0,1,3,0.6666666666666666,0.3333333333333333,0.0,1.0
SF-M26-2,SF-G27,12,7,4,1,8,6,0.3333333333333333,0.6666666666666666,0.14285714285714285,0.8571428571428571
SF-M26-2,SF-M22-2,14,9,4,3,10,6,0.2857142857142857,0.7142857142857143,0.3333333333333333,0.6666666666666666
SF-M26-2,SF-L22,8,6,6,1,2,5,0.75,0.25,0.16666666666666666,0.8333333333333334
SF-M26-2,SF-F27,11,15,3,3,8,12,0.2727272727272727,0.7272727272727273,0.2,0.8
SF-M26-2,SF-N22-2,8,16,2,10,6,6,0.25,0.75,0.625,0.375
SF-M26-2,SF-G28-2,2,2,2,2,0,0,1.0,0.0,1.0,0.0
SF-M26-2,SF-G28-1,1,6,1,1,0,5,1.0,0.0,0.16666666666666666,0.8333333333333334
SF-M26-2,SF-M22-1,4,4,1,0,3,4,0.25,0.75,0.0,1.0
SF-M26-2,SF-O25-1,9,6,2,2,7,4,0.2222222222222222,0.7777777777777778,0.3333333333333333,0.6666666666666666
SF-M26-2,SF-K22-2,7,8,6,1,1,7,0.8571428571428571,0.14285714285714285,0.125,0.875
SF-M26-2,SF-K24,11,12,8,7,3,5,0.7272727272727273,0.2727272727272727,0.5833333333333334,0.4166666666666667
SF-M26-2,SF-J23-2,25,22,5,7,20,15,0.2,0.8,0.3181818181818182,0.6818181818181818
SF-M26-2,SF-G23,9,43,7,3,2,40,0.7777777777777778,0.2222222222222222,0.06976744186046512,0.9302325581395349
SF-M26-2,SF-G24,85,3,77,0,8,3,0.9058823529411765,0.09411764705882353,0.0,1.0
SF-M26-2,SF-G25,3,1,1,0,2,1,0.3333333333333333,0.6666666666666666,0.0,1.0
SF-M26-2,SF-F23,31,7,24,1,7,6,0.7741935483870968,0.22580645161290322,0.14285714285714285,0.8571428571428571
SF-M26-2,SF-E23,5,7,2,2,3,5,0.4,0.6,0.2857142857142857,0.7142857142857143
SF-M26-2,SF-D24,3,3,2,0,1,3,0.6666666666666666,0.3333333333333333,0.0,1.0
SF-M26-2,SF-C22,5,7,2,2,3,5,0.4,0.6,0.2857142857142857,0.7142857142857143
SF-M26-2,SF-B22,2,2,0,2,2,0,0.0,1.0,1.0,0.0
SF-M26-2,SF-J17,6,3,0,0,6,3,0.0,1.0,0.0,1.0
SF-M26-2,SF-I19,1,1,0,0,1,1,0.0,1.0,0.0,1.0
SF-M26-2,SF-I20,3,1,2,1,1,0,0.6666666666666666,0.3333333333333333,1.0,0.0
SF-M26-2,SF-H20,5,7,3,3,2,4,0.6,0.4,0.42857142857142855,0.5714285714285714
SF-M26-2,SF-G19,14,4,11,1,3,3,0.7857142857142857,0.21428571428571427,0.25,0.75
SF-M26-2,SF-G18,2,1,2,1,0,0,1.0,0.0,1.0,0.0
SF-M26-2,SF-G20,18,1,14,0,4,1,0.7777777777777778,0.2222222222222222,0.0,1.0
SF-M26-2,SF-E20,3,3,3,1,0,2,1.0,0.0,0.3333333333333333,0.6666666666666666
SF-M26-2,SF-H30,16,24,5,12,11,12,0.3125,0.6875,0.5,0.5
SF-M26-2,SF-G30-2,30,22,20,16,10,6,0.6666666666666666,0.3333333333333333,0.7272727272727273,0.2727272727272727
SF-M26-2,SF-F30-1,8,3,1,1,7,2,0.125,0.875,0.3333333333333333,0.6666666666666666
SF-M26-2,SF-E29-2,51,42,47,40,4,2,0.9215686274509803,0.0784313725490196,0.9523809523809523,0.047619047619047616
SF-M26-2,SF-E29-1,27,19,15,13,12,6,0.5555555555555556,0.4444444444444444,0.6842105263157895,0.3157894736842105
SF-M26-2,SF-D29,22,16,6,2,16,14,0.2727272727272727,0.7272727272727273,0.125,0.875
SF-M26-2,SF-D28,4,2,0,0,4,2,0.0,1.0,0.0,1.0
SF-M26-2,SF-A27,17,18,13,18,4,0,0.7647058823529411,0.23529411764705882,1.0,0.0
SF-M26-2,SF-G29-2,32,30,10,6,22,24,0.3125,0.6875,0.2,0.8
SF-M26-2,SF-G29-1,30,72,7,1,23,71,0.23333333333333334,0.7666666666666667,0.013888888888888888,0.9861111111111112
SF-M26-2,SF-G30-1,14,9,4,5,10,4,0.2857142857142857,0.7142857142857143,0.5555555555555556,0.4444444444444444
SF-M26-2,SF-G29-3,18,16,0,2,18,14,0.0,1.0,0.125,0.875
SF-M26-2,SF-F29,18,45,2,1,16,44,0.1111111111111111,0.8888888888888888,0.022222222222222223,0.9777777777777777
SF-M26-2,SF-E29-3,2,2,0,0,2,2,0.0,1.0,0.0,1.0
SF-M26-2,SF-F28-1,2,8,2,6,0,2,1.0,0.0,0.75,0.25
SF-M26-2,SF-E28-2,1,1,0,1,1,0,0.0,1.0,1.0,0.0
SF-M26-2,SF-E28,2,2,0,1,2,1,0.0,1.0,0.5,0.5
SF-M26-2,SF-J12,2,2,2,1,0,1,1.0,0.0,0.5,0.5
SF-M26-2,SF-C20,2,1,0,0,2,1,0.0,1.0,0.0,1.0
SF-M26-2,SF-B19,5,5,1,0,4,5,0.2,0.8,0.0,1.0
SF-M26-2,SF-A20,12,9,0,3,12,6,0.0,1.0,0.3333333333333333,0.6666666666666666
SF-M26-2,SF-C26,2,6,0,1,2,5,0.0,1.0,0.16666666666666666,0.8333333333333334
SF-M26-2,SF-C25,3,4,1,0,2,4,0.3333333333333333,0.6666666666666666,0.0,1.0
SF-M26-2,SF-B25,5,3,0,3,5,0,0.0,1.0,1.0,0.0
SF-M26-2,SF-D27,1,4,1,1,0,3,1.0,0.0,0.25,0.75
SF-M26-2,SF-C28-1,1,5,1,4,0,1,1.0,0.0,0.8,0.2
SF-M26-2,SF-B28,5,3,4,2,1,1,0.8,0.2,0.6666666666666666,0.3333333333333333
SF-M26-2,SF-J1,2,1,0,0,2,1,0.0,1.0,0.0,1.0
SF-M26-2,SF-G7,2,1,0,0,2,1,0.0,1.0,0.0,1.0
SF-M26-2,SF-G26,2,3,1,1,1,2,0.5,0.5,0.3333333333333333,0.6666666666666666
SF-M26-2,SF-K21,128,49,105,1,23,48,0.8203125,0.1796875,0.02040816326530612,0.9795918367346939
SF-M26-2,SF-K22-1,4,6,2,0,2,6,0.5,0.5,0.0,1.0
SF-M26-2,SF-J23-1,74,43,17,10,57,33,0.22972972972972974,0.7702702702702703,0.23255813953488372,0.7674418604651163
SF-M26-2,SF-J22-1,13,52,6,36,7,16,0.46153846153846156,0.5384615384615384,0.6923076923076923,0.3076923076923077
SF-M26-2,SF-J22-2,10,23,2,3,8,20,0.2,0.8,0.13043478260869565,0.8695652173913043
SF-M26-2,SF-J21,7,7,2,3,5,4,0.2857142857142857,0.7142857142857143,0.42857142857142855,0.5714285714285714
SF-M26-2,SF-I21,1,1,0,0,1,1,0.0,1.0,0.0,1.0
SF-M26-2,SF-I23-2,6,9,3,1,3,8,0.5,0.5,0.1111111111111111,0.8888888888888888
SF-M26-2,SF-I24,1,2,1,0,0,2,1.0,0.0,0.0,1.0
SF-M26-2,SF-I23-1,1,3,0,0,1,3,0.0,1.0,0.0,1.0
SF-M26-2,SF-F26,6,8,1,2,5,6,0.16666666666666666,0.8333333333333334,0.25,0.75
SF-M26-2,SF-M15,1,2,1,0,0,2,1.0,0.0,0.0,1.0
SF-M26-2,SF-L20,3,1,1,0,2,1,0.3333333333333333,0.6666666666666666,0.0,1.0
SF-M26-2,SF-N20-1,15,8,1,0,14,8,0.06666666666666667,0.9333333333333333,0.0,1.0
SF-M26-2,SF-M20,10,2,2,0,8,2,0.2,0.8,0.0,1.0
SF-M26-2,SF-K17-2,1,1,1,0,0,1,1.0,0.0,0.0,1.0
SF-M26-2,SF-K20,1,1,1,0,0,1,1.0,0.0,0.0,1.0
SF-M26-2,SF-K15-,6,7,5,1,1,6,0.8333333333333334,0.16666666666666666,0.14285714285714285,0.8571428571428571
SF-M26-2,SF-K19,6,2,6,2,0,0,1.0,0.0,1.0,0.0
SF-M26-2,SF-K18,2,6,0,0,2,6,0.0,1.0,0.0,1.0
SF-M26-2,SF-K17,4,2,3,0,1,2,0.75,0.25,0.0,1.0
SF-M26-2,SF-J18,4,4,1,0,3,4,0.25,0.75,0.0,1.0
SF-M26-2,SF-J20,1,3,1,1,0,2,1.0,0.0,0.3333333333333333,0.6666666666666666
SF-M26-2,SF-J19,4,2,3,2,1,0,0.75,0.25,1.0,0.0
SF-M26-2,SF-M10,6,5,4,0,2,5,0.6666666666666666,0.3333333333333333,0.0,1.0
SF-M26-2,SF-Q21-2,3,5,1,1,2,4,0.3333333333333333,0.6666666666666666,0.2,0.8
SF-M26-2,SF-Q21-1,2,1,0,0,2,1,0.0,1.0,0.0,1.0
SF-M26-2,SF-P21,7,2,1,0,6,2,0.14285714285714285,0.8571428571428571,0.0,1.0
SF-M26-2,SF-O18,6,10,6,1,0,9,1.0,0.0,0.1,0.9
SF-M26-2,SF-O19,10,4,0,0,10,4,0.0,1.0,0.0,1.0
SF-M26-2,SF-O21,7,12,2,5,5,7,0.2857142857142857,0.7142857142857143,0.4166666666666667,0.5833333333333334
SF-M26-2,SF-O22,3,14,1,6,2,8,0.3333333333333333,0.6666666666666666,0.42857142857142855,0.5714285714285714
SF-M26-2,SF-N21,3,12,2,5,1,7,0.6666666666666666,0.3333333333333333,0.4166666666666667,0.5833333333333334
SF-M26-2,SF-N20-2,5,8,2,3,3,5,0.4,0.6,0.375,0.625
SF-M26-2,SF-M21,10,4,2,0,8,4,0.2,0.8,0.0,1.0
SF-M26-2,SF-L21,9,9,0,2,9,7,0.0,1.0,0.2222222222222222,0.7777777777777778
SF-M26-2,SF-Q30,8,9,3,3,5,6,0.375,0.625,0.3333333333333333,0.6666666666666666
SF-M26-2,SF-P30,9,7,0,3,9,4,0.0,1.0,0.42857142857142855,0.5714285714285714
SF-M26-2,SF-O30-2,2,5,0,3,2,2,0.0,1.0,0.6,0.4
SF-M26-2,SF-O30,29,33,7,14,22,19,0.2413793103448276,0.7586206896551724,0.42424242424242425,0.5757575757575758
SF-M26-2,SF-N27,218,121,67,60,151,61,0.3073394495412844,0.6926605504587156,0.49586776859504134,0.5041322314049587
SF-M26-2,SF-N29,24,10,13,4,11,6,0.5416666666666666,0.4583333333333333,0.4,0.6
SF-M26-2,SF-N28,26,34,15,17,11,17,0.5769230769230769,0.4230769230769231,0.5,0.5
SF-M26-2,SF-L30-1,28,33,20,23,8,10,0.7142857142857143,0.2857142857142857,0.696969696969697,0.30303030303030304
SF-M26-2,SF-L31-1,5,1,3,1,2,0,0.6,0.4,1.0,0.0
SF-M26-2,SF-K30-2,3,2,1,1,2,1,0.3333333333333333,0.6666666666666666,0.5,0.5
SF-M26-2,SF-L29,72,76,32,34,40,42,0.4444444444444444,0.5555555555555556,0.4473684210526316,0.5526315789473685
SF-M26-2,SF-J29-1,16,12,12,7,4,5,0.75,0.25,0.5833333333333334,0.4166666666666667
SF-M26-2,SF-I30,18,11,14,10,4,1,0.7777777777777778,0.2222222222222222,0.9090909090909091,0.09090909090909091
SF-M26-2,SF-I29-2,2,4,1,4,1,0,0.5,0.5,1.0,0.0
SF-M26-2,SF-I27,7,10,4,4,3,6,0.5714285714285714,0.42857142857142855,0.4,0.6
SF-M26-2,SF-I28,1,2,1,0,0,2,1.0,0.0,0.0,1.0
SF-M26-2,SF-I30-2,4,3,2,2,2,1,0.5,0.5,0.6666666666666666,0.3333333333333333
SF-M26-2,SF I29-1,2,2,0,0,2,2,0.0,1.0,0.0,1.0
SF-M26-2,SF-H28,8,5,6,2,2,3,0.75,0.25,0.4,0.6
SF-M26-2,SF-H29,2,3,1,2,1,1,0.5,0.5,0.6666666666666666,0.3333333333333333
SF-M26-2,SF-S24,4,3,0,0,4,3,0.0,1.0,0.0,1.0
SF-M26-2,SF-R24,29,26,2,4,27,22,0.06896551724137931,0.9310344827586207,0.15384615384615385,0.8461538461538461
SF-M26-2,SF-R26,2,1,0,0,2,1,0.0,1.0,0.0,1.0
SF-M26-2,SF-Q26,4,3,2,1,2,2,0.5,0.5,0.3333333333333333,0.6666666666666666
SF-M26-2,SF-P26,3,4,0,3,3,1,0.0,1.0,0.75,0.25
SF-M26-2,SF-O25-2,4,8,0,3,4,5,0.0,1.0,0.375,0.625
SF-M26-2,SF-N22-1B,6,7,3,3,3,4,0.5,0.5,0.42857142857142855,0.5714285714285714
SF-M26-2,SF-N26,4,4,1,4,3,0,0.25,0.75,1.0,0.0
SF-M26-2,SF-T22,10,6,7,6,3,0,0.7,0.3,1.0,0.0
SF-M26-2,SF-S22-2,1,4,0,1,1,3,0.0,1.0,0.25,0.75
SF-M26-2,SF-S22-1,3,7,1,4,2,3,0.3333333333333333,0.6666666666666666,0.5714285714285714,0.42857142857142855
SF-M26-2,SF-Q23-3,4,3,3,3,1,0,0.75,0.25,1.0,0.0
SF-M26-2,SF-Q22-1,8,10,4,0,4,10,0.5,0.5,0.0,1.0
SF-M26-2,SF-Q22-2,7,7,3,0,4,7,0.42857142857142855,0.5714285714285714,0.0,1.0
SF-M26-2,SF-P22,4,24,1,13,3,11,0.25,0.75,0.5416666666666666,0.4583333333333333
SF-M26-2,SF-U21,3,1,2,1,1,0,0.6666666666666666,0.3333333333333333,1.0,0.0
SF-M26-2,SF-T20,1,1,0,1,1,0,0.0,1.0,1.0,0.0
SF-L27,SF-M25,8,7,5,4,3,3,0.625,0.375,0.5714285714285714,0.42857142857142855
SF-L27,SF-M26-2,26,4,20,3,6,1,0.7692307692307693,0.23076923076923078,0.75,0.25
SF-L27,SF-K26,7,9,3,9,4,0,0.42857142857142855,0.5714285714285714,1.0,0.0
SF-L27,SF-J27,6,7,3,3,3,4,0.5,0.5,0.42857142857142855,0.5714285714285714
SF-L27,SF-M30,36,32,13,16,23,16,0.3611111111111111,0.6388888888888888,0.5,0.5
SF-L27,SF-L27-2,5,5,4,3,1,2,0.8,0.2,0.6,0.4
SF-L27,SF-J29-3,12,10,6,8,6,2,0.5,0.5,0.8,0.2
SF-L27,SF-J29,75,85,34,51,41,34,0.4533333333333333,0.5466666666666666,0.6,0.4
SF-L27,SF-L26,4,5,3,4,1,1,0.75,0.25,0.8,0.2
SF-L27,SF-M28,22,18,16,7,6,11,0.7272727272727273,0.2727272727272727,0.3888888888888889,0.6111111111111112
SF-L27,SF-L25,5,4,5,4,0,0,1.0,0.0,1.0,0.0
SF-L27,SF-M24,1,4,1,2,0,2,1.0,0.0,0.5,0.5
SF-L27,SF-L24,9,11,5,7,4,4,0.5555555555555556,0.4444444444444444,0.6363636363636364,0.36363636363636365
SF-L27,SF-N23,1,3,1,3,0,0,1.0,0.0,1.0,0.0
SF-L27,SF-N24-2,2,4,2,1,0,3,1.0,0.0,0.25,0.75
SF-L27,SF-K27-2,12,5,9,4,3,1,0.75,0.25,0.8,0.2
SF-L27,SF-J26-2,4,9,1,4,3,5,0.25,0.75,0.4444444444444444,0.5555555555555556
SF-L27,SF-K28-3,7,11,6,7,1,4,0.8571428571428571,0.14285714285714285,0.6363636363636364,0.36363636363636365
SF-L27,SF-L28,5,11,5,10,0,1,1.0,0.0,0.9090909090909091,0.09090909090909091
SF-L27,SF-K28,22,16,16,8,6,8,0.7272727272727273,0.2727272727272727,0.5,0.5
SF-L27,SF-K29-1,16,12,8,8,8,4,0.5,0.5,0.6666666666666666,0.3333333333333333
SF-L27,SF-J28-2,12,4,6,2,6,2,0.5,0.5,0.5,0.5
SF-L27,SF-K27,4,4,0,4,4,0,0.0,1.0,1.0,0.0
SF-L27,SF-K25,3,1,1,0,2,1,0.3333333333333333,0.6666666666666666,0.0,1.0
SF-L27,SF-J25,3,6,2,3,1,3,0.6666666666666666,0.3333333333333333,0.5,0.5
SF-L27,SF-H26-2,2,5,2,0,0,5,1.0,0.0,0.0,1.0
SF-L27,SF-N22-1A,1,1,0,0,1,1,0.0,1.0,0.0,1.0
SF-L27,SF-J24,9,8,7,4,2,4,0.7777777777777778,0.2222222222222222,0.5,0.5
SF-L27,SF-J26,24,17,10,10,14,7,0.4166666666666667,0.5833333333333334,0.5882352941176471,0.4117647058823529
SF-L27,SF-I25,2,11,2,4,0,7,1.0,0.0,0.36363636363636365,0.6363636363636364
SF-L27,SF-H26,8,10,4,4,4,6,0.5,0.5,0.4,0.6
SF-L27,SF-O23,1,3,0,1,1,2,0.0,1.0,0.3333333333333333,0.6666666666666666
SF-L27,SF-H27-1,5,6,3,4,2,2,0.6,0.4,0.6666666666666666,0.3333333333333333
SF-L27,SF-F28-2,5,13,2,2,3,11,0.4,0.6,0.15384615384615385,0.8461538461538461
SF-L27,SF-G27,9,8,0,4,9,4,0.0,1.0,0.5,0.5
SF-L27,SF-M22-2,5,1,4,0,1,1,0.8,0.2,0.0,1.0
SF-L27,SF-L22,2,3,2,2,0,1,1.0,0.0,0.6666666666666666,0.3333333333333333
SF-L27,SF-F27,19,5,1,2,18,3,0.05263157894736842,0.9473684210526315,0.4,0.6
SF-L27,SF-N22-2,4,8,0,4,4,4,0.0,1.0,0.5,0.5
SF-L27,SF-G28-2,3,8,1,0,2,8,0.3333333333333333,0.6666666666666666,0.0,1.0
SF-L27,SF-G28-1,2,3,0,0,2,3,0.0,1.0,0.0,1.0
SF-L27,SF-M22-1,6,3,4,1,2,2,0.6666666666666666,0.3333333333333333,0.3333333333333333,0.6666666666666666
SF-L27,SF-O25-1,1,2,0,0,1,2,0.0,1.0,0.0,1.0
SF-L27,SF-K24,4,10,3,7,1,3,0.75,0.25,0.7,0.3
SF-L27,SF-J23-2,2,1,2,0,0,1,1.0,0.0,0.0,1.0
SF-L27,SF-G23,9,1,0,0,9,1,0.0,1.0,0.0,1.0
SF-L27,SF-G24,6,1,4,1,2,0,0.6666666666666666,0.3333333333333333,1.0,0.0
SF-L27,SF-G25,4,3,0,0,4,3,0.0,1.0,0.0,1.0
SF-L27,SF-E23,4,1,1,0,3,1,0.25,0.75,0.0,1.0
SF-L27,SF-J17,1,4,0,0,1,4,0.0,1.0,0.0,1.0
SF-L27,SF-I20,1,1,0,0,1,1,0.0,1.0,0.0,1.0
SF-L27,SF-H20,8,1,8,0,0,1,1.0,0.0,0.0,1.0
SF-L27,SF-G19,2,4,2,1,0,3,1.0,0.0,0.25,0.75
SF-L27,SF-G18,4,1,1,0,3,1,0.25,0.75,0.0,1.0
SF-L27,SF-G20,1,3,1,0,0,3,1.0,0.0,0.0,1.0
SF-L27,SF-H30,7,8,5,5,2,3,0.7142857142857143,0.2857142857142857,0.625,0.375
SF-L27,SF-G30-2,14,9,8,6,6,3,0.5714285714285714,0.42857142857142855,0.6666666666666666,0.3333333333333333
SF-L27,SF-F30-1,5,5,4,1,1,4,0.8,0.2,0.2,0.8
SF-L27,SF-E29-2,5,2,2,2,3,0,0.4,0.6,1.0,0.0
SF-L27,SF-E29-1,9,6,3,4,6,2,0.3333333333333333,0.6666666666666666,0.6666666666666666,0.3333333333333333
SF-L27,SF-D29,2,12,2,9,0,3,1.0,0.0,0.75,0.25
SF-L27,SF-D28,1,2,0,0,1,2,0.0,1.0,0.0,1.0
SF-L27,SF-A27,6,1,6,0,0,1,1.0,0.0,0.0,1.0
SF-L27,SF-G29-2,5,13,3,4,2,9,0.6,0.4,0.3076923076923077,0.6923076923076923
SF-L27,SF-G29-1,4,8,2,0,2,8,0.5,0.5,0.0,1.0
SF-L27,SF-G30-1,14,23,7,7,7,16,0.5,0.5,0.30434782608695654,0.6956521739130435
SF-L27,SF-G29-3,4,1,2,0,2,1,0.5,0.5,0.0,1.0
SF-L27,SF-F29,2,1,0,0,2,1,0.0,1.0,0.0,1.0
SF-L27,SF-F15,1,1,0,0,1,1,0.0,1.0,0.0,1.0
SF-L27,SF-B21,1,1,1,1,0,0,1.0,0.0,1.0,0.0
SF-L27,SF-C26,1,6,0,1,1,5,0.0,1.0,0.16666666666666666,0.8333333333333334
SF-L27,SF-C25,1,1,0,0,1,1,0.0,1.0,0.0,1.0
SF-L27,SF-B25,1,2,1,2,0,0,1.0,0.0,1.0,0.0
SF-L27,SF-D27,2,1,2,0,0,1,1.0,0.0,0.0,1.0
SF-L27,SF-C28-1,3,3,2,3,1,0,0.6666666666666666,0.3333333333333333,1.0,0.0
SF-L27,SF-B28,5,6,3,6,2,0,0.6,0.4,1.0,0.0
SF-L27,SF-H25,1,1,0,0,1,1,0.0,1.0,0.0,1.0
SF-L27,SF-K21,2,1,0,0,2,1,0.0,1.0,0.0,1.0
SF-L27,SF-K22-1,5,6,1,4,4,2,0.2,0.8,0.6666666666666666,0.3333333333333333
SF-L27,SF-J23-1,8,6,6,2,2,4,0.75,0.25,0.3333333333333333,0.6666666666666666
SF-L27,SF-J22-1,2,5,0,1,2,4,0.0,1.0,0.2,0.8
SF-L27,SF-J22-2,4,5,1,3,3,2,0.25,0.75,0.6,0.4
SF-L27,SF-J21,2,1,2,0,0,1,1.0,0.0,0.0,1.0
SF-L27,SF-I23-2,2,1,2,1,0,0,1.0,0.0,1.0,0.0
SF-L27,SF-I24,6,2,4,1,2,1,0.6666666666666666,0.3333333333333333,0.5,0.5
SF-L27,SF-I23-1,57,29,23,1,34,28,0.40350877192982454,0.5964912280701754,0.034482758620689655,0.9655172413793104
SF-L27,SF-F26,5,2,2,1,3,1,0.4,0.6,0.5,0.5
SF-L27,SF-M13,1,1,0,1,1,0,0.0,1.0,1.0,0.0
SF-L27,SF-L19,7,1,2,1,5,0,0.2857142857142857,0.7142857142857143,1.0,0.0
SF-L27,SF-N20-1,1,3,1,2,0,1,1.0,0.0,0.6666666666666666,0.3333333333333333
SF-L27,SF-K15-,3,4,2,1,1,3,0.6666666666666666,0.3333333333333333,0.25,0.75
SF-L27,SF-K19,1,1,1,0,0,1,1.0,0.0,0.0,1.0
SF-L27,SF-K18,1,3,1,0,0,3,1.0,0.0,0.0,1.0
SF-L27,SF-J16,1,2,1,0,0,2,1.0,0.0,0.0,1.0
SF-L27,SF-J20,1,2,1,2,0,0,1.0,0.0,1.0,0.0
SF-L27,SF-J19,3,3,1,0,2,3,0.3333333333333333,0.6666666666666666,0.0,1.0
SF-L27,SF-R19,2,4,0,0,2,4,0.0,1.0,0.0,1.0
SF-L27,SF-Q21-2,2,1,1,1,1,0,0.5,0.5,1.0,0.0
SF-L27,SF-O18,3,13,0,1,3,12,0.0,1.0,0.07692307692307693,0.9230769230769231
SF-L27,SF-O21,1,4,1,3,0,1,1.0,0.0,0.75,0.25
SF-L27,SF-O22,2,6,0,2,2,4,0.0,1.0,0.3333333333333333,0.6666666666666666
SF-L27,SF-N21,2,6,1,2,1,4,0.5,0.5,0.3333333333333333,0.6666666666666666
SF-L27,SF-M21,3,4,2,2,1,2,0.6666666666666666,0.3333333333333333,0.5,0.5
SF-L27,SF-L21,2,3,0,0,2,3,0.0,1.0,0.0,1.0
SF-L27,SF-Q30,2,4,0,1,2,3,0.0,1.0,0.25,0.75
SF-L27,SF-P30,1,4,0,0,1,4,0.0,1.0,0.0,1.0
SF-L27,SF-O30,11,10,9,6,2,4,0.8181818181818182,0.18181818181818182,0.6,0.4
SF-L27,SF-N27,25,23,20,19,5,4,0.8,0.2,0.8260869565217391,0.17391304347826086
SF-L27,SF-N29,2,4,0,3,2,1,0.0,1.0,0.75,0.25
SF-L27,SF-L30-1,22,13,13,6,9,7,0.5909090909090909,0.4090909090909091,0.46153846153846156,0.5384615384615384
SF-L27,SF-L31-1,2,3,2,3,0,0,1.0,0.0,1.0,0.0
SF-L27,SF-K30-2,16,2,12,2,4,0,0.75,0.25,1.0,0.0
SF-L27,SF-L29,5,12,4,9,1,3,0.8,0.2,0.75,0.25
SF-L27,SF-J29-1,18,20,14,13,4,7,0.7777777777777778,0.2222222222222222,0.65,0.35
SF-L27,SF-I30,16,12,6,7,10,5,0.375,0.625,0.5833333333333334,0.4166666666666667
SF-L27,SF-I27,8,35,4,25,4,10,0.5,0.5,0.7142857142857143,0.2857142857142857
SF-L27,SF-I28,2,4,1,4,1,0,0.5,0.5,1.0,0.0
SF-L27,SF-I30-2,20,4,4,1,16,3,0.2,0.8,0.25,0.75
SF-L27,SF I29-1,4,1,0,1,4,0,0.0,1.0,1.0,0.0
SF-L27,SF-H28,8,13,3,5,5,8,0.375,0.625,0.38461538461538464,0.6153846153846154
SF-L27,SF-H29,1,1,1,0,0,1,1.0,0.0,0.0,1.0
SF-L27,SF-R24,4,5,3,4,1,1,0.75,0.25,0.8,0.2
SF-L27,SF-Q26,1,2,0,0,1,2,0.0,1.0,0.0,1.0
SF-L27,SF-N22-1B,2,1,1,0,1,1,0.5,0.5,0.0,1.0
SF-L27,SF-S22-1,7,2,1,0,6,2,0.14285714285714285,0.8571428571428571,0.0,1.0
SF-L27,SF-Q22-2,1,2,0,0,1,2,0.0,1.0,0.0,1.0
SF-L27,SF-P22,1,3,0,1,1,2,0.0,1.0,0.3333333333333333,0.6666666666666666
SF-K26,SF-M26,4,9,4,9,0,0,1.0,0.0,1.0,0.0
SF-K26,SF-M25,30,34,14,14,16,20,0.4666666666666667,0.5333333333333333,0.4117647058823529,0.5882352941176471
SF-K26,SF-M26-2,11,19,8,5,3,14,0.7272727272727273,0.2727272727272727,0.2631578947368421,0.7368421052631579
SF-K26,SF-L27,9,7,9,3,0,4,1.0,0.0,0.42857142857142855,0.5714285714285714
SF-K26,SF-J27,8,11,6,7,2,4,0.75,0.25,0.6363636363636364,0.36363636363636365
SF-K26,SF-M30,47,17,36,11,11,6,0.7659574468085106,0.23404255319148937,0.6470588235294118,0.35294117647058826
SF-K26,SF-L27-2,5,3,4,3,1,0,0.8,0.2,1.0,0.0
SF-K26,SF-J29-3,8,18,3,11,5,7,0.375,0.625,0.6111111111111112,0.3888888888888889
SF-K26,SF-J29,22,46,11,18,11,28,0.5,0.5,0.391304347826087,0.6086956521739131
SF-K26,SF-L26,16,5,7,2,9,3,0.4375,0.5625,0.4,0.6
SF-K26,SF-M28,50,47,31,14,19,33,0.62,0.38,0.2978723404255319,0.7021276595744681
SF-K26,SF-M27,4,8,4,6,0,2,1.0,0.0,0.75,0.25
SF-K26,SF-L25,8,20,2,12,6,8,0.25,0.75,0.6,0.4
SF-K26,SF-M24,11,17,7,11,4,6,0.6363636363636364,0.36363636363636365,0.6470588235294118,0.35294117647058826
SF-K26,SF-L24,23,27,19,14,4,13,0.8260869565217391,0.17391304347826086,0.5185185185185185,0.48148148148148145
SF-K26,SF-N23,7,10,3,6,4,4,0.42857142857142855,0.5714285714285714,0.6,0.4
SF-K26,SF-N24-2,3,7,0,1,3,6,0.0,1.0,0.14285714285714285,0.8571428571428571
SF-K26,SF-K27-2,30,23,21,19,9,4,0.7,0.3,0.8260869565217391,0.17391304347826086
SF-K26,SF-J26-2,18,17,13,11,5,6,0.7222222222222222,0.2777777777777778,0.6470588235294118,0.35294117647058826
SF-K26,SF-K28-3,5,5,5,4,0,1,1.0,0.0,0.8,0.2
SF-K26,SF-L28,51,57,41,49,10,8,0.803921568627451,0.19607843137254902,0.8596491228070176,0.14035087719298245
SF-K26,SF-K28,25,31,11,8,14,23,0.44,0.56,0.25806451612903225,0.7419354838709677
SF-K26,SF-K29-1,17,37,6,27,11,10,0.35294117647058826,0.6470588235294118,0.7297297297297297,0.2702702702702703
SF-K26,SF-J28-2,62,46,43,33,19,13,0.6935483870967742,0.3064516129032258,0.717391304347826,0.2826086956521739
SF-K26,SF-K27,10,6,6,6,4,0,0.6,0.4,1.0,0.0
SF-K26,SF-K25,24,18,18,12,6,6,0.75,0.25,0.6666666666666666,0.3333333333333333
SF-K26,SF-J25,119,57,84,28,35,29,0.7058823529411765,0.29411764705882354,0.49122807017543857,0.5087719298245614
SF-K26,SF-H26-2,11,8,8,5,3,3,0.7272727272727273,0.2727272727272727,0.625,0.375
SF-K26,SF-P24,10,15,10,9,0,6,1.0,0.0,0.6,0.4
SF-K26,SF-N22-1A,1,1,0,1,1,0,0.0,1.0,1.0,0.0
SF-K26,SF-J24,112,57,75,22,37,35,0.6696428571428571,0.33035714285714285,0.38596491228070173,0.6140350877192983
SF-K26,SF-O24,3,5,2,3,1,2,0.6666666666666666,0.3333333333333333,0.6,0.4
SF-K26,SF-J26,14,13,5,5,9,8,0.35714285714285715,0.6428571428571429,0.38461538461538464,0.6153846153846154
SF-K26,SF-I26-,4,5,2,0,2,5,0.5,0.5,0.0,1.0
SF-K26,SF-I25,69,57,27,12,42,45,0.391304347826087,0.6086956521739131,0.21052631578947367,0.7894736842105263
SF-K26,SF-K23,3,4,3,4,0,0,1.0,0.0,1.0,0.0
SF-K26,SF-H26,23,16,13,6,10,10,0.5652173913043478,0.43478260869565216,0.375,0.625
SF-K26,SF-O23,10,12,6,7,4,5,0.6,0.4,0.5833333333333334,0.4166666666666667
SF-K26,SF-H27-1,4,4,3,3,1,1,0.75,0.25,0.75,0.25
SF-K26,SF-F28-2,5,10,1,1,4,9,0.2,0.8,0.1,0.9
SF-K26,SF-G27,32,28,19,7,13,21,0.59375,0.40625,0.25,0.75
SF-K26,SF-M22-2,11,10,4,3,7,7,0.36363636363636365,0.6363636363636364,0.3,0.7
SF-K26,SF-L22,8,4,5,2,3,2,0.625,0.375,0.5,0.5
SF-K26,SF-F27,16,8,7,2,9,6,0.4375,0.5625,0.25,0.75
SF-K26,SF-N22-2,33,40,15,23,18,17,0.45454545454545453,0.5454545454545454,0.575,0.425
SF-K26,SF-G28-2,3,2,2,2,1,0,0.6666666666666666,0.3333333333333333,1.0,0.0
SF-K26,SF-G28-1,2,2,2,1,0,1,1.0,0.0,0.5,0.5
SF-K26,SF-M22-1,5,16,2,8,3,8,0.4,0.6,0.5,0.5
SF-K26,SF-O25-1,4,9,1,1,3,8,0.25,0.75,0.1111111111111111,0.8888888888888888
SF-K26,SF-K22-2,23,16,17,10,6,6,0.7391304347826086,0.2608695652173913,0.625,0.375
SF-K26,SF-K24,18,14,13,9,5,5,0.7222222222222222,0.2777777777777778,0.6428571428571429,0.35714285714285715
SF-K26,SF-J23-2,15,14,12,9,3,5,0.8,0.2,0.6428571428571429,0.35714285714285715
SF-K26,SF-G23,55,15,13,2,42,13,0.23636363636363636,0.7636363636363637,0.13333333333333333,0.8666666666666667
SF-K26,SF-G24,171,59,153,3,18,56,0.8947368421052632,0.10526315789473684,0.05084745762711865,0.9491525423728814
SF-K26,SF-G25,77,15,13,0,64,15,0.16883116883116883,0.8311688311688312,0.0,1.0
SF-K26,SF-F23,14,10,7,3,7,7,0.5,0.5,0.3,0.7
SF-K26,SF-E23,13,8,7,2,6,6,0.5384615384615384,0.46153846153846156,0.25,0.75
SF-K26,SF-J17,10,3,5,1,5,2,0.5,0.5,0.3333333333333333,0.6666666666666666
SF-K26,SF-I19,3,1,1,0,2,1,0.3333333333333333,0.6666666666666666,0.0,1.0
SF-K26,SF-I20,6,2,1,1,5,1,0.16666666666666666,0.8333333333333334,0.5,0.5
SF-K26,SF-H20,28,10,21,1,7,9,0.75,0.25,0.1,0.9
SF-K26,SF-H18,1,1,1,1,0,0,1.0,0.0,1.0,0.0
SF-K26,SF-G19,12,3,3,0,9,3,0.25,0.75,0.0,1.0
SF-K26,SF-G17,7,2,2,0,5,2,0.2857142857142857,0.7142857142857143,0.0,1.0
SF-K26,SF-G20,9,5,6,1,3,4,0.6666666666666666,0.3333333333333333,0.2,0.8
SF-K26,SF-F19,3,4,0,1,3,3,0.0,1.0,0.25,0.75
SF-K26,SF-E18,3,1,2,1,1,0,0.6666666666666666,0.3333333333333333,1.0,0.0
SF-K26,SF-E20,6,2,1,1,5,1,0.16666666666666666,0.8333333333333334,0.5,0.5
SF-K26,SF-H30,6,1,2,1,4,0,0.3333333333333333,0.6666666666666666,1.0,0.0
SF-K26,SF-G30-2,32,9,23,4,9,5,0.71875,0.28125,0.4444444444444444,0.5555555555555556
SF-K26,SF-F30-1,9,2,4,0,5,2,0.4444444444444444,0.5555555555555556,0.0,1.0
SF-K26,SF-E29-2,11,3,5,1,6,2,0.45454545454545453,0.5454545454545454,0.3333333333333333,0.6666666666666666
SF-K26,SF-E29-1,5,11,3,6,2,5,0.6,0.4,0.5454545454545454,0.45454545454545453
SF-K26,SF-D29,8,8,3,3,5,5,0.375,0.625,0.375,0.625
SF-K26,SF-D28,1,3,1,3,0,0,1.0,0.0,1.0,0.0
SF-K26,SF-A27,3,4,2,2,1,2,0.6666666666666666,0.3333333333333333,0.5,0.5
SF-K26,SF-G29-2,15,13,3,6,12,7,0.2,0.8,0.46153846153846156,0.5384615384615384
SF-K26,SF-G29-1,15,12,9,2,6,10,0.6,0.4,0.16666666666666666,0.8333333333333334
SF-K26,SF-G30-1,19,34,5,8,14,26,0.2631578947368421,0.7368421052631579,0.23529411764705882,0.7647058823529411
SF-K26,SF-G29-3,7,7,3,4,4,3,0.42857142857142855,0.5714285714285714,0.5714285714285714,0.42857142857142855
SF-K26,SF-F29,3,2,0,0,3,2,0.0,1.0,0.0,1.0
SF-K26,SF-F28-1,2,3,0,1,2,2,0.0,1.0,0.3333333333333333,0.6666666666666666
SF-K26,SF-E28-2,2,1,0,0,2,1,0.0,1.0,0.0,1.0
SF-K26,SF-E28,4,3,4,0,0,3,1.0,0.0,0.0,1.0
SF-K26,SF-J13,4,1,0,0,4,1,0.0,1.0,0.0,1.0
SF-K26,SF-J15,6,2,3,2,3,0,0.5,0.5,1.0,0.0
SF-K26,SF-G12,1,1,0,0,1,1,0.0,1.0,0.0,1.0
SF-K26,SF-G10-1,2,1,1,0,1,1,0.5,0.5,0.0,1.0
SF-K26,SF-F16,4,1,4,0,0,1,1.0,0.0,0.0,1.0
SF-K26,SF-C20,1,1,0,1,1,0,0.0,1.0,1.0,0.0
SF-K26,SF-B21,3,1,0,0,3,1,0.0,1.0,0.0,1.0
SF-K26,SF-B19,1,1,0,0,1,1,0.0,1.0,0.0,1.0
SF-K26,SF-A20,14,13,0,3,14,10,0.0,1.0,0.23076923076923078,0.7692307692307693
SF-K26,SF-C26,7,7,5,0,2,7,0.7142857142857143,0.2857142857142857,0.0,1.0
SF-K26,SF-C25,75,7,2,0,73,7,0.02666666666666667,0.9733333333333334,0.0,1.0
SF-K26,SF-B25,3,6,1,2,2,4,0.3333333333333333,0.6666666666666666,0.3333333333333333,0.6666666666666666
SF-K26,SF-E27,3,4,2,0,1,4,0.6666666666666666,0.3333333333333333,0.0,1.0
SF-K26,SF-D27,4,5,2,3,2,2,0.5,0.5,0.6,0.4
SF-K26,SF-C28-1,1,2,0,0,1,2,0.0,1.0,0.0,1.0
SF-K26,SF-B28,1,7,1,5,0,2,1.0,0.0,0.7142857142857143,0.2857142857142857
SF-K26,SF-J1,5,2,3,1,2,1,0.6,0.4,0.5,0.5
SF-K26,SF-G8,2,1,0,0,2,1,0.0,1.0,0.0,1.0
SF-K26,SF-H25,9,4,3,2,6,2,0.3333333333333333,0.6666666666666666,0.5,0.5
SF-K26,SF-G26,7,5,2,1,5,4,0.2857142857142857,0.7142857142857143,0.2,0.8
SF-K26,SF-K21,41,10,12,1,29,9,0.2926829268292683,0.7073170731707317,0.1,0.9
SF-K26,SF-K22-1,11,11,7,6,4,5,0.6363636363636364,0.36363636363636365,0.5454545454545454,0.45454545454545453
SF-K26,SF-J23-1,106,45,52,21,54,24,0.49056603773584906,0.5094339622641509,0.4666666666666667,0.5333333333333333
SF-K26,SF-J22-1,47,35,14,13,33,22,0.2978723404255319,0.7021276595744681,0.37142857142857144,0.6285714285714286
SF-K26,SF-J22-2,23,16,15,5,8,11,0.6521739130434783,0.34782608695652173,0.3125,0.6875
SF-K26,SF-J21,29,24,20,13,9,11,0.6896551724137931,0.3103448275862069,0.5416666666666666,0.4583333333333333
SF-K26,SF-I21,4,1,2,0,2,1,0.5,0.5,0.0,1.0
SF-K26,SF-I22,5,4,1,4,4,0,0.2,0.8,1.0,0.0
SF-K26,SF-I23-2,15,9,10,4,5,5,0.6666666666666666,0.3333333333333333,0.4444444444444444,0.5555555555555556
SF-K26,SF-I24,35,17,25,8,10,9,0.7142857142857143,0.2857142857142857,0.47058823529411764,0.5294117647058824
SF-K26,SF-I23-1,7,31,5,4,2,27,0.7142857142857143,0.2857142857142857,0.12903225806451613,0.8709677419354839
SF-K26,SF-F26,21,11,9,3,12,8,0.42857142857142855,0.5714285714285714,0.2727272727272727,0.7272727272727273
SF-K26,SF-M13,3,2,1,0,2,2,0.3333333333333333,0.6666666666666666,0.0,1.0
SF-K26,SF-M15,13,5,4,0,9,5,0.3076923076923077,0.6923076923076923,0.0,1.0
SF-K26,SF-L19,8,5,2,0,6,5,0.25,0.75,0.0,1.0
SF-K26,SF-L20,12,14,5,4,7,10,0.4166666666666667,0.5833333333333334,0.2857142857142857,0.7142857142857143
SF-K26,SF-N20-1,5,7,2,1,3,6,0.4,0.6,0.14285714285714285,0.8571428571428571
SF-K26,SF-M20,22,11,8,4,14,7,0.36363636363636365,0.6363636363636364,0.36363636363636365,0.6363636363636364
SF-K26,SF-K20,22,7,11,1,11,6,0.5,0.5,0.14285714285714285,0.8571428571428571
SF-K26,SF-K15-,23,9,17,0,6,9,0.7391304347826086,0.2608695652173913,0.0,1.0
SF-K26,SF-K19,6,4,2,0,4,4,0.3333333333333333,0.6666666666666666,0.0,1.0
SF-K26,SF-K18,7,3,2,0,5,3,0.2857142857142857,0.7142857142857143,0.0,1.0
SF-K26,SF-K17,5,7,2,1,3,6,0.4,0.6,0.14285714285714285,0.8571428571428571
SF-K26,SF-J18,8,5,4,0,4,5,0.5,0.5,0.0,1.0
SF-K26,SF-J20,14,7,4,3,10,4,0.2857142857142857,0.7142857142857143,0.42857142857142855,0.5714285714285714
SF-K26,SF-J19,45,22,10,1,35,21,0.2222222222222222,0.7777777777777778,0.045454545454545456,0.9545454545454546
SF-K26,SF-M12,4,3,0,0,4,3,0.0,1.0,0.0,1.0
SF-K26,SF-M10,2,1,0,0,2,1,0.0,1.0,0.0,1.0
SF-K26,SF-R19,2,3,1,0,1,3,0.5,0.5,0.0,1.0
SF-K26,SF-R20,4,2,1,0,3,2,0.25,0.75,0.0,1.0
SF-K26,SF-Q21-2,2,3,1,0,1,3,0.5,0.5,0.0,1.0
SF-K26,SF-Q21-1,4,11,1,4,3,7,0.25,0.75,0.36363636363636365,0.6363636363636364
SF-K26,SF-P21,13,3,5,0,8,3,0.38461538461538464,0.6153846153846154,0.0,1.0
SF-K26,SF-O18,26,76,18,1,8,75,0.6923076923076923,0.3076923076923077,0.013157894736842105,0.9868421052631579
SF-K26,SF-O19,9,7,3,3,6,4,0.3333333333333333,0.6666666666666666,0.42857142857142855,0.5714285714285714
SF-K26,SF-O21,23,20,2,7,21,13,0.08695652173913043,0.9130434782608695,0.35,0.65
SF-K26,SF-O22,20,14,4,1,16,13,0.2,0.8,0.07142857142857142,0.9285714285714286
SF-K26,SF-N21,12,23,11,7,1,16,0.9166666666666666,0.08333333333333333,0.30434782608695654,0.6956521739130435
SF-K26,SF-N20-2,3,4,1,0,2,4,0.3333333333333333,0.6666666666666666,0.0,1.0
SF-K26,SF-M21,13,13,4,5,9,8,0.3076923076923077,0.6923076923076923,0.38461538461538464,0.6153846153846154
SF-K26,SF-L21,19,10,9,2,10,8,0.47368421052631576,0.5263157894736842,0.2,0.8
SF-K26,SF-Q30,25,23,9,11,16,12,0.36,0.64,0.4782608695652174,0.5217391304347826
SF-K26,SF-P30,12,12,6,6,6,6,0.5,0.5,0.5,0.5
SF-K26,SF-O30-2,6,6,3,3,3,3,0.5,0.5,0.5,0.5
SF-K26,SF-O30,48,56,22,24,26,32,0.4583333333333333,0.5416666666666666,0.42857142857142855,0.5714285714285714
SF-K26,SF-N27,44,47,28,28,16,19,0.6363636363636364,0.36363636363636365,0.5957446808510638,0.40425531914893614
SF-K26,SF-N29,7,8,3,6,4,2,0.42857142857142855,0.5714285714285714,0.75,0.25
SF-K26,SF-N28,17,29,11,18,6,11,0.6470588235294118,0.35294117647058826,0.6206896551724138,0.3793103448275862
SF-K26,SF-L30-1,88,113,74,87,14,26,0.8409090909090909,0.1590909090909091,0.7699115044247787,0.23008849557522124
SF-K26,SF-L31-1,56,58,19,26,37,32,0.3392857142857143,0.6607142857142857,0.4482758620689655,0.5517241379310345
SF-K26,SF-K30-2,9,10,5,3,4,7,0.5555555555555556,0.4444444444444444,0.3,0.7
SF-K26,SF-L29,22,51,16,39,6,12,0.7272727272727273,0.2727272727272727,0.7647058823529411,0.23529411764705882
SF-K26,SF-J29-1,18,4,14,0,4,4,0.7777777777777778,0.2222222222222222,0.0,1.0
SF-K26,SF-I30,14,22,9,15,5,7,0.6428571428571429,0.35714285714285715,0.6818181818181818,0.3181818181818182
SF-K26,SF-I29-2,7,9,2,5,5,4,0.2857142857142857,0.7142857142857143,0.5555555555555556,0.4444444444444444
SF-K26,SF-I27,7,8,3,4,4,4,0.42857142857142855,0.5714285714285714,0.5,0.5
SF-K26,SF-I28,25,9,23,4,2,5,0.92,0.08,0.4444444444444444,0.5555555555555556
SF-K26,SF-I30-2,15,25,6,18,9,7,0.4,0.6,0.72,0.28
SF-K26,SF I29-1,3,1,0,0,3,1,0.0,1.0,0.0,1.0
SF-K26,SF-H28,8,9,4,3,4,6,0.5,0.5,0.3333333333333333,0.6666666666666666
SF-K26,SF-S24,15,10,5,4,10,6,0.3333333333333333,0.6666666666666666,0.4,0.6
SF-K26,SF-R24,11,21,9,7,2,14,0.8181818181818182,0.18181818181818182,0.3333333333333333,0.6666666666666666
SF-K26,SF-R26,3,7,3,2,0,5,1.0,0.0,0.2857142857142857,0.7142857142857143
SF-K26,SF-Q26,8,6,1,0,7,6,0.125,0.875,0.0,1.0
SF-K26,SF-P26,9,8,2,0,7,8,0.2222222222222222,0.7777777777777778,0.0,1.0
SF-K26,SF-O25-2,14,18,5,8,9,10,0.35714285714285715,0.6428571428571429,0.4444444444444444,0.5555555555555556
SF-K26,SF-N22-1B,3,4,2,3,1,1,0.6666666666666666,0.3333333333333333,0.75,0.25
SF-K26,SF-N26,13,8,1,1,12,7,0.07692307692307693,0.9230769230769231,0.125,0.875
SF-K26,SF-N25,12,4,4,0,8,4,0.3333333333333333,0.6666666666666666,0.0,1.0
SF-K26,SF-T21,2,11,0,1,2,10,0.0,1.0,0.09090909090909091,0.9090909090909091
SF-K26,SF-T22,3,4,1,1,2,3,0.3333333333333333,0.6666666666666666,0.25,0.75
SF-K26,SF-S22-2,2,3,2,1,0,2,1.0,0.0,0.3333333333333333,0.6666666666666666
SF-K26,SF-Q23-3,4,10,1,3,3,7,0.25,0.75,0.3,0.7
SF-K26,SF-Q22-1,12,11,4,2,8,9,0.3333333333333333,0.6666666666666666,0.18181818181818182,0.8181818181818182
SF-K26,SF-Q22-2,11,11,2,4,9,7,0.18181818181818182,0.8181818181818182,0.36363636363636365,0.6363636363636364
SF-K26,SF-P22,14,19,5,11,9,8,0.35714285714285715,0.6428571428571429,0.5789473684210527,0.42105263157894735
SF-K26,SF-W19,5,6,0,0,5,6,0.0,1.0,0.0,1.0
SF-K26,SF-S21,2,3,0,0,2,3,0.0,1.0,0.0,1.0
SF-K26,SF-V32,3,1,2,1,1,0,0.6666666666666666,0.3333333333333333,1.0,0.0
SF-J27,SF-M26,1,4,0,4,1,0,0.0,1.0,1.0,0.0
SF-J27,SF-M25,4,10,3,6,1,4,0.75,0.25,0.6,0.4
SF-J27,SF-M26-2,4,4,2,1,2,3,0.5,0.5,0.25,0.75
SF-J27,SF-L27,7,6,3,3,4,3,0.42857142857142855,0.5714285714285714,0.5,0.5
SF-J27,SF-K26,11,8,7,6,4,2,0.6363636363636364,0.36363636363636365,0.75,0.25
SF-J27,SF-M30,6,3,0,2,6,1,0.0,1.0,0.6666666666666666,0.3333333333333333
SF-J27,SF-L27-2,6,2,2,1,4,1,0.3333333333333333,0.6666666666666666,0.5,0.5
SF-J27,SF-J29-3,7,17,3,7,4,10,0.42857142857142855,0.5714285714285714,0.4117647058823529,0.5882352941176471
SF-J27,SF-J29,18,36,6,8,12,28,0.3333333333333333,0.6666666666666666,0.2222222222222222,0.7777777777777778
SF-J27,SF-L26,4,3,1,2,3,1,0.25,0.75,0.6666666666666666,0.3333333333333333
SF-J27,SF-M28,6,9,3,3,3,6,0.5,0.5,0.3333333333333333,0.6666666666666666
SF-J27,SF-L25,5,6,2,3,3,3,0.4,0.6,0.5,0.5
SF-J27,SF-M24,5,2,2,1,3,1,0.4,0.6,0.5,0.5
SF-J27,SF-L24,10,4,7,2,3,2,0.7,0.3,0.5,0.5
SF-J27,SF-K27-2,22,24,17,21,5,3,0.7727272727272727,0.22727272727272727,0.875,0.125
SF-J27,SF-J26-2,7,13,2,9,5,4,0.2857142857142857,0.7142857142857143,0.6923076923076923,0.3076923076923077
SF-J27,SF-K28-3,1,1,1,1,0,0,1.0,0.0,1.0,0.0
SF-J27,SF-L28,5,41,3,12,2,29,0.6,0.4,0.2926829268292683,0.7073170731707317
SF-J27,SF-K28,8,5,1,0,7,5,0.125,0.875,0.0,1.0
SF-J27,SF-K29-1,29,19,14,10,15,9,0.4827586206896552,0.5172413793103449,0.5263157894736842,0.47368421052631576
SF-J27,SF-J28-2,8,7,3,4,5,3,0.375,0.625,0.5714285714285714,0.42857142857142855
SF-J27,SF-K27,5,7,4,2,1,5,0.8,0.2,0.2857142857142857,0.7142857142857143
SF-J27,SF-K25,13,18,8,18,5,0,0.6153846153846154,0.38461538461538464,1.0,0.0
SF-J27,SF-J25,10,18,4,11,6,7,0.4,0.6,0.6111111111111112,0.3888888888888889
SF-J27,SF-H26-2,10,9,7,7,3,2,0.7,0.3,0.7777777777777778,0.2222222222222222
SF-J27,SF-P24,2,3,1,1,1,2,0.5,0.5,0.3333333333333333,0.6666666666666666
SF-J27,SF-J24,19,28,10,13,9,15,0.5263157894736842,0.47368421052631576,0.4642857142857143,0.5357142857142857
SF-J27,SF-O24,2,1,0,1,2,0,0.0,1.0,1.0,0.0
SF-J27,SF-J26,7,12,3,9,4,3,0.42857142857142855,0.5714285714285714,0.75,0.25
SF-J27,SF-I26-,2,5,2,2,0,3,1.0,0.0,0.4,0.6
SF-J27,SF-I25,8,17,3,5,5,12,0.375,0.625,0.29411764705882354,0.7058823529411765
SF-J27,SF-H26,10,16,8,11,2,5,0.8,0.2,0.6875,0.3125
SF-J27,SF-O23,1,2,0,0,1,2,0.0,1.0,0.0,1.0
SF-J27,SF-H27-1,12,6,5,1,7,5,0.4166666666666667,0.5833333333333334,0.16666666666666666,0.8333333333333334
SF-J27,SF-F28-2,6,12,4,5,2,7,0.6666666666666666,0.3333333333333333,0.4166666666666667,0.5833333333333334
SF-J27,SF-G27,18,8,11,4,7,4,0.6111111111111112,0.3888888888888889,0.5,0.5
SF-J27,SF-M22-2,9,8,3,0,6,8,0.3333333333333333,0.6666666666666666,0.0,1.0
SF-J27,SF-L22,6,4,2,0,4,4,0.3333333333333333,0.6666666666666666,0.0,1.0
SF-J27,SF-F27,11,8,1,4,10,4,0.09090909090909091,0.9090909090909091,0.5,0.5
SF-J27,SF-N22-2,7,6,4,2,3,4,0.5714285714285714,0.42857142857142855,0.3333333333333333,0.6666666666666666
SF-J27,SF-G28-2,3,3,0,0,3,3,0.0,1.0,0.0,1.0
SF-J27,SF-G28-1,7,7,5,2,2,5,0.7142857142857143,0.2857142857142857,0.2857142857142857,0.7142857142857143
SF-J27,SF-M22-1,4,6,2,3,2,3,0.5,0.5,0.5,0.5
SF-J27,SF-K22-2,4,4,4,1,0,3,1.0,0.0,0.25,0.75
SF-J27,SF-K24,8,9,7,3,1,6,0.875,0.125,0.3333333333333333,0.6666666666666666
SF-J27,SF-J23-2,3,4,2,3,1,1,0.6666666666666666,0.3333333333333333,0.75,0.25
SF-J27,SF-G23,27,10,4,0,23,10,0.14814814814814814,0.8518518518518519,0.0,1.0
SF-J27,SF-G24,8,4,4,1,4,3,0.5,0.5,0.25,0.75
SF-J27,SF-G25,12,12,2,2,10,10,0.16666666666666666,0.8333333333333334,0.16666666666666666,0.8333333333333334
SF-J27,SF-F23,8,7,1,3,7,4,0.125,0.875,0.42857142857142855,0.5714285714285714
SF-J27,SF-E23,42,26,34,1,8,25,0.8095238095238095,0.19047619047619047,0.038461538461538464,0.9615384615384616
SF-J27,SF-D24,3,1,2,0,1,1,0.6666666666666666,0.3333333333333333,0.0,1.0
SF-J27,SF-B22,3,2,1,2,2,0,0.3333333333333333,0.6666666666666666,1.0,0.0
SF-J27,SF-J17,7,2,1,0,6,2,0.14285714285714285,0.8571428571428571,0.0,1.0
SF-J27,SF-I20,14,20,0,1,14,19,0.0,1.0,0.05,0.95
SF-J27,SF-H18,1,1,0,0,1,1,0.0,1.0,0.0,1.0
SF-J27,SF-G19,7,1,1,0,6,1,0.14285714285714285,0.8571428571428571,0.0,1.0
SF-J27,SF-G17,5,2,1,0,4,2,0.2,0.8,0.0,1.0
SF-J27,SF-G18,45,46,0,1,45,45,0.0,1.0,0.021739130434782608,0.9782608695652174
SF-J27,SF-G20,2,1,1,0,1,1,0.5,0.5,0.0,1.0
SF-J27,SF-E20,6,2,6,2,0,0,1.0,0.0,1.0,0.0
SF-J27,SF-H30,1,1,0,0,1,1,0.0,1.0,0.0,1.0
SF-J27,SF-G30-2,5,6,2,2,3,4,0.4,0.6,0.3333333333333333,0.6666666666666666
SF-J27,SF-F30-1,8,4,6,4,2,0,0.75,0.25,1.0,0.0
SF-J27,SF-E29-2,4,6,4,6,0,0,1.0,0.0,1.0,0.0
SF-J27,SF-E29-1,4,7,2,7,2,0,0.5,0.5,1.0,0.0
SF-J27,SF-D28,1,2,1,1,0,1,1.0,0.0,0.5,0.5
SF-J27,SF-G29-2,8,26,1,8,7,18,0.125,0.875,0.3076923076923077,0.6923076923076923
SF-J27,SF-G29-1,8,8,3,2,5,6,0.375,0.625,0.25,0.75
SF-J27,SF-G30-1,4,11,4,1,0,10,1.0,0.0,0.09090909090909091,0.9090909090909091
SF-J27,SF-G29-3,6,5,2,2,4,3,0.3333333333333333,0.6666666666666666,0.4,0.6
SF-J27,SF-F30-2,2,2,0,2,2,0,0.0,1.0,1.0,0.0
SF-J27,SF-F29,3,4,1,1,2,3,0.3333333333333333,0.6666666666666666,0.25,0.75
SF-J27,SF-E29-3,2,3,0,0,2,3,0.0,1.0,0.0,1.0
SF-J27,SF-F28-1,4,7,0,0,4,7,0.0,1.0,0.0,1.0
SF-J27,SF-E28-2,2,2,0,0,2,2,0.0,1.0,0.0,1.0
SF-J27,SF-J12,2,1,0,0,2,1,0.0,1.0,0.0,1.0
SF-J27,SF-F15,1,2,0,0,1,2,0.0,1.0,0.0,1.0
SF-J27,SF-A20,1,3,0,0,1,3,0.0,1.0,0.0,1.0
SF-J27,SF-C26,4,2,1,1,3,1,0.25,0.75,0.5,0.5
SF-J27,SF-C25,4,5,3,1,1,4,0.75,0.25,0.2,0.8
SF-J27,SF-B25,2,4,2,2,0,2,1.0,0.0,0.5,0.5
SF-J27,SF-D27,1,5,1,3,0,2,1.0,0.0,0.6,0.4
SF-J27,SF-C28-2,2,1,0,0,2,1,0.0,1.0,0.0,1.0
SF-J27,SF-H25,31,4,21,0,10,4,0.6774193548387096,0.3225806451612903,0.0,1.0
SF-J27,SF-G26,10,13,3,4,7,9,0.3,0.7,0.3076923076923077,0.6923076923076923
SF-J27,SF-K21,38,7,5,1,33,6,0.13157894736842105,0.868421052631579,0.14285714285714285,0.8571428571428571
SF-J27,SF-K22-1,6,8,2,2,4,6,0.3333333333333333,0.6666666666666666,0.25,0.75
SF-J27,SF-J23-1,28,33,16,19,12,14,0.5714285714285714,0.42857142857142855,0.5757575757575758,0.42424242424242425
SF-J27,SF-J22-1,6,4,1,4,5,0,0.16666666666666666,0.8333333333333334,1.0,0.0
SF-J27,SF-J22-2,6,4,3,1,3,3,0.5,0.5,0.25,0.75
SF-J27,SF-J21,13,17,3,4,10,13,0.23076923076923078,0.7692307692307693,0.23529411764705882,0.7647058823529411
SF-J27,SF-I22,11,4,4,3,7,1,0.36363636363636365,0.6363636363636364,0.75,0.25
SF-J27,SF-I23-2,1,1,1,1,0,0,1.0,0.0,1.0,0.0
SF-J27,SF-I24,3,3,3,0,0,3,1.0,0.0,0.0,1.0
SF-J27,SF-I23-1,10,7,4,1,6,6,0.4,0.6,0.14285714285714285,0.8571428571428571
SF-J27,SF-F26,13,10,12,9,1,1,0.9230769230769231,0.07692307692307693,0.9,0.1
SF-J27,SF-M15,2,3,2,0,0,3,1.0,0.0,0.0,1.0
SF-J27,SF-L19,1,1,0,0,1,1,0.0,1.0,0.0,1.0
SF-J27,SF-M20,4,2,4,1,0,1,1.0,0.0,0.5,0.5
SF-J27,SF-K20,6,2,2,1,4,1,0.3333333333333333,0.6666666666666666,0.5,0.5
SF-J27,SF-K15-,1,4,0,1,1,3,0.0,1.0,0.25,0.75
SF-J27,SF-K19,9,9,1,1,8,8,0.1111111111111111,0.8888888888888888,0.1111111111111111,0.8888888888888888
SF-J27,SF-J16,1,2,1,1,0,1,1.0,0.0,0.5,0.5
SF-J27,SF-J18,2,1,1,0,1,1,0.5,0.5,0.0,1.0
SF-J27,SF-J20,7,3,2,0,5,3,0.2857142857142857,0.7142857142857143,0.0,1.0
SF-J27,SF-J19,1,4,1,1,0,3,1.0,0.0,0.25,0.75
SF-J27,SF-M10,1,1,0,0,1,1,0.0,1.0,0.0,1.0
SF-J27,SF-M11,17,2,16,0,1,2,0.9411764705882353,0.058823529411764705,0.0,1.0
SF-J27,SF-R20,2,2,0,0,2,2,0.0,1.0,0.0,1.0
SF-J27,SF-Q21-2,2,2,0,0,2,2,0.0,1.0,0.0,1.0
SF-J27,SF-Q21-1,1,1,0,0,1,1,0.0,1.0,0.0,1.0
SF-J27,SF-O18,2,1,1,0,1,1,0.5,0.5,0.0,1.0
SF-J27,SF-O21,2,3,1,1,1,2,0.5,0.5,0.3333333333333333,0.6666666666666666
SF-J27,SF-O22,11,6,1,1,10,5,0.09090909090909091,0.9090909090909091,0.16666666666666666,0.8333333333333334
SF-J27,SF-N21,1,5,0,0,1,5,0.0,1.0,0.0,1.0
SF-J27,SF-M21,9,6,1,0,8,6,0.1111111111111111,0.8888888888888888,0.0,1.0
SF-J27,SF-L21,6,15,1,1,5,14,0.16666666666666666,0.8333333333333334,0.06666666666666667,0.9333333333333333
SF-J27,SF-S29,1,1,1,1,0,0,1.0,0.0,1.0,0.0
SF-J27,SF-Q30,5,2,2,1,3,1,0.4,0.6,0.5,0.5
SF-J27,SF-P30,11,6,7,4,4,2,0.6363636363636364,0.36363636363636365,0.6666666666666666,0.3333333333333333
SF-J27,SF-O30-2,16,12,7,8,9,4,0.4375,0.5625,0.6666666666666666,0.3333333333333333
SF-J27,SF-O30,9,11,6,7,3,4,0.6666666666666666,0.3333333333333333,0.6363636363636364,0.36363636363636365
SF-J27,SF-N27,3,3,0,3,3,0,0.0,1.0,1.0,0.0
SF-J27,SF-N29,6,10,5,7,1,3,0.8333333333333334,0.16666666666666666,0.7,0.3
SF-J27,SF-N28,3,3,1,1,2,2,0.3333333333333333,0.6666666666666666,0.3333333333333333,0.6666666666666666
SF-J27,SF-L30-1,30,41,4,7,26,34,0.13333333333333333,0.8666666666666667,0.17073170731707318,0.8292682926829268
SF-J27,SF-K30-2,34,31,15,11,19,20,0.4411764705882353,0.5588235294117647,0.3548387096774194,0.6451612903225806
SF-J27,SF-L29,21,8,8,3,13,5,0.38095238095238093,0.6190476190476191,0.375,0.625
SF-J27,SF-J29-1,15,9,8,3,7,6,0.5333333333333333,0.4666666666666667,0.3333333333333333,0.6666666666666666
SF-J27,SF-I30,2,2,2,1,0,1,1.0,0.0,0.5,0.5
SF-J27,SF-I29-2,7,9,4,6,3,3,0.5714285714285714,0.42857142857142855,0.6666666666666666,0.3333333333333333
SF-J27,SF-I27,9,11,4,7,5,4,0.4444444444444444,0.5555555555555556,0.6363636363636364,0.36363636363636365
SF-J27,SF-I30-2,9,3,7,0,2,3,0.7777777777777778,0.2222222222222222,0.0,1.0
SF-J27,SF I29-1,6,4,1,2,5,2,0.16666666666666666,0.8333333333333334,0.5,0.5
SF-J27,SF-H28,8,18,3,10,5,8,0.375,0.625,0.5555555555555556,0.4444444444444444
SF-J27,SF-H29,4,3,2,0,2,3,0.5,0.5,0.0,1.0
SF-J27,SF-R24,5,10,2,6,3,4,0.4,0.6,0.6,0.4
SF-J27,SF-P26,1,2,1,0,0,2,1.0,0.0,0.0,1.0
SF-J27,SF-O25-2,1,3,1,2,0,1,1.0,0.0,0.6666666666666666,0.3333333333333333
SF-J27,SF-N22-1B,2,4,1,0,1,4,0.5,0.5,0.0,1.0
SF-J27,SF-N26,2,2,0,0,2,2,0.0,1.0,0.0,1.0
SF-J27,SF-N25,1,3,0,2,1,1,0.0,1.0,0.6666666666666666,0.3333333333333333
SF-J27,SF-T22,1,3,0,1,1,2,0.0,1.0,0.3333333333333333,0.6666666666666666
SF-J27,SF-S22-1,5,7,1,0,4,7,0.2,0.8,0.0,1.0
SF-J27,SF-Q23-3,2,7,1,3,1,4,0.5,0.5,0.42857142857142855,0.5714285714285714
SF-J27,SF-Q22-1,5,3,0,0,5,3,0.0,1.0,0.0,1.0
SF-J27,SF-Q22-2,3,5,1,3,2,2,0.3333333333333333,0.6666666666666666,0.6,0.4
SF-J27,SF-P22,33,28,6,6,27,22,0.18181818181818182,0.8181818181818182,0.21428571428571427,0.7857142857142857
SF-J27,SF-W19,1,1,1,1,0,0,1.0,0.0,1.0,0.0
SF-J27,SF-W19-2,2,1,0,0,2,1,0.0,1.0,0.0,1.0
SF-J27,SF-S21,2,1,0,0,2,1,0.0,1.0,0.0,1.0
SF-M30,SF-M26,5,11,4,4,1,7,0.8,0.2,0.36363636363636365,0.6363636363636364
SF-M30,SF-M25,14,31,6,7,8,24,0.42857142857142855,0.5714285714285714,0.22580645161290322,0.7741935483870968
SF-M30,SF-M26-2,7,10,5,6,2,4,0.7142857142857143,0.2857142857142857,0.6,0.4
SF-M30,SF-L27,32,36,16,13,16,23,0.5,0.5,0.3611111111111111,0.6388888888888888
SF-M30,SF-K26,17,47,11,36,6,11,0.6470588235294118,0.35294117647058826,0.7659574468085106,0.23404255319148937
SF-M30,SF-J27,3,6,2,0,1,6,0.6666666666666666,0.3333333333333333,0.0,1.0
SF-M30,SF-L27-2,5,32,2,13,3,19,0.4,0.6,0.40625,0.59375
SF-M30,SF-J29-3,57,57,47,44,10,13,0.8245614035087719,0.17543859649122806,0.7719298245614035,0.22807017543859648
SF-M30,SF-J29,61,46,19,22,42,24,0.3114754098360656,0.6885245901639344,0.4782608695652174,0.5217391304347826
SF-M30,SF-L26,9,18,2,11,7,7,0.2222222222222222,0.7777777777777778,0.6111111111111112,0.3888888888888889
SF-M30,SF-M28,25,95,13,77,12,18,0.52,0.48,0.8105263157894737,0.18947368421052632
SF-M30,SF-L25,128,86,97,78,31,8,0.7578125,0.2421875,0.9069767441860465,0.09302325581395349
SF-M30,SF-M24,14,11,5,4,9,7,0.35714285714285715,0.6428571428571429,0.36363636363636365,0.6363636363636364
SF-M30,SF-L24,4,11,4,6,0,5,1.0,0.0,0.5454545454545454,0.45454545454545453
SF-M30,SF-N23,20,11,3,4,17,7,0.15,0.85,0.36363636363636365,0.6363636363636364
SF-M30,SF-N24-2,10,9,1,2,9,7,0.1,0.9,0.2222222222222222,0.7777777777777778
SF-M30,SF-K27-2,36,40,15,14,21,26,0.4166666666666667,0.5833333333333334,0.35,0.65
SF-M30,SF-J26-2,14,71,7,33,7,38,0.5,0.5,0.4647887323943662,0.5352112676056338
SF-M30,SF-L28,40,34,36,28,4,6,0.9,0.1,0.8235294117647058,0.17647058823529413
SF-M30,SF-K28,8,3,4,1,4,2,0.5,0.5,0.3333333333333333,0.6666666666666666
SF-M30,SF-K29-1,310,474,137,142,173,332,0.44193548387096776,0.5580645161290323,0.29957805907172996,0.70042194092827
SF-M30,SF-J28-2,96,51,37,4,59,47,0.3854166666666667,0.6145833333333334,0.0784313725490196,0.9215686274509803
SF-M30,SF-K27,3,10,2,7,1,3,0.6666666666666666,0.3333333333333333,0.7,0.3
SF-M30,SF-K25,15,33,8,13,7,20,0.5333333333333333,0.4666666666666667,0.3939393939393939,0.6060606060606061
SF-M30,SF-J25,32,96,18,87,14,9,0.5625,0.4375,0.90625,0.09375
SF-M30,SF-H26-2,57,11,4,5,53,6,0.07017543859649122,0.9298245614035088,0.45454545454545453,0.5454545454545454
SF-M30,SF-P24,21,23,4,6,17,17,0.19047619047619047,0.8095238095238095,0.2608695652173913,0.7391304347826086
SF-M30,SF-J24,126,71,72,44,54,27,0.5714285714285714,0.42857142857142855,0.6197183098591549,0.38028169014084506
SF-M30,SF-O24,15,10,9,4,6,6,0.6,0.4,0.4,0.6
SF-M30,SF-J26,19,21,3,4,16,17,0.15789473684210525,0.8421052631578947,0.19047619047619047,0.8095238095238095
SF-M30,SF-I26-,20,17,9,3,11,14,0.45,0.55,0.17647058823529413,0.8235294117647058
SF-M30,SF-I25,12,46,0,10,12,36,0.0,1.0,0.21739130434782608,0.782608695652174
SF-M30,SF-K23,1,3,1,1,0,2,1.0,0.0,0.3333333333333333,0.6666666666666666
SF-M30,SF-H26,22,36,5,17,17,19,0.22727272727272727,0.7727272727272727,0.4722222222222222,0.5277777777777778
SF-M30,SF-O23,43,20,25,7,18,13,0.5813953488372093,0.4186046511627907,0.35,0.65
SF-M30,SF-H27-1,9,16,8,10,1,6,0.8888888888888888,0.1111111111111111,0.625,0.375
SF-M30,SF-F28-2,13,41,5,4,8,37,0.38461538461538464,0.6153846153846154,0.0975609756097561,0.9024390243902439
SF-M30,SF-G27,33,54,19,26,14,28,0.5757575757575758,0.42424242424242425,0.48148148148148145,0.5185185185185185
SF-M30,SF-M22-2,22,31,4,15,18,16,0.18181818181818182,0.8181818181818182,0.4838709677419355,0.5161290322580645
SF-M30,SF-L22,73,56,9,2,64,54,0.1232876712328767,0.8767123287671232,0.03571428571428571,0.9642857142857143
SF-M30,SF-F27,10,23,3,8,7,15,0.3,0.7,0.34782608695652173,0.6521739130434783
SF-M30,SF-N22-2,73,87,22,25,51,62,0.3013698630136986,0.6986301369863014,0.28735632183908044,0.7126436781609196
SF-M30,SF-G28-1,7,2,7,2,0,0,1.0,0.0,1.0,0.0
SF-M30,SF-M22-1,15,5,4,0,11,5,0.26666666666666666,0.7333333333333333,0.0,1.0
SF-M30,SF-O25-1,26,43,0,4,26,39,0.0,1.0,0.09302325581395349,0.9069767441860465
SF-M30,SF-K22-2,6,5,4,1,2,4,0.6666666666666666,0.3333333333333333,0.2,0.8
SF-M30,SF-K24,9,12,4,1,5,11,0.4444444444444444,0.5555555555555556,0.08333333333333333,0.9166666666666666
SF-M30,SF-G23,2,3,1,1,1,2,0.5,0.5,0.3333333333333333,0.6666666666666666
SF-M30,SF-G24,20,6,4,1,16,5,0.2,0.8,0.16666666666666666,0.8333333333333334
SF-M30,SF-G25,3,7,2,2,1,5,0.6666666666666666,0.3333333333333333,0.2857142857142857,0.7142857142857143
SF-M30,SF-F23,6,7,0,2,6,5,0.0,1.0,0.2857142857142857,0.7142857142857143
SF-M30,SF-E23,8,12,3,2,5,10,0.375,0.625,0.16666666666666666,0.8333333333333334
SF-M30,SF-D24,6,2,1,0,5,2,0.16666666666666666,0.8333333333333334,0.0,1.0
SF-M30,SF-B22,7,6,6,1,1,5,0.8571428571428571,0.14285714285714285,0.16666666666666666,0.8333333333333334
SF-M30,SF-J17,46,49,3,1,43,48,0.06521739130434782,0.9347826086956522,0.02040816326530612,0.9795918367346939
SF-M30,SF-I19,5,11,1,0,4,11,0.2,0.8,0.0,1.0
SF-M30,SF-I20,3,6,2,1,1,5,0.6666666666666666,0.3333333333333333,0.16666666666666666,0.8333333333333334
SF-M30,SF-H16,1,2,0,0,1,2,0.0,1.0,0.0,1.0
SF-M30,SF-H19,2,3,2,2,0,1,1.0,0.0,0.6666666666666666,0.3333333333333333
SF-M30,SF-H20,3,4,3,0,0,4,1.0,0.0,0.0,1.0
SF-M30,SF-G19,6,4,0,0,6,4,0.0,1.0,0.0,1.0
SF-M30,SF-G17,11,1,0,0,11,1,0.0,1.0,0.0,1.0
SF-M30,SF-G18,25,35,4,2,21,33,0.16,0.84,0.05714285714285714,0.9428571428571428
SF-M30,SF-F19,6,7,1,1,5,6,0.16666666666666666,0.8333333333333334,0.14285714285714285,0.8571428571428571
SF-M30,SF-E18,29,4,17,2,12,2,0.5862068965517241,0.41379310344827586,0.5,0.5
SF-M30,SF-H30,58,33,35,20,23,13,0.603448275862069,0.39655172413793105,0.6060606060606061,0.3939393939393939
SF-M30,SF-G30-2,49,77,32,67,17,10,0.6530612244897959,0.3469387755102041,0.8701298701298701,0.12987012987012986
SF-M30,SF-F30-1,34,25,15,6,19,19,0.4411764705882353,0.5588235294117647,0.24,0.76
SF-M30,SF-E29-2,297,327,205,227,92,100,0.6902356902356902,0.30976430976430974,0.6941896024464832,0.3058103975535168
SF-M30,SF-E29-1,76,143,49,74,27,69,0.6447368421052632,0.35526315789473684,0.5174825174825175,0.4825174825174825
SF-M30,SF-D29,45,68,39,36,6,32,0.8666666666666667,0.13333333333333333,0.5294117647058824,0.47058823529411764
SF-M30,SF-D28,10,16,6,11,4,5,0.6,0.4,0.6875,0.3125
SF-M30,SF-A27,21,57,6,42,15,15,0.2857142857142857,0.7142857142857143,0.7368421052631579,0.2631578947368421
SF-M30,SF-G29-2,31,24,19,18,12,6,0.6129032258064516,0.3870967741935484,0.75,0.25
SF-M30,SF-G29-1,4,15,3,13,1,2,0.75,0.25,0.8666666666666667,0.13333333333333333
SF-M30,SF-G30-1,66,44,55,33,11,11,0.8333333333333334,0.16666666666666666,0.75,0.25
SF-M30,SF-G29-3,8,6,5,4,3,2,0.625,0.375,0.6666666666666666,0.3333333333333333
SF-M30,SF-F30-2,10,2,1,2,9,0,0.1,0.9,1.0,0.0
SF-M30,SF-F29,39,61,26,28,13,33,0.6666666666666666,0.3333333333333333,0.45901639344262296,0.5409836065573771
SF-M30,SF-E29-3,51,11,6,4,45,7,0.11764705882352941,0.8823529411764706,0.36363636363636365,0.6363636363636364
SF-M30,SF-F28-1,5,7,2,4,3,3,0.4,0.6,0.5714285714285714,0.42857142857142855
SF-M30,SF-E28-2,3,2,1,0,2,2,0.3333333333333333,0.6666666666666666,0.0,1.0
SF-M30,SF-E28,7,2,5,2,2,0,0.7142857142857143,0.2857142857142857,1.0,0.0
SF-M30,SF-J12,15,34,15,0,0,34,1.0,0.0,0.0,1.0
SF-M30,SF-J13,2,1,1,0,1,1,0.5,0.5,0.0,1.0
SF-M30,SF-H12,4,5,0,0,4,5,0.0,1.0,0.0,1.0
SF-M30,SF-G13,2,2,0,0,2,2,0.0,1.0,0.0,1.0
SF-M30,SF-G12,6,3,0,0,6,3,0.0,1.0,0.0,1.0
SF-M30,SF-F16,4,6,0,0,4,6,0.0,1.0,0.0,1.0
SF-M30,SF-C20,3,11,3,1,0,10,1.0,0.0,0.09090909090909091,0.9090909090909091
SF-M30,SF-B19,34,30,2,2,32,28,0.058823529411764705,0.9411764705882353,0.06666666666666667,0.9333333333333333
SF-M30,SF-A20,4,7,0,4,4,3,0.0,1.0,0.5714285714285714,0.42857142857142855
SF-M30,SF-C26,57,26,7,1,50,25,0.12280701754385964,0.8771929824561403,0.038461538461538464,0.9615384615384616
SF-M30,SF-C25,19,18,1,2,18,16,0.05263157894736842,0.9473684210526315,0.1111111111111111,0.8888888888888888
SF-M30,SF-B25,13,12,9,7,4,5,0.6923076923076923,0.3076923076923077,0.5833333333333334,0.4166666666666667
SF-M30,SF-E27,1,2,0,2,1,0,0.0,1.0,1.0,0.0
SF-M30,SF-B28-2,7,3,0,1,7,2,0.0,1.0,0.3333333333333333,0.6666666666666666
SF-M30,SF-D27,18,13,14,7,4,6,0.7777777777777778,0.2222222222222222,0.5384615384615384,0.46153846153846156
SF-M30,SF-C28-2,4,2,1,0,3,2,0.25,0.75,0.0,1.0
SF-M30,SF-B28,16,43,10,38,6,5,0.625,0.375,0.8837209302325582,0.11627906976744186
SF-M30,SF-H0,1,3,0,0,1,3,0.0,1.0,0.0,1.0
SF-M30,SF-J3,1,2,0,1,1,1,0.0,1.0,0.5,0.5
SF-M30,SF-H25,5,2,3,2,2,0,0.6,0.4,1.0,0.0
SF-M30,SF-G26,3,9,2,3,1,6,0.6666666666666666,0.3333333333333333,0.3333333333333333,0.6666666666666666
SF-M30,SF-K21,37,14,9,1,28,13,0.24324324324324326,0.7567567567567568,0.07142857142857142,0.9285714285714286
SF-M30,SF-K22-1,3,5,2,1,1,4,0.6666666666666666,0.3333333333333333,0.2,0.8
SF-M30,SF-J23-1,23,26,13,12,10,14,0.5652173913043478,0.43478260869565216,0.46153846153846156,0.5384615384615384
SF-M30,SF-J22-1,4,9,2,4,2,5,0.5,0.5,0.4444444444444444,0.5555555555555556
SF-M30,SF-J22-2,19,10,1,2,18,8,0.05263157894736842,0.9473684210526315,0.2,0.8
SF-M30,SF-J21,8,6,2,2,6,4,0.25,0.75,0.3333333333333333,0.6666666666666666
SF-M30,SF-I21,5,6,1,5,4,1,0.2,0.8,0.8333333333333334,0.16666666666666666
SF-M30,SF-I22,101,65,13,6,88,59,0.12871287128712872,0.8712871287128713,0.09230769230769231,0.9076923076923077
SF-M30,SF-I23-2,7,10,5,5,2,5,0.7142857142857143,0.2857142857142857,0.5,0.5
SF-M30,SF-I24,14,10,12,2,2,8,0.8571428571428571,0.14285714285714285,0.2,0.8
SF-M30,SF-I23-1,31,5,6,1,25,4,0.1935483870967742,0.8064516129032258,0.2,0.8
SF-M30,SF-F26,14,16,5,3,9,13,0.35714285714285715,0.6428571428571429,0.1875,0.8125
SF-M30,SF-M13,135,65,18,1,117,64,0.13333333333333333,0.8666666666666667,0.015384615384615385,0.9846153846153847
SF-M30,SF-M15,80,33,68,16,12,17,0.85,0.15,0.48484848484848486,0.5151515151515151
SF-M30,SF-L19,14,20,2,1,12,19,0.14285714285714285,0.8571428571428571,0.05,0.95
SF-M30,SF-L20,6,13,1,5,5,8,0.16666666666666666,0.8333333333333334,0.38461538461538464,0.6153846153846154
SF-M30,SF-N20-1,22,18,3,3,19,15,0.13636363636363635,0.8636363636363636,0.16666666666666666,0.8333333333333334
SF-M30,SF-M20,150,163,124,108,26,55,0.8266666666666667,0.17333333333333334,0.6625766871165644,0.3374233128834356
SF-M30,SF-K17-2,4,1,2,0,2,1,0.5,0.5,0.0,1.0
SF-M30,SF-K20,32,19,4,3,28,16,0.125,0.875,0.15789473684210525,0.8421052631578947
SF-M30,SF-K15-,119,11,97,0,22,11,0.8151260504201681,0.18487394957983194,0.0,1.0
SF-M30,SF-K19,100,40,7,2,93,38,0.07,0.93,0.05,0.95
SF-M30,SF-K18,21,8,10,0,11,8,0.47619047619047616,0.5238095238095238,0.0,1.0
SF-M30,SF-K17,3,4,3,0,0,4,1.0,0.0,0.0,1.0
SF-M30,SF-J16,6,4,0,1,6,3,0.0,1.0,0.25,0.75
SF-M30,SF-J18,21,18,0,0,21,18,0.0,1.0,0.0,1.0
SF-M30,SF-J20,1,18,1,17,0,1,1.0,0.0,0.9444444444444444,0.05555555555555555
SF-M30,SF-J19,15,17,7,7,8,10,0.4666666666666667,0.5333333333333333,0.4117647058823529,0.5882352941176471
SF-M30,SF-M12,26,13,8,1,18,12,0.3076923076923077,0.6923076923076923,0.07692307692307693,0.9230769230769231
SF-M30,SF-M10,1,3,0,0,1,3,0.0,1.0,0.0,1.0
SF-M30,SF-M11,5,6,1,0,4,6,0.2,0.8,0.0,1.0
SF-M30,SF-R19,42,15,3,0,39,15,0.07142857142857142,0.9285714285714286,0.0,1.0
SF-M30,SF-Q21-2,23,46,1,0,22,46,0.043478260869565216,0.9565217391304348,0.0,1.0
SF-M30,SF-Q21-1,10,20,1,3,9,17,0.1,0.9,0.15,0.85
SF-M30,SF-P21,11,5,2,0,9,5,0.18181818181818182,0.8181818181818182,0.0,1.0
SF-M30,SF-O18,12,10,3,1,9,9,0.25,0.75,0.1,0.9
SF-M30,SF-O19,8,8,2,1,6,7,0.25,0.75,0.125,0.875
SF-M30,SF-O21,99,73,11,6,88,67,0.1111111111111111,0.8888888888888888,0.0821917808219178,0.9178082191780822
SF-M30,SF-O22,40,34,7,10,33,24,0.175,0.825,0.29411764705882354,0.7058823529411765
SF-M30,SF-N21,71,43,16,13,55,30,0.22535211267605634,0.7746478873239436,0.3023255813953488,0.6976744186046512
SF-M30,SF-N20-2,62,64,12,5,50,59,0.1935483870967742,0.8064516129032258,0.078125,0.921875
SF-M30,SF-M21,98,105,36,55,62,50,0.3673469387755102,0.6326530612244898,0.5238095238095238,0.47619047619047616
SF-M30,SF-L21,51,53,27,4,24,49,0.5294117647058824,0.47058823529411764,0.07547169811320754,0.9245283018867925
SF-M30,SF-S29,12,8,12,6,0,2,1.0,0.0,0.75,0.25
SF-M30,SF-S30,20,29,18,28,2,1,0.9,0.1,0.9655172413793104,0.034482758620689655
SF-M30,SF-Q30,34,52,17,24,17,28,0.5,0.5,0.46153846153846156,0.5384615384615384
SF-M30,SF-P30,103,124,35,47,68,77,0.33980582524271846,0.6601941747572816,0.3790322580645161,0.6209677419354839
SF-M30,SF-O30-2,72,52,67,43,5,9,0.9305555555555556,0.06944444444444445,0.8269230769230769,0.17307692307692307
SF-M30,SF-O30,350,362,296,291,54,71,0.8457142857142858,0.15428571428571428,0.8038674033149171,0.19613259668508287
SF-M30,SF-N27,49,75,33,52,16,23,0.673469387755102,0.32653061224489793,0.6933333333333334,0.30666666666666664
SF-M30,SF-N29,40,37,38,30,2,7,0.95,0.05,0.8108108108108109,0.1891891891891892
SF-M30,SF-N28,46,87,41,68,5,19,0.8913043478260869,0.10869565217391304,0.7816091954022989,0.21839080459770116
SF-M30,SF-L30-1,174,203,114,136,60,67,0.6551724137931034,0.3448275862068966,0.6699507389162561,0.33004926108374383
SF-M30,SF-L31-1,15,12,13,10,2,2,0.8666666666666667,0.13333333333333333,0.8333333333333334,0.16666666666666666
SF-M30,SF-K30-2,41,45,27,30,14,15,0.6585365853658537,0.34146341463414637,0.6666666666666666,0.3333333333333333
SF-M30,SF-L29,89,89,37,37,52,52,0.4157303370786517,0.5842696629213483,0.4157303370786517,0.5842696629213483
SF-M30,SF-J29-1,23,19,13,9,10,10,0.5652173913043478,0.43478260869565216,0.47368421052631576,0.5263157894736842
SF-M30,SF-I30,26,18,18,13,8,5,0.6923076923076923,0.3076923076923077,0.7222222222222222,0.2777777777777778
SF-M30,SF-I29-2,5,15,3,8,2,7,0.6,0.4,0.5333333333333333,0.4666666666666667
SF-M30,SF-I27,21,17,15,9,6,8,0.7142857142857143,0.2857142857142857,0.5294117647058824,0.47058823529411764
SF-M30,SF-I28,23,6,16,4,7,2,0.6956521739130435,0.30434782608695654,0.6666666666666666,0.3333333333333333
SF-M30,SF-I30-2,9,8,5,2,4,6,0.5555555555555556,0.4444444444444444,0.25,0.75
SF-M30,SF I29-1,32,6,28,0,4,6,0.875,0.125,0.0,1.0
SF-M30,SF-H28,6,22,5,12,1,10,0.8333333333333334,0.16666666666666666,0.5454545454545454,0.45454545454545453
SF-M30,SF-H29,18,2,14,0,4,2,0.7777777777777778,0.2222222222222222,0.0,1.0
SF-M30,SF-S24,24,31,5,4,19,27,0.20833333333333334,0.7916666666666666,0.12903225806451613,0.8709677419354839
SF-M30,SF-R24,25,29,6,6,19,23,0.24,0.76,0.20689655172413793,0.7931034482758621
SF-M30,SF-R26,6,10,3,3,3,7,0.5,0.5,0.3,0.7
SF-M30,SF-Q26,12,6,6,2,6,4,0.5,0.5,0.3333333333333333,0.6666666666666666
SF-M30,SF-P26,229,128,65,22,164,106,0.2838427947598253,0.7161572052401747,0.171875,0.828125
SF-M30,SF-O25-2,63,138,42,83,21,55,0.6666666666666666,0.3333333333333333,0.6014492753623188,0.39855072463768115
SF-M30,SF-N22-1B,5,15,3,9,2,6,0.6,0.4,0.6,0.4
SF-M30,SF-N26,16,15,6,9,10,6,0.375,0.625,0.6,0.4
SF-M30,SF-N25,10,4,3,1,7,3,0.3,0.7,0.25,0.75
SF-M30,SF-T21,2,2,1,1,1,1,0.5,0.5,0.5,0.5
SF-M30,SF-T22,32,31,21,28,11,3,0.65625,0.34375,0.9032258064516129,0.0967741935483871
SF-M30,SF-S22-2,17,10,4,2,13,8,0.23529411764705882,0.7647058823529411,0.2,0.8
SF-M30,SF-S22-1,15,1,1,0,14,1,0.06666666666666667,0.9333333333333333,0.0,1.0
SF-M30,SF-Q23-3,41,16,20,4,21,12,0.4878048780487805,0.5121951219512195,0.25,0.75
SF-M30,SF-Q22-1,24,48,1,19,23,29,0.041666666666666664,0.9583333333333334,0.3958333333333333,0.6041666666666666
SF-M30,SF-Q22-2,69,71,3,2,66,69,0.043478260869565216,0.9565217391304348,0.028169014084507043,0.971830985915493
SF-M30,SF-P22,28,39,13,5,15,34,0.4642857142857143,0.5357142857142857,0.1282051282051282,0.8717948717948718
SF-M30,SF-U21,9,5,6,1,3,4,0.6666666666666666,0.3333333333333333,0.2,0.8
SF-M30,SF-T20,10,2,4,0,6,2,0.4,0.6,0.0,1.0
SF-M30,SF-S21,7,2,1,0,6,2,0.14285714285714285,0.8571428571428571,0.0,1.0
SF-M30,SF-Y27,5,2,3,1,2,1,0.6,0.4,0.5,0.5
SF-M30,SF-W29,1,4,1,0,0,4,1.0,0.0,0.0,1.0
SF-M30,SF-V28,5,4,0,2,5,2,0.0,1.0,0.5,0.5
SF-M30,SF-V29,7,16,3,10,4,6,0.42857142857142855,0.5714285714285714,0.625,0.375
SF-M30,SF-V30,6,7,2,3,4,4,0.3333333333333333,0.6666666666666666,0.42857142857142855,0.5714285714285714
SF-M30,SF-V32,10,16,5,3,5,13,0.5,0.5,0.1875,0.8125
SF-M30,SF-U30,5,1,1,0,4,1,0.2,0.8,0.0,1.0
SF-M30,SF-W14,6,1,1,0,5,1,0.16666666666666666,0.8333333333333334,0.0,1.0
SF-M30,SF-Y25,120,79,15,26,105,53,0.125,0.875,0.3291139240506329,0.6708860759493671
SF-L27-2,SF-M26,4,2,2,1,2,1,0.5,0.5,0.5,0.5
SF-L27-2,SF-M25,1,4,1,2,0,2,1.0,0.0,0.5,0.5
SF-L27-2,SF-M26-2,10,3,9,1,1,2,0.9,0.1,0.3333333333333333,0.6666666666666666
SF-L27-2,SF-L27,5,5,3,4,2,1,0.6,0.4,0.8,0.2
SF-L27-2,SF-K26,3,5,3,4,0,1,1.0,0.0,0.8,0.2
SF-L27-2,SF-J27,2,6,1,2,1,4,0.5,0.5,0.3333333333333333,0.6666666666666666
SF-L27-2,SF-M30,32,5,13,2,19,3,0.40625,0.59375,0.4,0.6
SF-L27-2,SF-J29-3,2,5,2,2,0,3,1.0,0.0,0.4,0.6
SF-L27-2,SF-J29,66,77,41,60,25,17,0.6212121212121212,0.3787878787878788,0.7792207792207793,0.22077922077922077
SF-L27-2,SF-L26,1,4,0,3,1,1,0.0,1.0,0.75,0.25
SF-L27-2,SF-M28,46,25,22,11,24,14,0.4782608695652174,0.5217391304347826,0.44,0.56
SF-L27-2,SF-L25,2,2,1,2,1,0,0.5,0.5,1.0,0.0
SF-L27-2,SF-M24,1,4,1,4,0,0,1.0,0.0,1.0,0.0
SF-L27-2,SF-L24,3,1,3,1,0,0,1.0,0.0,1.0,0.0
SF-L27-2,SF-N23,7,12,7,12,0,0,1.0,0.0,1.0,0.0
SF-L27-2,SF-N24-2,3,2,2,1,1,1,0.6666666666666666,0.3333333333333333,0.5,0.5
SF-L27-2,SF-K27-2,10,8,9,8,1,0,0.9,0.1,1.0,0.0
SF-L27-2,SF-J26-2,9,32,3,22,6,10,0.3333333333333333,0.6666666666666666,0.6875,0.3125
SF-L27-2,SF-K28-3,5,5,5,5,0,0,1.0,0.0,1.0,0.0
SF-L27-2,SF-L28,26,11,21,9,5,2,0.8076923076923077,0.19230769230769232,0.8181818181818182,0.18181818181818182
SF-L27-2,SF-K28,3,16,3,16,0,0,1.0,0.0,1.0,0.0
SF-L27-2,SF-K29-1,8,7,4,3,4,4,0.5,0.5,0.42857142857142855,0.5714285714285714
SF-L27-2,SF-J28-2,4,7,4,3,0,4,1.0,0.0,0.42857142857142855,0.5714285714285714
SF-L27-2,SF-K27,5,5,2,4,3,1,0.4,0.6,0.8,0.2
SF-L27-2,SF-K25,8,11,7,9,1,2,0.875,0.125,0.8181818181818182,0.18181818181818182
SF-L27-2,SF-J25,9,7,6,6,3,1,0.6666666666666666,0.3333333333333333,0.8571428571428571,0.14285714285714285
SF-L27-2,SF-J24,6,3,5,3,1,0,0.8333333333333334,0.16666666666666666,1.0,0.0
SF-L27-2,SF-I26-,1,4,0,2,1,2,0.0,1.0,0.5,0.5
SF-L27-2,SF-I25,5,11,4,4,1,7,0.8,0.2,0.36363636363636365,0.6363636363636364
SF-L27-2,SF-H26,17,11,14,7,3,4,0.8235294117647058,0.17647058823529413,0.6363636363636364,0.36363636363636365
SF-L27-2,SF-H27-1,5,3,1,2,4,1,0.2,0.8,0.6666666666666666,0.3333333333333333
SF-L27-2,SF-F28-2,2,9,1,2,1,7,0.5,0.5,0.2222222222222222,0.7777777777777778
SF-L27-2,SF-G27,7,13,3,9,4,4,0.42857142857142855,0.5714285714285714,0.6923076923076923,0.3076923076923077
SF-L27-2,SF-M22-2,3,1,2,0,1,1,0.6666666666666666,0.3333333333333333,0.0,1.0
SF-L27-2,SF-L22,2,4,0,2,2,2,0.0,1.0,0.5,0.5
SF-L27-2,SF-N22-2,2,27,0,26,2,1,0.0,1.0,0.9629629629629629,0.037037037037037035
SF-L27-2,SF-G28-2,1,2,1,0,0,2,1.0,0.0,0.0,1.0
SF-L27-2,SF-O25-1,3,2,2,2,1,0,0.6666666666666666,0.3333333333333333,1.0,0.0
SF-L27-2,SF-K22-2,3,2,0,0,3,2,0.0,1.0,0.0,1.0
SF-L27-2,SF-G23,3,5,0,2,3,3,0.0,1.0,0.4,0.6
SF-L27-2,SF-G24,3,5,1,4,2,1,0.3333333333333333,0.6666666666666666,0.8,0.2
SF-L27-2,SF-G25,12,10,2,3,10,7,0.16666666666666666,0.8333333333333334,0.3,0.7
SF-L27-2,SF-F23,1,3,1,1,0,2,1.0,0.0,0.3333333333333333,0.6666666666666666
SF-L27-2,SF-E23,3,2,3,0,0,2,1.0,0.0,0.0,1.0
SF-L27-2,SF-I19,1,1,0,0,1,1,0.0,1.0,0.0,1.0
SF-L27-2,SF-H30,4,3,4,0,0,3,1.0,0.0,0.0,1.0
SF-L27-2,SF-G30-2,19,7,16,6,3,1,0.8421052631578947,0.15789473684210525,0.8571428571428571,0.14285714285714285
SF-L27-2,SF-E29-1,6,5,5,4,1,1,0.8333333333333334,0.16666666666666666,0.8,0.2
SF-L27-2,SF-D29,2,2,1,2,1,0,0.5,0.5,1.0,0.0
SF-L27-2,SF-A27,4,2,3,2,1,0,0.75,0.25,1.0,0.0
SF-L27-2,SF-G29-2,4,4,3,3,1,1,0.75,0.25,0.75,0.25
SF-L27-2,SF-E29-3,1,1,0,0,1,1,0.0,1.0,0.0,1.0
SF-L27-2,SF-F28-1,1,1,0,0,1,1,0.0,1.0,0.0,1.0
SF-L27-2,SF-E28-2,1,1,0,0,1,1,0.0,1.0,0.0,1.0
SF-L27-2,SF-E28,1,1,1,0,0,1,1.0,0.0,0.0,1.0
SF-L27-2,SF-C25,1,6,0,6,1,0,0.0,1.0,1.0,0.0
SF-L27-2,SF-D27,1,4,0,4,1,0,0.0,1.0,1.0,0.0
SF-L27-2,SF-H25,4,5,1,0,3,5,0.25,0.75,0.0,1.0
SF-L27-2,SF-G26,5,6,3,1,2,5,0.6,0.4,0.16666666666666666,0.8333333333333334
SF-L27-2,SF-K21,1,5,0,1,1,4,0.0,1.0,0.2,0.8
SF-L27-2,SF-J23-1,11,11,7,7,4,4,0.6363636363636364,0.36363636363636365,0.6363636363636364,0.36363636363636365
SF-L27-2,SF-J21,3,1,1,0,2,1,0.3333333333333333,0.6666666666666666,0.0,1.0
SF-L27-2,SF-I22,1,1,1,1,0,0,1.0,0.0,1.0,0.0
SF-L27-2,SF-I23-2,4,1,4,0,0,1,1.0,0.0,0.0,1.0
SF-L27-2,SF-I24,6,6,5,5,1,1,0.8333333333333334,0.16666666666666666,0.8333333333333334,0.16666666666666666
SF-L27-2,SF-I23-1,5,7,5,5,0,2,1.0,0.0,0.7142857142857143,0.2857142857142857
SF-L27-2,SF-F26,1,6,1,0,0,6,1.0,0.0,0.0,1.0
SF-L27-2,SF-M15,2,4,1,1,1,3,0.5,0.5,0.25,0.75
SF-L27-2,SF-N20-1,1,2,1,0,0,2,1.0,0.0,0.0,1.0
SF-L27-2,SF-M20,3,2,1,0,2,2,0.3333333333333333,0.6666666666666666,0.0,1.0
SF-L27-2,SF-K17-2,2,1,1,0,1,1,0.5,0.5,0.0,1.0
SF-L27-2,SF-K15-,1,4,1,1,0,3,1.0,0.0,0.25,0.75
SF-L27-2,SF-K19,1,1,0,0,1,1,0.0,1.0,0.0,1.0
SF-L27-2,SF-J16,2,3,0,0,2,3,0.0,1.0,0.0,1.0
SF-L27-2,SF-J18,7,1,2,0,5,1,0.2857142857142857,0.7142857142857143,0.0,1.0
SF-L27-2,SF-O19,1,1,1,1,0,0,1.0,0.0,1.0,0.0
SF-L27-2,SF-N20-2,1,2,1,1,0,1,1.0,0.0,0.5,0.5
SF-L27-2,SF-L21,1,6,0,5,1,1,0.0,1.0,0.8333333333333334,0.16666666666666666
SF-L27-2,SF-Q30,8,5,4,2,4,3,0.5,0.5,0.4,0.6
SF-L27-2,SF-P30,3,3,2,1,1,2,0.6666666666666666,0.3333333333333333,0.3333333333333333,0.6666666666666666
SF-L27-2,SF-O30-2,2,4,1,3,1,1,0.5,0.5,0.75,0.25
SF-L27-2,SF-O30,13,12,10,10,3,2,0.7692307692307693,0.23076923076923078,0.8333333333333334,0.16666666666666666
SF-L27-2,SF-N29,17,6,14,6,3,0,0.8235294117647058,0.17647058823529413,1.0,0.0
SF-L27-2,SF-N28,4,4,3,2,1,2,0.75,0.25,0.5,0.5
SF-L27-2,SF-L30-1,57,40,48,36,9,4,0.8421052631578947,0.15789473684210525,0.9,0.1
SF-L27-2,SF-L31-1,5,5,4,5,1,0,0.8,0.2,1.0,0.0
SF-L27-2,SF-K30-2,30,6,27,4,3,2,0.9,0.1,0.6666666666666666,0.3333333333333333
SF-L27-2,SF-L29,33,8,19,6,14,2,0.5757575757575758,0.42424242424242425,0.75,0.25
SF-L27-2,SF-J29-1,3,5,2,5,1,0,0.6666666666666666,0.3333333333333333,1.0,0.0
SF-L27-2,SF-I30,7,6,6,4,1,2,0.8571428571428571,0.14285714285714285,0.6666666666666666,0.3333333333333333
SF-L27-2,SF-I29-2,2,5,2,5,0,0,1.0,0.0,1.0,0.0
SF-L27-2,SF-I27,9,12,1,2,8,10,0.1111111111111111,0.8888888888888888,0.16666666666666666,0.8333333333333334
SF-L27-2,SF-I28,13,2,5,0,8,2,0.38461538461538464,0.6153846153846154,0.0,1.0
SF-L27-2,SF-I30-2,2,1,1,1,1,0,0.5,0.5,1.0,0.0
SF-L27-2,SF I29-1,3,1,1,1,2,0,0.3333333333333333,0.6666666666666666,1.0,0.0
SF-L27-2,SF-H28,3,5,1,2,2,3,0.3333333333333333,0.6666666666666666,0.4,0.6
SF-L27-2,SF-H29,2,2,1,2,1,0,0.5,0.5,1.0,0.0
SF-L27-2,SF-Q23-3,1,2,0,1,1,1,0.0,1.0,0.5,0.5
SF-L27-2,SF-Q22-1,1,2,0,0,1,2,0.0,1.0,0.0,1.0
SF-L27-2,SF-Q22-2,1,1,0,0,1,1,0.0,1.0,0.0,1.0
SF-J29-3,SF-M26,1,1,1,0,0,1,1.0,0.0,0.0,1.0
SF-J29-3,SF-M25,7,2,5,1,2,1,0.7142857142857143,0.2857142857142857,0.5,0.5
SF-J29-3,SF-M26-2,7,18,5,10,2,8,0.7142857142857143,0.2857142857142857,0.5555555555555556,0.4444444444444444
SF-J29-3,SF-L27,10,12,8,6,2,6,0.8,0.2,0.5,0.5
SF-J29-3,SF-K26,18,8,11,3,7,5,0.6111111111111112,0.3888888888888889,0.375,0.625
SF-J29-3,SF-J27,17,7,7,3,10,4,0.4117647058823529,0.5882352941176471,0.42857142857142855,0.5714285714285714
SF-J29-3,SF-M30,57,57,44,47,13,10,0.7719298245614035,0.22807017543859648,0.8245614035087719,0.17543859649122806
SF-J29-3,SF-L27-2,5,2,2,2,3,0,0.4,0.6,1.0,0.0
SF-J29-3,SF-J29,9,21,3,14,6,7,0.3333333333333333,0.6666666666666666,0.6666666666666666,0.3333333333333333
SF-J29-3,SF-L26,29,11,8,5,21,6,0.27586206896551724,0.7241379310344828,0.45454545454545453,0.5454545454545454
SF-J29-3,SF-M28,7,8,1,6,6,2,0.14285714285714285,0.8571428571428571,0.75,0.25
SF-J29-3,SF-L25,7,2,4,2,3,0,0.5714285714285714,0.42857142857142855,1.0,0.0
SF-J29-3,SF-M24,2,7,1,2,1,5,0.5,0.5,0.2857142857142857,0.7142857142857143
SF-J29-3,SF-L24,2,1,2,0,0,1,1.0,0.0,0.0,1.0
SF-J29-3,SF-N23,1,3,1,3,0,0,1.0,0.0,1.0,0.0
SF-J29-3,SF-N24-2,1,4,0,1,1,3,0.0,1.0,0.25,0.75
SF-J29-3,SF-K27-2,27,56,20,39,7,17,0.7407407407407407,0.25925925925925924,0.6964285714285714,0.30357142857142855
SF-J29-3,SF-J26-2,8,12,4,6,4,6,0.5,0.5,0.5,0.5
SF-J29-3,SF-K28-3,5,7,0,2,5,5,0.0,1.0,0.2857142857142857,0.7142857142857143
SF-J29-3,SF-L28,73,71,34,26,39,45,0.4657534246575342,0.5342465753424658,0.36619718309859156,0.6338028169014085
SF-J29-3,SF-K28,11,7,10,5,1,2,0.9090909090909091,0.09090909090909091,0.7142857142857143,0.2857142857142857
SF-J29-3,SF-K29-1,25,17,22,13,3,4,0.88,0.12,0.7647058823529411,0.23529411764705882
SF-J29-3,SF-J28-2,13,2,8,2,5,0,0.6153846153846154,0.38461538461538464,1.0,0.0
SF-J29-3,SF-K27,7,1,5,1,2,0,0.7142857142857143,0.2857142857142857,1.0,0.0
SF-J29-3,SF-K25,9,11,7,8,2,3,0.7777777777777778,0.2222222222222222,0.7272727272727273,0.2727272727272727
SF-J29-3,SF-J25,18,28,13,12,5,16,0.7222222222222222,0.2777777777777778,0.42857142857142855,0.5714285714285714
SF-J29-3,SF-H26-2,24,10,14,5,10,5,0.5833333333333334,0.4166666666666667,0.5,0.5
SF-J29-3,SF-P24,3,4,1,3,2,1,0.3333333333333333,0.6666666666666666,0.75,0.25
SF-J29-3,SF-J24,8,9,5,2,3,7,0.625,0.375,0.2222222222222222,0.7777777777777778
SF-J29-3,SF-J26,4,8,1,4,3,4,0.25,0.75,0.5,0.5
SF-J29-3,SF-I26-,2,4,2,2,0,2,1.0,0.0,0.5,0.5
SF-J29-3,SF-I25,11,28,7,8,4,20,0.6363636363636364,0.36363636363636365,0.2857142857142857,0.7142857142857143
SF-J29-3,SF-H26,15,17,8,13,7,4,0.5333333333333333,0.4666666666666667,0.7647058823529411,0.23529411764705882
SF-J29-3,SF-O23,3,6,0,1,3,5,0.0,1.0,0.16666666666666666,0.8333333333333334
SF-J29-3,SF-H27-1,19,10,15,7,4,3,0.7894736842105263,0.21052631578947367,0.7,0.3
SF-J29-3,SF-F28-2,8,5,6,4,2,1,0.75,0.25,0.8,0.2
SF-J29-3,SF-G27,32,24,21,16,11,8,0.65625,0.34375,0.6666666666666666,0.3333333333333333
SF-J29-3,SF-M22-2,3,4,2,1,1,3,0.6666666666666666,0.3333333333333333,0.25,0.75
SF-J29-3,SF-F27,13,9,8,3,5,6,0.6153846153846154,0.38461538461538464,0.3333333333333333,0.6666666666666666
SF-J29-3,SF-N22-2,3,4,0,0,3,4,0.0,1.0,0.0,1.0
SF-J29-3,SF-G28-2,10,8,6,0,4,8,0.6,0.4,0.0,1.0
SF-J29-3,SF-G28-1,3,4,2,1,1,3,0.6666666666666666,0.3333333333333333,0.25,0.75
SF-J29-3,SF-M22-1,3,3,2,3,1,0,0.6666666666666666,0.3333333333333333,1.0,0.0
SF-J29-3,SF-K24,4,5,3,2,1,3,0.75,0.25,0.4,0.6
SF-J29-3,SF-J23-2,1,2,1,2,0,0,1.0,0.0,1.0,0.0
SF-J29-3,SF-G23,2,3,1,1,1,2,0.5,0.5,0.3333333333333333,0.6666666666666666
SF-J29-3,SF-G24,15,16,7,4,8,12,0.4666666666666667,0.5333333333333333,0.25,0.75
SF-J29-3,SF-G25,18,12,8,1,10,11,0.4444444444444444,0.5555555555555556,0.08333333333333333,0.9166666666666666
SF-J29-3,SF-F23,3,12,1,2,2,10,0.3333333333333333,0.6666666666666666,0.16666666666666666,0.8333333333333334
SF-J29-3,SF-E23,4,4,3,1,1,3,0.75,0.25,0.25,0.75
SF-J29-3,SF-B22,5,5,1,3,4,2,0.2,0.8,0.6,0.4
SF-J29-3,SF-J17,26,10,16,0,10,10,0.6153846153846154,0.38461538461538464,0.0,1.0
SF-J29-3,SF-I19,2,1,1,1,1,0,0.5,0.5,1.0,0.0
SF-J29-3,SF-I20,5,1,1,0,4,1,0.2,0.8,0.0,1.0
SF-J29-3,SF-G19,6,1,4,1,2,0,0.6666666666666666,0.3333333333333333,1.0,0.0
SF-J29-3,SF-G20,3,5,1,2,2,3,0.3333333333333333,0.6666666666666666,0.4,0.6
SF-J29-3,SF-F19,2,2,0,0,2,2,0.0,1.0,0.0,1.0
SF-J29-3,SF-E20,1,1,0,0,1,1,0.0,1.0,0.0,1.0
SF-J29-3,SF-H30,56,26,42,24,14,2,0.75,0.25,0.9230769230769231,0.07692307692307693
SF-J29-3,SF-G30-2,38,27,22,19,16,8,0.5789473684210527,0.42105263157894735,0.7037037037037037,0.2962962962962963
SF-J29-3,SF-F30-1,21,5,15,3,6,2,0.7142857142857143,0.2857142857142857,0.6,0.4
SF-J29-3,SF-E29-2,33,7,23,4,10,3,0.696969696969697,0.30303030303030304,0.5714285714285714,0.42857142857142855
SF-J29-3,SF-E29-1,22,20,17,16,5,4,0.7727272727272727,0.22727272727272727,0.8,0.2
SF-J29-3,SF-D29,55,44,54,37,1,7,0.9818181818181818,0.01818181818181818,0.8409090909090909,0.1590909090909091
SF-J29-3,SF-D28,14,25,12,16,2,9,0.8571428571428571,0.14285714285714285,0.64,0.36
SF-J29-3,SF-A27,38,21,20,16,18,5,0.5263157894736842,0.47368421052631576,0.7619047619047619,0.23809523809523808
SF-J29-3,SF-G29-2,47,48,19,23,28,25,0.40425531914893614,0.5957446808510638,0.4791666666666667,0.5208333333333334
SF-J29-3,SF-G29-1,10,3,4,2,6,1,0.4,0.6,0.6666666666666666,0.3333333333333333
SF-J29-3,SF-G30-1,71,37,38,23,33,14,0.5352112676056338,0.4647887323943662,0.6216216216216216,0.3783783783783784
SF-J29-3,SF-G29-3,19,21,12,7,7,14,0.631578947368421,0.3684210526315789,0.3333333333333333,0.6666666666666666
SF-J29-3,SF-F30-2,10,13,8,11,2,2,0.8,0.2,0.8461538461538461,0.15384615384615385
SF-J29-3,SF-F29,10,7,7,4,3,3,0.7,0.3,0.5714285714285714,0.42857142857142855
SF-J29-3,SF-E29-3,8,1,3,1,5,0,0.375,0.625,1.0,0.0
SF-J29-3,SF-F28-1,4,5,1,4,3,1,0.25,0.75,0.8,0.2
SF-J29-3,SF-E28-2,3,1,1,0,2,1,0.3333333333333333,0.6666666666666666,0.0,1.0
SF-J29-3,SF-E28,46,30,44,30,2,0,0.9565217391304348,0.043478260869565216,1.0,0.0
SF-J29-3,SF-J10,1,1,0,1,1,0,0.0,1.0,1.0,0.0
SF-J29-3,SF-J13,1,1,0,1,1,0,0.0,1.0,1.0,0.0
SF-J29-3,SF-C20,1,1,0,1,1,0,0.0,1.0,1.0,0.0
SF-J29-3,SF-B21,1,2,0,0,1,2,0.0,1.0,0.0,1.0
SF-J29-3,SF-B19,2,3,0,2,2,1,0.0,1.0,0.6666666666666666,0.3333333333333333
SF-J29-3,SF-A20,2,5,1,1,1,4,0.5,0.5,0.2,0.8
SF-J29-3,SF-C26,41,23,25,3,16,20,0.6097560975609756,0.3902439024390244,0.13043478260869565,0.8695652173913043
SF-J29-3,SF-C25,6,6,0,1,6,5,0.0,1.0,0.16666666666666666,0.8333333333333334
SF-J29-3,SF-B25,3,8,2,8,1,0,0.6666666666666666,0.3333333333333333,1.0,0.0
SF-J29-3,SF-E27,11,6,10,4,1,2,0.9090909090909091,0.09090909090909091,0.6666666666666666,0.3333333333333333
SF-J29-3,SF-D27,7,6,4,2,3,4,0.5714285714285714,0.42857142857142855,0.3333333333333333,0.6666666666666666
SF-J29-3,SF-C28-2,3,23,1,15,2,8,0.3333333333333333,0.6666666666666666,0.6521739130434783,0.34782608695652173
SF-J29-3,SF-C28-1,8,3,7,3,1,0,0.875,0.125,1.0,0.0
SF-J29-3,SF-B28,9,13,6,9,3,4,0.6666666666666666,0.3333333333333333,0.6923076923076923,0.3076923076923077
SF-J29-3,SF-H25,3,2,2,0,1,2,0.6666666666666666,0.3333333333333333,0.0,1.0
SF-J29-3,SF-G26,13,18,8,9,5,9,0.6153846153846154,0.38461538461538464,0.5,0.5
SF-J29-3,SF-K21,7,2,4,0,3,2,0.5714285714285714,0.42857142857142855,0.0,1.0
SF-J29-3,SF-K22-1,2,4,1,2,1,2,0.5,0.5,0.5,0.5
SF-J29-3,SF-J23-1,35,12,15,5,20,7,0.42857142857142855,0.5714285714285714,0.4166666666666667,0.5833333333333334
SF-J29-3,SF-J22-1,5,3,0,0,5,3,0.0,1.0,0.0,1.0
SF-J29-3,SF-J22-2,3,3,1,1,2,2,0.3333333333333333,0.6666666666666666,0.3333333333333333,0.6666666666666666
SF-J29-3,SF-J21,6,1,3,0,3,1,0.5,0.5,0.0,1.0
SF-J29-3,SF-I23-2,2,2,1,2,1,0,0.5,0.5,1.0,0.0
SF-J29-3,SF-I24,6,7,3,1,3,6,0.5,0.5,0.14285714285714285,0.8571428571428571
SF-J29-3,SF-I23-1,2,8,1,1,1,7,0.5,0.5,0.125,0.875
SF-J29-3,SF-F26,29,10,10,5,19,5,0.3448275862068966,0.6551724137931034,0.5,0.5
SF-J29-3,SF-M13,8,1,5,0,3,1,0.625,0.375,0.0,1.0
SF-J29-3,SF-L19,1,1,1,0,0,1,1.0,0.0,0.0,1.0
SF-J29-3,SF-L20,2,5,2,2,0,3,1.0,0.0,0.4,0.6
SF-J29-3,SF-N20-1,5,3,0,0,5,3,0.0,1.0,0.0,1.0
SF-J29-3,SF-M20,5,4,0,1,5,3,0.0,1.0,0.25,0.75
SF-J29-3,SF-K20,1,5,1,1,0,4,1.0,0.0,0.2,0.8
SF-J29-3,SF-K15-,3,2,1,0,2,2,0.3333333333333333,0.6666666666666666,0.0,1.0
SF-J29-3,SF-K18,4,1,1,0,3,1,0.25,0.75,0.0,1.0
SF-J29-3,SF-J18,2,2,0,0,2,2,0.0,1.0,0.0,1.0
SF-J29-3,SF-J20,5,3,3,1,2,2,0.6,0.4,0.3333333333333333,0.6666666666666666
SF-J29-3,SF-J19,16,9,0,1,16,8,0.0,1.0,0.1111111111111111,0.8888888888888888
SF-J29-3,SF-M11,3,1,0,1,3,0,0.0,1.0,1.0,0.0
SF-J29-3,SF-Q21-1,1,1,1,0,0,1,1.0,0.0,0.0,1.0
SF-J29-3,SF-O21,7,9,2,2,5,7,0.2857142857142857,0.7142857142857143,0.2222222222222222,0.7777777777777778
SF-J29-3,SF-N21,3,4,1,2,2,2,0.3333333333333333,0.6666666666666666,0.5,0.5
SF-J29-3,SF-M21,3,5,1,1,2,4,0.3333333333333333,0.6666666666666666,0.2,0.8
SF-J29-3,SF-L21,6,8,2,1,4,7,0.3333333333333333,0.6666666666666666,0.125,0.875
SF-J29-3,SF-S29,4,3,1,0,3,3,0.25,0.75,0.0,1.0
SF-J29-3,SF-S30,3,1,2,1,1,0,0.6666666666666666,0.3333333333333333,1.0,0.0
SF-J29-3,SF-Q30,2,3,0,1,2,2,0.0,1.0,0.3333333333333333,0.6666666666666666
SF-J29-3,SF-P30,16,17,8,5,8,12,0.5,0.5,0.29411764705882354,0.7058823529411765
SF-J29-3,SF-O30-2,14,22,5,16,9,6,0.35714285714285715,0.6428571428571429,0.7272727272727273,0.2727272727272727
SF-J29-3,SF-O30,62,82,34,54,28,28,0.5483870967741935,0.45161290322580644,0.6585365853658537,0.34146341463414637
SF-J29-3,SF-N27,8,12,4,6,4,6,0.5,0.5,0.5,0.5
SF-J29-3,SF-N29,2,6,1,2,1,4,0.5,0.5,0.3333333333333333,0.6666666666666666
SF-J29-3,SF-N28,9,10,4,6,5,4,0.4444444444444444,0.5555555555555556,0.6,0.4
SF-J29-3,SF-L30-1,89,105,77,88,12,17,0.8651685393258427,0.1348314606741573,0.8380952380952381,0.1619047619047619
SF-J29-3,SF-L31-1,5,2,2,2,3,0,0.4,0.6,1.0,0.0
SF-J29-3,SF-K30-2,28,35,26,31,2,4,0.9285714285714286,0.07142857142857142,0.8857142857142857,0.11428571428571428
SF-J29-3,SF-L29,27,71,17,57,10,14,0.6296296296296297,0.37037037037037035,0.8028169014084507,0.19718309859154928
SF-J29-3,SF-J29-1,6,20,3,17,3,3,0.5,0.5,0.85,0.15
SF-J29-3,SF-I30,20,22,17,15,3,7,0.85,0.15,0.6818181818181818,0.3181818181818182
SF-J29-3,SF-I29-2,22,10,13,5,9,5,0.5909090909090909,0.4090909090909091,0.5,0.5
SF-J29-3,SF-I27,10,16,5,9,5,7,0.5,0.5,0.5625,0.4375
SF-J29-3,SF-I28,20,13,15,12,5,1,0.75,0.25,0.9230769230769231,0.07692307692307693
SF-J29-3,SF-I30-2,7,2,6,1,1,1,0.8571428571428571,0.14285714285714285,0.5,0.5
SF-J29-3,SF I29-1,8,6,5,2,3,4,0.625,0.375,0.3333333333333333,0.6666666666666666
SF-J29-3,SF-H28,79,56,60,53,19,3,0.759493670886076,0.24050632911392406,0.9464285714285714,0.05357142857142857
SF-J29-3,SF-H29,6,3,2,2,4,1,0.3333333333333333,0.6666666666666666,0.6666666666666666,0.3333333333333333
SF-J29-3,SF-R24,5,2,3,2,2,0,0.6,0.4,1.0,0.0
SF-J29-3,SF-S22-1,2,3,0,0,2,3,0.0,1.0,0.0,1.0
SF-J29-3,SF-Q22-1,1,1,0,0,1,1,0.0,1.0,0.0,1.0
SF-J29-3,SF-Q22-2,1,2,0,1,1,1,0.0,1.0,0.5,0.5
SF-J29-3,SF-P22,2,2,1,0,1,2,0.5,0.5,0.0,1.0
SF-J29,SF-M26,23,12,7,2,16,10,0.30434782608695654,0.6956521739130435,0.16666666666666666,0.8333333333333334
SF-J29,SF-M25,16,15,8,5,8,10,0.5,0.5,0.3333333333333333,0.6666666666666666
SF-J29,SF-M26-2,82,60,52,25,30,35,0.6341463414634146,0.36585365853658536,0.4166666666666667,0.5833333333333334
SF-J29,SF-L27,85,75,51,34,34,41,0.6,0.4,0.4533333333333333,0.5466666666666666
SF-J29,SF-K26,46,22,18,11,28,11,0.391304347826087,0.6086956521739131,0.5,0.5
SF-J29,SF-J27,36,18,8,6,28,12,0.2222222222222222,0.7777777777777778,0.3333333333333333,0.6666666666666666
SF-J29,SF-M30,46,61,22,19,24,42,0.4782608695652174,0.5217391304347826,0.3114754098360656,0.6885245901639344
SF-J29,SF-L27-2,77,66,60,41,17,25,0.7792207792207793,0.22077922077922077,0.6212121212121212,0.3787878787878788
SF-J29,SF-J29-3,21,9,14,3,7,6,0.6666666666666666,0.3333333333333333,0.3333333333333333,0.6666666666666666
SF-J29,SF-L26,145,129,71,89,74,40,0.4896551724137931,0.5103448275862069,0.689922480620155,0.31007751937984496
SF-J29,SF-M28,58,60,31,11,27,49,0.5344827586206896,0.46551724137931033,0.18333333333333332,0.8166666666666667
SF-J29,SF-M27,36,26,23,5,13,21,0.6388888888888888,0.3611111111111111,0.19230769230769232,0.8076923076923077
SF-J29,SF-L25,16,23,11,10,5,13,0.6875,0.3125,0.43478260869565216,0.5652173913043478
SF-J29,SF-M24,11,13,5,4,6,9,0.45454545454545453,0.5454545454545454,0.3076923076923077,0.6923076923076923
SF-J29,SF-L24,10,10,7,6,3,4,0.7,0.3,0.6,0.4
SF-J29,SF-N23,6,16,4,4,2,12,0.6666666666666666,0.3333333333333333,0.25,0.75
SF-J29,SF-N24-2,4,1,2,0,2,1,0.5,0.5,0.0,1.0
SF-J29,SF-K27-2,64,62,53,42,11,20,0.828125,0.171875,0.6774193548387096,0.3225806451612903
SF-J29,SF-J26-2,32,61,16,33,16,28,0.5,0.5,0.5409836065573771,0.45901639344262296
SF-J29,SF-K28-3,9,19,8,16,1,3,0.8888888888888888,0.1111111111111111,0.8421052631578947,0.15789473684210525
SF-J29,SF-L28,20,35,14,13,6,22,0.7,0.3,0.37142857142857144,0.6285714285714286
SF-J29,SF-K28,22,50,17,38,5,12,0.7727272727272727,0.22727272727272727,0.76,0.24
SF-J29,SF-K29-1,37,19,27,10,10,9,0.7297297297297297,0.2702702702702703,0.5263157894736842,0.47368421052631576
SF-J29,SF-J28-2,8,15,1,7,7,8,0.125,0.875,0.4666666666666667,0.5333333333333333
SF-J29,SF-K27,5,19,2,12,3,7,0.4,0.6,0.631578947368421,0.3684210526315789
SF-J29,SF-K25,37,33,22,8,15,25,0.5945945945945946,0.40540540540540543,0.24242424242424243,0.7575757575757576
SF-J29,SF-J25,107,84,58,37,49,47,0.5420560747663551,0.45794392523364486,0.44047619047619047,0.5595238095238095
SF-J29,SF-H26-2,23,16,18,6,5,10,0.782608695652174,0.21739130434782608,0.375,0.625
SF-J29,SF-P24,11,6,9,2,2,4,0.8181818181818182,0.18181818181818182,0.3333333333333333,0.6666666666666666
SF-J29,SF-N22-1A,7,5,0,1,7,4,0.0,1.0,0.2,0.8
SF-J29,SF-J24,89,45,48,31,41,14,0.5393258426966292,0.4606741573033708,0.6888888888888889,0.3111111111111111
SF-J29,SF-O24,2,2,2,1,0,1,1.0,0.0,0.5,0.5
SF-J29,SF-J26,20,14,7,9,13,5,0.35,0.65,0.6428571428571429,0.35714285714285715
SF-J29,SF-I26-,18,15,17,8,1,7,0.9444444444444444,0.05555555555555555,0.5333333333333333,0.4666666666666667
SF-J29,SF-I25,31,94,18,8,13,86,0.5806451612903226,0.41935483870967744,0.0851063829787234,0.9148936170212766
SF-J29,SF-K23,1,2,1,2,0,0,1.0,0.0,1.0,0.0
SF-J29,SF-H26,42,53,19,35,23,18,0.4523809523809524,0.5476190476190477,0.660377358490566,0.33962264150943394
SF-J29,SF-O23,6,14,2,7,4,7,0.3333333333333333,0.6666666666666666,0.5,0.5
SF-J29,SF-H27-1,38,28,27,19,11,9,0.7105263157894737,0.2894736842105263,0.6785714285714286,0.32142857142857145
SF-J29,SF-F28-2,29,20,15,3,14,17,0.5172413793103449,0.4827586206896552,0.15,0.85
SF-J29,SF-G27,60,45,32,18,28,27,0.5333333333333333,0.4666666666666667,0.4,0.6
SF-J29,SF-M22-2,26,16,7,8,19,8,0.2692307692307692,0.7307692307692307,0.5,0.5
SF-J29,SF-L22,43,51,14,20,29,31,0.32558139534883723,0.6744186046511628,0.39215686274509803,0.6078431372549019
SF-J29,SF-F27,39,27,13,7,26,20,0.3333333333333333,0.6666666666666666,0.25925925925925924,0.7407407407407407
SF-J29,SF-N22-2,25,31,5,11,20,20,0.2,0.8,0.3548387096774194,0.6451612903225806
SF-J29,SF-G28-2,14,17,3,2,11,15,0.21428571428571427,0.7857142857142857,0.11764705882352941,0.8823529411764706
SF-J29,SF-G28-1,13,11,7,4,6,7,0.5384615384615384,0.46153846153846156,0.36363636363636365,0.6363636363636364
SF-J29,SF-M22-1,22,14,8,9,14,5,0.36363636363636365,0.6363636363636364,0.6428571428571429,0.35714285714285715
SF-J29,SF-O25-1,4,3,3,1,1,2,0.75,0.25,0.3333333333333333,0.6666666666666666
SF-J29,SF-K22-2,10,6,4,3,6,3,0.4,0.6,0.5,0.5
SF-J29,SF-K24,19,15,12,4,7,11,0.631578947368421,0.3684210526315789,0.26666666666666666,0.7333333333333333
SF-J29,SF-J23-2,19,7,14,4,5,3,0.7368421052631579,0.2631578947368421,0.5714285714285714,0.42857142857142855
SF-J29,SF-G23,21,8,5,2,16,6,0.23809523809523808,0.7619047619047619,0.25,0.75
SF-J29,SF-G24,67,20,13,0,54,20,0.19402985074626866,0.8059701492537313,0.0,1.0
SF-J29,SF-G25,56,53,4,3,52,50,0.07142857142857142,0.9285714285714286,0.05660377358490566,0.9433962264150944
SF-J29,SF-F23,24,44,7,4,17,40,0.2916666666666667,0.7083333333333334,0.09090909090909091,0.9090909090909091
SF-J29,SF-E23,12,11,5,3,7,8,0.4166666666666667,0.5833333333333334,0.2727272727272727,0.7272727272727273
SF-J29,SF-D24,5,4,2,0,3,4,0.4,0.6,0.0,1.0
SF-J29,SF-C22,5,4,0,2,5,2,0.0,1.0,0.5,0.5
SF-J29,SF-B22,14,8,3,2,11,6,0.21428571428571427,0.7857142857142857,0.25,0.75
SF-J29,SF-J17,8,8,6,1,2,7,0.75,0.25,0.125,0.875
SF-J29,SF-I19,2,2,1,0,1,2,0.5,0.5,0.0,1.0
SF-J29,SF-I20,10,3,1,1,9,2,0.1,0.9,0.3333333333333333,0.6666666666666666
SF-J29,SF-H20,12,7,1,2,11,5,0.08333333333333333,0.9166666666666666,0.2857142857142857,0.7142857142857143
SF-J29,SF-G19,10,2,2,1,8,1,0.2,0.8,0.5,0.5
SF-J29,SF-G17,5,11,0,0,5,11,0.0,1.0,0.0,1.0
SF-J29,SF-G18,8,2,3,1,5,1,0.375,0.625,0.5,0.5
SF-J29,SF-G20,48,40,3,5,45,35,0.0625,0.9375,0.125,0.875
SF-J29,SF-F19,1,3,0,0,1,3,0.0,1.0,0.0,1.0
SF-J29,SF-E18,1,1,0,0,1,1,0.0,1.0,0.0,1.0
SF-J29,SF-E20,5,5,1,2,4,3,0.2,0.8,0.4,0.6
SF-J29,SF-H30,19,21,13,16,6,5,0.6842105263157895,0.3157894736842105,0.7619047619047619,0.23809523809523808
SF-J29,SF-G30-2,18,23,8,12,10,11,0.4444444444444444,0.5555555555555556,0.5217391304347826,0.4782608695652174
SF-J29,SF-F30-1,10,13,4,6,6,7,0.4,0.6,0.46153846153846156,0.5384615384615384
SF-J29,SF-E29-2,13,17,8,8,5,9,0.6153846153846154,0.38461538461538464,0.47058823529411764,0.5294117647058824
SF-J29,SF-E29-1,14,24,8,8,6,16,0.5714285714285714,0.42857142857142855,0.3333333333333333,0.6666666666666666
SF-J29,SF-D29,11,18,7,6,4,12,0.6363636363636364,0.36363636363636365,0.3333333333333333,0.6666666666666666
SF-J29,SF-D28,44,64,11,42,33,22,0.25,0.75,0.65625,0.34375
SF-J29,SF-A27,10,11,3,8,7,3,0.3,0.7,0.7272727272727273,0.2727272727272727
SF-J29,SF-G29-2,26,21,9,10,17,11,0.34615384615384615,0.6538461538461539,0.47619047619047616,0.5238095238095238
SF-J29,SF-G29-1,16,15,4,3,12,12,0.25,0.75,0.2,0.8
SF-J29,SF-G30-1,29,46,19,33,10,13,0.6551724137931034,0.3448275862068966,0.717391304347826,0.2826086956521739
SF-J29,SF-G29-3,13,27,7,2,6,25,0.5384615384615384,0.46153846153846156,0.07407407407407407,0.9259259259259259
SF-J29,SF-F30-2,6,7,3,4,3,3,0.5,0.5,0.5714285714285714,0.42857142857142855
SF-J29,SF-F29,8,20,7,8,1,12,0.875,0.125,0.4,0.6
SF-J29,SF-E29-3,6,4,2,0,4,4,0.3333333333333333,0.6666666666666666,0.0,1.0
SF-J29,SF-F28-1,8,1,4,1,4,0,0.5,0.5,1.0,0.0
SF-J29,SF-E28,86,111,79,101,7,10,0.9186046511627907,0.08139534883720931,0.9099099099099099,0.09009009009009009
SF-J29,SF-J10,1,2,1,1,0,1,1.0,0.0,0.5,0.5
SF-J29,SF-J12,5,4,0,0,5,4,0.0,1.0,0.0,1.0
SF-J29,SF-J13,1,4,0,3,1,1,0.0,1.0,0.75,0.25
SF-J29,SF-I16,2,2,0,1,2,1,0.0,1.0,0.5,0.5
SF-J29,SF-B19,56,55,2,3,54,52,0.03571428571428571,0.9642857142857143,0.05454545454545454,0.9454545454545454
SF-J29,SF-A20,12,19,0,3,12,16,0.0,1.0,0.15789473684210525,0.8421052631578947
SF-J29,SF-A19,1,6,1,1,0,5,1.0,0.0,0.16666666666666666,0.8333333333333334
SF-J29,SF-C26,84,60,15,6,69,54,0.17857142857142858,0.8214285714285714,0.1,0.9
SF-J29,SF-C25,7,11,1,1,6,10,0.14285714285714285,0.8571428571428571,0.09090909090909091,0.9090909090909091
SF-J29,SF-B25,7,12,3,7,4,5,0.42857142857142855,0.5714285714285714,0.5833333333333334,0.4166666666666667
SF-J29,SF-E27,7,2,1,1,6,1,0.14285714285714285,0.8571428571428571,0.5,0.5
SF-J29,SF-B28-2,8,7,7,6,1,1,0.875,0.125,0.8571428571428571,0.14285714285714285
SF-J29,SF-D27,6,6,4,1,2,5,0.6666666666666666,0.3333333333333333,0.16666666666666666,0.8333333333333334
SF-J29,SF-C28-2,63,27,20,11,43,16,0.31746031746031744,0.6825396825396826,0.4074074074074074,0.5925925925925926
SF-J29,SF-C28-1,2,1,1,1,1,0,0.5,0.5,1.0,0.0
SF-J29,SF-B28,8,14,6,10,2,4,0.75,0.25,0.7142857142857143,0.2857142857142857
SF-J29,SF-J5,1,4,0,0,1,4,0.0,1.0,0.0,1.0
SF-J29,SF-G7,1,3,1,1,0,2,1.0,0.0,0.3333333333333333,0.6666666666666666
SF-J29,SF-H25,13,16,3,0,10,16,0.23076923076923078,0.7692307692307693,0.0,1.0
SF-J29,SF-G26,27,70,10,19,17,51,0.37037037037037035,0.6296296296296297,0.2714285714285714,0.7285714285714285
SF-J29,SF-K21,19,3,10,0,9,3,0.5263157894736842,0.47368421052631576,0.0,1.0
SF-J29,SF-K22-1,22,9,8,4,14,5,0.36363636363636365,0.6363636363636364,0.4444444444444444,0.5555555555555556
SF-J29,SF-J23-1,112,100,27,22,85,78,0.24107142857142858,0.7589285714285714,0.22,0.78
SF-J29,SF-J22-1,36,18,11,8,25,10,0.3055555555555556,0.6944444444444444,0.4444444444444444,0.5555555555555556
SF-J29,SF-J22-2,11,12,3,5,8,7,0.2727272727272727,0.7272727272727273,0.4166666666666667,0.5833333333333334
SF-J29,SF-J21,19,12,9,2,10,10,0.47368421052631576,0.5263157894736842,0.16666666666666666,0.8333333333333334
SF-J29,SF-I21,2,8,0,2,2,6,0.0,1.0,0.25,0.75
SF-J29,SF-I22,2,5,0,2,2,3,0.0,1.0,0.4,0.6
SF-J29,SF-I23-2,8,5,6,1,2,4,0.75,0.25,0.2,0.8
SF-J29,SF-I24,8,15,3,4,5,11,0.375,0.625,0.26666666666666666,0.7333333333333333
SF-J29,SF-I23-1,11,14,4,1,7,13,0.36363636363636365,0.6363636363636364,0.07142857142857142,0.9285714285714286
SF-J29,SF-F26,98,88,62,36,36,52,0.6326530612244898,0.3673469387755102,0.4090909090909091,0.5909090909090909
SF-J29,SF-M13,6,4,2,2,4,2,0.3333333333333333,0.6666666666666666,0.5,0.5
SF-J29,SF-M15,6,5,1,2,5,3,0.16666666666666666,0.8333333333333334,0.4,0.6
SF-J29,SF-L19,7,4,1,1,6,3,0.14285714285714285,0.8571428571428571,0.25,0.75
SF-J29,SF-L20,13,6,7,3,6,3,0.5384615384615384,0.46153846153846156,0.5,0.5
SF-J29,SF-N20-1,3,2,0,0,3,2,0.0,1.0,0.0,1.0
SF-J29,SF-M20,15,11,4,4,11,7,0.26666666666666666,0.7333333333333333,0.36363636363636365,0.6363636363636364
SF-J29,SF-K17-2,8,4,1,0,7,4,0.125,0.875,0.0,1.0
SF-J29,SF-K20,30,30,3,4,27,26,0.1,0.9,0.13333333333333333,0.8666666666666667
SF-J29,SF-K15-,5,15,1,3,4,12,0.2,0.8,0.2,0.8
SF-J29,SF-K19,23,6,6,1,17,5,0.2608695652173913,0.7391304347826086,0.16666666666666666,0.8333333333333334
SF-J29,SF-K18,10,4,1,1,9,3,0.1,0.9,0.25,0.75
SF-J29,SF-K17,23,9,9,0,14,9,0.391304347826087,0.6086956521739131,0.0,1.0
SF-J29,SF-J16,5,1,3,0,2,1,0.6,0.4,0.0,1.0
SF-J29,SF-J18,8,8,4,0,4,8,0.5,0.5,0.0,1.0
SF-J29,SF-J20,7,10,4,4,3,6,0.5714285714285714,0.42857142857142855,0.4,0.6
SF-J29,SF-J19,4,17,2,5,2,12,0.5,0.5,0.29411764705882354,0.7058823529411765
SF-J29,SF-M12,3,1,1,0,2,1,0.3333333333333333,0.6666666666666666,0.0,1.0
SF-J29,SF-M11,3,2,1,0,2,2,0.3333333333333333,0.6666666666666666,0.0,1.0
SF-J29,SF-R19,4,7,2,1,2,6,0.5,0.5,0.14285714285714285,0.8571428571428571
SF-J29,SF-R20,1,1,1,0,0,1,1.0,0.0,0.0,1.0
SF-J29,SF-Q21-2,2,1,0,0,2,1,0.0,1.0,0.0,1.0
SF-J29,SF-Q21-1,8,4,2,0,6,4,0.25,0.75,0.0,1.0
SF-J29,SF-P21,4,3,2,1,2,2,0.5,0.5,0.3333333333333333,0.6666666666666666
SF-J29,SF-O18,11,6,2,2,9,4,0.18181818181818182,0.8181818181818182,0.3333333333333333,0.6666666666666666
SF-J29,SF-O19,25,4,19,2,6,2,0.76,0.24,0.5,0.5
SF-J29,SF-O21,29,23,8,3,21,20,0.27586206896551724,0.7241379310344828,0.13043478260869565,0.8695652173913043
SF-J29,SF-O22,12,28,4,9,8,19,0.3333333333333333,0.6666666666666666,0.32142857142857145,0.6785714285714286
SF-J29,SF-N21,6,10,0,4,6,6,0.0,1.0,0.4,0.6
SF-J29,SF-M21,14,13,8,2,6,11,0.5714285714285714,0.42857142857142855,0.15384615384615385,0.8461538461538461
SF-J29,SF-L21,37,20,5,6,32,14,0.13513513513513514,0.8648648648648649,0.3,0.7
SF-J29,SF-Q30,13,10,6,2,7,8,0.46153846153846156,0.5384615384615384,0.2,0.8
SF-J29,SF-P30,38,13,33,5,5,8,0.868421052631579,0.13157894736842105,0.38461538461538464,0.6153846153846154
SF-J29,SF-O30-2,14,18,4,6,10,12,0.2857142857142857,0.7142857142857143,0.3333333333333333,0.6666666666666666
SF-J29,SF-O30,27,60,13,27,14,33,0.48148148148148145,0.5185185185185185,0.45,0.55
SF-J29,SF-N27,20,31,11,11,9,20,0.55,0.45,0.3548387096774194,0.6451612903225806
SF-J29,SF-N29,13,18,8,6,5,12,0.6153846153846154,0.38461538461538464,0.3333333333333333,0.6666666666666666
SF-J29,SF-N28,45,25,39,16,6,9,0.8666666666666667,0.13333333333333333,0.64,0.36
SF-J29,SF-L30-1,24,33,15,21,9,12,0.625,0.375,0.6363636363636364,0.36363636363636365
SF-J29,SF-L31-1,5,5,4,4,1,1,0.8,0.2,0.8,0.2
SF-J29,SF-K30-2,10,13,8,9,2,4,0.8,0.2,0.6923076923076923,0.3076923076923077
SF-J29,SF-L29,38,27,32,15,6,12,0.8421052631578947,0.15789473684210525,0.5555555555555556,0.4444444444444444
SF-J29,SF-J29-1,15,28,11,14,4,14,0.7333333333333333,0.26666666666666666,0.5,0.5
SF-J29,SF-I30,65,36,55,24,10,12,0.8461538461538461,0.15384615384615385,0.6666666666666666,0.3333333333333333
SF-J29,SF-I29-2,17,12,9,6,8,6,0.5294117647058824,0.47058823529411764,0.5,0.5
SF-J29,SF-I27,23,86,13,32,10,54,0.5652173913043478,0.43478260869565216,0.37209302325581395,0.627906976744186
SF-J29,SF-I28,25,6,13,5,12,1,0.52,0.48,0.8333333333333334,0.16666666666666666
SF-J29,SF-I30-2,18,7,7,4,11,3,0.3888888888888889,0.6111111111111112,0.5714285714285714,0.42857142857142855
SF-J29,SF I29-1,18,9,6,3,12,6,0.3333333333333333,0.6666666666666666,0.3333333333333333,0.6666666666666666
SF-J29,SF-H28,46,29,29,19,17,10,0.6304347826086957,0.3695652173913043,0.6551724137931034,0.3448275862068966
SF-J29,SF-H29,9,8,4,2,5,6,0.4444444444444444,0.5555555555555556,0.25,0.75
SF-J29,SF-S24,9,12,2,2,7,10,0.2222222222222222,0.7777777777777778,0.16666666666666666,0.8333333333333334
SF-J29,SF-R24,4,10,4,2,0,8,1.0,0.0,0.2,0.8
SF-J29,SF-R26,6,1,4,0,2,1,0.6666666666666666,0.3333333333333333,0.0,1.0
SF-J29,SF-Q26,5,2,5,1,0,1,1.0,0.0,0.5,0.5
SF-J29,SF-P26,12,5,10,3,2,2,0.8333333333333334,0.16666666666666666,0.6,0.4
SF-J29,SF-O25-2,2,7,1,4,1,3,0.5,0.5,0.5714285714285714,0.42857142857142855
SF-J29,SF-N22-1B,26,25,3,5,23,20,0.11538461538461539,0.8846153846153846,0.2,0.8
SF-J29,SF-N26,7,1,2,0,5,1,0.2857142857142857,0.7142857142857143,0.0,1.0
SF-J29,SF-N25,7,5,3,1,4,4,0.42857142857142855,0.5714285714285714,0.2,0.8
SF-J29,SF-T22,1,2,0,1,1,1,0.0,1.0,0.5,0.5
SF-J29,SF-S22-1,4,2,0,1,4,1,0.0,1.0,0.5,0.5
SF-J29,SF-Q23-3,10,6,5,5,5,1,0.5,0.5,0.8333333333333334,0.16666666666666666
SF-J29,SF-Q22-1,12,15,5,4,7,11,0.4166666666666667,0.5833333333333334,0.26666666666666666,0.7333333333333333
SF-J29,SF-Q22-2,3,4,0,1,3,3,0.0,1.0,0.25,0.75
SF-J29,SF-P22,7,6,0,0,7,6,0.0,1.0,0.0,1.0
SF-J29,SF-S21,1,2,0,0,1,2,0.0,1.0,0.0,1.0
SF-J29,SF-W14,1,1,1,0,0,1,1.0,0.0,0.0,1.0
SF-L26,SF-M26,6,11,2,11,4,0,0.3333333333333333,0.6666666666666666,1.0,0.0
SF-L26,SF-M25,17,13,11,7,6,6,0.6470588235294118,0.35294117647058826,0.5384615384615384,0.46153846153846156
SF-L26,SF-M26-2,47,14,46,8,1,6,0.9787234042553191,0.02127659574468085,0.5714285714285714,0.42857142857142855
SF-L26,SF-L27,5,4,4,3,1,1,0.8,0.2,0.75,0.25
SF-L26,SF-K26,5,16,2,7,3,9,0.4,0.6,0.4375,0.5625
SF-L26,SF-J27,3,4,2,1,1,3,0.6666666666666666,0.3333333333333333,0.25,0.75
SF-L26,SF-M30,18,9,11,2,7,7,0.6111111111111112,0.3888888888888889,0.2222222222222222,0.7777777777777778
SF-L26,SF-L27-2,4,1,3,0,1,1,0.75,0.25,0.0,1.0
SF-L26,SF-J29-3,11,29,5,8,6,21,0.45454545454545453,0.5454545454545454,0.27586206896551724,0.7241379310344828
SF-L26,SF-J29,129,145,89,71,40,74,0.689922480620155,0.31007751937984496,0.4896551724137931,0.5103448275862069
SF-L26,SF-M28,14,8,12,2,2,6,0.8571428571428571,0.14285714285714285,0.25,0.75
SF-L26,SF-M27,9,10,7,7,2,3,0.7777777777777778,0.2222222222222222,0.7,0.3
SF-L26,SF-L25,11,29,7,15,4,14,0.6363636363636364,0.36363636363636365,0.5172413793103449,0.4827586206896552
SF-L26,SF-M24,26,29,18,21,8,8,0.6923076923076923,0.3076923076923077,0.7241379310344828,0.27586206896551724
SF-L26,SF-L24,37,60,32,47,5,13,0.8648648648648649,0.13513513513513514,0.7833333333333333,0.21666666666666667
SF-L26,SF-N23,30,19,10,13,20,6,0.3333333333333333,0.6666666666666666,0.6842105263157895,0.3157894736842105
SF-L26,SF-N24-2,10,48,7,15,3,33,0.7,0.3,0.3125,0.6875
SF-L26,SF-K27-2,3,3,2,0,1,3,0.6666666666666666,0.3333333333333333,0.0,1.0
SF-L26,SF-J26-2,48,36,39,33,9,3,0.8125,0.1875,0.9166666666666666,0.08333333333333333
SF-L26,SF-K28-3,7,2,7,2,0,0,1.0,0.0,1.0,0.0
SF-L26,SF-L28,127,87,56,18,71,69,0.4409448818897638,0.5590551181102362,0.20689655172413793,0.7931034482758621
SF-L26,SF-K28,31,14,21,8,10,6,0.6774193548387096,0.3225806451612903,0.5714285714285714,0.42857142857142855
SF-L26,SF-K29-1,21,18,4,4,17,14,0.19047619047619047,0.8095238095238095,0.2222222222222222,0.7777777777777778
SF-L26,SF-J28-2,80,88,48,71,32,17,0.6,0.4,0.8068181818181818,0.19318181818181818
SF-L26,SF-K27,2,2,1,1,1,1,0.5,0.5,0.5,0.5
SF-L26,SF-K25,8,11,5,7,3,4,0.625,0.375,0.6363636363636364,0.36363636363636365
SF-L26,SF-J25,74,49,21,5,53,44,0.28378378378378377,0.7162162162162162,0.10204081632653061,0.8979591836734694
SF-L26,SF-H26-2,1,3,1,0,0,3,1.0,0.0,0.0,1.0
SF-L26,SF-P24,21,24,5,6,16,18,0.23809523809523808,0.7619047619047619,0.25,0.75
SF-L26,SF-N22-1A,2,3,1,1,1,2,0.5,0.5,0.3333333333333333,0.6666666666666666
SF-L26,SF-J24,20,10,13,8,7,2,0.65,0.35,0.8,0.2
SF-L26,SF-O24,15,2,5,1,10,1,0.3333333333333333,0.6666666666666666,0.5,0.5
SF-L26,SF-J26,38,56,13,26,25,30,0.34210526315789475,0.6578947368421053,0.4642857142857143,0.5357142857142857
SF-L26,SF-I26-,10,2,2,1,8,1,0.2,0.8,0.5,0.5
SF-L26,SF-I25,158,116,67,49,91,67,0.4240506329113924,0.5759493670886076,0.4224137931034483,0.5775862068965517
SF-L26,SF-K23,6,11,5,10,1,1,0.8333333333333334,0.16666666666666666,0.9090909090909091,0.09090909090909091
SF-L26,SF-H26,21,24,10,5,11,19,0.47619047619047616,0.5238095238095238,0.20833333333333334,0.7916666666666666
SF-L26,SF-O23,22,27,5,11,17,16,0.22727272727272727,0.7727272727272727,0.4074074074074074,0.5925925925925926
SF-L26,SF-H27-1,1,3,0,2,1,1,0.0,1.0,0.6666666666666666,0.3333333333333333
SF-L26,SF-F28-2,2,1,0,0,2,1,0.0,1.0,0.0,1.0
SF-L26,SF-G27,5,10,1,4,4,6,0.2,0.8,0.4,0.6
SF-L26,SF-M22-2,80,73,40,31,40,42,0.5,0.5,0.4246575342465753,0.5753424657534246
SF-L26,SF-L22,46,50,36,35,10,15,0.782608695652174,0.21739130434782608,0.7,0.3
SF-L26,SF-F27,19,3,3,1,16,2,0.15789473684210525,0.8421052631578947,0.3333333333333333,0.6666666666666666
SF-L26,SF-N22-2,201,233,33,23,168,210,0.16417910447761194,0.835820895522388,0.09871244635193133,0.9012875536480687
SF-L26,SF-M22-1,69,71,36,17,33,54,0.5217391304347826,0.4782608695652174,0.23943661971830985,0.7605633802816901
SF-L26,SF-O25-1,14,10,11,7,3,3,0.7857142857142857,0.21428571428571427,0.7,0.3
SF-L26,SF-K22-2,67,100,65,89,2,11,0.9701492537313433,0.029850746268656716,0.89,0.11
SF-L26,SF-K24,43,64,17,28,26,36,0.3953488372093023,0.6046511627906976,0.4375,0.5625
SF-L26,SF-J23-2,32,16,19,3,13,13,0.59375,0.40625,0.1875,0.8125
SF-L26,SF-G23,3,21,0,0,3,21,0.0,1.0,0.0,1.0
SF-L26,SF-G24,7,10,0,1,7,9,0.0,1.0,0.1,0.9
SF-L26,SF-G25,23,6,22,5,1,1,0.9565217391304348,0.043478260869565216,0.8333333333333334,0.16666666666666666
SF-L26,SF-F23,1,1,1,0,0,1,1.0,0.0,0.0,1.0
SF-L26,SF-D24,3,4,1,0,2,4,0.3333333333333333,0.6666666666666666,0.0,1.0
SF-L26,SF-B22,3,1,1,0,2,1,0.3333333333333333,0.6666666666666666,0.0,1.0
SF-L26,SF-J17,2,1,0,0,2,1,0.0,1.0,0.0,1.0
SF-L26,SF-I19,25,24,2,0,23,24,0.08,0.92,0.0,1.0
SF-L26,SF-I20,42,45,16,2,26,43,0.38095238095238093,0.6190476190476191,0.044444444444444446,0.9555555555555556
SF-L26,SF-H16,1,3,0,0,1,3,0.0,1.0,0.0,1.0
SF-L26,SF-H20,1,4,0,2,1,2,0.0,1.0,0.5,0.5
SF-L26,SF-G19,34,19,24,8,10,11,0.7058823529411765,0.29411764705882354,0.42105263157894735,0.5789473684210527
SF-L26,SF-G17,1,2,0,0,1,2,0.0,1.0,0.0,1.0
SF-L26,SF-G20,1,6,0,2,1,4,0.0,1.0,0.3333333333333333,0.6666666666666666
SF-L26,SF-F19,1,1,0,0,1,1,0.0,1.0,0.0,1.0
SF-L26,SF-H30,4,7,3,5,1,2,0.75,0.25,0.7142857142857143,0.2857142857142857
SF-L26,SF-G30-2,9,8,3,6,6,2,0.3333333333333333,0.6666666666666666,0.75,0.25
SF-L26,SF-E29-2,2,1,2,0,0,1,1.0,0.0,0.0,1.0
SF-L26,SF-G29-2,6,2,2,0,4,2,0.3333333333333333,0.6666666666666666,0.0,1.0
SF-L26,SF-G29-1,1,13,1,2,0,11,1.0,0.0,0.15384615384615385,0.8461538461538461
SF-L26,SF-G30-1,22,4,2,0,20,4,0.09090909090909091,0.9090909090909091,0.0,1.0
SF-L26,SF-G29-3,5,4,4,0,1,4,0.8,0.2,0.0,1.0
SF-L26,SF-F30-2,2,3,1,0,1,3,0.5,0.5,0.0,1.0
SF-L26,SF-F29,2,1,2,0,0,1,1.0,0.0,0.0,1.0
SF-L26,SF-E28,3,4,3,4,0,0,1.0,0.0,1.0,0.0
SF-L26,SF-J13,2,1,2,0,0,1,1.0,0.0,0.0,1.0
SF-L26,SF-J15,2,1,0,0,2,1,0.0,1.0,0.0,1.0
SF-L26,SF-B21,2,1,2,1,0,0,1.0,0.0,1.0,0.0
SF-L26,SF-C25,43,91,5,0,38,91,0.11627906976744186,0.8837209302325582,0.0,1.0
SF-L26,SF-H25,1,1,0,0,1,1,0.0,1.0,0.0,1.0
SF-L26,SF-G26,2,12,0,11,2,1,0.0,1.0,0.9166666666666666,0.08333333333333333
SF-L26,SF-K21,61,14,53,0,8,14,0.8688524590163934,0.13114754098360656,0.0,1.0
SF-L26,SF-K22-1,43,90,22,54,21,36,0.5116279069767442,0.4883720930232558,0.6,0.4
SF-L26,SF-J23-1,163,161,69,36,94,125,0.4233128834355828,0.5766871165644172,0.2236024844720497,0.7763975155279503
SF-L26,SF-J22-1,17,22,7,15,10,7,0.4117647058823529,0.5882352941176471,0.6818181818181818,0.3181818181818182
SF-L26,SF-J22-2,12,12,2,7,10,5,0.16666666666666666,0.8333333333333334,0.5833333333333334,0.4166666666666667
SF-L26,SF-J21,45,66,13,13,32,53,0.28888888888888886,0.7111111111111111,0.19696969696969696,0.803030303030303
SF-L26,SF-I21,19,11,10,9,9,2,0.5263157894736842,0.47368421052631576,0.8181818181818182,0.18181818181818182
SF-L26,SF-I22,14,7,10,1,4,6,0.7142857142857143,0.2857142857142857,0.14285714285714285,0.8571428571428571
SF-L26,SF-I23-2,20,6,5,0,15,6,0.25,0.75,0.0,1.0
SF-L26,SF-I24,5,8,4,7,1,1,0.8,0.2,0.875,0.125
SF-L26,SF-I23-1,13,7,9,3,4,4,0.6923076923076923,0.3076923076923077,0.42857142857142855,0.5714285714285714
SF-L26,SF-F26,21,9,14,3,7,6,0.6666666666666666,0.3333333333333333,0.3333333333333333,0.6666666666666666
SF-L26,SF-M13,4,2,2,0,2,2,0.5,0.5,0.0,1.0
SF-L26,SF-M15,1,1,1,0,0,1,1.0,0.0,0.0,1.0
SF-L26,SF-L19,33,6,18,2,15,4,0.5454545454545454,0.45454545454545453,0.3333333333333333,0.6666666666666666
SF-L26,SF-L20,47,39,17,15,30,24,0.3617021276595745,0.6382978723404256,0.38461538461538464,0.6153846153846154
SF-L26,SF-N20-1,85,90,10,5,75,85,0.11764705882352941,0.8823529411764706,0.05555555555555555,0.9444444444444444
SF-L26,SF-M20,218,160,58,35,160,125,0.26605504587155965,0.7339449541284404,0.21875,0.78125
SF-L26,SF-K17-2,39,9,22,0,17,9,0.5641025641025641,0.4358974358974359,0.0,1.0
SF-L26,SF-K20,32,26,8,2,24,24,0.25,0.75,0.07692307692307693,0.9230769230769231
SF-L26,SF-K15-,3,6,1,0,2,6,0.3333333333333333,0.6666666666666666,0.0,1.0
SF-L26,SF-K19,23,17,13,8,10,9,0.5652173913043478,0.43478260869565216,0.47058823529411764,0.5294117647058824
SF-L26,SF-K18,3,12,1,0,2,12,0.3333333333333333,0.6666666666666666,0.0,1.0
SF-L26,SF-K17,2,1,0,0,2,1,0.0,1.0,0.0,1.0
SF-L26,SF-J16,5,2,0,0,5,2,0.0,1.0,0.0,1.0
SF-L26,SF-J18,9,9,0,0,9,9,0.0,1.0,0.0,1.0
SF-L26,SF-J20,4,7,1,1,3,6,0.25,0.75,0.14285714285714285,0.8571428571428571
SF-L26,SF-J19,11,4,2,0,9,4,0.18181818181818182,0.8181818181818182,0.0,1.0
SF-L26,SF-M10,2,2,0,0,2,2,0.0,1.0,0.0,1.0
SF-L26,SF-M11,7,3,0,0,7,3,0.0,1.0,0.0,1.0
SF-L26,SF-R19,33,5,6,0,27,5,0.18181818181818182,0.8181818181818182,0.0,1.0
SF-L26,SF-Q21-2,13,17,1,0,12,17,0.07692307692307693,0.9230769230769231,0.0,1.0
SF-L26,SF-Q21-1,8,5,3,0,5,5,0.375,0.625,0.0,1.0
SF-L26,SF-P21,24,16,11,2,13,14,0.4583333333333333,0.5416666666666666,0.125,0.875
SF-L26,SF-O18,173,72,71,3,102,69,0.41040462427745666,0.5895953757225434,0.041666666666666664,0.9583333333333334
SF-L26,SF-O19,77,66,24,19,53,47,0.3116883116883117,0.6883116883116883,0.2878787878787879,0.7121212121212122
SF-L26,SF-O21,55,29,15,6,40,23,0.2727272727272727,0.7272727272727273,0.20689655172413793,0.7931034482758621
SF-L26,SF-O22,209,189,70,68,139,121,0.3349282296650718,0.6650717703349283,0.35978835978835977,0.6402116402116402
SF-L26,SF-N21,48,48,4,3,44,45,0.08333333333333333,0.9166666666666666,0.0625,0.9375
SF-L26,SF-N20-2,49,59,6,7,43,52,0.12244897959183673,0.8775510204081632,0.11864406779661017,0.8813559322033898
SF-L26,SF-M21,290,291,132,84,158,207,0.45517241379310347,0.5448275862068965,0.28865979381443296,0.711340206185567
SF-L26,SF-L21,91,87,24,21,67,66,0.26373626373626374,0.7362637362637363,0.2413793103448276,0.7586206896551724
SF-L26,SF-Q30,28,24,19,22,9,2,0.6785714285714286,0.32142857142857145,0.9166666666666666,0.08333333333333333
SF-L26,SF-P30,3,11,1,3,2,8,0.3333333333333333,0.6666666666666666,0.2727272727272727,0.7272727272727273
SF-L26,SF-O30-2,4,3,1,1,3,2,0.25,0.75,0.3333333333333333,0.6666666666666666
SF-L26,SF-O30,81,86,18,18,63,68,0.2222222222222222,0.7777777777777778,0.20930232558139536,0.7906976744186046
SF-L26,SF-N27,27,47,22,23,5,24,0.8148148148148148,0.18518518518518517,0.48936170212765956,0.5106382978723404
SF-L26,SF-N29,3,6,1,3,2,3,0.3333333333333333,0.6666666666666666,0.5,0.5
SF-L26,SF-N28,46,38,25,13,21,25,0.5434782608695652,0.45652173913043476,0.34210526315789475,0.6578947368421053
SF-L26,SF-L30-1,63,77,21,22,42,55,0.3333333333333333,0.6666666666666666,0.2857142857142857,0.7142857142857143
SF-L26,SF-L31-1,5,9,2,1,3,8,0.4,0.6,0.1111111111111111,0.8888888888888888
SF-L26,SF-K30-2,17,5,1,1,16,4,0.058823529411764705,0.9411764705882353,0.2,0.8
SF-L26,SF-L29,72,73,28,23,44,50,0.3888888888888889,0.6111111111111112,0.3150684931506849,0.684931506849315
SF-L26,SF-J29-1,42,34,25,17,17,17,0.5952380952380952,0.40476190476190477,0.5,0.5
SF-L26,SF-I30,49,46,33,28,16,18,0.673469387755102,0.32653061224489793,0.6086956521739131,0.391304347826087
SF-L26,SF-I27,59,68,18,59,41,9,0.3050847457627119,0.6949152542372882,0.8676470588235294,0.1323529411764706
SF-L26,SF-I28,3,3,2,1,1,2,0.6666666666666666,0.3333333333333333,0.3333333333333333,0.6666666666666666
SF-L26,SF-I30-2,16,15,12,13,4,2,0.75,0.25,0.8666666666666667,0.13333333333333333
SF-L26,SF-H28,3,3,2,2,1,1,0.6666666666666666,0.3333333333333333,0.6666666666666666,0.3333333333333333
SF-L26,SF-S24,78,68,19,24,59,44,0.24358974358974358,0.7564102564102564,0.35294117647058826,0.6470588235294118
SF-L26,SF-R24,114,129,47,52,67,77,0.41228070175438597,0.5877192982456141,0.40310077519379844,0.5968992248062015
SF-L26,SF-R26,2,3,1,1,1,2,0.5,0.5,0.3333333333333333,0.6666666666666666
SF-L26,SF-Q26,62,46,13,3,49,43,0.20967741935483872,0.7903225806451613,0.06521739130434782,0.9347826086956522
SF-L26,SF-P26,11,6,5,0,6,6,0.45454545454545453,0.5454545454545454,0.0,1.0
SF-L26,SF-O25-2,4,10,2,6,2,4,0.5,0.5,0.6,0.4
SF-L26,SF-N22-1B,18,13,7,4,11,9,0.3888888888888889,0.6111111111111112,0.3076923076923077,0.6923076923076923
SF-L26,SF-N26,17,12,12,3,5,9,0.7058823529411765,0.29411764705882354,0.25,0.75
SF-L26,SF-N25,6,18,3,6,3,12,0.5,0.5,0.3333333333333333,0.6666666666666666
SF-L26,SF-T21,8,5,7,0,1,5,0.875,0.125,0.0,1.0
SF-L26,SF-T22,11,31,3,17,8,14,0.2727272727272727,0.7272727272727273,0.5483870967741935,0.45161290322580644
SF-L26,SF-S22-1,25,15,8,1,17,14,0.32,0.68,0.06666666666666667,0.9333333333333333
SF-L26,SF-Q23-3,17,29,4,19,13,10,0.23529411764705882,0.7647058823529411,0.6551724137931034,0.3448275862068966
SF-L26,SF-Q22-1,68,71,42,39,26,32,0.6176470588235294,0.38235294117647056,0.5492957746478874,0.4507042253521127
SF-L26,SF-Q22-2,54,36,27,10,27,26,0.5,0.5,0.2777777777777778,0.7222222222222222
SF-L26,SF-P22,82,42,31,18,51,24,0.3780487804878049,0.6219512195121951,0.42857142857142855,0.5714285714285714
SF-L26,SF-W19,5,4,0,0,5,4,0.0,1.0,0.0,1.0
SF-L26,SF-U21,10,16,3,3,7,13,0.3,0.7,0.1875,0.8125
SF-L26,SF-T20,9,10,0,0,9,10,0.0,1.0,0.0,1.0
SF-L26,SF-S21,20,16,1,0,19,16,0.05,0.95,0.0,1.0
SF-L26,SF-BB17,2,4,0,0,2,4,0.0,1.0,0.0,1.0
SF-L26,SF-Y25,6,1,6,0,0,1,1.0,0.0,0.0,1.0
SF-M28,SF-M26,13,15,3,5,10,10,0.23076923076923078,0.7692307692307693,0.3333333333333333,0.6666666666666666
SF-M28,SF-M25,13,17,6,7,7,10,0.46153846153846156,0.5384615384615384,0.4117647058823529,0.5882352941176471
SF-M28,SF-M26-2,40,55,18,39,22,16,0.45,0.55,0.7090909090909091,0.2909090909090909
SF-M28,SF-L27,18,22,7,16,11,6,0.3888888888888889,0.6111111111111112,0.7272727272727273,0.2727272727272727
SF-M28,SF-K26,47,50,14,31,33,19,0.2978723404255319,0.7021276595744681,0.62,0.38
SF-M28,SF-J27,9,6,3,3,6,3,0.3333333333333333,0.6666666666666666,0.5,0.5
SF-M28,SF-M30,95,25,77,13,18,12,0.8105263157894737,0.18947368421052632,0.52,0.48
SF-M28,SF-L27-2,25,46,11,22,14,24,0.44,0.56,0.4782608695652174,0.5217391304347826
SF-M28,SF-J29-3,8,7,6,1,2,6,0.75,0.25,0.14285714285714285,0.8571428571428571
SF-M28,SF-J29,60,58,11,31,49,27,0.18333333333333332,0.8166666666666667,0.5344827586206896,0.46551724137931033
SF-M28,SF-L26,8,14,2,12,6,2,0.25,0.75,0.8571428571428571,0.14285714285714285
SF-M28,SF-M27,19,11,12,5,7,6,0.631578947368421,0.3684210526315789,0.45454545454545453,0.5454545454545454
SF-M28,SF-L25,5,23,1,18,4,5,0.2,0.8,0.782608695652174,0.21739130434782608
SF-M28,SF-M24,10,11,6,2,4,9,0.6,0.4,0.18181818181818182,0.8181818181818182
SF-M28,SF-L24,17,17,10,10,7,7,0.5882352941176471,0.4117647058823529,0.5882352941176471,0.4117647058823529
SF-M28,SF-N23,4,7,1,2,3,5,0.25,0.75,0.2857142857142857,0.7142857142857143
SF-M28,SF-N24-2,7,9,2,4,5,5,0.2857142857142857,0.7142857142857143,0.4444444444444444,0.5555555555555556
SF-M28,SF-K27-2,26,17,16,11,10,6,0.6153846153846154,0.38461538461538464,0.6470588235294118,0.35294117647058826
SF-M28,SF-J26-2,8,92,1,28,7,64,0.125,0.875,0.30434782608695654,0.6956521739130435
SF-M28,SF-K28-3,5,5,1,5,4,0,0.2,0.8,1.0,0.0
SF-M28,SF-L28,29,7,26,3,3,4,0.896551724137931,0.10344827586206896,0.42857142857142855,0.5714285714285714
SF-M28,SF-K28,31,19,23,19,8,0,0.7419354838709677,0.25806451612903225,1.0,0.0
SF-M28,SF-K29-1,47,25,22,16,25,9,0.46808510638297873,0.5319148936170213,0.64,0.36
SF-M28,SF-J28-2,20,18,13,10,7,8,0.65,0.35,0.5555555555555556,0.4444444444444444
SF-M28,SF-K27,4,12,2,8,2,4,0.5,0.5,0.6666666666666666,0.3333333333333333
SF-M28,SF-K25,11,3,5,2,6,1,0.45454545454545453,0.5454545454545454,0.6666666666666666,0.3333333333333333
SF-M28,SF-J25,18,10,6,3,12,7,0.3333333333333333,0.6666666666666666,0.3,0.7
SF-M28,SF-H26-2,12,11,1,2,11,9,0.08333333333333333,0.9166666666666666,0.18181818181818182,0.8181818181818182
SF-M28,SF-P24,5,2,0,0,5,2,0.0,1.0,0.0,1.0
SF-M28,SF-N22-1A,1,3,1,1,0,2,1.0,0.0,0.3333333333333333,0.6666666666666666
SF-M28,SF-J24,30,30,11,9,19,21,0.36666666666666664,0.6333333333333333,0.3,0.7
SF-M28,SF-J26,92,6,16,3,76,3,0.17391304347826086,0.8260869565217391,0.5,0.5
SF-M28,SF-I26-,1,6,0,3,1,3,0.0,1.0,0.5,0.5
SF-M28,SF-I25,23,21,11,10,12,11,0.4782608695652174,0.5217391304347826,0.47619047619047616,0.5238095238095238
SF-M28,SF-H26,11,9,6,4,5,5,0.5454545454545454,0.45454545454545453,0.4444444444444444,0.5555555555555556
SF-M28,SF-O23,8,8,1,1,7,7,0.125,0.875,0.125,0.875
SF-M28,SF-H27-1,10,15,4,5,6,10,0.4,0.6,0.3333333333333333,0.6666666666666666
SF-M28,SF-F28-2,11,9,2,1,9,8,0.18181818181818182,0.8181818181818182,0.1111111111111111,0.8888888888888888
SF-M28,SF-G27,19,14,3,5,16,9,0.15789473684210525,0.8421052631578947,0.35714285714285715,0.6428571428571429
SF-M28,SF-M22-2,6,11,1,1,5,10,0.16666666666666666,0.8333333333333334,0.09090909090909091,0.9090909090909091
SF-M28,SF-L22,9,3,2,0,7,3,0.2222222222222222,0.7777777777777778,0.0,1.0
SF-M28,SF-F27,2,5,0,0,2,5,0.0,1.0,0.0,1.0
SF-M28,SF-N22-2,18,20,7,8,11,12,0.3888888888888889,0.6111111111111112,0.4,0.6
SF-M28,SF-G28-2,10,4,6,2,4,2,0.6,0.4,0.5,0.5
SF-M28,SF-G28-1,4,2,1,1,3,1,0.25,0.75,0.5,0.5
SF-M28,SF-M22-1,6,2,1,1,5,1,0.16666666666666666,0.8333333333333334,0.5,0.5
SF-M28,SF-O25-1,5,5,3,0,2,5,0.6,0.4,0.0,1.0
SF-M28,SF-K24,9,3,6,2,3,1,0.6666666666666666,0.3333333333333333,0.6666666666666666,0.3333333333333333
SF-M28,SF-J23-2,11,5,8,0,3,5,0.7272727272727273,0.2727272727272727,0.0,1.0
SF-M28,SF-G23,2,9,1,0,1,9,0.5,0.5,0.0,1.0
SF-M28,SF-G24,15,5,3,0,12,5,0.2,0.8,0.0,1.0
SF-M28,SF-G25,2,4,0,1,2,3,0.0,1.0,0.25,0.75
SF-M28,SF-F23,9,8,1,0,8,8,0.1111111111111111,0.8888888888888888,0.0,1.0
SF-M28,SF-E23,9,12,4,3,5,9,0.4444444444444444,0.5555555555555556,0.25,0.75
SF-M28,SF-C22,1,4,0,0,1,4,0.0,1.0,0.0,1.0
SF-M28,SF-B22,2,2,0,2,2,0,0.0,1.0,1.0,0.0
SF-M28,SF-J17,1,5,0,0,1,5,0.0,1.0,0.0,1.0
SF-M28,SF-I19,4,8,4,0,0,8,1.0,0.0,0.0,1.0
SF-M28,SF-H20,1,7,1,1,0,6,1.0,0.0,0.14285714285714285,0.8571428571428571
SF-M28,SF-G19,3,8,0,0,3,8,0.0,1.0,0.0,1.0
SF-M28,SF-G20,2,2,0,1,2,1,0.0,1.0,0.5,0.5
SF-M28,SF-H30,21,17,16,11,5,6,0.7619047619047619,0.23809523809523808,0.6470588235294118,0.35294117647058826
SF-M28,SF-G30-2,15,46,7,5,8,41,0.4666666666666667,0.5333333333333333,0.10869565217391304,0.8913043478260869
SF-M28,SF-F30-1,7,4,5,3,2,1,0.7142857142857143,0.2857142857142857,0.75,0.25
SF-M28,SF-E29-2,7,8,3,3,4,5,0.42857142857142855,0.5714285714285714,0.375,0.625
SF-M28,SF-E29-1,27,27,17,19,10,8,0.6296296296296297,0.37037037037037035,0.7037037037037037,0.2962962962962963
SF-M28,SF-D29,13,20,5,12,8,8,0.38461538461538464,0.6153846153846154,0.6,0.4
SF-M28,SF-D28,4,3,0,1,4,2,0.0,1.0,0.3333333333333333,0.6666666666666666
SF-M28,SF-A27,8,5,3,5,5,0,0.375,0.625,1.0,0.0
SF-M28,SF-G29-2,13,6,8,1,5,5,0.6153846153846154,0.38461538461538464,0.16666666666666666,0.8333333333333334
SF-M28,SF-G29-1,10,5,1,1,9,4,0.1,0.9,0.2,0.8
SF-M28,SF-G30-1,16,8,7,5,9,3,0.4375,0.5625,0.625,0.375
SF-M28,SF-F30-2,5,7,4,3,1,4,0.8,0.2,0.42857142857142855,0.5714285714285714
SF-M28,SF-F29,5,2,2,0,3,2,0.4,0.6,0.0,1.0
SF-M28,SF-E29-3,4,2,1,0,3,2,0.25,0.75,0.0,1.0
SF-M28,SF-F28-1,4,5,2,4,2,1,0.5,0.5,0.8,0.2
SF-M28,SF-E28-2,2,4,1,1,1,3,0.5,0.5,0.25,0.75
SF-M28,SF-E28,5,4,1,0,4,4,0.2,0.8,0.0,1.0
SF-M28,SF-J13,2,2,0,0,2,2,0.0,1.0,0.0,1.0
SF-M28,SF-G10-1,1,1,0,0,1,1,0.0,1.0,0.0,1.0
SF-M28,SF-F15,2,1,1,1,1,0,0.5,0.5,1.0,0.0
SF-M28,SF-C20,2,1,0,1,2,0,0.0,1.0,1.0,0.0
SF-M28,SF-C25,3,4,0,0,3,4,0.0,1.0,0.0,1.0
SF-M28,SF-B25,2,4,0,2,2,2,0.0,1.0,0.5,0.5
SF-M28,SF-B28-2,1,1,0,0,1,1,0.0,1.0,0.0,1.0
SF-M28,SF-D27,2,6,1,4,1,2,0.5,0.5,0.6666666666666666,0.3333333333333333
SF-M28,SF-C28-2,3,1,1,0,2,1,0.3333333333333333,0.6666666666666666,0.0,1.0
SF-M28,SF-C28-1,1,1,0,0,1,1,0.0,1.0,0.0,1.0
SF-M28,SF-J3,1,1,0,0,1,1,0.0,1.0,0.0,1.0
SF-M28,SF-G26,2,9,0,7,2,2,0.0,1.0,0.7777777777777778,0.2222222222222222
SF-M28,SF-K21,4,3,0,0,4,3,0.0,1.0,0.0,1.0
SF-M28,SF-K22-1,7,5,2,0,5,5,0.2857142857142857,0.7142857142857143,0.0,1.0
SF-M28,SF-J23-1,23,7,8,5,15,2,0.34782608695652173,0.6521739130434783,0.7142857142857143,0.2857142857142857
SF-M28,SF-J22-1,5,7,1,0,4,7,0.2,0.8,0.0,1.0
SF-M28,SF-J22-2,13,9,4,3,9,6,0.3076923076923077,0.6923076923076923,0.3333333333333333,0.6666666666666666
SF-M28,SF-J21,6,6,1,1,5,5,0.16666666666666666,0.8333333333333334,0.16666666666666666,0.8333333333333334
SF-M28,SF-I23-2,3,3,1,0,2,3,0.3333333333333333,0.6666666666666666,0.0,1.0
SF-M28,SF-I24,7,2,1,1,6,1,0.14285714285714285,0.8571428571428571,0.5,0.5
SF-M28,SF-I23-1,3,3,0,2,3,1,0.0,1.0,0.6666666666666666,0.3333333333333333
SF-M28,SF-F26,28,17,5,5,23,12,0.17857142857142858,0.8214285714285714,0.29411764705882354,0.7058823529411765
SF-M28,SF-M13,3,3,0,0,3,3,0.0,1.0,0.0,1.0
SF-M28,SF-M15,3,5,1,0,2,5,0.3333333333333333,0.6666666666666666,0.0,1.0
SF-M28,SF-L19,6,8,2,1,4,7,0.3333333333333333,0.6666666666666666,0.125,0.875
SF-M28,SF-L20,2,4,0,0,2,4,0.0,1.0,0.0,1.0
SF-M28,SF-N20-1,4,12,2,2,2,10,0.5,0.5,0.16666666666666666,0.8333333333333334
SF-M28,SF-M20,7,39,2,2,5,37,0.2857142857142857,0.7142857142857143,0.05128205128205128,0.9487179487179487
SF-M28,SF-K20,4,4,0,0,4,4,0.0,1.0,0.0,1.0
SF-M28,SF-K15-,3,4,0,1,3,3,0.0,1.0,0.25,0.75
SF-M28,SF-K19,5,10,1,2,4,8,0.2,0.8,0.2,0.8
SF-M28,SF-K18,5,6,2,1,3,5,0.4,0.6,0.16666666666666666,0.8333333333333334
SF-M28,SF-K17,1,4,0,2,1,2,0.0,1.0,0.5,0.5
SF-M28,SF-J18,3,3,0,1,3,2,0.0,1.0,0.3333333333333333,0.6666666666666666
SF-M28,SF-J19,6,8,3,2,3,6,0.5,0.5,0.25,0.75
SF-M28,SF-M11,2,2,2,1,0,1,1.0,0.0,0.5,0.5
SF-M28,SF-R19,3,3,2,0,1,3,0.6666666666666666,0.3333333333333333,0.0,1.0
SF-M28,SF-Q21-2,1,19,0,0,1,19,0.0,1.0,0.0,1.0
SF-M28,SF-Q21-1,3,4,0,0,3,4,0.0,1.0,0.0,1.0
SF-M28,SF-P21,7,5,0,1,7,4,0.0,1.0,0.2,0.8
SF-M28,SF-O18,2,5,1,2,1,3,0.5,0.5,0.4,0.6
SF-M28,SF-O19,2,5,0,2,2,3,0.0,1.0,0.4,0.6
SF-M28,SF-O21,25,28,9,11,16,17,0.36,0.64,0.39285714285714285,0.6071428571428571
SF-M28,SF-O22,15,31,3,6,12,25,0.2,0.8,0.1935483870967742,0.8064516129032258
SF-M28,SF-N21,6,14,4,4,2,10,0.6666666666666666,0.3333333333333333,0.2857142857142857,0.7142857142857143
SF-M28,SF-N20-2,1,10,0,2,1,8,0.0,1.0,0.2,0.8
SF-M28,SF-M21,4,6,2,3,2,3,0.5,0.5,0.5,0.5
SF-M28,SF-L21,4,5,1,1,3,4,0.25,0.75,0.2,0.8
SF-M28,SF-S29,2,4,0,1,2,3,0.0,1.0,0.25,0.75
SF-M28,SF-S30,3,3,0,0,3,3,0.0,1.0,0.0,1.0
SF-M28,SF-Q30,15,18,1,10,14,8,0.06666666666666667,0.9333333333333333,0.5555555555555556,0.4444444444444444
SF-M28,SF-P30,20,13,8,8,12,5,0.4,0.6,0.6153846153846154,0.38461538461538464
SF-M28,SF-O30-2,9,8,2,4,7,4,0.2222222222222222,0.7777777777777778,0.5,0.5
SF-M28,SF-O30,21,19,7,10,14,9,0.3333333333333333,0.6666666666666666,0.5263157894736842,0.47368421052631576
SF-M28,SF-N27,116,115,50,62,66,53,0.43103448275862066,0.5689655172413793,0.5391304347826087,0.4608695652173913
SF-M28,SF-N29,17,5,8,4,9,1,0.47058823529411764,0.5294117647058824,0.8,0.2
SF-M28,SF-N28,45,37,20,27,25,10,0.4444444444444444,0.5555555555555556,0.7297297297297297,0.2702702702702703
SF-M28,SF-L30-1,32,26,14,13,18,13,0.4375,0.5625,0.5,0.5
SF-M28,SF-L31-1,10,2,6,1,4,1,0.6,0.4,0.5,0.5
SF-M28,SF-K30-2,24,28,3,2,21,26,0.125,0.875,0.07142857142857142,0.9285714285714286
SF-M28,SF-L29,33,24,26,14,7,10,0.7878787878787878,0.21212121212121213,0.5833333333333334,0.4166666666666667
SF-M28,SF-J29-1,8,10,3,3,5,7,0.375,0.625,0.3,0.7
SF-M28,SF-I30,8,3,4,0,4,3,0.5,0.5,0.0,1.0
SF-M28,SF-I29-2,2,2,1,1,1,1,0.5,0.5,0.5,0.5
SF-M28,SF-I27,7,8,2,4,5,4,0.2857142857142857,0.7142857142857143,0.5,0.5
SF-M28,SF-I28,10,12,4,0,6,12,0.4,0.6,0.0,1.0
SF-M28,SF-I30-2,6,7,1,2,5,5,0.16666666666666666,0.8333333333333334,0.2857142857142857,0.7142857142857143
SF-M28,SF I29-1,2,1,0,0,2,1,0.0,1.0,0.0,1.0
SF-M28,SF-H28,6,13,5,3,1,10,0.8333333333333334,0.16666666666666666,0.23076923076923078,0.7692307692307693
SF-M28,SF-H29,4,3,4,2,0,1,1.0,0.0,0.6666666666666666,0.3333333333333333
SF-M28,SF-S24,12,8,7,6,5,2,0.5833333333333334,0.4166666666666667,0.75,0.25
SF-M28,SF-R24,6,13,0,4,6,9,0.0,1.0,0.3076923076923077,0.6923076923076923
SF-M28,SF-R26,2,1,0,0,2,1,0.0,1.0,0.0,1.0
SF-M28,SF-Q26,8,8,3,4,5,4,0.375,0.625,0.5,0.5
SF-M28,SF-P26,92,88,49,58,43,30,0.532608695652174,0.4673913043478261,0.6590909090909091,0.3409090909090909
SF-M28,SF-O25-2,5,9,0,5,5,4,0.0,1.0,0.5555555555555556,0.4444444444444444
SF-M28,SF-N22-1B,12,25,3,4,9,21,0.25,0.75,0.16,0.84
SF-M28,SF-N26,4,5,0,2,4,3,0.0,1.0,0.4,0.6
SF-M28,SF-N25,6,7,2,1,4,6,0.3333333333333333,0.6666666666666666,0.14285714285714285,0.8571428571428571
SF-M28,SF-S22-2,1,2,0,0,1,2,0.0,1.0,0.0,1.0
SF-M28,SF-S22-1,2,1,0,0,2,1,0.0,1.0,0.0,1.0
SF-M28,SF-Q23-3,9,3,2,2,7,1,0.2222222222222222,0.7777777777777778,0.6666666666666666,0.3333333333333333
SF-M28,SF-Q22-1,13,9,2,1,11,8,0.15384615384615385,0.8461538461538461,0.1111111111111111,0.8888888888888888
SF-M28,SF-Q22-2,19,7,0,1,19,6,0.0,1.0,0.14285714285714285,0.8571428571428571
SF-M28,SF-P22,15,19,1,2,14,17,0.06666666666666667,0.9333333333333333,0.10526315789473684,0.8947368421052632
SF-M28,SF-Z28,1,1,0,1,1,0,0.0,1.0,1.0,0.0
SF-M28,SF-V29,3,4,1,3,2,1,0.3333333333333333,0.6666666666666666,0.75,0.25
SF-M28,SF-V30,4,5,1,1,3,4,0.25,0.75,0.2,0.8
SF-M28,SF-V32,4,4,3,3,1,1,0.75,0.25,0.75,0.25
SF-M27,SF-M26,1,1,0,0,1,1,0.0,1.0,0.0,1.0
SF-M27,SF-M25,2,2,1,1,1,1,0.5,0.5,0.5,0.5
SF-M27,SF-M26-2,1,3,1,3,0,0,1.0,0.0,1.0,0.0
SF-M27,SF-K26,8,4,6,4,2,0,0.75,0.25,1.0,0.0
SF-M27,SF-J29,26,36,5,23,21,13,0.19230769230769232,0.8076923076923077,0.6388888888888888,0.3611111111111111
SF-M27,SF-L26,10,9,7,7,3,2,0.7,0.3,0.7777777777777778,0.2222222222222222
SF-M27,SF-M28,11,19,5,12,6,7,0.45454545454545453,0.5454545454545454,0.631578947368421,0.3684210526315789
SF-M27,SF-L25,7,9,2,6,5,3,0.2857142857142857,0.7142857142857143,0.6666666666666666,0.3333333333333333
SF-M27,SF-M24,1,1,0,1,1,0,0.0,1.0,1.0,0.0
SF-M27,SF-L24,13,13,10,9,3,4,0.7692307692307693,0.23076923076923078,0.6923076923076923,0.3076923076923077
SF-M27,SF-N23,2,1,0,1,2,0,0.0,1.0,1.0,0.0
SF-M27,SF-K28-3,1,1,1,1,0,0,1.0,0.0,1.0,0.0
SF-M27,SF-L28,2,1,1,0,1,1,0.5,0.5,0.0,1.0
SF-M27,SF-K28,4,1,4,1,0,0,1.0,0.0,1.0,0.0
SF-M27,SF-K29-1,2,1,0,1,2,0,0.0,1.0,1.0,0.0
SF-M27,SF-K25,3,3,2,1,1,2,0.6666666666666666,0.3333333333333333,0.3333333333333333,0.6666666666666666
SF-M27,SF-J25,2,3,1,2,1,1,0.5,0.5,0.6666666666666666,0.3333333333333333
SF-M27,SF-H26-2,1,2,0,0,1,2,0.0,1.0,0.0,1.0
SF-M27,SF-N22-1A,1,1,1,0,0,1,1.0,0.0,0.0,1.0
SF-M27,SF-J24,3,2,2,0,1,2,0.6666666666666666,0.3333333333333333,0.0,1.0
SF-M27,SF-J26,4,3,3,3,1,0,0.75,0.25,1.0,0.0
SF-M27,SF-I25,1,12,1,5,0,7,1.0,0.0,0.4166666666666667,0.5833333333333334
SF-M27,SF-H26,2,2,1,1,1,1,0.5,0.5,0.5,0.5
SF-M27,SF-O23,2,2,0,0,2,2,0.0,1.0,0.0,1.0
SF-M27,SF-H27-1,2,3,2,2,0,1,1.0,0.0,0.6666666666666666,0.3333333333333333
SF-M27,SF-M22-2,1,2,1,1,0,1,1.0,0.0,0.5,0.5
SF-M27,SF-N22-2,1,3,1,1,0,2,1.0,0.0,0.3333333333333333,0.6666666666666666
SF-M27,SF-G28-2,1,1,0,1,1,0,0.0,1.0,1.0,0.0
SF-M27,SF-M22-1,7,1,7,1,0,0,1.0,0.0,1.0,0.0
SF-M27,SF-K24,2,2,1,1,1,1,0.5,0.5,0.5,0.5
SF-M27,SF-G24,1,1,1,0,0,1,1.0,0.0,0.0,1.0
SF-M27,SF-F23,3,1,2,0,1,1,0.6666666666666666,0.3333333333333333,0.0,1.0
SF-M27,SF-E23,4,2,0,1,4,1,0.0,1.0,0.5,0.5
SF-M27,SF-I19,48,3,29,0,19,3,0.6041666666666666,0.3958333333333333,0.0,1.0
SF-M27,SF-H20,1,2,1,0,0,2,1.0,0.0,0.0,1.0
SF-M27,SF-G19,40,10,36,0,4,10,0.9,0.1,0.0,1.0
SF-M27,SF-G20,8,1,7,0,1,1,0.875,0.125,0.0,1.0
SF-M27,SF-H30,4,7,3,5,1,2,0.75,0.25,0.7142857142857143,0.2857142857142857
SF-M27,SF-G30-2,6,5,3,2,3,3,0.5,0.5,0.4,0.6
SF-M27,SF-D29,5,1,3,0,2,1,0.6,0.4,0.0,1.0
SF-M27,SF-A27,3,1,3,1,0,0,1.0,0.0,1.0,0.0
SF-M27,SF-J13,1,1,0,0,1,1,0.0,1.0,0.0,1.0
SF-M27,SF-A20,1,2,1,0,0,2,1.0,0.0,0.0,1.0
SF-M27,SF-B28,1,4,1,4,0,0,1.0,0.0,1.0,0.0
SF-M27,SF-J23-1,3,3,1,0,2,3,0.3333333333333333,0.6666666666666666,0.0,1.0
SF-M27,SF-I24,3,1,0,1,3,0,0.0,1.0,1.0,0.0
SF-M27,SF-F26,3,2,2,1,1,1,0.6666666666666666,0.3333333333333333,0.5,0.5
SF-M27,SF-M20,2,3,0,0,2,3,0.0,1.0,0.0,1.0
SF-M27,SF-K19,1,1,0,0,1,1,0.0,1.0,0.0,1.0
SF-M27,SF-R19,1,1,0,0,1,1,0.0,1.0,0.0,1.0
SF-M27,SF-P21,1,1,0,0,1,1,0.0,1.0,0.0,1.0
SF-M27,SF-O21,3,2,0,2,3,0,0.0,1.0,1.0,0.0
SF-M27,SF-O22,11,4,2,1,9,3,0.18181818181818182,0.8181818181818182,0.25,0.75
SF-M27,SF-N21,5,2,0,0,5,2,0.0,1.0,0.0,1.0
SF-M27,SF-L21,2,1,2,0,0,1,1.0,0.0,0.0,1.0
SF-M27,SF-Q30,1,3,0,3,1,0,0.0,1.0,1.0,0.0
SF-M27,SF-O30-2,2,2,2,0,0,2,1.0,0.0,0.0,1.0
SF-M27,SF-O30,1,3,1,2,0,1,1.0,0.0,0.6666666666666666,0.3333333333333333
SF-M27,SF-N27,5,6,4,6,1,0,0.8,0.2,1.0,0.0
SF-M27,SF-N28,9,5,0,5,9,0,0.0,1.0,1.0,0.0
SF-M27,SF-L29,8,2,7,2,1,0,0.875,0.125,1.0,0.0
SF-M27,SF I29-1,1,1,1,1,0,0,1.0,0.0,1.0,0.0
SF-M27,SF-R24,1,2,1,1,0,1,1.0,0.0,0.5,0.5
SF-M27,SF-P26,1,1,0,0,1,1,0.0,1.0,0.0,1.0
SF-M27,SF-N25,1,2,0,2,1,0,0.0,1.0,1.0,0.0
SF-M27,SF-Q22-1,1,1,1,1,0,0,1.0,0.0,1.0,0.0
SF-M27,SF-P22,2,2,1,1,1,1,0.5,0.5,0.5,0.5
SF-L25,SF-M26,6,3,3,2,3,1,0.5,0.5,0.6666666666666666,0.3333333333333333
SF-L25,SF-M25,26,15,15,3,11,12,0.5769230769230769,0.4230769230769231,0.2,0.8
SF-L25,SF-M26-2,18,15,15,9,3,6,0.8333333333333334,0.16666666666666666,0.6,0.4
SF-L25,SF-L27,4,5,4,5,0,0,1.0,0.0,1.0,0.0
SF-L25,SF-K26,20,8,12,2,8,6,0.6,0.4,0.25,0.75
SF-L25,SF-J27,6,5,3,2,3,3,0.5,0.5,0.4,0.6
SF-L25,SF-M30,86,128,78,97,8,31,0.9069767441860465,0.09302325581395349,0.7578125,0.2421875
SF-L25,SF-L27-2,2,2,2,1,0,1,1.0,0.0,0.5,0.5
SF-L25,SF-J29-3,2,7,2,4,0,3,1.0,0.0,0.5714285714285714,0.42857142857142855
SF-L25,SF-J29,23,16,10,11,13,5,0.43478260869565216,0.5652173913043478,0.6875,0.3125
SF-L25,SF-L26,29,11,15,7,14,4,0.5172413793103449,0.4827586206896552,0.6363636363636364,0.36363636363636365
SF-L25,SF-M28,23,5,18,1,5,4,0.782608695652174,0.21739130434782608,0.2,0.8
SF-L25,SF-M27,9,7,6,2,3,5,0.6666666666666666,0.3333333333333333,0.2857142857142857,0.7142857142857143
SF-L25,SF-M24,5,11,2,8,3,3,0.4,0.6,0.7272727272727273,0.2727272727272727
SF-L25,SF-L24,19,14,16,11,3,3,0.8421052631578947,0.15789473684210525,0.7857142857142857,0.21428571428571427
SF-L25,SF-N23,8,3,6,2,2,1,0.75,0.25,0.6666666666666666,0.3333333333333333
SF-L25,SF-N24-2,7,10,4,7,3,3,0.5714285714285714,0.42857142857142855,0.7,0.3
SF-L25,SF-K27-2,14,18,11,15,3,3,0.7857142857142857,0.21428571428571427,0.8333333333333334,0.16666666666666666
SF-L25,SF-J26-2,9,9,7,6,2,3,0.7777777777777778,0.2222222222222222,0.6666666666666666,0.3333333333333333
SF-L25,SF-K28-3,23,5,21,3,2,2,0.9130434782608695,0.08695652173913043,0.6,0.4
SF-L25,SF-L28,11,9,9,8,2,1,0.8181818181818182,0.18181818181818182,0.8888888888888888,0.1111111111111111
SF-L25,SF-K28,9,8,7,7,2,1,0.7777777777777778,0.2222222222222222,0.875,0.125
SF-L25,SF-K29-1,11,15,11,9,0,6,1.0,0.0,0.6,0.4
SF-L25,SF-J28-2,9,3,4,1,5,2,0.4444444444444444,0.5555555555555556,0.3333333333333333,0.6666666666666666
SF-L25,SF-K27,60,102,58,102,2,0,0.9666666666666667,0.03333333333333333,1.0,0.0
SF-L25,SF-K25,15,23,15,17,0,6,1.0,0.0,0.7391304347826086,0.2608695652173913
SF-L25,SF-J25,55,34,33,20,22,14,0.6,0.4,0.5882352941176471,0.4117647058823529
SF-L25,SF-P24,6,9,4,7,2,2,0.6666666666666666,0.3333333333333333,0.7777777777777778,0.2222222222222222
SF-L25,SF-J24,12,6,11,6,1,0,0.9166666666666666,0.08333333333333333,1.0,0.0
SF-L25,SF-O24,8,4,6,3,2,1,0.75,0.25,0.75,0.25
SF-L25,SF-J26,9,14,1,4,8,10,0.1111111111111111,0.8888888888888888,0.2857142857142857,0.7142857142857143
SF-L25,SF-I26-,24,15,17,2,7,13,0.7083333333333334,0.2916666666666667,0.13333333333333333,0.8666666666666667
SF-L25,SF-I25,92,75,76,66,16,9,0.8260869565217391,0.17391304347826086,0.88,0.12
SF-L25,SF-K23,2,2,1,2,1,0,0.5,0.5,1.0,0.0
SF-L25,SF-H26,29,24,24,16,5,8,0.8275862068965517,0.1724137931034483,0.6666666666666666,0.3333333333333333
SF-L25,SF-O23,11,9,6,5,5,4,0.5454545454545454,0.45454545454545453,0.5555555555555556,0.4444444444444444
SF-L25,SF-H27-1,12,4,10,4,2,0,0.8333333333333334,0.16666666666666666,1.0,0.0
SF-L25,SF-F28-2,4,4,3,2,1,2,0.75,0.25,0.5,0.5
SF-L25,SF-G27,22,38,17,27,5,11,0.7727272727272727,0.22727272727272727,0.7105263157894737,0.2894736842105263
SF-L25,SF-M22-2,10,9,7,3,3,6,0.7,0.3,0.3333333333333333,0.6666666666666666
SF-L25,SF-L22,20,13,6,3,14,10,0.3,0.7,0.23076923076923078,0.7692307692307693
SF-L25,SF-F27,8,5,7,2,1,3,0.875,0.125,0.4,0.6
SF-L25,SF-N22-2,19,48,13,38,6,10,0.6842105263157895,0.3157894736842105,0.7916666666666666,0.20833333333333334
SF-L25,SF-M22-1,9,9,7,5,2,4,0.7777777777777778,0.2222222222222222,0.5555555555555556,0.4444444444444444
SF-L25,SF-O25-1,3,11,2,4,1,7,0.6666666666666666,0.3333333333333333,0.36363636363636365,0.6363636363636364
SF-L25,SF-K22-2,26,15,22,6,4,9,0.8461538461538461,0.15384615384615385,0.4,0.6
SF-L25,SF-K24,42,60,42,51,0,9,1.0,0.0,0.85,0.15
SF-L25,SF-J23-2,23,19,18,10,5,9,0.782608695652174,0.21739130434782608,0.5263157894736842,0.47368421052631576
SF-L25,SF-G23,17,3,10,0,7,3,0.5882352941176471,0.4117647058823529,0.0,1.0
SF-L25,SF-G24,44,32,18,2,26,30,0.4090909090909091,0.5909090909090909,0.0625,0.9375
SF-L25,SF-G25,20,7,12,0,8,7,0.6,0.4,0.0,1.0
SF-L25,SF-F23,30,12,13,0,17,12,0.43333333333333335,0.5666666666666667,0.0,1.0
SF-L25,SF-E23,22,8,6,1,16,7,0.2727272727272727,0.7272727272727273,0.125,0.875
SF-L25,SF-D24,2,2,2,0,0,2,1.0,0.0,0.0,1.0
SF-L25,SF-C22,6,12,2,0,4,12,0.3333333333333333,0.6666666666666666,0.0,1.0
SF-L25,SF-B22,105,59,0,2,105,57,0.0,1.0,0.03389830508474576,0.9661016949152542
SF-L25,SF-J17,7,2,4,0,3,2,0.5714285714285714,0.42857142857142855,0.0,1.0
SF-L25,SF-I19,1,6,1,0,0,6,1.0,0.0,0.0,1.0
SF-L25,SF-I20,34,22,11,1,23,21,0.3235294117647059,0.6764705882352942,0.045454545454545456,0.9545454545454546
SF-L25,SF-H20,2,2,2,0,0,2,1.0,0.0,0.0,1.0
SF-L25,SF-H17,1,2,0,2,1,0,0.0,1.0,1.0,0.0
SF-L25,SF-G19,1,3,0,3,1,0,0.0,1.0,1.0,0.0
SF-L25,SF-G20,5,7,0,0,5,7,0.0,1.0,0.0,1.0
SF-L25,SF-F19,3,1,0,0,3,1,0.0,1.0,0.0,1.0
SF-L25,SF-E18,1,1,0,0,1,1,0.0,1.0,0.0,1.0
SF-L25,SF-E20,1,1,0,0,1,1,0.0,1.0,0.0,1.0
SF-L25,SF-H30,6,3,3,2,3,1,0.5,0.5,0.6666666666666666,0.3333333333333333
SF-L25,SF-G30-2,12,9,5,6,7,3,0.4166666666666667,0.5833333333333334,0.6666666666666666,0.3333333333333333
SF-L25,SF-F30-1,2,3,2,3,0,0,1.0,0.0,1.0,0.0
SF-L25,SF-E29-2,8,5,1,4,7,1,0.125,0.875,0.8,0.2
SF-L25,SF-E29-1,4,5,4,0,0,5,1.0,0.0,0.0,1.0
SF-L25,SF-D29,1,2,0,0,1,2,0.0,1.0,0.0,1.0
SF-L25,SF-D28,9,23,4,22,5,1,0.4444444444444444,0.5555555555555556,0.9565217391304348,0.043478260869565216
SF-L25,SF-A27,1,3,1,2,0,1,1.0,0.0,0.6666666666666666,0.3333333333333333
SF-L25,SF-G29-2,19,19,9,9,10,10,0.47368421052631576,0.5263157894736842,0.47368421052631576,0.5263157894736842
SF-L25,SF-G29-1,12,6,10,4,2,2,0.8333333333333334,0.16666666666666666,0.6666666666666666,0.3333333333333333
SF-L25,SF-G30-1,16,10,8,6,8,4,0.5,0.5,0.6,0.4
SF-L25,SF-G29-3,15,10,8,4,7,6,0.5333333333333333,0.4666666666666667,0.4,0.6
SF-L25,SF-F30-2,8,10,8,9,0,1,1.0,0.0,0.9,0.1
SF-L25,SF-F29,3,1,3,1,0,0,1.0,0.0,1.0,0.0
SF-L25,SF-E28,1,2,0,1,1,1,0.0,1.0,0.5,0.5
SF-L25,SF-J10,1,1,0,0,1,1,0.0,1.0,0.0,1.0
SF-L25,SF-H12,2,2,0,0,2,2,0.0,1.0,0.0,1.0
SF-L25,SF-G12,2,1,0,0,2,1,0.0,1.0,0.0,1.0
SF-L25,SF-F16,1,1,0,0,1,1,0.0,1.0,0.0,1.0
SF-L25,SF-B19,1,1,1,0,0,1,1.0,0.0,0.0,1.0
SF-L25,SF-A20,2,4,0,1,2,3,0.0,1.0,0.25,0.75
SF-L25,SF-C26,9,9,3,3,6,6,0.3333333333333333,0.6666666666666666,0.3333333333333333,0.6666666666666666
SF-L25,SF-C25,13,6,7,3,6,3,0.5384615384615384,0.46153846153846156,0.5,0.5
SF-L25,SF-B25,7,6,3,0,4,6,0.42857142857142855,0.5714285714285714,0.0,1.0
SF-L25,SF-E27,3,1,2,0,1,1,0.6666666666666666,0.3333333333333333,0.0,1.0
SF-L25,SF-B28-2,4,9,1,0,3,9,0.25,0.75,0.0,1.0
SF-L25,SF-D27,19,17,11,15,8,2,0.5789473684210527,0.42105263157894735,0.8823529411764706,0.11764705882352941
SF-L25,SF-C28-2,7,5,5,5,2,0,0.7142857142857143,0.2857142857142857,1.0,0.0
SF-L25,SF-G5,4,2,1,0,3,2,0.25,0.75,0.0,1.0
SF-L25,SF-G7,1,1,0,1,1,0,0.0,1.0,1.0,0.0
SF-L25,SF-H25,2,2,1,0,1,2,0.5,0.5,0.0,1.0
SF-L25,SF-G26,2,5,1,2,1,3,0.5,0.5,0.4,0.6
SF-L25,SF-K21,16,7,11,0,5,7,0.6875,0.3125,0.0,1.0
SF-L25,SF-K22-1,49,38,46,31,3,7,0.9387755102040817,0.061224489795918366,0.8157894736842105,0.18421052631578946
SF-L25,SF-J23-1,70,72,57,43,13,29,0.8142857142857143,0.18571428571428572,0.5972222222222222,0.4027777777777778
SF-L25,SF-J22-1,11,20,6,14,5,6,0.5454545454545454,0.45454545454545453,0.7,0.3
SF-L25,SF-J22-2,12,5,4,4,8,1,0.3333333333333333,0.6666666666666666,0.8,0.2
SF-L25,SF-J21,28,30,19,14,9,16,0.6785714285714286,0.32142857142857145,0.4666666666666667,0.5333333333333333
SF-L25,SF-I21,11,3,7,3,4,0,0.6363636363636364,0.36363636363636365,1.0,0.0
SF-L25,SF-I22,5,5,5,4,0,1,1.0,0.0,0.8,0.2
SF-L25,SF-I23-2,6,6,5,4,1,2,0.8333333333333334,0.16666666666666666,0.6666666666666666,0.3333333333333333
SF-L25,SF-I24,10,7,4,3,6,4,0.4,0.6,0.42857142857142855,0.5714285714285714
SF-L25,SF-I23-1,10,10,6,2,4,8,0.6,0.4,0.2,0.8
SF-L25,SF-F26,21,11,8,5,13,6,0.38095238095238093,0.6190476190476191,0.45454545454545453,0.5454545454545454
SF-L25,SF-M13,12,2,10,0,2,2,0.8333333333333334,0.16666666666666666,0.0,1.0
SF-L25,SF-M15,1,4,0,0,1,4,0.0,1.0,0.0,1.0
SF-L25,SF-L19,7,4,4,0,3,4,0.5714285714285714,0.42857142857142855,0.0,1.0
SF-L25,SF-L20,6,8,3,2,3,6,0.5,0.5,0.25,0.75
SF-L25,SF-N20-1,25,13,5,0,20,13,0.2,0.8,0.0,1.0
SF-L25,SF-M20,14,16,5,1,9,15,0.35714285714285715,0.6428571428571429,0.0625,0.9375
SF-L25,SF-K20,7,5,5,1,2,4,0.7142857142857143,0.2857142857142857,0.2,0.8
SF-L25,SF-K15-,8,6,2,1,6,5,0.25,0.75,0.16666666666666666,0.8333333333333334
SF-L25,SF-K19,16,11,5,2,11,9,0.3125,0.6875,0.18181818181818182,0.8181818181818182
SF-L25,SF-K18,10,14,2,0,8,14,0.2,0.8,0.0,1.0
SF-L25,SF-J16,3,3,0,0,3,3,0.0,1.0,0.0,1.0
SF-L25,SF-J18,6,8,0,2,6,6,0.0,1.0,0.25,0.75
SF-L25,SF-J20,8,8,2,1,6,7,0.25,0.75,0.125,0.875
SF-L25,SF-J19,12,8,1,4,11,4,0.08333333333333333,0.9166666666666666,0.5,0.5
SF-L25,SF-M12,1,7,0,0,1,7,0.0,1.0,0.0,1.0
SF-L25,SF-M10,3,2,3,1,0,1,1.0,0.0,0.5,0.5
SF-L25,SF-M11,4,3,1,0,3,3,0.25,0.75,0.0,1.0
SF-L25,SF-R19,6,1,2,0,4,1,0.3333333333333333,0.6666666666666666,0.0,1.0
SF-L25,SF-Q21-2,3,3,2,0,1,3,0.6666666666666666,0.3333333333333333,0.0,1.0
SF-L25,SF-Q21-1,9,11,6,7,3,4,0.6666666666666666,0.3333333333333333,0.6363636363636364,0.36363636363636365
SF-L25,SF-P21,2,5,0,1,2,4,0.0,1.0,0.2,0.8
SF-L25,SF-O18,23,23,1,0,22,23,0.043478260869565216,0.9565217391304348,0.0,1.0
SF-L25,SF-O19,18,20,4,1,14,19,0.2222222222222222,0.7777777777777778,0.05,0.95
SF-L25,SF-O21,17,16,10,8,7,8,0.5882352941176471,0.4117647058823529,0.5,0.5
SF-L25,SF-O22,5,10,1,1,4,9,0.2,0.8,0.1,0.9
SF-L25,SF-N21,9,5,7,1,2,4,0.7777777777777778,0.2222222222222222,0.2,0.8
SF-L25,SF-N20-2,7,5,4,3,3,2,0.5714285714285714,0.42857142857142855,0.6,0.4
SF-L25,SF-M21,12,19,4,4,8,15,0.3333333333333333,0.6666666666666666,0.21052631578947367,0.7894736842105263
SF-L25,SF-L21,24,25,13,4,11,21,0.5416666666666666,0.4583333333333333,0.16,0.84
SF-L25,SF-S30,1,1,1,0,0,1,1.0,0.0,0.0,1.0
SF-L25,SF-Q30,2,1,0,0,2,1,0.0,1.0,0.0,1.0
SF-L25,SF-P30,4,5,3,3,1,2,0.75,0.25,0.6,0.4
SF-L25,SF-O30-2,4,4,1,2,3,2,0.25,0.75,0.5,0.5
SF-L25,SF-O30,10,9,4,7,6,2,0.4,0.6,0.7777777777777778,0.2222222222222222
SF-L25,SF-N27,9,9,8,4,1,5,0.8888888888888888,0.1111111111111111,0.4444444444444444,0.5555555555555556
SF-L25,SF-N29,4,3,4,3,0,0,1.0,0.0,1.0,0.0
SF-L25,SF-N28,14,11,9,8,5,3,0.6428571428571429,0.35714285714285715,0.7272727272727273,0.2727272727272727
SF-L25,SF-L30-1,69,117,56,96,13,21,0.8115942028985508,0.18840579710144928,0.8205128205128205,0.1794871794871795
SF-L25,SF-L31-1,1,2,1,0,0,2,1.0,0.0,0.0,1.0
SF-L25,SF-K30-2,11,9,5,5,6,4,0.45454545454545453,0.5454545454545454,0.5555555555555556,0.4444444444444444
SF-L25,SF-L29,29,18,19,10,10,8,0.6551724137931034,0.3448275862068966,0.5555555555555556,0.4444444444444444
SF-L25,SF-J29-1,10,6,4,2,6,4,0.4,0.6,0.3333333333333333,0.6666666666666666
SF-L25,SF-I30,9,11,5,4,4,7,0.5555555555555556,0.4444444444444444,0.36363636363636365,0.6363636363636364
SF-L25,SF-I27,49,42,10,13,39,29,0.20408163265306123,0.7959183673469388,0.30952380952380953,0.6904761904761905
SF-L25,SF-I28,31,16,11,3,20,13,0.3548387096774194,0.6451612903225806,0.1875,0.8125
SF-L25,SF-I30-2,17,14,7,6,10,8,0.4117647058823529,0.5882352941176471,0.42857142857142855,0.5714285714285714
SF-L25,SF I29-1,3,1,1,1,2,0,0.3333333333333333,0.6666666666666666,1.0,0.0
SF-L25,SF-H28,19,41,12,23,7,18,0.631578947368421,0.3684210526315789,0.5609756097560976,0.43902439024390244
SF-L25,SF-H29,2,2,2,1,0,1,1.0,0.0,0.5,0.5
SF-L25,SF-S24,9,16,3,3,6,13,0.3333333333333333,0.6666666666666666,0.1875,0.8125
SF-L25,SF-R24,14,16,6,12,8,4,0.42857142857142855,0.5714285714285714,0.75,0.25
SF-L25,SF-Q26,3,6,2,4,1,2,0.6666666666666666,0.3333333333333333,0.6666666666666666,0.3333333333333333
SF-L25,SF-P26,10,2,6,1,4,1,0.6,0.4,0.5,0.5
SF-L25,SF-O25-2,13,29,8,9,5,20,0.6153846153846154,0.38461538461538464,0.3103448275862069,0.6896551724137931
SF-L25,SF-N22-1B,6,6,5,3,1,3,0.8333333333333334,0.16666666666666666,0.5,0.5
SF-L25,SF-N26,14,7,10,4,4,3,0.7142857142857143,0.2857142857142857,0.5714285714285714,0.42857142857142855
SF-L25,SF-N25,11,16,1,1,10,15,0.09090909090909091,0.9090909090909091,0.0625,0.9375
SF-L25,SF-T22,3,9,1,8,2,1,0.3333333333333333,0.6666666666666666,0.8888888888888888,0.1111111111111111
SF-L25,SF-S22-2,3,2,0,0,3,2,0.0,1.0,0.0,1.0
SF-L25,SF-S22-1,7,9,2,1,5,8,0.2857142857142857,0.7142857142857143,0.1111111111111111,0.8888888888888888
SF-L25,SF-Q23-3,3,16,1,8,2,8,0.3333333333333333,0.6666666666666666,0.5,0.5
SF-L25,SF-Q22-1,10,10,7,5,3,5,0.7,0.3,0.5,0.5
SF-L25,SF-Q22-2,15,9,8,3,7,6,0.5333333333333333,0.4666666666666667,0.3333333333333333,0.6666666666666666
SF-L25,SF-P22,7,11,3,3,4,8,0.42857142857142855,0.5714285714285714,0.2727272727272727,0.7272727272727273
SF-L25,SF-W19,4,3,1,0,3,3,0.25,0.75,0.0,1.0
SF-L25,SF-U21,2,1,0,0,2,1,0.0,1.0,0.0,1.0
SF-L25,SF-T20,7,6,1,0,6,6,0.14285714285714285,0.8571428571428571,0.0,1.0
SF-L25,SF-S21,3,1,2,0,1,1,0.6666666666666666,0.3333333333333333,0.0,1.0
SF-M24,SF-M25,13,8,10,7,3,1,0.7692307692307693,0.23076923076923078,0.875,0.125
SF-M24,SF-M26-2,7,8,5,3,2,5,0.7142857142857143,0.2857142857142857,0.375,0.625
SF-M24,SF-L27,4,1,2,1,2,0,0.5,0.5,1.0,0.0
SF-M24,SF-K26,17,11,11,7,6,4,0.6470588235294118,0.35294117647058826,0.6363636363636364,0.36363636363636365
SF-M24,SF-J27,2,5,1,2,1,3,0.5,0.5,0.4,0.6
SF-M24,SF-M30,11,14,4,5,7,9,0.36363636363636365,0.6363636363636364,0.35714285714285715,0.6428571428571429
SF-M24,SF-L27-2,4,1,4,1,0,0,1.0,0.0,1.0,0.0
SF-M24,SF-J29-3,7,2,2,1,5,1,0.2857142857142857,0.7142857142857143,0.5,0.5
SF-M24,SF-J29,13,11,4,5,9,6,0.3076923076923077,0.6923076923076923,0.45454545454545453,0.5454545454545454
SF-M24,SF-L26,29,26,21,18,8,8,0.7241379310344828,0.27586206896551724,0.6923076923076923,0.3076923076923077
SF-M24,SF-M28,11,10,2,6,9,4,0.18181818181818182,0.8181818181818182,0.6,0.4
SF-M24,SF-M27,1,1,1,0,0,1,1.0,0.0,0.0,1.0
SF-M24,SF-L25,11,5,8,2,3,3,0.7272727272727273,0.2727272727272727,0.4,0.6
SF-M24,SF-L24,29,48,23,37,6,11,0.7931034482758621,0.20689655172413793,0.7708333333333334,0.22916666666666666
SF-M24,SF-N23,55,22,39,19,16,3,0.7090909090909091,0.2909090909090909,0.8636363636363636,0.13636363636363635
SF-M24,SF-N24-2,26,34,19,18,7,16,0.7307692307692307,0.2692307692307692,0.5294117647058824,0.47058823529411764
SF-M24,SF-K27-2,20,10,14,5,6,5,0.7,0.3,0.5,0.5
SF-M24,SF-J26-2,14,16,6,8,8,8,0.42857142857142855,0.5714285714285714,0.5,0.5
SF-M24,SF-K28-3,4,3,4,3,0,0,1.0,0.0,1.0,0.0
SF-M24,SF-L28,3,4,2,2,1,2,0.6666666666666666,0.3333333333333333,0.5,0.5
SF-M24,SF-K28,3,2,3,1,0,1,1.0,0.0,0.5,0.5
SF-M24,SF-K29-1,12,3,8,2,4,1,0.6666666666666666,0.3333333333333333,0.6666666666666666,0.3333333333333333
SF-M24,SF-J28-2,5,6,2,5,3,1,0.4,0.6,0.8333333333333334,0.16666666666666666
SF-M24,SF-K25,9,26,7,20,2,6,0.7777777777777778,0.2222222222222222,0.7692307692307693,0.23076923076923078
SF-M24,SF-J25,28,21,20,11,8,10,0.7142857142857143,0.2857142857142857,0.5238095238095238,0.47619047619047616
SF-M24,SF-H26-2,8,2,5,0,3,2,0.625,0.375,0.0,1.0
SF-M24,SF-P24,21,17,11,14,10,3,0.5238095238095238,0.47619047619047616,0.8235294117647058,0.17647058823529413
SF-M24,SF-N22-1A,9,6,4,0,5,6,0.4444444444444444,0.5555555555555556,0.0,1.0
SF-M24,SF-J24,14,15,11,10,3,5,0.7857142857142857,0.21428571428571427,0.6666666666666666,0.3333333333333333
SF-M24,SF-O24,30,10,24,8,6,2,0.8,0.2,0.8,0.2
SF-M24,SF-J26,9,12,4,3,5,9,0.4444444444444444,0.5555555555555556,0.25,0.75
SF-M24,SF-I26-,4,3,2,0,2,3,0.5,0.5,0.0,1.0
SF-M24,SF-I25,7,13,6,8,1,5,0.8571428571428571,0.14285714285714285,0.6153846153846154,0.38461538461538464
SF-M24,SF-H26,16,26,9,13,7,13,0.5625,0.4375,0.5,0.5
SF-M24,SF-O23,46,14,39,11,7,3,0.8478260869565217,0.15217391304347827,0.7857142857142857,0.21428571428571427
SF-M24,SF-H27-1,8,8,7,3,1,5,0.875,0.125,0.375,0.625
SF-M24,SF-F28-2,7,6,3,3,4,3,0.42857142857142855,0.5714285714285714,0.5,0.5
SF-M24,SF-G27,10,20,7,7,3,13,0.7,0.3,0.35,0.65
SF-M24,SF-M22-2,86,59,28,16,58,43,0.32558139534883723,0.6744186046511628,0.2711864406779661,0.7288135593220338
SF-M24,SF-L22,14,20,6,7,8,13,0.42857142857142855,0.5714285714285714,0.35,0.65
SF-M24,SF-F27,3,6,3,2,0,4,1.0,0.0,0.3333333333333333,0.6666666666666666
SF-M24,SF-N22-2,47,28,23,18,24,10,0.48936170212765956,0.5106382978723404,0.6428571428571429,0.35714285714285715
SF-M24,SF-M22-1,7,5,5,2,2,3,0.7142857142857143,0.2857142857142857,0.4,0.6
SF-M24,SF-O25-1,8,10,4,8,4,2,0.5,0.5,0.8,0.2
SF-M24,SF-K22-2,4,6,4,6,0,0,1.0,0.0,1.0,0.0
SF-M24,SF-K24,23,17,19,15,4,2,0.8260869565217391,0.17391304347826086,0.8823529411764706,0.11764705882352941
SF-M24,SF-J23-2,10,6,7,3,3,3,0.7,0.3,0.5,0.5
SF-M24,SF-G23,7,6,5,1,2,5,0.7142857142857143,0.2857142857142857,0.16666666666666666,0.8333333333333334
SF-M24,SF-G24,128,108,111,53,17,55,0.8671875,0.1328125,0.49074074074074076,0.5092592592592593
SF-M24,SF-G25,12,15,7,4,5,11,0.5833333333333334,0.4166666666666667,0.26666666666666666,0.7333333333333333
SF-M24,SF-F23,24,10,7,0,17,10,0.2916666666666667,0.7083333333333334,0.0,1.0
SF-M24,SF-E23,5,6,1,1,4,5,0.2,0.8,0.16666666666666666,0.8333333333333334
SF-M24,SF-D24,1,1,1,0,0,1,1.0,0.0,0.0,1.0
SF-M24,SF-B22,6,4,0,2,6,2,0.0,1.0,0.5,0.5
SF-M24,SF-J17,1,1,0,0,1,1,0.0,1.0,0.0,1.0
SF-M24,SF-I19,6,5,1,0,5,5,0.16666666666666666,0.8333333333333334,0.0,1.0
SF-M24,SF-I20,2,5,0,3,2,2,0.0,1.0,0.6,0.4
SF-M24,SF-H16,3,1,2,0,1,1,0.6666666666666666,0.3333333333333333,0.0,1.0
SF-M24,SF-H20,1,1,0,0,1,1,0.0,1.0,0.0,1.0
SF-M24,SF-H17,1,1,0,0,1,1,0.0,1.0,0.0,1.0
SF-M24,SF-G19,3,1,0,0,3,1,0.0,1.0,0.0,1.0
SF-M24,SF-F19,3,1,0,0,3,1,0.0,1.0,0.0,1.0
SF-M24,SF-H30,3,6,0,4,3,2,0.0,1.0,0.6666666666666666,0.3333333333333333
SF-M24,SF-G30-2,7,11,3,4,4,7,0.42857142857142855,0.5714285714285714,0.36363636363636365,0.6363636363636364
SF-M24,SF-F30-1,6,8,3,6,3,2,0.5,0.5,0.75,0.25
SF-M24,SF-E29-2,6,4,1,3,5,1,0.16666666666666666,0.8333333333333334,0.75,0.25
SF-M24,SF-E29-1,11,4,0,3,11,1,0.0,1.0,0.75,0.25
SF-M24,SF-D29,41,48,3,4,38,44,0.07317073170731707,0.926829268292683,0.08333333333333333,0.9166666666666666
SF-M24,SF-D28,2,1,2,0,0,1,1.0,0.0,0.0,1.0
SF-M24,SF-A27,1,2,1,1,0,1,1.0,0.0,0.5,0.5
SF-M24,SF-G29-2,19,13,5,5,14,8,0.2631578947368421,0.7368421052631579,0.38461538461538464,0.6153846153846154
SF-M24,SF-G29-1,2,1,1,0,1,1,0.5,0.5,0.0,1.0
SF-M24,SF-G30-1,17,18,1,4,16,14,0.058823529411764705,0.9411764705882353,0.2222222222222222,0.7777777777777778
SF-M24,SF-G29-3,10,2,1,2,9,0,0.1,0.9,1.0,0.0
SF-M24,SF-F29,6,1,4,1,2,0,0.6666666666666666,0.3333333333333333,1.0,0.0
SF-M24,SF-E29-3,1,3,1,1,0,2,1.0,0.0,0.3333333333333333,0.6666666666666666
SF-M24,SF-F28-1,4,4,3,3,1,1,0.75,0.25,0.75,0.25
SF-M24,SF-E28-2,4,2,3,0,1,2,0.75,0.25,0.0,1.0
SF-M24,SF-J10,1,2,0,2,1,0,0.0,1.0,1.0,0.0
SF-M24,SF-J12,4,1,3,0,1,1,0.75,0.25,0.0,1.0
SF-M24,SF-G11,1,1,0,0,1,1,0.0,1.0,0.0,1.0
SF-M24,SF-G12,5,2,1,0,4,2,0.2,0.8,0.0,1.0
SF-M24,SF-G10-1,1,3,0,0,1,3,0.0,1.0,0.0,1.0
SF-M24,SF-F16,1,1,0,1,1,0,0.0,1.0,1.0,0.0
SF-M24,SF-C20,1,1,0,0,1,1,0.0,1.0,0.0,1.0
SF-M24,SF-B21,14,7,0,0,14,7,0.0,1.0,0.0,1.0
SF-M24,SF-A20,1,2,0,1,1,1,0.0,1.0,0.5,0.5
SF-M24,SF-C25,2,4,0,2,2,2,0.0,1.0,0.5,0.5
SF-M24,SF-B25,2,2,0,0,2,2,0.0,1.0,0.0,1.0
SF-M24,SF-E27,1,1,0,0,1,1,0.0,1.0,0.0,1.0
SF-M24,SF-D27,2,8,1,8,1,0,0.5,0.5,1.0,0.0
SF-M24,SF-G7,1,4,1,1,0,3,1.0,0.0,0.25,0.75
SF-M24,SF-F9,1,1,0,0,1,1,0.0,1.0,0.0,1.0
SF-M24,SF-H25,4,19,3,4,1,15,0.75,0.25,0.21052631578947367,0.7894736842105263
SF-M24,SF-G26,4,5,2,4,2,1,0.5,0.5,0.8,0.2
SF-M24,SF-K21,8,7,5,2,3,5,0.625,0.375,0.2857142857142857,0.7142857142857143
SF-M24,SF-K22-1,6,2,5,1,1,1,0.8333333333333334,0.16666666666666666,0.5,0.5
SF-M24,SF-J23-1,39,31,32,25,7,6,0.8205128205128205,0.1794871794871795,0.8064516129032258,0.1935483870967742
SF-M24,SF-J22-1,5,2,2,1,3,1,0.4,0.6,0.5,0.5
SF-M24,SF-J22-2,4,5,0,1,4,4,0.0,1.0,0.2,0.8
SF-M24,SF-J21,5,1,3,0,2,1,0.6,0.4,0.0,1.0
SF-M24,SF-I23-2,4,12,3,8,1,4,0.75,0.25,0.6666666666666666,0.3333333333333333
SF-M24,SF-I24,1,1,1,0,0,1,1.0,0.0,0.0,1.0
SF-M24,SF-I23-1,4,14,2,9,2,5,0.5,0.5,0.6428571428571429,0.35714285714285715
SF-M24,SF-F26,17,10,7,5,10,5,0.4117647058823529,0.5882352941176471,0.5,0.5
SF-M24,SF-M13,1,3,1,0,0,3,1.0,0.0,0.0,1.0
SF-M24,SF-M15,3,4,3,0,0,4,1.0,0.0,0.0,1.0
SF-M24,SF-L19,12,2,6,0,6,2,0.5,0.5,0.0,1.0
SF-M24,SF-L20,3,10,3,4,0,6,1.0,0.0,0.4,0.6
SF-M24,SF-N20-1,5,12,2,4,3,8,0.4,0.6,0.3333333333333333,0.6666666666666666
SF-M24,SF-M20,21,18,15,4,6,14,0.7142857142857143,0.2857142857142857,0.2222222222222222,0.7777777777777778
SF-M24,SF-K20,7,17,2,8,5,9,0.2857142857142857,0.7142857142857143,0.47058823529411764,0.5294117647058824
SF-M24,SF-K15-,6,7,3,2,3,5,0.5,0.5,0.2857142857142857,0.7142857142857143
SF-M24,SF-K19,15,4,13,1,2,3,0.8666666666666667,0.13333333333333333,0.25,0.75
SF-M24,SF-K18,28,4,28,3,0,1,1.0,0.0,0.75,0.25
SF-M24,SF-K17,6,5,4,0,2,5,0.6666666666666666,0.3333333333333333,0.0,1.0
SF-M24,SF-J16,4,3,4,0,0,3,1.0,0.0,0.0,1.0
SF-M24,SF-J18,6,4,1,3,5,1,0.16666666666666666,0.8333333333333334,0.75,0.25
SF-M24,SF-J20,3,1,2,0,1,1,0.6666666666666666,0.3333333333333333,0.0,1.0
SF-M24,SF-J19,3,2,2,2,1,0,0.6666666666666666,0.3333333333333333,1.0,0.0
SF-M24,SF-M12,2,19,1,1,1,18,0.5,0.5,0.05263157894736842,0.9473684210526315
SF-M24,SF-M10,2,1,2,0,0,1,1.0,0.0,0.0,1.0
SF-M24,SF-M11,2,3,1,0,1,3,0.5,0.5,0.0,1.0
SF-M24,SF-R19,8,4,1,0,7,4,0.125,0.875,0.0,1.0
SF-M24,SF-R20,4,3,0,0,4,3,0.0,1.0,0.0,1.0
SF-M24,SF-Q21-2,3,5,0,1,3,4,0.0,1.0,0.2,0.8
SF-M24,SF-Q21-1,10,3,4,1,6,2,0.4,0.6,0.3333333333333333,0.6666666666666666
SF-M24,SF-P21,12,4,6,0,6,4,0.5,0.5,0.0,1.0
SF-M24,SF-O18,5,4,2,1,3,3,0.4,0.6,0.25,0.75
SF-M24,SF-O19,10,10,3,4,7,6,0.3,0.7,0.4,0.6
SF-M24,SF-O21,32,35,25,23,7,12,0.78125,0.21875,0.6571428571428571,0.34285714285714286
SF-M24,SF-O22,24,21,14,14,10,7,0.5833333333333334,0.4166666666666667,0.6666666666666666,0.3333333333333333
SF-M24,SF-N21,29,13,16,7,13,6,0.5517241379310345,0.4482758620689655,0.5384615384615384,0.46153846153846156
SF-M24,SF-N20-2,3,8,2,0,1,8,0.6666666666666666,0.3333333333333333,0.0,1.0
SF-M24,SF-M21,7,21,6,14,1,7,0.8571428571428571,0.14285714285714285,0.6666666666666666,0.3333333333333333
SF-M24,SF-L21,16,30,2,4,14,26,0.125,0.875,0.13333333333333333,0.8666666666666667
SF-M24,SF-Q30,2,3,2,1,0,2,1.0,0.0,0.3333333333333333,0.6666666666666666
SF-M24,SF-P30,4,3,0,3,4,0,0.0,1.0,1.0,0.0
SF-M24,SF-O30-2,2,4,0,3,2,1,0.0,1.0,0.75,0.25
SF-M24,SF-O30,18,25,8,20,10,5,0.4444444444444444,0.5555555555555556,0.8,0.2
SF-M24,SF-N27,13,12,10,8,3,4,0.7692307692307693,0.23076923076923078,0.6666666666666666,0.3333333333333333
SF-M24,SF-N29,8,3,5,2,3,1,0.625,0.375,0.6666666666666666,0.3333333333333333
SF-M24,SF-N28,9,18,6,13,3,5,0.6666666666666666,0.3333333333333333,0.7222222222222222,0.2777777777777778
SF-M24,SF-L30-1,36,25,19,16,17,9,0.5277777777777778,0.4722222222222222,0.64,0.36
SF-M24,SF-L31-1,9,5,1,4,8,1,0.1111111111111111,0.8888888888888888,0.8,0.2
SF-M24,SF-K30-2,12,5,10,3,2,2,0.8333333333333334,0.16666666666666666,0.6,0.4
SF-M24,SF-L29,17,13,10,7,7,6,0.5882352941176471,0.4117647058823529,0.5384615384615384,0.46153846153846156
SF-M24,SF-J29-1,8,5,5,3,3,2,0.625,0.375,0.6,0.4
SF-M24,SF-I30,38,37,31,32,7,5,0.8157894736842105,0.18421052631578946,0.8648648648648649,0.13513513513513514
SF-M24,SF-I29-2,5,2,3,2,2,0,0.6,0.4,1.0,0.0
SF-M24,SF-I27,5,11,4,4,1,7,0.8,0.2,0.36363636363636365,0.6363636363636364
SF-M24,SF-I28,7,6,3,5,4,1,0.42857142857142855,0.5714285714285714,0.8333333333333334,0.16666666666666666
SF-M24,SF-I30-2,12,5,10,4,2,1,0.8333333333333334,0.16666666666666666,0.8,0.2
SF-M24,SF I29-1,9,3,3,2,6,1,0.3333333333333333,0.6666666666666666,0.6666666666666666,0.3333333333333333
SF-M24,SF-H28,8,7,7,4,1,3,0.875,0.125,0.5714285714285714,0.42857142857142855
SF-M24,SF-H29,2,2,0,0,2,2,0.0,1.0,0.0,1.0
SF-M24,SF-S24,45,46,28,27,17,19,0.6222222222222222,0.37777777777777777,0.5869565217391305,0.41304347826086957
SF-M24,SF-R24,26,34,11,18,15,16,0.4230769230769231,0.5769230769230769,0.5294117647058824,0.47058823529411764
SF-M24,SF-R26,4,5,3,4,1,1,0.75,0.25,0.8,0.2
SF-M24,SF-Q26,16,17,12,16,4,1,0.75,0.25,0.9411764705882353,0.058823529411764705
SF-M24,SF-P26,37,27,18,11,19,16,0.4864864864864865,0.5135135135135135,0.4074074074074074,0.5925925925925926
SF-M24,SF-O25-2,18,16,9,7,9,9,0.5,0.5,0.4375,0.5625
SF-M24,SF-N22-1B,48,16,31,10,17,6,0.6458333333333334,0.3541666666666667,0.625,0.375
SF-M24,SF-N26,21,13,5,6,16,7,0.23809523809523808,0.7619047619047619,0.46153846153846156,0.5384615384615384
SF-M24,SF-N25,22,10,16,3,6,7,0.7272727272727273,0.2727272727272727,0.3,0.7
SF-M24,SF-T21,5,6,5,3,0,3,1.0,0.0,0.5,0.5
SF-M24,SF-T22,7,10,4,6,3,4,0.5714285714285714,0.42857142857142855,0.6,0.4
SF-M24,SF-S22-2,4,3,1,0,3,3,0.25,0.75,0.0,1.0
SF-M24,SF-S22-1,10,10,3,4,7,6,0.3,0.7,0.4,0.6
SF-M24,SF-Q23-3,14,19,9,10,5,9,0.6428571428571429,0.35714285714285715,0.5263157894736842,0.47368421052631576
SF-M24,SF-Q22-1,8,9,4,3,4,6,0.5,0.5,0.3333333333333333,0.6666666666666666
SF-M24,SF-Q22-2,21,13,14,10,7,3,0.6666666666666666,0.3333333333333333,0.7692307692307693,0.23076923076923078
SF-M24,SF-P22,10,17,6,13,4,4,0.6,0.4,0.7647058823529411,0.23529411764705882
SF-M24,SF-U21,7,2,2,0,5,2,0.2857142857142857,0.7142857142857143,0.0,1.0
SF-M24,SF-T20,5,6,3,1,2,5,0.6,0.4,0.16666666666666666,0.8333333333333334
SF-M24,SF-S21,1,1,1,0,0,1,1.0,0.0,0.0,1.0
SF-M24,SF-Y27,3,2,0,0,3,2,0.0,1.0,0.0,1.0
SF-M24,SF-W14,3,1,0,0,3,1,0.0,1.0,0.0,1.0
SF-L24,SF-M25,33,26,21,12,12,14,0.6363636363636364,0.36363636363636365,0.46153846153846156,0.5384615384615384
SF-L24,SF-M26-2,40,37,18,19,22,18,0.45,0.55,0.5135135135135135,0.4864864864864865
SF-L24,SF-L27,11,9,7,5,4,4,0.6363636363636364,0.36363636363636365,0.5555555555555556,0.4444444444444444
SF-L24,SF-K26,27,23,14,19,13,4,0.5185185185185185,0.48148148148148145,0.8260869565217391,0.17391304347826086
SF-L24,SF-J27,4,10,2,7,2,3,0.5,0.5,0.7,0.3
SF-L24,SF-M30,11,4,6,4,5,0,0.5454545454545454,0.45454545454545453,1.0,0.0
SF-L24,SF-L27-2,1,3,1,3,0,0,1.0,0.0,1.0,0.0
SF-L24,SF-J29-3,1,2,0,2,1,0,0.0,1.0,1.0,0.0
SF-L24,SF-J29,10,10,6,7,4,3,0.6,0.4,0.7,0.3
SF-L24,SF-L26,60,37,47,32,13,5,0.7833333333333333,0.21666666666666667,0.8648648648648649,0.13513513513513514
SF-L24,SF-M28,17,17,10,10,7,7,0.5882352941176471,0.4117647058823529,0.5882352941176471,0.4117647058823529
SF-L24,SF-M27,13,13,9,10,4,3,0.6923076923076923,0.3076923076923077,0.7692307692307693,0.23076923076923078
SF-L24,SF-L25,14,19,11,16,3,3,0.7857142857142857,0.21428571428571427,0.8421052631578947,0.15789473684210525
SF-L24,SF-M24,48,29,37,23,11,6,0.7708333333333334,0.22916666666666666,0.7931034482758621,0.20689655172413793
SF-L24,SF-N23,32,28,18,20,14,8,0.5625,0.4375,0.7142857142857143,0.2857142857142857
SF-L24,SF-N24-2,17,25,9,12,8,13,0.5294117647058824,0.47058823529411764,0.48,0.52
SF-L24,SF-K27-2,15,7,12,0,3,7,0.8,0.2,0.0,1.0
SF-L24,SF-J26-2,48,83,32,49,16,34,0.6666666666666666,0.3333333333333333,0.5903614457831325,0.40963855421686746
SF-L24,SF-K28-3,2,2,2,0,0,2,1.0,0.0,0.0,1.0
SF-L24,SF-L28,14,14,9,11,5,3,0.6428571428571429,0.35714285714285715,0.7857142857142857,0.21428571428571427
SF-L24,SF-K28,3,3,2,2,1,1,0.6666666666666666,0.3333333333333333,0.6666666666666666,0.3333333333333333
SF-L24,SF-K29-1,6,5,5,2,1,3,0.8333333333333334,0.16666666666666666,0.4,0.6
SF-L24,SF-J28-2,2,4,1,4,1,0,0.5,0.5,1.0,0.0
SF-L24,SF-K27,8,6,3,5,5,1,0.375,0.625,0.8333333333333334,0.16666666666666666
SF-L24,SF-K25,50,66,35,57,15,9,0.7,0.3,0.8636363636363636,0.13636363636363635
SF-L24,SF-J25,85,43,45,25,40,18,0.5294117647058824,0.47058823529411764,0.5813953488372093,0.4186046511627907
SF-L24,SF-H26-2,8,7,5,1,3,6,0.625,0.375,0.14285714285714285,0.8571428571428571
SF-L24,SF-P24,18,13,6,8,12,5,0.3333333333333333,0.6666666666666666,0.6153846153846154,0.38461538461538464
SF-L24,SF-N22-1A,6,12,2,10,4,2,0.3333333333333333,0.6666666666666666,0.8333333333333334,0.16666666666666666
SF-L24,SF-J24,26,29,14,21,12,8,0.5384615384615384,0.46153846153846156,0.7241379310344828,0.27586206896551724
SF-L24,SF-O24,36,33,22,20,14,13,0.6111111111111112,0.3888888888888889,0.6060606060606061,0.3939393939393939
SF-L24,SF-J26,17,26,7,15,10,11,0.4117647058823529,0.5882352941176471,0.5769230769230769,0.4230769230769231
SF-L24,SF-I26-,14,8,10,5,4,3,0.7142857142857143,0.2857142857142857,0.625,0.375
SF-L24,SF-I25,10,17,5,15,5,2,0.5,0.5,0.8823529411764706,0.11764705882352941
SF-L24,SF-K23,4,3,0,2,4,1,0.0,1.0,0.6666666666666666,0.3333333333333333
SF-L24,SF-H26,44,40,28,30,16,10,0.6363636363636364,0.36363636363636365,0.75,0.25
SF-L24,SF-O23,11,21,4,12,7,9,0.36363636363636365,0.6363636363636364,0.5714285714285714,0.42857142857142855
SF-L24,SF-H27-1,13,21,9,14,4,7,0.6923076923076923,0.3076923076923077,0.6666666666666666,0.3333333333333333
SF-L24,SF-F28-2,6,3,3,0,3,3,0.5,0.5,0.0,1.0
SF-L24,SF-G27,12,5,8,2,4,3,0.6666666666666666,0.3333333333333333,0.4,0.6
SF-L24,SF-M22-2,15,18,5,9,10,9,0.3333333333333333,0.6666666666666666,0.5,0.5
SF-L24,SF-L22,48,51,21,20,27,31,0.4375,0.5625,0.39215686274509803,0.6078431372549019
SF-L24,SF-F27,3,5,2,2,1,3,0.6666666666666666,0.3333333333333333,0.4,0.6
SF-L24,SF-N22-2,28,49,19,14,9,35,0.6785714285714286,0.32142857142857145,0.2857142857142857,0.7142857142857143
SF-L24,SF-G28-2,3,3,1,2,2,1,0.3333333333333333,0.6666666666666666,0.6666666666666666,0.3333333333333333
SF-L24,SF-M22-1,29,26,21,15,8,11,0.7241379310344828,0.27586206896551724,0.5769230769230769,0.4230769230769231
SF-L24,SF-O25-1,15,8,7,4,8,4,0.4666666666666667,0.5333333333333333,0.5,0.5
SF-L24,SF-K22-2,15,24,10,18,5,6,0.6666666666666666,0.3333333333333333,0.75,0.25
SF-L24,SF-K24,50,50,42,44,8,6,0.84,0.16,0.88,0.12
SF-L24,SF-J23-2,28,22,19,15,9,7,0.6785714285714286,0.32142857142857145,0.6818181818181818,0.3181818181818182
SF-L24,SF-G23,14,7,8,3,6,4,0.5714285714285714,0.42857142857142855,0.42857142857142855,0.5714285714285714
SF-L24,SF-G24,17,10,10,1,7,9,0.5882352941176471,0.4117647058823529,0.1,0.9
SF-L24,SF-G25,9,7,5,3,4,4,0.5555555555555556,0.4444444444444444,0.42857142857142855,0.5714285714285714
SF-L24,SF-F23,18,10,10,3,8,7,0.5555555555555556,0.4444444444444444,0.3,0.7
SF-L24,SF-E23,10,3,4,1,6,2,0.4,0.6,0.3333333333333333,0.6666666666666666
SF-L24,SF-D24,5,5,4,1,1,4,0.8,0.2,0.2,0.8
SF-L24,SF-J17,5,1,4,0,1,1,0.8,0.2,0.0,1.0
SF-L24,SF-I20,2,3,1,2,1,1,0.5,0.5,0.6666666666666666,0.3333333333333333
SF-L24,SF-H16,1,4,0,1,1,3,0.0,1.0,0.25,0.75
SF-L24,SF-H20,9,5,8,3,1,2,0.8888888888888888,0.1111111111111111,0.6,0.4
SF-L24,SF-G19,1,1,0,0,1,1,0.0,1.0,0.0,1.0
SF-L24,SF-G20,5,4,1,1,4,3,0.2,0.8,0.25,0.75
SF-L24,SF-E18,5,2,4,1,1,1,0.8,0.2,0.5,0.5
SF-L24,SF-E20,1,1,1,0,0,1,1.0,0.0,0.0,1.0
SF-L24,SF-H30,5,1,3,1,2,0,0.6,0.4,1.0,0.0
SF-L24,SF-G30-2,10,9,5,4,5,5,0.5,0.5,0.4444444444444444,0.5555555555555556
SF-L24,SF-F30-1,2,5,1,2,1,3,0.5,0.5,0.4,0.6
SF-L24,SF-E29-2,4,3,2,1,2,2,0.5,0.5,0.3333333333333333,0.6666666666666666
SF-L24,SF-E29-1,10,9,7,5,3,4,0.7,0.3,0.5555555555555556,0.4444444444444444
SF-L24,SF-D29,2,9,1,0,1,9,0.5,0.5,0.0,1.0
SF-L24,SF-D28,4,2,2,2,2,0,0.5,0.5,1.0,0.0
SF-L24,SF-A27,4,2,3,2,1,0,0.75,0.25,1.0,0.0
SF-L24,SF-G29-2,42,30,26,17,16,13,0.6190476190476191,0.38095238095238093,0.5666666666666667,0.43333333333333335
SF-L24,SF-G29-1,7,2,3,1,4,1,0.42857142857142855,0.5714285714285714,0.5,0.5
SF-L24,SF-G30-1,10,13,7,6,3,7,0.7,0.3,0.46153846153846156,0.5384615384615384
SF-L24,SF-G29-3,16,7,13,4,3,3,0.8125,0.1875,0.5714285714285714,0.42857142857142855
SF-L24,SF-F30-2,1,2,1,1,0,1,1.0,0.0,0.5,0.5
SF-L24,SF-F28-1,2,3,0,2,2,1,0.0,1.0,0.6666666666666666,0.3333333333333333
SF-L24,SF-E28,3,1,3,1,0,0,1.0,0.0,1.0,0.0
SF-L24,SF-J10,3,1,2,1,1,0,0.6666666666666666,0.3333333333333333,1.0,0.0
SF-L24,SF-J13,9,5,1,1,8,4,0.1111111111111111,0.8888888888888888,0.2,0.8
SF-L24,SF-G10-2,3,2,0,0,3,2,0.0,1.0,0.0,1.0
SF-L24,SF-F15,3,3,0,0,3,3,0.0,1.0,0.0,1.0
SF-L24,SF-B21,2,3,0,0,2,3,0.0,1.0,0.0,1.0
SF-L24,SF-C26,8,6,2,1,6,5,0.25,0.75,0.16666666666666666,0.8333333333333334
SF-L24,SF-C25,12,14,2,0,10,14,0.16666666666666666,0.8333333333333334,0.0,1.0
SF-L24,SF-B25,3,3,0,2,3,1,0.0,1.0,0.6666666666666666,0.3333333333333333
SF-L24,SF-B28-2,30,22,6,1,24,21,0.2,0.8,0.045454545454545456,0.9545454545454546
SF-L24,SF-D27,3,2,1,1,2,1,0.3333333333333333,0.6666666666666666,0.5,0.5
SF-L24,SF-B28,6,1,0,1,6,0,0.0,1.0,1.0,0.0
SF-L24,SF-H25,1,6,0,4,1,2,0.0,1.0,0.6666666666666666,0.3333333333333333
SF-L24,SF-G26,8,4,2,2,6,2,0.25,0.75,0.5,0.5
SF-L24,SF-K21,8,5,6,2,2,3,0.75,0.25,0.4,0.6
SF-L24,SF-K22-1,31,50,14,20,17,30,0.45161290322580644,0.5483870967741935,0.4,0.6
SF-L24,SF-J23-1,60,72,32,39,28,33,0.5333333333333333,0.4666666666666667,0.5416666666666666,0.4583333333333333
SF-L24,SF-J22-1,12,14,9,6,3,8,0.75,0.25,0.42857142857142855,0.5714285714285714
SF-L24,SF-J22-2,12,2,3,1,9,1,0.25,0.75,0.5,0.5
SF-L24,SF-J21,13,7,6,3,7,4,0.46153846153846156,0.5384615384615384,0.42857142857142855,0.5714285714285714
SF-L24,SF-I22,19,18,5,2,14,16,0.2631578947368421,0.7368421052631579,0.1111111111111111,0.8888888888888888
SF-L24,SF-I23-2,7,9,3,6,4,3,0.42857142857142855,0.5714285714285714,0.6666666666666666,0.3333333333333333
SF-L24,SF-I24,12,11,6,6,6,5,0.5,0.5,0.5454545454545454,0.45454545454545453
SF-L24,SF-I23-1,16,31,11,23,5,8,0.6875,0.3125,0.7419354838709677,0.25806451612903225
SF-L24,SF-F26,17,9,8,1,9,8,0.47058823529411764,0.5294117647058824,0.1111111111111111,0.8888888888888888
SF-L24,SF-M13,9,4,7,0,2,4,0.7777777777777778,0.2222222222222222,0.0,1.0
SF-L24,SF-L19,8,7,5,0,3,7,0.625,0.375,0.0,1.0
SF-L24,SF-L20,12,8,9,3,3,5,0.75,0.25,0.375,0.625
SF-L24,SF-N20-1,7,6,4,2,3,4,0.5714285714285714,0.42857142857142855,0.3333333333333333,0.6666666666666666
SF-L24,SF-M20,18,17,12,6,6,11,0.6666666666666666,0.3333333333333333,0.35294117647058826,0.6470588235294118
SF-L24,SF-K17-2,3,2,2,0,1,2,0.6666666666666666,0.3333333333333333,0.0,1.0
SF-L24,SF-K20,10,9,7,3,3,6,0.7,0.3,0.3333333333333333,0.6666666666666666
SF-L24,SF-K15-,8,8,3,1,5,7,0.375,0.625,0.125,0.875
SF-L24,SF-K19,7,3,4,1,3,2,0.5714285714285714,0.42857142857142855,0.3333333333333333,0.6666666666666666
SF-L24,SF-K17,7,2,2,0,5,2,0.2857142857142857,0.7142857142857143,0.0,1.0
SF-L24,SF-J16,2,5,2,0,0,5,1.0,0.0,0.0,1.0
SF-L24,SF-J18,1,4,1,1,0,3,1.0,0.0,0.25,0.75
SF-L24,SF-J20,5,6,4,6,1,0,0.8,0.2,1.0,0.0
SF-L24,SF-J19,8,2,5,0,3,2,0.625,0.375,0.0,1.0
SF-L24,SF-M12,3,32,0,0,3,32,0.0,1.0,0.0,1.0
SF-L24,SF-M10,12,16,1,0,11,16,0.08333333333333333,0.9166666666666666,0.0,1.0
SF-L24,SF-M11,6,1,5,0,1,1,0.8333333333333334,0.16666666666666666,0.0,1.0
SF-L24,SF-R19,4,5,0,0,4,5,0.0,1.0,0.0,1.0
SF-L24,SF-R20,2,4,0,1,2,3,0.0,1.0,0.25,0.75
SF-L24,SF-Q21-2,5,3,1,0,4,3,0.2,0.8,0.0,1.0
SF-L24,SF-Q21-1,5,1,3,1,2,0,0.6,0.4,1.0,0.0
SF-L24,SF-P21,2,6,1,2,1,4,0.5,0.5,0.3333333333333333,0.6666666666666666
SF-L24,SF-O18,7,10,1,2,6,8,0.14285714285714285,0.8571428571428571,0.2,0.8
SF-L24,SF-O19,30,19,9,7,21,12,0.3,0.7,0.3684210526315789,0.631578947368421
SF-L24,SF-O21,32,27,16,11,16,16,0.5,0.5,0.4074074074074074,0.5925925925925926
SF-L24,SF-O22,33,10,12,6,21,4,0.36363636363636365,0.6363636363636364,0.6,0.4
SF-L24,SF-N21,8,16,4,9,4,7,0.5,0.5,0.5625,0.4375
SF-L24,SF-N20-2,4,7,3,1,1,6,0.75,0.25,0.14285714285714285,0.8571428571428571
SF-L24,SF-M21,24,26,12,14,12,12,0.5,0.5,0.5384615384615384,0.46153846153846156
SF-L24,SF-L21,18,26,7,6,11,20,0.3888888888888889,0.6111111111111112,0.23076923076923078,0.7692307692307693
SF-L24,SF-Q30,5,5,4,2,1,3,0.8,0.2,0.4,0.6
SF-L24,SF-P30,13,6,5,3,8,3,0.38461538461538464,0.6153846153846154,0.5,0.5
SF-L24,SF-O30-2,2,2,0,0,2,2,0.0,1.0,0.0,1.0
SF-L24,SF-O30,10,14,1,2,9,12,0.1,0.9,0.14285714285714285,0.8571428571428571
SF-L24,SF-N27,12,7,8,2,4,5,0.6666666666666666,0.3333333333333333,0.2857142857142857,0.7142857142857143
SF-L24,SF-N29,8,4,7,4,1,0,0.875,0.125,1.0,0.0
SF-L24,SF-N28,9,6,6,2,3,4,0.6666666666666666,0.3333333333333333,0.3333333333333333,0.6666666666666666
SF-L24,SF-L30-1,31,25,17,16,14,9,0.5483870967741935,0.45161290322580644,0.64,0.36
SF-L24,SF-K30-2,4,3,2,1,2,2,0.5,0.5,0.3333333333333333,0.6666666666666666
SF-L24,SF-L29,11,15,10,7,1,8,0.9090909090909091,0.09090909090909091,0.4666666666666667,0.5333333333333333
SF-L24,SF-J29-1,3,1,1,1,2,0,0.3333333333333333,0.6666666666666666,1.0,0.0
SF-L24,SF-I30,5,11,4,10,1,1,0.8,0.2,0.9090909090909091,0.09090909090909091
SF-L24,SF-I29-2,2,6,0,1,2,5,0.0,1.0,0.16666666666666666,0.8333333333333334
SF-L24,SF-I27,9,15,7,8,2,7,0.7777777777777778,0.2222222222222222,0.5333333333333333,0.4666666666666667
SF-L24,SF-I28,6,8,3,5,3,3,0.5,0.5,0.625,0.375
SF-L24,SF-I30-2,61,44,55,42,6,2,0.9016393442622951,0.09836065573770492,0.9545454545454546,0.045454545454545456
SF-L24,SF I29-1,1,4,0,0,1,4,0.0,1.0,0.0,1.0
SF-L24,SF-H28,14,49,5,40,9,9,0.35714285714285715,0.6428571428571429,0.8163265306122449,0.1836734693877551
SF-L24,SF-H29,3,15,0,7,3,8,0.0,1.0,0.4666666666666667,0.5333333333333333
SF-L24,SF-S24,28,36,12,14,16,22,0.42857142857142855,0.5714285714285714,0.3888888888888889,0.6111111111111112
SF-L24,SF-R24,50,45,16,23,34,22,0.32,0.68,0.5111111111111111,0.4888888888888889
SF-L24,SF-R26,2,2,1,1,1,1,0.5,0.5,0.5,0.5
SF-L24,SF-Q26,6,6,4,3,2,3,0.6666666666666666,0.3333333333333333,0.5,0.5
SF-L24,SF-P26,17,9,5,1,12,8,0.29411764705882354,0.7058823529411765,0.1111111111111111,0.8888888888888888
SF-L24,SF-O25-2,11,15,7,8,4,7,0.6363636363636364,0.36363636363636365,0.5333333333333333,0.4666666666666667
SF-L24,SF-N22-1B,59,60,52,48,7,12,0.8813559322033898,0.11864406779661017,0.8,0.2
SF-L24,SF-N26,10,2,6,1,4,1,0.6,0.4,0.5,0.5
SF-L24,SF-N25,13,8,11,7,2,1,0.8461538461538461,0.15384615384615385,0.875,0.125
SF-L24,SF-T21,5,2,2,0,3,2,0.4,0.6,0.0,1.0
SF-L24,SF-T22,5,11,4,4,1,7,0.8,0.2,0.36363636363636365,0.6363636363636364
SF-L24,SF-S22-2,5,3,0,1,5,2,0.0,1.0,0.3333333333333333,0.6666666666666666
SF-L24,SF-S22-1,4,12,1,8,3,4,0.25,0.75,0.6666666666666666,0.3333333333333333
SF-L24,SF-Q23-3,7,19,4,12,3,7,0.5714285714285714,0.42857142857142855,0.631578947368421,0.3684210526315789
SF-L24,SF-Q22-1,13,14,7,7,6,7,0.5384615384615384,0.46153846153846156,0.5,0.5
SF-L24,SF-Q22-2,17,19,13,11,4,8,0.7647058823529411,0.23529411764705882,0.5789473684210527,0.42105263157894735
SF-L24,SF-P22,18,17,11,10,7,7,0.6111111111111112,0.3888888888888889,0.5882352941176471,0.4117647058823529
SF-L24,SF-W19,3,1,1,0,2,1,0.3333333333333333,0.6666666666666666,0.0,1.0
SF-L24,SF-U21,2,1,0,1,2,0,0.0,1.0,1.0,0.0
SF-L24,SF-T20,2,4,0,3,2,1,0.0,1.0,0.75,0.25
SF-L24,SF-W14,1,1,0,0,1,1,0.0,1.0,0.0,1.0
SF-N23,SF-M25,5,4,3,3,2,1,0.6,0.4,0.75,0.25
SF-N23,SF-M26-2,9,7,6,4,3,3,0.6666666666666666,0.3333333333333333,0.5714285714285714,0.42857142857142855
SF-N23,SF-L27,3,1,3,1,0,0,1.0,0.0,1.0,0.0
SF-N23,SF-K26,10,7,6,3,4,4,0.6,0.4,0.42857142857142855,0.5714285714285714
SF-N23,SF-M30,11,20,4,3,7,17,0.36363636363636365,0.6363636363636364,0.15,0.85
SF-N23,SF-L27-2,12,7,12,7,0,0,1.0,0.0,1.0,0.0
SF-N23,SF-J29-3,3,1,3,1,0,0,1.0,0.0,1.0,0.0
SF-N23,SF-J29,16,6,4,4,12,2,0.25,0.75,0.6666666666666666,0.3333333333333333
SF-N23,SF-L26,19,30,13,10,6,20,0.6842105263157895,0.3157894736842105,0.3333333333333333,0.6666666666666666
SF-N23,SF-M28,7,4,2,1,5,3,0.2857142857142857,0.7142857142857143,0.25,0.75
SF-N23,SF-M27,1,2,1,0,0,2,1.0,0.0,0.0,1.0
SF-N23,SF-L25,3,8,2,6,1,2,0.6666666666666666,0.3333333333333333,0.75,0.25
SF-N23,SF-M24,22,55,19,39,3,16,0.8636363636363636,0.13636363636363635,0.7090909090909091,0.2909090909090909
SF-N23,SF-L24,28,32,20,18,8,14,0.7142857142857143,0.2857142857142857,0.5625,0.4375
SF-N23,SF-N24-2,15,10,7,4,8,6,0.4666666666666667,0.5333333333333333,0.4,0.6
SF-N23,SF-K27-2,7,7,3,2,4,5,0.42857142857142855,0.5714285714285714,0.2857142857142857,0.7142857142857143
SF-N23,SF-J26-2,3,14,2,7,1,7,0.6666666666666666,0.3333333333333333,0.5,0.5
SF-N23,SF-K28-3,11,5,0,0,11,5,0.0,1.0,0.0,1.0
SF-N23,SF-L28,19,19,15,12,4,7,0.7894736842105263,0.21052631578947367,0.631578947368421,0.3684210526315789
SF-N23,SF-K28,9,5,2,3,7,2,0.2222222222222222,0.7777777777777778,0.6,0.4
SF-N23,SF-K29-1,9,2,1,0,8,2,0.1111111111111111,0.8888888888888888,0.0,1.0
SF-N23,SF-J28-2,7,1,5,1,2,0,0.7142857142857143,0.2857142857142857,1.0,0.0
SF-N23,SF-K27,1,1,0,0,1,1,0.0,1.0,0.0,1.0
SF-N23,SF-K25,25,38,14,22,11,16,0.56,0.44,0.5789473684210527,0.42105263157894735
SF-N23,SF-J25,19,12,13,5,6,7,0.6842105263157895,0.3157894736842105,0.4166666666666667,0.5833333333333334
SF-N23,SF-H26-2,7,4,3,0,4,4,0.42857142857142855,0.5714285714285714,0.0,1.0
SF-N23,SF-P24,15,8,9,6,6,2,0.6,0.4,0.75,0.25
SF-N23,SF-N22-1A,1,3,1,1,0,2,1.0,0.0,0.3333333333333333,0.6666666666666666
SF-N23,SF-J24,11,19,6,13,5,6,0.5454545454545454,0.45454545454545453,0.6842105263157895,0.3157894736842105
SF-N23,SF-O24,19,10,15,7,4,3,0.7894736842105263,0.21052631578947367,0.7,0.3
SF-N23,SF-J26,4,13,1,4,3,9,0.25,0.75,0.3076923076923077,0.6923076923076923
SF-N23,SF-I26-,5,6,4,0,1,6,0.8,0.2,0.0,1.0
SF-N23,SF-I25,10,6,7,3,3,3,0.7,0.3,0.5,0.5
SF-N23,SF-K23,1,2,0,1,1,1,0.0,1.0,0.5,0.5
SF-N23,SF-H26,11,9,4,4,7,5,0.36363636363636365,0.6363636363636364,0.4444444444444444,0.5555555555555556
SF-N23,SF-O23,15,2,12,1,3,1,0.8,0.2,0.5,0.5
SF-N23,SF-H27-1,21,9,15,5,6,4,0.7142857142857143,0.2857142857142857,0.5555555555555556,0.4444444444444444
SF-N23,SF-F28-2,10,9,2,2,8,7,0.2,0.8,0.2222222222222222,0.7777777777777778
SF-N23,SF-G27,8,19,5,7,3,12,0.625,0.375,0.3684210526315789,0.631578947368421
SF-N23,SF-M22-2,9,10,6,6,3,4,0.6666666666666666,0.3333333333333333,0.6,0.4
SF-N23,SF-L22,7,12,4,9,3,3,0.5714285714285714,0.42857142857142855,0.75,0.25
SF-N23,SF-F27,8,9,5,4,3,5,0.625,0.375,0.4444444444444444,0.5555555555555556
SF-N23,SF-N22-2,41,43,31,33,10,10,0.7560975609756098,0.24390243902439024,0.7674418604651163,0.23255813953488372
SF-N23,SF-G28-2,1,2,0,0,1,2,0.0,1.0,0.0,1.0
SF-N23,SF-M22-1,7,4,7,4,0,0,1.0,0.0,1.0,0.0
SF-N23,SF-O25-1,7,3,6,3,1,0,0.8571428571428571,0.14285714285714285,1.0,0.0
SF-N23,SF-K22-2,3,5,3,0,0,5,1.0,0.0,0.0,1.0
SF-N23,SF-K24,12,6,9,6,3,0,0.75,0.25,1.0,0.0
SF-N23,SF-J23-2,2,3,2,2,0,1,1.0,0.0,0.6666666666666666,0.3333333333333333
SF-N23,SF-G23,4,2,0,0,4,2,0.0,1.0,0.0,1.0
SF-N23,SF-G24,15,8,2,0,13,8,0.13333333333333333,0.8666666666666667,0.0,1.0
SF-N23,SF-G25,6,4,3,2,3,2,0.5,0.5,0.5,0.5
SF-N23,SF-F23,43,7,32,5,11,2,0.7441860465116279,0.2558139534883721,0.7142857142857143,0.2857142857142857
SF-N23,SF-E23,22,7,1,0,21,7,0.045454545454545456,0.9545454545454546,0.0,1.0
SF-N23,SF-D24,11,4,0,0,11,4,0.0,1.0,0.0,1.0
SF-N23,SF-C22,93,51,0,0,93,51,0.0,1.0,0.0,1.0
SF-N23,SF-B22,2,7,0,3,2,4,0.0,1.0,0.42857142857142855,0.5714285714285714
SF-N23,SF-J17,2,1,0,0,2,1,0.0,1.0,0.0,1.0
SF-N23,SF-I19,2,3,1,0,1,3,0.5,0.5,0.0,1.0
SF-N23,SF-H16,4,4,1,1,3,3,0.25,0.75,0.25,0.75
SF-N23,SF-H20,2,1,1,0,1,1,0.5,0.5,0.0,1.0
SF-N23,SF-G19,2,1,0,0,2,1,0.0,1.0,0.0,1.0
SF-N23,SF-G20,2,1,0,0,2,1,0.0,1.0,0.0,1.0
SF-N23,SF-F19,1,1,0,0,1,1,0.0,1.0,0.0,1.0
SF-N23,SF-H30,2,4,2,2,0,2,1.0,0.0,0.5,0.5
SF-N23,SF-G30-2,9,5,1,0,8,5,0.1111111111111111,0.8888888888888888,0.0,1.0
SF-N23,SF-E29-2,3,22,3,17,0,5,1.0,0.0,0.7727272727272727,0.22727272727272727
SF-N23,SF-E29-1,2,6,1,6,1,0,0.5,0.5,1.0,0.0
SF-N23,SF-D29,3,3,0,1,3,2,0.0,1.0,0.3333333333333333,0.6666666666666666
SF-N23,SF-D28,4,3,0,1,4,2,0.0,1.0,0.3333333333333333,0.6666666666666666
SF-N23,SF-A27,1,1,1,1,0,0,1.0,0.0,1.0,0.0
SF-N23,SF-G29-2,16,13,7,1,9,12,0.4375,0.5625,0.07692307692307693,0.9230769230769231
SF-N23,SF-G29-1,11,2,8,1,3,1,0.7272727272727273,0.2727272727272727,0.5,0.5
SF-N23,SF-G30-1,8,8,5,2,3,6,0.625,0.375,0.25,0.75
SF-N23,SF-G29-3,7,1,4,0,3,1,0.5714285714285714,0.42857142857142855,0.0,1.0
SF-N23,SF-F30-2,1,3,0,0,1,3,0.0,1.0,0.0,1.0
SF-N23,SF-F29,8,2,6,1,2,1,0.75,0.25,0.5,0.5
SF-N23,SF-E29-3,3,3,0,2,3,1,0.0,1.0,0.6666666666666666,0.3333333333333333
SF-N23,SF-J10,2,1,1,0,1,1,0.5,0.5,0.0,1.0
SF-N23,SF-J12,4,5,1,0,3,5,0.25,0.75,0.0,1.0
SF-N23,SF-J13,3,2,0,0,3,2,0.0,1.0,0.0,1.0
SF-N23,SF-G11,9,1,2,0,7,1,0.2222222222222222,0.7777777777777778,0.0,1.0
SF-N23,SF-B21,1,1,0,0,1,1,0.0,1.0,0.0,1.0
SF-N23,SF-A20,2,2,0,0,2,2,0.0,1.0,0.0,1.0
SF-N23,SF-C26,27,3,21,1,6,2,0.7777777777777778,0.2222222222222222,0.3333333333333333,0.6666666666666666
SF-N23,SF-C25,3,3,1,1,2,2,0.3333333333333333,0.6666666666666666,0.3333333333333333,0.6666666666666666
SF-N23,SF-D27,5,2,5,2,0,0,1.0,0.0,1.0,0.0
SF-N23,SF-C28-2,3,1,2,1,1,0,0.6666666666666666,0.3333333333333333,1.0,0.0
SF-N23,SF-J1,1,4,0,0,1,4,0.0,1.0,0.0,1.0
SF-N23,SF-H25,3,2,2,0,1,2,0.6666666666666666,0.3333333333333333,0.0,1.0
SF-N23,SF-G26,4,5,2,1,2,4,0.5,0.5,0.2,0.8
SF-N23,SF-K21,4,3,4,1,0,2,1.0,0.0,0.3333333333333333,0.6666666666666666
SF-N23,SF-K22-1,11,9,8,4,3,5,0.7272727272727273,0.2727272727272727,0.4444444444444444,0.5555555555555556
SF-N23,SF-J23-1,13,18,9,15,4,3,0.6923076923076923,0.3076923076923077,0.8333333333333334,0.16666666666666666
SF-N23,SF-J22-1,8,1,5,0,3,1,0.625,0.375,0.0,1.0
SF-N23,SF-J22-2,13,4,6,1,7,3,0.46153846153846156,0.5384615384615384,0.25,0.75
SF-N23,SF-J21,7,5,5,2,2,3,0.7142857142857143,0.2857142857142857,0.4,0.6
SF-N23,SF-I23-2,4,8,4,7,0,1,1.0,0.0,0.875,0.125
SF-N23,SF-I24,2,1,2,1,0,0,1.0,0.0,1.0,0.0
SF-N23,SF-I23-1,10,10,9,9,1,1,0.9,0.1,0.9,0.1
SF-N23,SF-F26,6,3,4,0,2,3,0.6666666666666666,0.3333333333333333,0.0,1.0
SF-N23,SF-M13,5,4,0,1,5,3,0.0,1.0,0.25,0.75
SF-N23,SF-M15,9,9,2,1,7,8,0.2222222222222222,0.7777777777777778,0.1111111111111111,0.8888888888888888
SF-N23,SF-L19,18,33,4,17,14,16,0.2222222222222222,0.7777777777777778,0.5151515151515151,0.48484848484848486
SF-N23,SF-L20,5,7,2,1,3,6,0.4,0.6,0.14285714285714285,0.8571428571428571
SF-N23,SF-N20-1,3,12,3,4,0,8,1.0,0.0,0.3333333333333333,0.6666666666666666
SF-N23,SF-M20,16,13,5,4,11,9,0.3125,0.6875,0.3076923076923077,0.6923076923076923
SF-N23,SF-K17-2,2,3,1,0,1,3,0.5,0.5,0.0,1.0
SF-N23,SF-K20,8,12,7,4,1,8,0.875,0.125,0.3333333333333333,0.6666666666666666
SF-N23,SF-K15-,15,6,10,0,5,6,0.6666666666666666,0.3333333333333333,0.0,1.0
SF-N23,SF-K19,16,10,7,3,9,7,0.4375,0.5625,0.3,0.7
SF-N23,SF-K18,16,4,7,1,9,3,0.4375,0.5625,0.25,0.75
SF-N23,SF-K17,12,1,5,1,7,0,0.4166666666666667,0.5833333333333334,1.0,0.0
SF-N23,SF-J16,4,1,1,0,3,1,0.25,0.75,0.0,1.0
SF-N23,SF-J18,6,6,1,0,5,6,0.16666666666666666,0.8333333333333334,0.0,1.0
SF-N23,SF-J19,3,2,3,0,0,2,1.0,0.0,0.0,1.0
SF-N23,SF-M12,1,2,0,2,1,0,0.0,1.0,1.0,0.0
SF-N23,SF-M10,1,1,1,1,0,0,1.0,0.0,1.0,0.0
SF-N23,SF-M11,1,1,0,0,1,1,0.0,1.0,0.0,1.0
SF-N23,SF-R19,4,4,1,0,3,4,0.25,0.75,0.0,1.0
SF-N23,SF-R20,4,2,1,0,3,2,0.25,0.75,0.0,1.0
SF-N23,SF-Q21-2,11,4,4,1,7,3,0.36363636363636365,0.6363636363636364,0.25,0.75
SF-N23,SF-Q21-1,46,13,9,3,37,10,0.1956521739130435,0.8043478260869565,0.23076923076923078,0.7692307692307693
SF-N23,SF-P21,6,5,2,0,4,5,0.3333333333333333,0.6666666666666666,0.0,1.0
SF-N23,SF-O18,61,17,50,2,11,15,0.819672131147541,0.18032786885245902,0.11764705882352941,0.8823529411764706
SF-N23,SF-O19,27,14,17,6,10,8,0.6296296296296297,0.37037037037037035,0.42857142857142855,0.5714285714285714
SF-N23,SF-O21,19,24,10,9,9,15,0.5263157894736842,0.47368421052631576,0.375,0.625
SF-N23,SF-O22,15,13,7,8,8,5,0.4666666666666667,0.5333333333333333,0.6153846153846154,0.38461538461538464
SF-N23,SF-N21,19,10,16,4,3,6,0.8421052631578947,0.15789473684210525,0.4,0.6
SF-N23,SF-N20-2,36,20,32,14,4,6,0.8888888888888888,0.1111111111111111,0.7,0.3
SF-N23,SF-M21,18,10,8,2,10,8,0.4444444444444444,0.5555555555555556,0.2,0.8
SF-N23,SF-L21,14,13,2,3,12,10,0.14285714285714285,0.8571428571428571,0.23076923076923078,0.7692307692307693
SF-N23,SF-Q30,12,10,5,4,7,6,0.4166666666666667,0.5833333333333334,0.4,0.6
SF-N23,SF-P30,5,5,2,4,3,1,0.4,0.6,0.8,0.2
SF-N23,SF-O30-2,10,13,6,1,4,12,0.6,0.4,0.07692307692307693,0.9230769230769231
SF-N23,SF-O30,11,22,3,10,8,12,0.2727272727272727,0.7272727272727273,0.45454545454545453,0.5454545454545454
SF-N23,SF-N27,17,22,12,8,5,14,0.7058823529411765,0.29411764705882354,0.36363636363636365,0.6363636363636364
SF-N23,SF-N29,17,10,8,3,9,7,0.47058823529411764,0.5294117647058824,0.3,0.7
SF-N23,SF-N28,21,19,8,6,13,13,0.38095238095238093,0.6190476190476191,0.3157894736842105,0.6842105263157895
SF-N23,SF-L30-1,21,24,12,8,9,16,0.5714285714285714,0.42857142857142855,0.3333333333333333,0.6666666666666666
SF-N23,SF-L31-1,13,4,8,2,5,2,0.6153846153846154,0.38461538461538464,0.5,0.5
SF-N23,SF-K30-2,1,5,0,4,1,1,0.0,1.0,0.8,0.2
SF-N23,SF-L29,11,3,7,2,4,1,0.6363636363636364,0.36363636363636365,0.6666666666666666,0.3333333333333333
SF-N23,SF-J29-1,8,7,5,6,3,1,0.625,0.375,0.8571428571428571,0.14285714285714285
SF-N23,SF-I30,4,7,3,2,1,5,0.75,0.25,0.2857142857142857,0.7142857142857143
SF-N23,SF-I27,5,9,3,0,2,9,0.6,0.4,0.0,1.0
SF-N23,SF-I28,5,1,1,0,4,1,0.2,0.8,0.0,1.0
SF-N23,SF I29-1,1,1,0,0,1,1,0.0,1.0,0.0,1.0
SF-N23,SF-H28,11,15,7,4,4,11,0.6363636363636364,0.36363636363636365,0.26666666666666666,0.7333333333333333
SF-N23,SF-H29,1,1,0,0,1,1,0.0,1.0,0.0,1.0
SF-N23,SF-S24,14,18,7,8,7,10,0.5,0.5,0.4444444444444444,0.5555555555555556
SF-N23,SF-R24,40,36,25,27,15,9,0.625,0.375,0.75,0.25
SF-N23,SF-R26,2,4,1,3,1,1,0.5,0.5,0.75,0.25
SF-N23,SF-P26,10,7,6,3,4,4,0.6,0.4,0.42857142857142855,0.5714285714285714
SF-N23,SF-O25-2,10,10,8,4,2,6,0.8,0.2,0.4,0.6
SF-N23,SF-N22-1B,14,28,13,26,1,2,0.9285714285714286,0.07142857142857142,0.9285714285714286,0.07142857142857142
SF-N23,SF-N26,11,5,8,4,3,1,0.7272727272727273,0.2727272727272727,0.8,0.2
SF-N23,SF-N25,12,10,7,3,5,7,0.5833333333333334,0.4166666666666667,0.3,0.7
SF-N23,SF-T21,4,11,0,2,4,9,0.0,1.0,0.18181818181818182,0.8181818181818182
SF-N23,SF-T22,11,10,6,5,5,5,0.5454545454545454,0.45454545454545453,0.5,0.5
SF-N23,SF-S22-2,1,5,1,2,0,3,1.0,0.0,0.4,0.6
SF-N23,SF-S22-1,5,15,3,8,2,7,0.6,0.4,0.5333333333333333,0.4666666666666667
SF-N23,SF-Q23-3,4,10,2,8,2,2,0.5,0.5,0.8,0.2
SF-N23,SF-Q22-1,8,11,6,6,2,5,0.75,0.25,0.5454545454545454,0.45454545454545453
SF-N23,SF-Q22-2,11,10,5,6,6,4,0.45454545454545453,0.5454545454545454,0.6,0.4
SF-N23,SF-P22,12,7,8,3,4,4,0.6666666666666666,0.3333333333333333,0.42857142857142855,0.5714285714285714
SF-N23,SF-W19,1,2,0,1,1,1,0.0,1.0,0.5,0.5
SF-N23,SF-U21,1,5,1,1,0,4,1.0,0.0,0.2,0.8
SF-N23,SF-T20,6,5,2,1,4,4,0.3333333333333333,0.6666666666666666,0.2,0.8
SF-N23,SF-S21,5,2,0,0,5,2,0.0,1.0,0.0,1.0
SF-N23,SF-V30,2,2,0,0,2,2,0.0,1.0,0.0,1.0
SF-N24-2,SF-M26,1,1,0,1,1,0,0.0,1.0,1.0,0.0
SF-N24-2,SF-M25,10,8,6,2,4,6,0.6,0.4,0.25,0.75
SF-N24-2,SF-L27,4,2,1,2,3,0,0.25,0.75,1.0,0.0
SF-N24-2,SF-K26,7,3,1,0,6,3,0.14285714285714285,0.8571428571428571,0.0,1.0
SF-N24-2,SF-M30,9,10,2,1,7,9,0.2222222222222222,0.7777777777777778,0.1,0.9
SF-N24-2,SF-L27-2,2,3,1,2,1,1,0.5,0.5,0.6666666666666666,0.3333333333333333
SF-N24-2,SF-J29-3,4,1,1,0,3,1,0.25,0.75,0.0,1.0
SF-N24-2,SF-J29,1,4,0,2,1,2,0.0,1.0,0.5,0.5
SF-N24-2,SF-L26,48,10,15,7,33,3,0.3125,0.6875,0.7,0.3
SF-N24-2,SF-M28,9,7,4,2,5,5,0.4444444444444444,0.5555555555555556,0.2857142857142857,0.7142857142857143
SF-N24-2,SF-L25,10,7,7,4,3,3,0.7,0.3,0.5714285714285714,0.42857142857142855
SF-N24-2,SF-M24,34,26,18,19,16,7,0.5294117647058824,0.47058823529411764,0.7307692307692307,0.2692307692307692
SF-N24-2,SF-L24,25,17,12,9,13,8,0.48,0.52,0.5294117647058824,0.47058823529411764
SF-N24-2,SF-N23,10,15,4,7,6,8,0.4,0.6,0.4666666666666667,0.5333333333333333
SF-N24-2,SF-K27-2,2,1,0,0,2,1,0.0,1.0,0.0,1.0
SF-N24-2,SF-J26-2,6,9,3,3,3,6,0.5,0.5,0.3333333333333333,0.6666666666666666
SF-N24-2,SF-L28,5,4,0,0,5,4,0.0,1.0,0.0,1.0
SF-N24-2,SF-K29-1,3,7,0,4,3,3,0.0,1.0,0.5714285714285714,0.42857142857142855
SF-N24-2,SF-J28-2,9,6,6,4,3,2,0.6666666666666666,0.3333333333333333,0.6666666666666666,0.3333333333333333
SF-N24-2,SF-K25,16,13,9,7,7,6,0.5625,0.4375,0.5384615384615384,0.46153846153846156
SF-N24-2,SF-J25,14,9,11,8,3,1,0.7857142857142857,0.21428571428571427,0.8888888888888888,0.1111111111111111
SF-N24-2,SF-P24,46,47,29,25,17,22,0.6304347826086957,0.3695652173913043,0.5319148936170213,0.46808510638297873
SF-N24-2,SF-N22-1A,6,3,2,1,4,2,0.3333333333333333,0.6666666666666666,0.3333333333333333,0.6666666666666666
SF-N24-2,SF-J24,28,15,19,9,9,6,0.6785714285714286,0.32142857142857145,0.6,0.4
SF-N24-2,SF-O24,17,10,13,7,4,3,0.7647058823529411,0.23529411764705882,0.7,0.3
SF-N24-2,SF-J26,1,1,1,0,0,1,1.0,0.0,0.0,1.0
SF-N24-2,SF-I26-,3,1,2,0,1,1,0.6666666666666666,0.3333333333333333,0.0,1.0
SF-N24-2,SF-I25,5,1,3,1,2,0,0.6,0.4,1.0,0.0
SF-N24-2,SF-K23,2,2,1,1,1,1,0.5,0.5,0.5,0.5
SF-N24-2,SF-H26,12,4,3,0,9,4,0.25,0.75,0.0,1.0
SF-N24-2,SF-O23,28,20,18,9,10,11,0.6428571428571429,0.35714285714285715,0.45,0.55
SF-N24-2,SF-H27-1,6,10,1,0,5,10,0.16666666666666666,0.8333333333333334,0.0,1.0
SF-N24-2,SF-F28-2,1,2,0,0,1,2,0.0,1.0,0.0,1.0
SF-N24-2,SF-G27,9,9,2,2,7,7,0.2222222222222222,0.7777777777777778,0.2222222222222222,0.7777777777777778
SF-N24-2,SF-M22-2,8,9,6,6,2,3,0.75,0.25,0.6666666666666666,0.3333333333333333
SF-N24-2,SF-L22,14,9,10,4,4,5,0.7142857142857143,0.2857142857142857,0.4444444444444444,0.5555555555555556
SF-N24-2,SF-F27,14,2,2,0,12,2,0.14285714285714285,0.8571428571428571,0.0,1.0
SF-N24-2,SF-N22-2,46,36,30,25,16,11,0.6521739130434783,0.34782608695652173,0.6944444444444444,0.3055555555555556
SF-N24-2,SF-M22-1,6,3,6,2,0,1,1.0,0.0,0.6666666666666666,0.3333333333333333
SF-N24-2,SF-O25-1,20,16,14,13,6,3,0.7,0.3,0.8125,0.1875
SF-N24-2,SF-K22-2,5,9,1,7,4,2,0.2,0.8,0.7777777777777778,0.2222222222222222
SF-N24-2,SF-K24,8,7,6,6,2,1,0.75,0.25,0.8571428571428571,0.14285714285714285
SF-N24-2,SF-J23-2,6,9,4,3,2,6,0.6666666666666666,0.3333333333333333,0.3333333333333333,0.6666666666666666
SF-N24-2,SF-G23,6,3,3,0,3,3,0.5,0.5,0.0,1.0
SF-N24-2,SF-G24,4,5,1,0,3,5,0.25,0.75,0.0,1.0
SF-N24-2,SF-G25,4,4,1,0,3,4,0.25,0.75,0.0,1.0
SF-N24-2,SF-F23,2,1,2,0,0,1,1.0,0.0,0.0,1.0
SF-N24-2,SF-E23,1,8,0,0,1,8,0.0,1.0,0.0,1.0
SF-N24-2,SF-D24,3,1,1,0,2,1,0.3333333333333333,0.6666666666666666,0.0,1.0
SF-N24-2,SF-C22,5,37,0,0,5,37,0.0,1.0,0.0,1.0
SF-N24-2,SF-B22,2,2,1,1,1,1,0.5,0.5,0.5,0.5
SF-N24-2,SF-E18,1,1,0,0,1,1,0.0,1.0,0.0,1.0
SF-N24-2,SF-E20,2,1,1,0,1,1,0.5,0.5,0.0,1.0
SF-N24-2,SF-H30,1,3,0,1,1,2,0.0,1.0,0.3333333333333333,0.6666666666666666
SF-N24-2,SF-F30-1,1,1,1,1,0,0,1.0,0.0,1.0,0.0
SF-N24-2,SF-E29-2,2,2,2,2,0,0,1.0,0.0,1.0,0.0
SF-N24-2,SF-E29-1,2,5,0,1,2,4,0.0,1.0,0.2,0.8
SF-N24-2,SF-G29-2,11,8,2,1,9,7,0.18181818181818182,0.8181818181818182,0.125,0.875
SF-N24-2,SF-G29-1,4,1,1,0,3,1,0.25,0.75,0.0,1.0
SF-N24-2,SF-G30-1,2,5,0,0,2,5,0.0,1.0,0.0,1.0
SF-N24-2,SF-E29-3,19,3,0,1,19,2,0.0,1.0,0.3333333333333333,0.6666666666666666
SF-N24-2,SF-J12,5,6,3,2,2,4,0.6,0.4,0.3333333333333333,0.6666666666666666
SF-N24-2,SF-C21,10,5,0,0,10,5,0.0,1.0,0.0,1.0
SF-N24-2,SF-C26,1,2,0,1,1,1,0.0,1.0,0.5,0.5
SF-N24-2,SF-C25,3,2,0,0,3,2,0.0,1.0,0.0,1.0
SF-N24-2,SF-B25,2,1,0,0,2,1,0.0,1.0,0.0,1.0
SF-N24-2,SF-D27,1,1,0,0,1,1,0.0,1.0,0.0,1.0
SF-N24-2,SF-H25,2,3,2,0,0,3,1.0,0.0,0.0,1.0
SF-N24-2,SF-G26,2,1,1,0,1,1,0.5,0.5,0.0,1.0
SF-N24-2,SF-K21,10,2,9,0,1,2,0.9,0.1,0.0,1.0
SF-N24-2,SF-K22-1,5,8,5,5,0,3,1.0,0.0,0.625,0.375
SF-N24-2,SF-J23-1,32,12,19,6,13,6,0.59375,0.40625,0.5,0.5
SF-N24-2,SF-J22-1,19,11,15,8,4,3,0.7894736842105263,0.21052631578947367,0.7272727272727273,0.2727272727272727
SF-N24-2,SF-J22-2,11,1,7,0,4,1,0.6363636363636364,0.36363636363636365,0.0,1.0
SF-N24-2,SF-J21,4,5,3,1,1,4,0.75,0.25,0.2,0.8
SF-N24-2,SF-I23-2,2,2,1,0,1,2,0.5,0.5,0.0,1.0
SF-N24-2,SF-I24,7,1,7,0,0,1,1.0,0.0,0.0,1.0
SF-N24-2,SF-I23-1,5,1,4,1,1,0,0.8,0.2,1.0,0.0
SF-N24-2,SF-F26,4,2,1,1,3,1,0.25,0.75,0.5,0.5
SF-N24-2,SF-M13,5,1,1,0,4,1,0.2,0.8,0.0,1.0
SF-N24-2,SF-M15,14,7,3,2,11,5,0.21428571428571427,0.7857142857142857,0.2857142857142857,0.7142857142857143
SF-N24-2,SF-L19,13,25,5,1,8,24,0.38461538461538464,0.6153846153846154,0.04,0.96
SF-N24-2,SF-L20,27,7,2,0,25,7,0.07407407407407407,0.9259259259259259,0.0,1.0
SF-N24-2,SF-N20-1,7,7,6,2,1,5,0.8571428571428571,0.14285714285714285,0.2857142857142857,0.7142857142857143
SF-N24-2,SF-M20,11,7,2,3,9,4,0.18181818181818182,0.8181818181818182,0.42857142857142855,0.5714285714285714
SF-N24-2,SF-K17-2,4,4,4,0,0,4,1.0,0.0,0.0,1.0
SF-N24-2,SF-K20,11,12,6,1,5,11,0.5454545454545454,0.45454545454545453,0.08333333333333333,0.9166666666666666
SF-N24-2,SF-K15-,7,9,2,2,5,7,0.2857142857142857,0.7142857142857143,0.2222222222222222,0.7777777777777778
SF-N24-2,SF-K19,14,12,4,3,10,9,0.2857142857142857,0.7142857142857143,0.25,0.75
SF-N24-2,SF-K18,9,14,3,3,6,11,0.3333333333333333,0.6666666666666666,0.21428571428571427,0.7857142857142857
SF-N24-2,SF-K17,6,4,4,1,2,3,0.6666666666666666,0.3333333333333333,0.25,0.75
SF-N24-2,SF-J16,2,4,0,0,2,4,0.0,1.0,0.0,1.0
SF-N24-2,SF-J18,15,4,3,0,12,4,0.2,0.8,0.0,1.0
SF-N24-2,SF-J19,3,6,2,0,1,6,0.6666666666666666,0.3333333333333333,0.0,1.0
SF-N24-2,SF-O12,2,5,0,0,2,5,0.0,1.0,0.0,1.0
SF-N24-2,SF-M12,7,7,1,0,6,7,0.14285714285714285,0.8571428571428571,0.0,1.0
SF-N24-2,SF-R19,5,2,0,0,5,2,0.0,1.0,0.0,1.0
SF-N24-2,SF-Q21-2,2,2,1,0,1,2,0.5,0.5,0.0,1.0
SF-N24-2,SF-Q21-1,28,5,22,0,6,5,0.7857142857142857,0.21428571428571427,0.0,1.0
SF-N24-2,SF-P21,8,6,3,0,5,6,0.375,0.625,0.0,1.0
SF-N24-2,SF-O18,5,5,3,0,2,5,0.6,0.4,0.0,1.0
SF-N24-2,SF-O19,7,12,2,4,5,8,0.2857142857142857,0.7142857142857143,0.3333333333333333,0.6666666666666666
SF-N24-2,SF-O21,30,27,20,8,10,19,0.6666666666666666,0.3333333333333333,0.2962962962962963,0.7037037037037037
SF-N24-2,SF-O22,9,15,7,8,2,7,0.7777777777777778,0.2222222222222222,0.5333333333333333,0.4666666666666667
SF-N24-2,SF-N21,19,19,9,11,10,8,0.47368421052631576,0.5263157894736842,0.5789473684210527,0.42105263157894735
SF-N24-2,SF-N20-2,8,32,1,2,7,30,0.125,0.875,0.0625,0.9375
SF-N24-2,SF-M21,9,5,3,0,6,5,0.3333333333333333,0.6666666666666666,0.0,1.0
SF-N24-2,SF-L21,11,14,1,1,10,13,0.09090909090909091,0.9090909090909091,0.07142857142857142,0.9285714285714286
SF-N24-2,SF-Q30,1,5,1,2,0,3,1.0,0.0,0.4,0.6
SF-N24-2,SF-P30,14,2,4,1,10,1,0.2857142857142857,0.7142857142857143,0.5,0.5
SF-N24-2,SF-O30-2,5,1,0,1,5,0,0.0,1.0,1.0,0.0
SF-N24-2,SF-O30,6,6,0,1,6,5,0.0,1.0,0.16666666666666666,0.8333333333333334
SF-N24-2,SF-N27,13,13,8,8,5,5,0.6153846153846154,0.38461538461538464,0.6153846153846154,0.38461538461538464
SF-N24-2,SF-N29,7,10,0,5,7,5,0.0,1.0,0.5,0.5
SF-N24-2,SF-N28,11,10,6,1,5,9,0.5454545454545454,0.45454545454545453,0.1,0.9
SF-N24-2,SF-L30-1,7,5,2,1,5,4,0.2857142857142857,0.7142857142857143,0.2,0.8
SF-N24-2,SF-L31-1,1,1,1,1,0,0,1.0,0.0,1.0,0.0
SF-N24-2,SF-K30-2,1,3,0,0,1,3,0.0,1.0,0.0,1.0
SF-N24-2,SF-L29,15,6,7,0,8,6,0.4666666666666667,0.5333333333333333,0.0,1.0
SF-N24-2,SF-I27,5,3,3,1,2,2,0.6,0.4,0.3333333333333333,0.6666666666666666
SF-N24-2,SF-I28,1,1,0,0,1,1,0.0,1.0,0.0,1.0
SF-N24-2,SF-I30-2,2,6,2,4,0,2,1.0,0.0,0.6666666666666666,0.3333333333333333
SF-N24-2,SF-H28,37,20,27,20,10,0,0.7297297297297297,0.2702702702702703,1.0,0.0
SF-N24-2,SF-S24,18,37,9,25,9,12,0.5,0.5,0.6756756756756757,0.32432432432432434
SF-N24-2,SF-R24,76,112,39,56,37,56,0.5131578947368421,0.4868421052631579,0.5,0.5
SF-N24-2,SF-Q26,20,17,3,8,17,9,0.15,0.85,0.47058823529411764,0.5294117647058824
SF-N24-2,SF-P26,38,15,17,4,21,11,0.4473684210526316,0.5526315789473685,0.26666666666666666,0.7333333333333333
SF-N24-2,SF-O25-2,16,29,12,11,4,18,0.75,0.25,0.3793103448275862,0.6206896551724138
SF-N24-2,SF-N22-1B,19,16,9,5,10,11,0.47368421052631576,0.5263157894736842,0.3125,0.6875
SF-N24-2,SF-N26,19,11,12,1,7,10,0.631578947368421,0.3684210526315789,0.09090909090909091,0.9090909090909091
SF-N24-2,SF-N25,16,11,11,8,5,3,0.6875,0.3125,0.7272727272727273,0.2727272727272727
SF-N24-2,SF-T22,8,6,5,4,3,2,0.625,0.375,0.6666666666666666,0.3333333333333333
SF-N24-2,SF-S22-1,3,4,1,1,2,3,0.3333333333333333,0.6666666666666666,0.25,0.75
SF-N24-2,SF-Q23-3,7,12,5,5,2,7,0.7142857142857143,0.2857142857142857,0.4166666666666667,0.5833333333333334
SF-N24-2,SF-Q22-1,9,14,6,7,3,7,0.6666666666666666,0.3333333333333333,0.5,0.5
SF-N24-2,SF-Q22-2,43,42,38,39,5,3,0.8837209302325582,0.11627906976744186,0.9285714285714286,0.07142857142857142
SF-N24-2,SF-P22,16,14,12,9,4,5,0.75,0.25,0.6428571428571429,0.35714285714285715
SF-N24-2,SF-W19,1,3,0,2,1,1,0.0,1.0,0.6666666666666666,0.3333333333333333
SF-N24-2,SF-U21,1,1,1,0,0,1,1.0,0.0,0.0,1.0
SF-N24-2,SF-T20,5,4,1,2,4,2,0.2,0.8,0.5,0.5
SF-N24-2,SF-S21,4,1,3,1,1,0,0.75,0.25,1.0,0.0
SF-N24-2,SF-W14,18,12,14,0,4,12,0.7777777777777778,0.2222222222222222,0.0,1.0
SF-K27-2,SF-M26,5,9,5,7,0,2,1.0,0.0,0.7777777777777778,0.2222222222222222
SF-K27-2,SF-M25,43,42,34,28,9,14,0.7906976744186046,0.20930232558139536,0.6666666666666666,0.3333333333333333
SF-K27-2,SF-M26-2,3,5,3,5,0,0,1.0,0.0,1.0,0.0
SF-K27-2,SF-L27,5,12,4,9,1,3,0.8,0.2,0.75,0.25
SF-K27-2,SF-K26,23,30,19,21,4,9,0.8260869565217391,0.17391304347826086,0.7,0.3
SF-K27-2,SF-J27,24,22,21,17,3,5,0.875,0.125,0.7727272727272727,0.22727272727272727
SF-K27-2,SF-M30,40,36,14,15,26,21,0.35,0.65,0.4166666666666667,0.5833333333333334
SF-K27-2,SF-L27-2,8,10,8,9,0,1,1.0,0.0,0.9,0.1
SF-K27-2,SF-J29-3,56,27,39,20,17,7,0.6964285714285714,0.30357142857142855,0.7407407407407407,0.25925925925925924
SF-K27-2,SF-J29,62,64,42,53,20,11,0.6774193548387096,0.3225806451612903,0.828125,0.171875
SF-K27-2,SF-L26,3,3,0,2,3,1,0.0,1.0,0.6666666666666666,0.3333333333333333
SF-K27-2,SF-M28,17,26,11,16,6,10,0.6470588235294118,0.35294117647058826,0.6153846153846154,0.38461538461538464
SF-K27-2,SF-L25,18,14,15,11,3,3,0.8333333333333334,0.16666666666666666,0.7857142857142857,0.21428571428571427
SF-K27-2,SF-M24,10,20,5,14,5,6,0.5,0.5,0.7,0.3
SF-K27-2,SF-L24,7,15,0,12,7,3,0.0,1.0,0.8,0.2
SF-K27-2,SF-N23,7,7,2,3,5,4,0.2857142857142857,0.7142857142857143,0.42857142857142855,0.5714285714285714
SF-K27-2,SF-N24-2,1,2,0,0,1,2,0.0,1.0,0.0,1.0
SF-K27-2,SF-J26-2,11,20,1,12,10,8,0.09090909090909091,0.9090909090909091,0.6,0.4
SF-K27-2,SF-K28-3,3,2,2,2,1,0,0.6666666666666666,0.3333333333333333,1.0,0.0
SF-K27-2,SF-L28,43,34,27,23,16,11,0.627906976744186,0.37209302325581395,0.6764705882352942,0.3235294117647059
SF-K27-2,SF-K28,10,11,8,9,2,2,0.8,0.2,0.8181818181818182,0.18181818181818182
SF-K27-2,SF-K29-1,28,31,23,22,5,9,0.8214285714285714,0.17857142857142858,0.7096774193548387,0.2903225806451613
SF-K27-2,SF-J28-2,42,50,18,33,24,17,0.42857142857142855,0.5714285714285714,0.66,0.34
SF-K27-2,SF-K27,4,12,4,10,0,2,1.0,0.0,0.8333333333333334,0.16666666666666666
SF-K27-2,SF-K25,12,11,12,9,0,2,1.0,0.0,0.8181818181818182,0.18181818181818182
SF-K27-2,SF-J25,36,22,27,13,9,9,0.75,0.25,0.5909090909090909,0.4090909090909091
SF-K27-2,SF-H26-2,14,15,6,9,8,6,0.42857142857142855,0.5714285714285714,0.6,0.4
SF-K27-2,SF-P24,7,13,3,6,4,7,0.42857142857142855,0.5714285714285714,0.46153846153846156,0.5384615384615384
SF-K27-2,SF-J24,27,13,20,5,7,8,0.7407407407407407,0.25925925925925924,0.38461538461538464,0.6153846153846154
SF-K27-2,SF-O24,16,15,13,15,3,0,0.8125,0.1875,1.0,0.0
SF-K27-2,SF-J26,4,6,1,4,3,2,0.25,0.75,0.6666666666666666,0.3333333333333333
SF-K27-2,SF-I26-,8,7,1,4,7,3,0.125,0.875,0.5714285714285714,0.42857142857142855
SF-K27-2,SF-I25,21,28,10,14,11,14,0.47619047619047616,0.5238095238095238,0.5,0.5
SF-K27-2,SF-K23,1,3,1,3,0,0,1.0,0.0,1.0,0.0
SF-K27-2,SF-H26,20,24,11,16,9,8,0.55,0.45,0.6666666666666666,0.3333333333333333
SF-K27-2,SF-O23,12,14,4,2,8,12,0.3333333333333333,0.6666666666666666,0.14285714285714285,0.8571428571428571
SF-K27-2,SF-H27-1,10,17,6,8,4,9,0.6,0.4,0.47058823529411764,0.5294117647058824
SF-K27-2,SF-F28-2,12,15,4,4,8,11,0.3333333333333333,0.6666666666666666,0.26666666666666666,0.7333333333333333
SF-K27-2,SF-G27,22,41,12,22,10,19,0.5454545454545454,0.45454545454545453,0.5365853658536586,0.4634146341463415
SF-K27-2,SF-M22-2,12,16,5,7,7,9,0.4166666666666667,0.5833333333333334,0.4375,0.5625
SF-K27-2,SF-L22,21,13,8,4,13,9,0.38095238095238093,0.6190476190476191,0.3076923076923077,0.6923076923076923
SF-K27-2,SF-F27,14,17,8,4,6,13,0.5714285714285714,0.42857142857142855,0.23529411764705882,0.7647058823529411
SF-K27-2,SF-N22-2,24,38,6,17,18,21,0.25,0.75,0.4473684210526316,0.5526315789473685
SF-K27-2,SF-G28-1,4,8,2,4,2,4,0.5,0.5,0.5,0.5
SF-K27-2,SF-M22-1,19,20,7,5,12,15,0.3684210526315789,0.631578947368421,0.25,0.75
SF-K27-2,SF-O25-1,1,4,0,3,1,1,0.0,1.0,0.75,0.25
SF-K27-2,SF-K22-2,9,10,4,7,5,3,0.4444444444444444,0.5555555555555556,0.7,0.3
SF-K27-2,SF-K24,15,11,5,7,10,4,0.3333333333333333,0.6666666666666666,0.6363636363636364,0.36363636363636365
SF-K27-2,SF-J23-2,9,10,3,5,6,5,0.3333333333333333,0.6666666666666666,0.5,0.5
SF-K27-2,SF-G23,8,10,4,1,4,9,0.5,0.5,0.1,0.9
SF-K27-2,SF-G24,11,15,5,1,6,14,0.45454545454545453,0.5454545454545454,0.06666666666666667,0.9333333333333333
SF-K27-2,SF-G25,17,5,6,2,11,3,0.35294117647058826,0.6470588235294118,0.4,0.6
SF-K27-2,SF-F23,8,11,1,2,7,9,0.125,0.875,0.18181818181818182,0.8181818181818182
SF-K27-2,SF-E23,10,11,4,3,6,8,0.4,0.6,0.2727272727272727,0.7272727272727273
SF-K27-2,SF-C22,1,1,0,0,1,1,0.0,1.0,0.0,1.0
SF-K27-2,SF-B22,1,4,1,4,0,0,1.0,0.0,1.0,0.0
SF-K27-2,SF-J17,37,17,8,2,29,15,0.21621621621621623,0.7837837837837838,0.11764705882352941,0.8823529411764706
SF-K27-2,SF-I19,2,7,0,1,2,6,0.0,1.0,0.14285714285714285,0.8571428571428571
SF-K27-2,SF-I20,4,2,1,1,3,1,0.25,0.75,0.5,0.5
SF-K27-2,SF-H16,3,1,0,0,3,1,0.0,1.0,0.0,1.0
SF-K27-2,SF-H20,6,12,2,5,4,7,0.3333333333333333,0.6666666666666666,0.4166666666666667,0.5833333333333334
SF-K27-2,SF-G19,9,6,4,1,5,5,0.4444444444444444,0.5555555555555556,0.16666666666666666,0.8333333333333334
SF-K27-2,SF-G18,6,3,1,2,5,1,0.16666666666666666,0.8333333333333334,0.6666666666666666,0.3333333333333333
SF-K27-2,SF-G20,10,6,1,1,9,5,0.1,0.9,0.16666666666666666,0.8333333333333334
SF-K27-2,SF-F19,1,1,1,0,0,1,1.0,0.0,0.0,1.0
SF-K27-2,SF-E18,3,1,1,0,2,1,0.3333333333333333,0.6666666666666666,0.0,1.0
SF-K27-2,SF-H30,17,9,8,8,9,1,0.47058823529411764,0.5294117647058824,0.8888888888888888,0.1111111111111111
SF-K27-2,SF-G30-2,39,42,22,24,17,18,0.5641025641025641,0.4358974358974359,0.5714285714285714,0.42857142857142855
SF-K27-2,SF-F30-1,8,4,7,4,1,0,0.875,0.125,1.0,0.0
SF-K27-2,SF-E29-2,7,12,6,9,1,3,0.8571428571428571,0.14285714285714285,0.75,0.25
SF-K27-2,SF-E29-1,14,28,14,21,0,7,1.0,0.0,0.75,0.25
SF-K27-2,SF-D29,10,26,9,22,1,4,0.9,0.1,0.8461538461538461,0.15384615384615385
SF-K27-2,SF-D28,3,5,2,1,1,4,0.6666666666666666,0.3333333333333333,0.2,0.8
SF-K27-2,SF-A27,6,5,4,2,2,3,0.6666666666666666,0.3333333333333333,0.4,0.6
SF-K27-2,SF-G29-2,12,12,6,7,6,5,0.5,0.5,0.5833333333333334,0.4166666666666667
SF-K27-2,SF-G29-1,9,18,3,12,6,6,0.3333333333333333,0.6666666666666666,0.6666666666666666,0.3333333333333333
SF-K27-2,SF-G30-1,19,18,11,13,8,5,0.5789473684210527,0.42105263157894735,0.7222222222222222,0.2777777777777778
SF-K27-2,SF-G29-3,8,3,6,1,2,2,0.75,0.25,0.3333333333333333,0.6666666666666666
SF-K27-2,SF-F30-2,10,10,5,4,5,6,0.5,0.5,0.4,0.6
SF-K27-2,SF-F29,3,2,3,1,0,1,1.0,0.0,0.5,0.5
SF-K27-2,SF-F28-1,1,3,0,0,1,3,0.0,1.0,0.0,1.0
SF-K27-2,SF-E28-2,1,2,1,2,0,0,1.0,0.0,1.0,0.0
SF-K27-2,SF-E28,5,6,2,2,3,4,0.4,0.6,0.3333333333333333,0.6666666666666666
SF-K27-2,SF-J12,3,6,0,1,3,5,0.0,1.0,0.16666666666666666,0.8333333333333334
SF-K27-2,SF-H13,1,1,0,0,1,1,0.0,1.0,0.0,1.0
SF-K27-2,SF-H12,1,1,0,1,1,0,0.0,1.0,1.0,0.0
SF-K27-2,SF-G13,1,1,0,0,1,1,0.0,1.0,0.0,1.0
SF-K27-2,SF-G11,1,1,0,0,1,1,0.0,1.0,0.0,1.0
SF-K27-2,SF-C20,1,2,0,2,1,0,0.0,1.0,1.0,0.0
SF-K27-2,SF-B21,1,2,0,1,1,1,0.0,1.0,0.5,0.5
SF-K27-2,SF-B19,1,6,0,6,1,0,0.0,1.0,1.0,0.0
SF-K27-2,SF-A20,6,10,1,6,5,4,0.16666666666666666,0.8333333333333334,0.6,0.4
SF-K27-2,SF-A19,3,2,0,2,3,0,0.0,1.0,1.0,0.0
SF-K27-2,SF-C26,8,6,6,4,2,2,0.75,0.25,0.6666666666666666,0.3333333333333333
SF-K27-2,SF-C25,12,13,3,3,9,10,0.25,0.75,0.23076923076923078,0.7692307692307693
SF-K27-2,SF-B25,12,6,3,2,9,4,0.25,0.75,0.3333333333333333,0.6666666666666666
SF-K27-2,SF-E27,4,1,2,0,2,1,0.5,0.5,0.0,1.0
SF-K27-2,SF-D27,5,19,3,14,2,5,0.6,0.4,0.7368421052631579,0.2631578947368421
SF-K27-2,SF-C28-2,3,4,0,3,3,1,0.0,1.0,0.75,0.25
SF-K27-2,SF-C28-1,1,1,1,1,0,0,1.0,0.0,1.0,0.0
SF-K27-2,SF-B28,27,28,24,26,3,2,0.8888888888888888,0.1111111111111111,0.9285714285714286,0.07142857142857142
SF-K27-2,SF-J1,1,2,0,2,1,0,0.0,1.0,1.0,0.0
SF-K27-2,SF-H25,1,5,1,2,0,3,1.0,0.0,0.4,0.6
SF-K27-2,SF-G26,8,9,2,7,6,2,0.25,0.75,0.7777777777777778,0.2222222222222222
SF-K27-2,SF-K21,12,13,3,0,9,13,0.25,0.75,0.0,1.0
SF-K27-2,SF-K22-1,3,10,0,8,3,2,0.0,1.0,0.8,0.2
SF-K27-2,SF-J23-1,47,34,28,12,19,22,0.5957446808510638,0.40425531914893614,0.35294117647058826,0.6470588235294118
SF-K27-2,SF-J22-1,17,21,3,3,14,18,0.17647058823529413,0.8235294117647058,0.14285714285714285,0.8571428571428571
SF-K27-2,SF-J22-2,14,20,9,11,5,9,0.6428571428571429,0.35714285714285715,0.55,0.45
SF-K27-2,SF-J21,29,23,16,7,13,16,0.5517241379310345,0.4482758620689655,0.30434782608695654,0.6956521739130435
SF-K27-2,SF-I22,6,9,3,5,3,4,0.5,0.5,0.5555555555555556,0.4444444444444444
SF-K27-2,SF-I23-2,5,8,2,3,3,5,0.4,0.6,0.375,0.625
SF-K27-2,SF-I24,3,9,1,8,2,1,0.3333333333333333,0.6666666666666666,0.8888888888888888,0.1111111111111111
SF-K27-2,SF-I23-1,8,10,4,5,4,5,0.5,0.5,0.5,0.5
SF-K27-2,SF-F26,15,15,10,9,5,6,0.6666666666666666,0.3333333333333333,0.6,0.4
SF-K27-2,SF-M13,3,1,0,0,3,1,0.0,1.0,0.0,1.0
SF-K27-2,SF-M15,15,7,3,1,12,6,0.2,0.8,0.14285714285714285,0.8571428571428571
SF-K27-2,SF-L19,6,8,2,3,4,5,0.3333333333333333,0.6666666666666666,0.375,0.625
SF-K27-2,SF-L20,11,27,2,5,9,22,0.18181818181818182,0.8181818181818182,0.18518518518518517,0.8148148148148148
SF-K27-2,SF-N20-1,10,9,0,0,10,9,0.0,1.0,0.0,1.0
SF-K27-2,SF-M20,16,9,6,2,10,7,0.375,0.625,0.2222222222222222,0.7777777777777778
SF-K27-2,SF-K17-2,3,1,0,0,3,1,0.0,1.0,0.0,1.0
SF-K27-2,SF-K20,14,14,5,3,9,11,0.35714285714285715,0.6428571428571429,0.21428571428571427,0.7857142857142857
SF-K27-2,SF-K15-,9,30,4,6,5,24,0.4444444444444444,0.5555555555555556,0.2,0.8
SF-K27-2,SF-K19,12,4,2,3,10,1,0.16666666666666666,0.8333333333333334,0.75,0.25
SF-K27-2,SF-K18,8,17,4,0,4,17,0.5,0.5,0.0,1.0
SF-K27-2,SF-K17,4,12,2,4,2,8,0.5,0.5,0.3333333333333333,0.6666666666666666
SF-K27-2,SF-J16,1,2,0,0,1,2,0.0,1.0,0.0,1.0
SF-K27-2,SF-J18,11,9,1,0,10,9,0.09090909090909091,0.9090909090909091,0.0,1.0
SF-K27-2,SF-J20,7,3,6,1,1,2,0.8571428571428571,0.14285714285714285,0.3333333333333333,0.6666666666666666
SF-K27-2,SF-J19,8,25,4,8,4,17,0.5,0.5,0.32,0.68
SF-K27-2,SF-M12,1,2,1,0,0,2,1.0,0.0,0.0,1.0
SF-K27-2,SF-M10,1,2,1,0,0,2,1.0,0.0,0.0,1.0
SF-K27-2,SF-M11,5,2,3,2,2,0,0.6,0.4,1.0,0.0
SF-K27-2,SF-R20,4,2,0,0,4,2,0.0,1.0,0.0,1.0
SF-K27-2,SF-Q21-2,14,5,1,0,13,5,0.07142857142857142,0.9285714285714286,0.0,1.0
SF-K27-2,SF-Q21-1,4,4,3,3,1,1,0.75,0.25,0.75,0.25
SF-K27-2,SF-O18,12,13,2,2,10,11,0.16666666666666666,0.8333333333333334,0.15384615384615385,0.8461538461538461
SF-K27-2,SF-O19,18,11,1,1,17,10,0.05555555555555555,0.9444444444444444,0.09090909090909091,0.9090909090909091
SF-K27-2,SF-O21,25,22,11,12,14,10,0.44,0.56,0.5454545454545454,0.45454545454545453
SF-K27-2,SF-O22,20,15,9,10,11,5,0.45,0.55,0.6666666666666666,0.3333333333333333
SF-K27-2,SF-N21,9,14,5,3,4,11,0.5555555555555556,0.4444444444444444,0.21428571428571427,0.7857142857142857
SF-K27-2,SF-N20-2,7,8,1,2,6,6,0.14285714285714285,0.8571428571428571,0.25,0.75
SF-K27-2,SF-M21,10,11,3,5,7,6,0.3,0.7,0.45454545454545453,0.5454545454545454
SF-K27-2,SF-L21,10,11,5,5,5,6,0.5,0.5,0.45454545454545453,0.5454545454545454
SF-K27-2,SF-S29,13,3,12,0,1,3,0.9230769230769231,0.07692307692307693,0.0,1.0
SF-K27-2,SF-S30,3,2,3,2,0,0,1.0,0.0,1.0,0.0
SF-K27-2,SF-Q30,10,10,5,5,5,5,0.5,0.5,0.5,0.5
SF-K27-2,SF-P30,12,13,7,8,5,5,0.5833333333333334,0.4166666666666667,0.6153846153846154,0.38461538461538464
SF-K27-2,SF-O30-2,12,8,7,5,5,3,0.5833333333333334,0.4166666666666667,0.625,0.375
SF-K27-2,SF-O30,19,31,9,22,10,9,0.47368421052631576,0.5263157894736842,0.7096774193548387,0.2903225806451613
SF-K27-2,SF-N27,24,23,14,15,10,8,0.5833333333333334,0.4166666666666667,0.6521739130434783,0.34782608695652173
SF-K27-2,SF-N29,10,14,8,11,2,3,0.8,0.2,0.7857142857142857,0.21428571428571427
SF-K27-2,SF-N28,30,20,12,8,18,12,0.4,0.6,0.4,0.6
SF-K27-2,SF-L30-1,27,83,19,37,8,46,0.7037037037037037,0.2962962962962963,0.4457831325301205,0.5542168674698795
SF-K27-2,SF-L31-1,3,9,0,3,3,6,0.0,1.0,0.3333333333333333,0.6666666666666666
SF-K27-2,SF-K30-2,5,8,4,7,1,1,0.8,0.2,0.875,0.125
SF-K27-2,SF-L29,41,34,29,25,12,9,0.7073170731707317,0.2926829268292683,0.7352941176470589,0.2647058823529412
SF-K27-2,SF-J29-1,27,12,17,9,10,3,0.6296296296296297,0.37037037037037035,0.75,0.25
SF-K27-2,SF-I30,11,13,9,10,2,3,0.8181818181818182,0.18181818181818182,0.7692307692307693,0.23076923076923078
SF-K27-2,SF-I29-2,9,20,4,11,5,9,0.4444444444444444,0.5555555555555556,0.55,0.45
SF-K27-2,SF-I27,10,41,6,31,4,10,0.6,0.4,0.7560975609756098,0.24390243902439024
SF-K27-2,SF-I28,15,11,11,7,4,4,0.7333333333333333,0.26666666666666666,0.6363636363636364,0.36363636363636365
SF-K27-2,SF-I30-2,22,25,9,11,13,14,0.4090909090909091,0.5909090909090909,0.44,0.56
SF-K27-2,SF I29-1,7,11,3,4,4,7,0.42857142857142855,0.5714285714285714,0.36363636363636365,0.6363636363636364
SF-K27-2,SF-H28,10,31,7,28,3,3,0.7,0.3,0.9032258064516129,0.0967741935483871
SF-K27-2,SF-H29,2,3,2,1,0,2,1.0,0.0,0.3333333333333333,0.6666666666666666
SF-K27-2,SF-S24,9,7,5,5,4,2,0.5555555555555556,0.4444444444444444,0.7142857142857143,0.2857142857142857
SF-K27-2,SF-R24,16,28,5,11,11,17,0.3125,0.6875,0.39285714285714285,0.6071428571428571
SF-K27-2,SF-R26,5,8,1,1,4,7,0.2,0.8,0.125,0.875
SF-K27-2,SF-Q26,10,2,3,1,7,1,0.3,0.7,0.5,0.5
SF-K27-2,SF-P26,18,11,9,2,9,9,0.5,0.5,0.18181818181818182,0.8181818181818182
SF-K27-2,SF-O25-2,11,7,4,3,7,4,0.36363636363636365,0.6363636363636364,0.42857142857142855,0.5714285714285714
SF-K27-2,SF-N22-1B,1,4,0,2,1,2,0.0,1.0,0.5,0.5
SF-K27-2,SF-N26,4,6,2,4,2,2,0.5,0.5,0.6666666666666666,0.3333333333333333
SF-K27-2,SF-N25,4,7,3,3,1,4,0.75,0.25,0.42857142857142855,0.5714285714285714
SF-K27-2,SF-T22,1,10,0,2,1,8,0.0,1.0,0.2,0.8
SF-K27-2,SF-S22-2,2,1,0,0,2,1,0.0,1.0,0.0,1.0
SF-K27-2,SF-S22-1,9,3,4,2,5,1,0.4444444444444444,0.5555555555555556,0.6666666666666666,0.3333333333333333
SF-K27-2,SF-Q23-3,9,3,2,0,7,3,0.2222222222222222,0.7777777777777778,0.0,1.0
SF-K27-2,SF-Q22-1,10,8,4,4,6,4,0.4,0.6,0.5,0.5
SF-K27-2,SF-Q22-2,15,13,8,9,7,4,0.5333333333333333,0.4666666666666667,0.6923076923076923,0.3076923076923077
SF-K27-2,SF-P22,30,37,4,29,26,8,0.13333333333333333,0.8666666666666667,0.7837837837837838,0.21621621621621623
SF-K27-2,SF-T20,1,1,0,0,1,1,0.0,1.0,0.0,1.0
SF-K27-2,SF-S21,3,4,0,1,3,3,0.0,1.0,0.25,0.75
SF-K27-2,SF-V32,6,4,5,4,1,0,0.8333333333333334,0.16666666666666666,1.0,0.0
SF-J26-2,SF-M25,16,9,10,4,6,5,0.625,0.375,0.4444444444444444,0.5555555555555556
SF-J26-2,SF-M26-2,19,4,2,0,17,4,0.10526315789473684,0.8947368421052632,0.0,1.0
SF-J26-2,SF-L27,9,4,4,1,5,3,0.4444444444444444,0.5555555555555556,0.25,0.75
SF-J26-2,SF-K26,17,18,11,13,6,5,0.6470588235294118,0.35294117647058826,0.7222222222222222,0.2777777777777778
SF-J26-2,SF-J27,13,7,9,2,4,5,0.6923076923076923,0.3076923076923077,0.2857142857142857,0.7142857142857143
SF-J26-2,SF-M30,71,14,33,7,38,7,0.4647887323943662,0.5352112676056338,0.5,0.5
SF-J26-2,SF-L27-2,32,9,22,3,10,6,0.6875,0.3125,0.3333333333333333,0.6666666666666666
SF-J26-2,SF-J29-3,12,8,6,4,6,4,0.5,0.5,0.5,0.5
SF-J26-2,SF-J29,61,32,33,16,28,16,0.5409836065573771,0.45901639344262296,0.5,0.5
SF-J26-2,SF-L26,36,48,33,39,3,9,0.9166666666666666,0.08333333333333333,0.8125,0.1875
SF-J26-2,SF-M28,92,8,28,1,64,7,0.30434782608695654,0.6956521739130435,0.125,0.875
SF-J26-2,SF-L25,9,9,6,7,3,2,0.6666666666666666,0.3333333333333333,0.7777777777777778,0.2222222222222222
SF-J26-2,SF-M24,16,14,8,6,8,8,0.5,0.5,0.42857142857142855,0.5714285714285714
SF-J26-2,SF-L24,83,48,49,32,34,16,0.5903614457831325,0.40963855421686746,0.6666666666666666,0.3333333333333333
SF-J26-2,SF-N23,14,3,7,2,7,1,0.5,0.5,0.6666666666666666,0.3333333333333333
SF-J26-2,SF-N24-2,9,6,3,3,6,3,0.3333333333333333,0.6666666666666666,0.5,0.5
SF-J26-2,SF-K27-2,20,11,12,1,8,10,0.6,0.4,0.09090909090909091,0.9090909090909091
SF-J26-2,SF-L28,14,13,7,8,7,5,0.5,0.5,0.6153846153846154,0.38461538461538464
SF-J26-2,SF-K28,13,9,10,6,3,3,0.7692307692307693,0.23076923076923078,0.6666666666666666,0.3333333333333333
SF-J26-2,SF-K29-1,48,13,18,10,30,3,0.375,0.625,0.7692307692307693,0.23076923076923078
SF-J26-2,SF-J28-2,30,31,14,11,16,20,0.4666666666666667,0.5333333333333333,0.3548387096774194,0.6451612903225806
SF-J26-2,SF-K27,16,7,14,3,2,4,0.875,0.125,0.42857142857142855,0.5714285714285714
SF-J26-2,SF-K25,68,27,61,15,7,12,0.8970588235294118,0.10294117647058823,0.5555555555555556,0.4444444444444444
SF-J26-2,SF-J25,103,64,88,39,15,25,0.8543689320388349,0.14563106796116504,0.609375,0.390625
SF-J26-2,SF-H26-2,53,39,9,7,44,32,0.16981132075471697,0.8301886792452831,0.1794871794871795,0.8205128205128205
SF-J26-2,SF-P24,20,5,4,4,16,1,0.2,0.8,0.8,0.2
SF-J26-2,SF-J24,52,40,44,31,8,9,0.8461538461538461,0.15384615384615385,0.775,0.225
SF-J26-2,SF-O24,19,13,6,1,13,12,0.3157894736842105,0.6842105263157895,0.07692307692307693,0.9230769230769231
SF-J26-2,SF-J26,21,37,11,27,10,10,0.5238095238095238,0.47619047619047616,0.7297297297297297,0.2702702702702703
SF-J26-2,SF-I26-,9,8,7,2,2,6,0.7777777777777778,0.2222222222222222,0.25,0.75
SF-J26-2,SF-I25,25,38,14,24,11,14,0.56,0.44,0.631578947368421,0.3684210526315789
SF-J26-2,SF-H26,18,37,11,21,7,16,0.6111111111111112,0.3888888888888889,0.5675675675675675,0.43243243243243246
SF-J26-2,SF-O23,15,4,3,1,12,3,0.2,0.8,0.25,0.75
SF-J26-2,SF-H27-1,14,18,9,11,5,7,0.6428571428571429,0.35714285714285715,0.6111111111111112,0.3888888888888889
SF-J26-2,SF-F28-2,9,24,4,6,5,18,0.4444444444444444,0.5555555555555556,0.25,0.75
SF-J26-2,SF-G27,45,70,20,28,25,42,0.4444444444444444,0.5555555555555556,0.4,0.6
SF-J26-2,SF-M22-2,23,34,9,11,14,23,0.391304347826087,0.6086956521739131,0.3235294117647059,0.6764705882352942
SF-J26-2,SF-L22,10,8,1,5,9,3,0.1,0.9,0.625,0.375
SF-J26-2,SF-F27,26,31,10,11,16,20,0.38461538461538464,0.6153846153846154,0.3548387096774194,0.6451612903225806
SF-J26-2,SF-N22-2,27,12,9,2,18,10,0.3333333333333333,0.6666666666666666,0.16666666666666666,0.8333333333333334
SF-J26-2,SF-G28-2,4,4,1,2,3,2,0.25,0.75,0.5,0.5
SF-J26-2,SF-G28-1,11,12,8,8,3,4,0.7272727272727273,0.2727272727272727,0.6666666666666666,0.3333333333333333
SF-J26-2,SF-M22-1,16,7,8,5,8,2,0.5,0.5,0.7142857142857143,0.2857142857142857
SF-J26-2,SF-O25-1,52,28,2,2,50,26,0.038461538461538464,0.9615384615384616,0.07142857142857142,0.9285714285714286
SF-J26-2,SF-K22-2,6,9,3,6,3,3,0.5,0.5,0.6666666666666666,0.3333333333333333
SF-J26-2,SF-K24,8,10,7,6,1,4,0.875,0.125,0.6,0.4
SF-J26-2,SF-J23-2,5,8,5,4,0,4,1.0,0.0,0.5,0.5
SF-J26-2,SF-G23,8,8,3,0,5,8,0.375,0.625,0.0,1.0
SF-J26-2,SF-G24,15,12,5,3,10,9,0.3333333333333333,0.6666666666666666,0.25,0.75
SF-J26-2,SF-G25,6,7,4,3,2,4,0.6666666666666666,0.3333333333333333,0.42857142857142855,0.5714285714285714
SF-J26-2,SF-F23,24,32,5,4,19,28,0.20833333333333334,0.7916666666666666,0.125,0.875
SF-J26-2,SF-E23,12,21,3,6,9,15,0.25,0.75,0.2857142857142857,0.7142857142857143
SF-J26-2,SF-D24,3,1,3,0,0,1,1.0,0.0,0.0,1.0
SF-J26-2,SF-C22,4,5,1,0,3,5,0.25,0.75,0.0,1.0
SF-J26-2,SF-B22,2,6,2,4,0,2,1.0,0.0,0.6666666666666666,0.3333333333333333
SF-J26-2,SF-J17,20,12,19,9,1,3,0.95,0.05,0.75,0.25
SF-J26-2,SF-I19,1,2,0,2,1,0,0.0,1.0,1.0,0.0
SF-J26-2,SF-I20,24,10,1,5,23,5,0.041666666666666664,0.9583333333333334,0.5,0.5
SF-J26-2,SF-H16,1,1,1,0,0,1,1.0,0.0,0.0,1.0
SF-J26-2,SF-H20,13,7,10,5,3,2,0.7692307692307693,0.23076923076923078,0.7142857142857143,0.2857142857142857
SF-J26-2,SF-G19,3,4,1,0,2,4,0.3333333333333333,0.6666666666666666,0.0,1.0
SF-J26-2,SF-G17,1,2,0,0,1,2,0.0,1.0,0.0,1.0
SF-J26-2,SF-G18,4,9,1,2,3,7,0.25,0.75,0.2222222222222222,0.7777777777777778
SF-J26-2,SF-G20,8,7,6,2,2,5,0.75,0.25,0.2857142857142857,0.7142857142857143
SF-J26-2,SF-F19,3,4,1,1,2,3,0.3333333333333333,0.6666666666666666,0.25,0.75
SF-J26-2,SF-E18,99,91,87,62,12,29,0.8787878787878788,0.12121212121212122,0.6813186813186813,0.31868131868131866
SF-J26-2,SF-E20,15,7,4,1,11,6,0.26666666666666666,0.7333333333333333,0.14285714285714285,0.8571428571428571
SF-J26-2,SF-H30,62,62,58,62,4,0,0.9354838709677419,0.06451612903225806,1.0,0.0
SF-J26-2,SF-G30-2,6,16,3,6,3,10,0.5,0.5,0.375,0.625
SF-J26-2,SF-F30-1,2,13,2,9,0,4,1.0,0.0,0.6923076923076923,0.3076923076923077
SF-J26-2,SF-E29-2,9,18,5,11,4,7,0.5555555555555556,0.4444444444444444,0.6111111111111112,0.3888888888888889
SF-J26-2,SF-E29-1,15,43,7,18,8,25,0.4666666666666667,0.5333333333333333,0.4186046511627907,0.5813953488372093
SF-J26-2,SF-D29,43,25,42,14,1,11,0.9767441860465116,0.023255813953488372,0.56,0.44
SF-J26-2,SF-D28,5,8,4,6,1,2,0.8,0.2,0.75,0.25
SF-J26-2,SF-A27,7,18,4,9,3,9,0.5714285714285714,0.42857142857142855,0.5,0.5
SF-J26-2,SF-G29-2,25,51,11,23,14,28,0.44,0.56,0.45098039215686275,0.5490196078431373
SF-J26-2,SF-G29-1,27,38,5,12,22,26,0.18518518518518517,0.8148148148148148,0.3157894736842105,0.6842105263157895
SF-J26-2,SF-G30-1,4,10,1,4,3,6,0.25,0.75,0.4,0.6
SF-J26-2,SF-G29-3,9,21,4,1,5,20,0.4444444444444444,0.5555555555555556,0.047619047619047616,0.9523809523809523
SF-J26-2,SF-F30-2,3,15,3,9,0,6,1.0,0.0,0.6,0.4
SF-J26-2,SF-F29,12,22,5,7,7,15,0.4166666666666667,0.5833333333333334,0.3181818181818182,0.6818181818181818
SF-J26-2,SF-F28-1,2,7,1,1,1,6,0.5,0.5,0.14285714285714285,0.8571428571428571
SF-J26-2,SF-E28,3,2,1,1,2,1,0.3333333333333333,0.6666666666666666,0.5,0.5
SF-J26-2,SF-J10,4,2,1,0,3,2,0.25,0.75,0.0,1.0
SF-J26-2,SF-J12,1,5,0,1,1,4,0.0,1.0,0.2,0.8
SF-J26-2,SF-J15,2,2,0,2,2,0,0.0,1.0,1.0,0.0
SF-J26-2,SF-G13,1,1,0,0,1,1,0.0,1.0,0.0,1.0
SF-J26-2,SF-G12,2,1,2,0,0,1,1.0,0.0,0.0,1.0
SF-J26-2,SF-F15,9,7,8,0,1,7,0.8888888888888888,0.1111111111111111,0.0,1.0
SF-J26-2,SF-F16,1,1,1,0,0,1,1.0,0.0,0.0,1.0
SF-J26-2,SF-C20,5,3,0,0,5,3,0.0,1.0,0.0,1.0
SF-J26-2,SF-B19,7,4,1,3,6,1,0.14285714285714285,0.8571428571428571,0.75,0.25
SF-J26-2,SF-A20,5,8,1,3,4,5,0.2,0.8,0.375,0.625
SF-J26-2,SF-A19,2,1,0,0,2,1,0.0,1.0,0.0,1.0
SF-J26-2,SF-C26,9,11,5,5,4,6,0.5555555555555556,0.4444444444444444,0.45454545454545453,0.5454545454545454
SF-J26-2,SF-C25,5,11,1,2,4,9,0.2,0.8,0.18181818181818182,0.8181818181818182
SF-J26-2,SF-B25,2,9,0,2,2,7,0.0,1.0,0.2222222222222222,0.7777777777777778
SF-J26-2,SF-D27,5,17,1,3,4,14,0.2,0.8,0.17647058823529413,0.8235294117647058
SF-J26-2,SF-C28-2,2,2,2,1,0,1,1.0,0.0,0.5,0.5
SF-J26-2,SF-C28-1,3,2,2,2,1,0,0.6666666666666666,0.3333333333333333,1.0,0.0
SF-J26-2,SF-B28,10,22,9,20,1,2,0.9,0.1,0.9090909090909091,0.09090909090909091
SF-J26-2,SF-J1,1,2,0,2,1,0,0.0,1.0,1.0,0.0
SF-J26-2,SF-G8,1,2,0,0,1,2,0.0,1.0,0.0,1.0
SF-J26-2,SF-H25,5,14,1,3,4,11,0.2,0.8,0.21428571428571427,0.7857142857142857
SF-J26-2,SF-G26,13,21,4,7,9,14,0.3076923076923077,0.6923076923076923,0.3333333333333333,0.6666666666666666
SF-J26-2,SF-K21,10,8,1,4,9,4,0.1,0.9,0.5,0.5
SF-J26-2,SF-K22-1,16,17,14,10,2,7,0.875,0.125,0.5882352941176471,0.4117647058823529
SF-J26-2,SF-J23-1,39,37,22,17,17,20,0.5641025641025641,0.4358974358974359,0.4594594594594595,0.5405405405405406
SF-J26-2,SF-J22-1,11,8,2,4,9,4,0.18181818181818182,0.8181818181818182,0.5,0.5
SF-J26-2,SF-J22-2,11,13,7,6,4,7,0.6363636363636364,0.36363636363636365,0.46153846153846156,0.5384615384615384
SF-J26-2,SF-J21,33,21,20,10,13,11,0.6060606060606061,0.3939393939393939,0.47619047619047616,0.5238095238095238
SF-J26-2,SF-I21,1,5,0,2,1,3,0.0,1.0,0.4,0.6
SF-J26-2,SF-I22,19,15,3,0,16,15,0.15789473684210525,0.8421052631578947,0.0,1.0
SF-J26-2,SF-I23-2,3,1,2,0,1,1,0.6666666666666666,0.3333333333333333,0.0,1.0
SF-J26-2,SF-I24,6,4,3,3,3,1,0.5,0.5,0.75,0.25
SF-J26-2,SF-I23-1,5,5,3,4,2,1,0.6,0.4,0.8,0.2
SF-J26-2,SF-F26,71,52,10,8,61,44,0.14084507042253522,0.8591549295774648,0.15384615384615385,0.8461538461538461
SF-J26-2,SF-M13,18,8,0,0,18,8,0.0,1.0,0.0,1.0
SF-J26-2,SF-M15,2,2,0,1,2,1,0.0,1.0,0.5,0.5
SF-J26-2,SF-L19,4,6,2,1,2,5,0.5,0.5,0.16666666666666666,0.8333333333333334
SF-J26-2,SF-L20,6,7,3,2,3,5,0.5,0.5,0.2857142857142857,0.7142857142857143
SF-J26-2,SF-N20-1,4,3,1,1,3,2,0.25,0.75,0.3333333333333333,0.6666666666666666
SF-J26-2,SF-M20,15,15,5,3,10,12,0.3333333333333333,0.6666666666666666,0.2,0.8
SF-J26-2,SF-K17-2,9,5,3,2,6,3,0.3333333333333333,0.6666666666666666,0.4,0.6
SF-J26-2,SF-K20,9,13,2,1,7,12,0.2222222222222222,0.7777777777777778,0.07692307692307693,0.9230769230769231
SF-J26-2,SF-K15-,21,20,4,0,17,20,0.19047619047619047,0.8095238095238095,0.0,1.0
SF-J26-2,SF-K19,6,4,3,0,3,4,0.5,0.5,0.0,1.0
SF-J26-2,SF-K18,7,4,5,3,2,1,0.7142857142857143,0.2857142857142857,0.75,0.25
SF-J26-2,SF-K17,11,6,6,0,5,6,0.5454545454545454,0.45454545454545453,0.0,1.0
SF-J26-2,SF-J16,2,4,1,0,1,4,0.5,0.5,0.0,1.0
SF-J26-2,SF-J18,5,2,4,1,1,1,0.8,0.2,0.5,0.5
SF-J26-2,SF-J20,29,20,21,12,8,8,0.7241379310344828,0.27586206896551724,0.6,0.4
SF-J26-2,SF-J19,5,7,4,3,1,4,0.8,0.2,0.42857142857142855,0.5714285714285714
SF-J26-2,SF-M12,8,2,2,1,6,1,0.25,0.75,0.5,0.5
SF-J26-2,SF-M10,1,1,0,1,1,0,0.0,1.0,1.0,0.0
SF-J26-2,SF-M11,6,2,2,0,4,2,0.3333333333333333,0.6666666666666666,0.0,1.0
SF-J26-2,SF-R19,6,3,1,0,5,3,0.16666666666666666,0.8333333333333334,0.0,1.0
SF-J26-2,SF-P21,7,4,3,0,4,4,0.42857142857142855,0.5714285714285714,0.0,1.0
SF-J26-2,SF-O18,2,6,1,2,1,4,0.5,0.5,0.3333333333333333,0.6666666666666666
SF-J26-2,SF-O19,22,9,3,0,19,9,0.13636363636363635,0.8636363636363636,0.0,1.0
SF-J26-2,SF-O21,28,21,2,5,26,16,0.07142857142857142,0.9285714285714286,0.23809523809523808,0.7619047619047619
SF-J26-2,SF-O22,20,17,4,4,16,13,0.2,0.8,0.23529411764705882,0.7647058823529411
SF-J26-2,SF-N21,11,25,4,1,7,24,0.36363636363636365,0.6363636363636364,0.04,0.96
SF-J26-2,SF-N20-2,2,1,0,0,2,1,0.0,1.0,0.0,1.0
SF-J26-2,SF-M21,14,2,5,0,9,2,0.35714285714285715,0.6428571428571429,0.0,1.0
SF-J26-2,SF-L21,63,34,11,6,52,28,0.1746031746031746,0.8253968253968254,0.17647058823529413,0.8235294117647058
SF-J26-2,SF-Q30,50,47,0,10,50,37,0.0,1.0,0.2127659574468085,0.7872340425531915
SF-J26-2,SF-P30,7,8,5,2,2,6,0.7142857142857143,0.2857142857142857,0.25,0.75
SF-J26-2,SF-O30-2,16,8,3,2,13,6,0.1875,0.8125,0.25,0.75
SF-J26-2,SF-O30,25,14,8,3,17,11,0.32,0.68,0.21428571428571427,0.7857142857142857
SF-J26-2,SF-N27,19,4,7,1,12,3,0.3684210526315789,0.631578947368421,0.25,0.75
SF-J26-2,SF-N29,8,3,3,1,5,2,0.375,0.625,0.3333333333333333,0.6666666666666666
SF-J26-2,SF-N28,8,7,5,2,3,5,0.625,0.375,0.2857142857142857,0.7142857142857143
SF-J26-2,SF-L30-1,103,49,71,15,32,34,0.6893203883495146,0.3106796116504854,0.30612244897959184,0.6938775510204082
SF-J26-2,SF-L31-1,4,2,0,0,4,2,0.0,1.0,0.0,1.0
SF-J26-2,SF-K30-2,9,7,5,3,4,4,0.5555555555555556,0.4444444444444444,0.42857142857142855,0.5714285714285714
SF-J26-2,SF-L29,43,26,30,13,13,13,0.6976744186046512,0.3023255813953488,0.5,0.5
SF-J26-2,SF-J29-1,39,14,15,8,24,6,0.38461538461538464,0.6153846153846154,0.5714285714285714,0.42857142857142855
SF-J26-2,SF-I30,38,3,20,2,18,1,0.5263157894736842,0.47368421052631576,0.6666666666666666,0.3333333333333333
SF-J26-2,SF-I29-2,2,4,0,2,2,2,0.0,1.0,0.5,0.5
SF-J26-2,SF-I27,21,62,11,44,10,18,0.5238095238095238,0.47619047619047616,0.7096774193548387,0.2903225806451613
SF-J26-2,SF-I28,19,29,9,20,10,9,0.47368421052631576,0.5263157894736842,0.6896551724137931,0.3103448275862069
SF-J26-2,SF-I30-2,7,8,3,1,4,7,0.42857142857142855,0.5714285714285714,0.125,0.875
SF-J26-2,SF I29-1,4,15,2,2,2,13,0.5,0.5,0.13333333333333333,0.8666666666666667
SF-J26-2,SF-H28,9,45,5,34,4,11,0.5555555555555556,0.4444444444444444,0.7555555555555555,0.24444444444444444
SF-J26-2,SF-H29,6,12,3,6,3,6,0.5,0.5,0.5,0.5
SF-J26-2,SF-S24,11,4,6,1,5,3,0.5454545454545454,0.45454545454545453,0.25,0.75
SF-J26-2,SF-R24,25,17,17,11,8,6,0.68,0.32,0.6470588235294118,0.35294117647058826
SF-J26-2,SF-R26,2,1,1,1,1,0,0.5,0.5,1.0,0.0
SF-J26-2,SF-P26,13,15,4,1,9,14,0.3076923076923077,0.6923076923076923,0.06666666666666667,0.9333333333333333
SF-J26-2,SF-O25-2,65,29,0,0,65,29,0.0,1.0,0.0,1.0
SF-J26-2,SF-N22-1B,3,6,2,3,1,3,0.6666666666666666,0.3333333333333333,0.5,0.5
SF-J26-2,SF-N26,1,2,1,0,0,2,1.0,0.0,0.0,1.0
SF-J26-2,SF-N25,8,8,2,1,6,7,0.25,0.75,0.125,0.875
SF-J26-2,SF-T22,2,3,0,1,2,2,0.0,1.0,0.3333333333333333,0.6666666666666666
SF-J26-2,SF-S22-2,8,4,1,1,7,3,0.125,0.875,0.25,0.75
SF-J26-2,SF-S22-1,5,5,0,2,5,3,0.0,1.0,0.4,0.6
SF-J26-2,SF-Q23-3,17,11,4,3,13,8,0.23529411764705882,0.7647058823529411,0.2727272727272727,0.7272727272727273
SF-J26-2,SF-Q22-1,19,8,8,2,11,6,0.42105263157894735,0.5789473684210527,0.25,0.75
SF-J26-2,SF-Q22-2,17,7,4,6,13,1,0.23529411764705882,0.7647058823529411,0.8571428571428571,0.14285714285714285
SF-J26-2,SF-P22,30,31,3,1,27,30,0.1,0.9,0.03225806451612903,0.967741935483871
SF-J26-2,SF-W19-2,1,1,0,0,1,1,0.0,1.0,0.0,1.0
SF-J26-2,SF-T20,12,3,1,0,11,3,0.08333333333333333,0.9166666666666666,0.0,1.0
SF-J26-2,SF-S21,2,2,1,1,1,1,0.5,0.5,0.5,0.5
SF-J26-2,SF-AA28,12,11,0,1,12,10,0.0,1.0,0.09090909090909091,0.9090909090909091
SF-J26-2,SF-Y30,2,2,2,1,0,1,1.0,0.0,0.5,0.5
SF-J26-2,SF-X29,3,2,0,2,3,0,0.0,1.0,1.0,0.0
SF-J26-2,SF-U30,2,2,0,0,2,2,0.0,1.0,0.0,1.0
SF-K28-3,SF-M26,1,1,1,0,0,1,1.0,0.0,0.0,1.0
SF-K28-3,SF-M25,4,2,2,2,2,0,0.5,0.5,1.0,0.0
SF-K28-3,SF-M26-2,3,1,2,1,1,0,0.6666666666666666,0.3333333333333333,1.0,0.0
SF-K28-3,SF-L27,11,7,7,6,4,1,0.6363636363636364,0.36363636363636365,0.8571428571428571,0.14285714285714285
SF-K28-3,SF-K26,5,5,4,5,1,0,0.8,0.2,1.0,0.0
SF-K28-3,SF-J27,1,1,1,1,0,0,1.0,0.0,1.0,0.0
SF-K28-3,SF-L27-2,5,5,5,5,0,0,1.0,0.0,1.0,0.0
SF-K28-3,SF-J29-3,7,5,2,0,5,5,0.2857142857142857,0.7142857142857143,0.0,1.0
SF-K28-3,SF-J29,19,9,16,8,3,1,0.8421052631578947,0.15789473684210525,0.8888888888888888,0.1111111111111111
SF-K28-3,SF-L26,2,7,2,7,0,0,1.0,0.0,1.0,0.0
SF-K28-3,SF-M28,5,5,5,1,0,4,1.0,0.0,0.2,0.8
SF-K28-3,SF-M27,1,1,1,1,0,0,1.0,0.0,1.0,0.0
SF-K28-3,SF-L25,5,23,3,21,2,2,0.6,0.4,0.9130434782608695,0.08695652173913043
SF-K28-3,SF-M24,3,4,3,4,0,0,1.0,0.0,1.0,0.0
SF-K28-3,SF-L24,2,2,0,2,2,0,0.0,1.0,1.0,0.0
SF-K28-3,SF-N23,5,11,0,0,5,11,0.0,1.0,0.0,1.0
SF-K28-3,SF-K27-2,2,3,2,2,0,1,1.0,0.0,0.6666666666666666,0.3333333333333333
SF-K28-3,SF-K28,14,2,12,2,2,0,0.8571428571428571,0.14285714285714285,1.0,0.0
SF-K28-3,SF-K29-1,14,4,14,4,0,0,1.0,0.0,1.0,0.0
SF-K28-3,SF-J28-2,2,1,1,0,1,1,0.5,0.5,0.0,1.0
SF-K28-3,SF-K27,1,2,0,2,1,0,0.0,1.0,1.0,0.0
SF-K28-3,SF-J25,1,7,1,2,0,5,1.0,0.0,0.2857142857142857,0.7142857142857143
SF-K28-3,SF-H26-2,1,3,1,2,0,1,1.0,0.0,0.6666666666666666,0.3333333333333333
SF-K28-3,SF-J24,2,2,2,2,0,0,1.0,0.0,1.0,0.0
SF-K28-3,SF-J26,2,1,2,0,0,1,1.0,0.0,0.0,1.0
SF-K28-3,SF-I26-,1,1,0,1,1,0,0.0,1.0,1.0,0.0
SF-K28-3,SF-H26,2,3,2,2,0,1,1.0,0.0,0.6666666666666666,0.3333333333333333
SF-K28-3,SF-H27-1,1,1,0,1,1,0,0.0,1.0,1.0,0.0
SF-K28-3,SF-G27,5,1,3,0,2,1,0.6,0.4,0.0,1.0
SF-K28-3,SF-L22,1,1,0,1,1,0,0.0,1.0,1.0,0.0
SF-K28-3,SF-F27,1,1,0,1,1,0,0.0,1.0,1.0,0.0
SF-K28-3,SF-N22-2,3,2,1,0,2,2,0.3333333333333333,0.6666666666666666,0.0,1.0
SF-K28-3,SF-M22-1,3,1,2,1,1,0,0.6666666666666666,0.3333333333333333,1.0,0.0
SF-K28-3,SF-K22-2,1,1,0,1,1,0,0.0,1.0,1.0,0.0
SF-K28-3,SF-G20,1,2,0,0,1,2,0.0,1.0,0.0,1.0
SF-K28-3,SF-H30,1,2,1,2,0,0,1.0,0.0,1.0,0.0
SF-K28-3,SF-G30-2,3,2,3,1,0,1,1.0,0.0,0.5,0.5
SF-K28-3,SF-E29-1,1,2,1,2,0,0,1.0,0.0,1.0,0.0
SF-K28-3,SF-D29,2,1,2,1,0,0,1.0,0.0,1.0,0.0
SF-K28-3,SF-A27,1,2,1,1,0,1,1.0,0.0,0.5,0.5
SF-K28-3,SF-G29-2,4,3,4,2,0,1,1.0,0.0,0.6666666666666666,0.3333333333333333
SF-K28-3,SF-B25,1,1,1,0,0,1,1.0,0.0,0.0,1.0
SF-K28-3,SF-D27,1,3,0,1,1,2,0.0,1.0,0.3333333333333333,0.6666666666666666
SF-K28-3,SF-J22-1,2,3,0,1,2,2,0.0,1.0,0.3333333333333333,0.6666666666666666
SF-K28-3,SF-J21,2,1,0,0,2,1,0.0,1.0,0.0,1.0
SF-K28-3,SF-F26,1,1,1,0,0,1,1.0,0.0,0.0,1.0
SF-K28-3,SF-L19,1,1,0,0,1,1,0.0,1.0,0.0,1.0
SF-K28-3,SF-K17-2,3,1,0,1,3,0,0.0,1.0,1.0,0.0
SF-K28-3,SF-K15-,12,8,0,0,12,8,0.0,1.0,0.0,1.0
SF-K28-3,SF-K17,2,1,0,0,2,1,0.0,1.0,0.0,1.0
SF-K28-3,SF-O18,1,1,0,0,1,1,0.0,1.0,0.0,1.0
SF-K28-3,SF-O21,2,3,0,2,2,1,0.0,1.0,0.6666666666666666,0.3333333333333333
SF-K28-3,SF-N20-2,2,2,0,2,2,0,0.0,1.0,1.0,0.0
SF-K28-3,SF-M21,1,1,0,1,1,0,0.0,1.0,1.0,0.0
SF-K28-3,SF-Q30,7,6,3,3,4,3,0.42857142857142855,0.5714285714285714,0.5,0.5
SF-K28-3,SF-O30-2,3,5,1,3,2,2,0.3333333333333333,0.6666666666666666,0.6,0.4
SF-K28-3,SF-O30,1,4,1,4,0,0,1.0,0.0,1.0,0.0
SF-K28-3,SF-N27,1,4,1,3,0,1,1.0,0.0,0.75,0.25
SF-K28-3,SF-N29,1,3,1,3,0,0,1.0,0.0,1.0,0.0
SF-K28-3,SF-N28,2,2,1,2,1,0,0.5,0.5,1.0,0.0
SF-K28-3,SF-L30-1,2,1,1,1,1,0,0.5,0.5,1.0,0.0
SF-K28-3,SF-J29-1,5,1,2,1,3,0,0.4,0.6,1.0,0.0
SF-K28-3,SF-I29-2,1,1,1,1,0,0,1.0,0.0,1.0,0.0
SF-K28-3,SF-P26,1,1,1,1,0,0,1.0,0.0,1.0,0.0
SF-K28-3,SF-O25-2,1,3,0,1,1,2,0.0,1.0,0.3333333333333333,0.6666666666666666
SF-K28-3,SF-N22-1B,1,2,0,0,1,2,0.0,1.0,0.0,1.0
SF-K28-3,SF-Q22-1,2,2,1,1,1,1,0.5,0.5,0.5,0.5
SF-K28-3,SF-P22,3,1,2,1,1,0,0.6666666666666666,0.3333333333333333,1.0,0.0
SF-L28,SF-M26,2,4,1,3,1,1,0.5,0.5,0.75,0.25
SF-L28,SF-M25,11,19,3,9,8,10,0.2727272727272727,0.7272727272727273,0.47368421052631576,0.5263157894736842
SF-L28,SF-M26-2,46,35,31,28,15,7,0.6739130434782609,0.32608695652173914,0.8,0.2
SF-L28,SF-L27,11,5,10,5,1,0,0.9090909090909091,0.09090909090909091,1.0,0.0
SF-L28,SF-K26,57,51,49,41,8,10,0.8596491228070176,0.14035087719298245,0.803921568627451,0.19607843137254902
SF-L28,SF-J27,41,5,12,3,29,2,0.2926829268292683,0.7073170731707317,0.6,0.4
SF-L28,SF-M30,34,40,28,36,6,4,0.8235294117647058,0.17647058823529413,0.9,0.1
SF-L28,SF-L27-2,11,26,9,21,2,5,0.8181818181818182,0.18181818181818182,0.8076923076923077,0.19230769230769232
SF-L28,SF-J29-3,71,73,26,34,45,39,0.36619718309859156,0.6338028169014085,0.4657534246575342,0.5342465753424658
SF-L28,SF-J29,35,20,13,14,22,6,0.37142857142857144,0.6285714285714286,0.7,0.3
SF-L28,SF-L26,87,127,18,56,69,71,0.20689655172413793,0.7931034482758621,0.4409448818897638,0.5590551181102362
SF-L28,SF-M28,7,29,3,26,4,3,0.42857142857142855,0.5714285714285714,0.896551724137931,0.10344827586206896
SF-L28,SF-M27,1,2,0,1,1,1,0.0,1.0,0.5,0.5
SF-L28,SF-L25,9,11,8,9,1,2,0.8888888888888888,0.1111111111111111,0.8181818181818182,0.18181818181818182
SF-L28,SF-M24,4,3,2,2,2,1,0.5,0.5,0.6666666666666666,0.3333333333333333
SF-L28,SF-L24,14,14,11,9,3,5,0.7857142857142857,0.21428571428571427,0.6428571428571429,0.35714285714285715
SF-L28,SF-N23,19,19,12,15,7,4,0.631578947368421,0.3684210526315789,0.7894736842105263,0.21052631578947367
SF-L28,SF-N24-2,4,5,0,0,4,5,0.0,1.0,0.0,1.0
SF-L28,SF-K27-2,34,43,23,27,11,16,0.6764705882352942,0.3235294117647059,0.627906976744186,0.37209302325581395
SF-L28,SF-J26-2,13,14,8,7,5,7,0.6153846153846154,0.38461538461538464,0.5,0.5
SF-L28,SF-K29-1,81,174,46,127,35,47,0.5679012345679012,0.43209876543209874,0.7298850574712644,0.27011494252873564
SF-L28,SF-J28-2,7,14,4,10,3,4,0.5714285714285714,0.42857142857142855,0.7142857142857143,0.2857142857142857
SF-L28,SF-K27,2,22,1,6,1,16,0.5,0.5,0.2727272727272727,0.7272727272727273
SF-L28,SF-K25,23,21,18,18,5,3,0.782608695652174,0.21739130434782608,0.8571428571428571,0.14285714285714285
SF-L28,SF-J25,29,24,16,16,13,8,0.5517241379310345,0.4482758620689655,0.6666666666666666,0.3333333333333333
SF-L28,SF-H26-2,3,7,3,2,0,5,1.0,0.0,0.2857142857142857,0.7142857142857143
SF-L28,SF-P24,4,7,2,4,2,3,0.5,0.5,0.5714285714285714,0.42857142857142855
SF-L28,SF-J24,5,14,3,7,2,7,0.6,0.4,0.5,0.5
SF-L28,SF-O24,1,5,1,3,0,2,1.0,0.0,0.6,0.4
SF-L28,SF-J26,2,5,2,3,0,2,1.0,0.0,0.6,0.4
SF-L28,SF-I25,2,15,2,7,0,8,1.0,0.0,0.4666666666666667,0.5333333333333333
SF-L28,SF-H26,5,4,3,3,2,1,0.6,0.4,0.75,0.25
SF-L28,SF-O23,5,4,1,2,4,2,0.2,0.8,0.5,0.5
SF-L28,SF-H27-1,20,11,14,7,6,4,0.7,0.3,0.6363636363636364,0.36363636363636365
SF-L28,SF-F28-2,3,9,3,4,0,5,1.0,0.0,0.4444444444444444,0.5555555555555556
SF-L28,SF-G27,9,8,5,5,4,3,0.5555555555555556,0.4444444444444444,0.625,0.375
SF-L28,SF-M22-2,19,18,9,2,10,16,0.47368421052631576,0.5263157894736842,0.1111111111111111,0.8888888888888888
SF-L28,SF-L22,2,1,2,0,0,1,1.0,0.0,0.0,1.0
SF-L28,SF-F27,5,6,4,5,1,1,0.8,0.2,0.8333333333333334,0.16666666666666666
SF-L28,SF-N22-2,9,8,5,3,4,5,0.5555555555555556,0.4444444444444444,0.375,0.625
SF-L28,SF-G28-2,7,2,3,0,4,2,0.42857142857142855,0.5714285714285714,0.0,1.0
SF-L28,SF-G28-1,2,1,0,0,2,1,0.0,1.0,0.0,1.0
SF-L28,SF-M22-1,3,1,1,1,2,0,0.3333333333333333,0.6666666666666666,1.0,0.0
SF-L28,SF-O25-1,1,1,1,1,0,0,1.0,0.0,1.0,0.0
SF-L28,SF-K22-2,4,6,3,5,1,1,0.75,0.25,0.8333333333333334,0.16666666666666666
SF-L28,SF-K24,3,2,2,1,1,1,0.6666666666666666,0.3333333333333333,0.5,0.5
SF-L28,SF-J23-2,2,2,1,0,1,2,0.5,0.5,0.0,1.0
SF-L28,SF-G23,3,3,1,3,2,0,0.3333333333333333,0.6666666666666666,1.0,0.0
SF-L28,SF-G24,12,1,6,1,6,0,0.5,0.5,1.0,0.0
SF-L28,SF-G25,4,4,2,0,2,4,0.5,0.5,0.0,1.0
SF-L28,SF-F23,5,5,4,3,1,2,0.8,0.2,0.6,0.4
SF-L28,SF-E23,16,7,12,3,4,4,0.75,0.25,0.42857142857142855,0.5714285714285714
SF-L28,SF-D24,1,1,0,0,1,1,0.0,1.0,0.0,1.0
SF-L28,SF-C22,1,3,0,3,1,0,0.0,1.0,1.0,0.0
SF-L28,SF-H16,1,1,0,0,1,1,0.0,1.0,0.0,1.0
SF-L28,SF-H20,2,3,1,2,1,1,0.5,0.5,0.6666666666666666,0.3333333333333333
SF-L28,SF-G19,2,1,1,0,1,1,0.5,0.5,0.0,1.0
SF-L28,SF-G17,1,2,1,0,0,2,1.0,0.0,0.0,1.0
SF-L28,SF-G20,6,4,3,0,3,4,0.5,0.5,0.0,1.0
SF-L28,SF-F19,1,3,1,1,0,2,1.0,0.0,0.3333333333333333,0.6666666666666666
SF-L28,SF-H30,46,49,31,25,15,24,0.6739130434782609,0.32608695652173914,0.5102040816326531,0.4897959183673469
SF-L28,SF-G30-2,26,10,15,4,11,6,0.5769230769230769,0.4230769230769231,0.4,0.6
SF-L28,SF-F30-1,12,8,9,6,3,2,0.75,0.25,0.75,0.25
SF-L28,SF-E29-2,110,130,65,34,45,96,0.5909090909090909,0.4090909090909091,0.26153846153846155,0.7384615384615385
SF-L28,SF-E29-1,44,66,30,43,14,23,0.6818181818181818,0.3181818181818182,0.6515151515151515,0.3484848484848485
SF-L28,SF-D29,22,41,6,25,16,16,0.2727272727272727,0.7272727272727273,0.6097560975609756,0.3902439024390244
SF-L28,SF-D28,16,7,6,4,10,3,0.375,0.625,0.5714285714285714,0.42857142857142855
SF-L28,SF-A27,2,8,2,5,0,3,1.0,0.0,0.625,0.375
SF-L28,SF-G29-2,18,14,11,11,7,3,0.6111111111111112,0.3888888888888889,0.7857142857142857,0.21428571428571427
SF-L28,SF-G29-1,16,15,7,2,9,13,0.4375,0.5625,0.13333333333333333,0.8666666666666667
SF-L28,SF-G30-1,9,6,4,4,5,2,0.4444444444444444,0.5555555555555556,0.6666666666666666,0.3333333333333333
SF-L28,SF-G29-3,5,1,5,0,0,1,1.0,0.0,0.0,1.0
SF-L28,SF-F30-2,14,18,6,5,8,13,0.42857142857142855,0.5714285714285714,0.2777777777777778,0.7222222222222222
SF-L28,SF-F29,4,4,1,2,3,2,0.25,0.75,0.5,0.5
SF-L28,SF-F28-1,1,3,1,3,0,0,1.0,0.0,1.0,0.0
SF-L28,SF-E28-2,7,5,5,2,2,3,0.7142857142857143,0.2857142857142857,0.4,0.6
SF-L28,SF-E28,4,6,3,3,1,3,0.75,0.25,0.5,0.5
SF-L28,SF-J10,1,1,0,0,1,1,0.0,1.0,0.0,1.0
SF-L28,SF-B19,2,8,0,6,2,2,0.0,1.0,0.75,0.25
SF-L28,SF-A20,10,15,10,13,0,2,1.0,0.0,0.8666666666666667,0.13333333333333333
SF-L28,SF-A19,1,1,1,0,0,1,1.0,0.0,0.0,1.0
SF-L28,SF-C26,9,5,9,4,0,1,1.0,0.0,0.8,0.2
SF-L28,SF-C25,9,11,9,7,0,4,1.0,0.0,0.6363636363636364,0.36363636363636365
SF-L28,SF-B25,40,27,37,25,3,2,0.925,0.075,0.9259259259259259,0.07407407407407407
SF-L28,SF-E27,1,2,0,2,1,0,0.0,1.0,1.0,0.0
SF-L28,SF-B28-2,2,7,2,4,0,3,1.0,0.0,0.5714285714285714,0.42857142857142855
SF-L28,SF-D27,9,14,2,6,7,8,0.2222222222222222,0.7777777777777778,0.42857142857142855,0.5714285714285714
SF-L28,SF-C28-1,2,5,1,2,1,3,0.5,0.5,0.4,0.6
SF-L28,SF-B28,26,43,26,40,0,3,1.0,0.0,0.9302325581395349,0.06976744186046512
SF-L28,SF-H25,3,1,0,0,3,1,0.0,1.0,0.0,1.0
SF-L28,SF-K22-1,3,1,3,0,0,1,1.0,0.0,0.0,1.0
SF-L28,SF-J23-1,9,6,6,3,3,3,0.6666666666666666,0.3333333333333333,0.5,0.5
SF-L28,SF-J22-1,6,6,4,3,2,3,0.6666666666666666,0.3333333333333333,0.5,0.5
SF-L28,SF-J22-2,7,4,5,2,2,2,0.7142857142857143,0.2857142857142857,0.5,0.5
SF-L28,SF-J21,6,12,4,6,2,6,0.6666666666666666,0.3333333333333333,0.5,0.5
SF-L28,SF-I21,1,3,1,2,0,1,1.0,0.0,0.6666666666666666,0.3333333333333333
SF-L28,SF-I22,4,1,3,0,1,1,0.75,0.25,0.0,1.0
SF-L28,SF-I24,6,6,5,3,1,3,0.8333333333333334,0.16666666666666666,0.5,0.5
SF-L28,SF-F26,7,5,3,2,4,3,0.42857142857142855,0.5714285714285714,0.4,0.6
SF-L28,SF-M13,26,24,5,0,21,24,0.19230769230769232,0.8076923076923077,0.0,1.0
SF-L28,SF-M15,6,4,1,1,5,3,0.16666666666666666,0.8333333333333334,0.25,0.75
SF-L28,SF-L19,3,1,0,0,3,1,0.0,1.0,0.0,1.0
SF-L28,SF-N20-1,2,5,2,1,0,4,1.0,0.0,0.2,0.8
SF-L28,SF-M20,14,11,4,3,10,8,0.2857142857142857,0.7142857142857143,0.2727272727272727,0.7272727272727273
SF-L28,SF-K20,1,3,0,1,1,2,0.0,1.0,0.3333333333333333,0.6666666666666666
SF-L28,SF-K19,4,4,1,0,3,4,0.25,0.75,0.0,1.0
SF-L28,SF-K18,18,1,5,0,13,1,0.2777777777777778,0.7222222222222222,0.0,1.0
SF-L28,SF-J18,4,3,1,0,3,3,0.25,0.75,0.0,1.0
SF-L28,SF-J19,4,4,0,0,4,4,0.0,1.0,0.0,1.0
SF-L28,SF-R19,1,1,0,0,1,1,0.0,1.0,0.0,1.0
SF-L28,SF-Q21-2,14,13,0,0,14,13,0.0,1.0,0.0,1.0
SF-L28,SF-P21,2,1,2,0,0,1,1.0,0.0,0.0,1.0
SF-L28,SF-O18,3,1,0,0,3,1,0.0,1.0,0.0,1.0
SF-L28,SF-O19,5,2,2,1,3,1,0.4,0.6,0.5,0.5
SF-L28,SF-O21,13,15,4,11,9,4,0.3076923076923077,0.6923076923076923,0.7333333333333333,0.26666666666666666
SF-L28,SF-O22,8,12,3,2,5,10,0.375,0.625,0.16666666666666666,0.8333333333333334
SF-L28,SF-N21,5,7,1,1,4,6,0.2,0.8,0.14285714285714285,0.8571428571428571
SF-L28,SF-N20-2,1,5,0,1,1,4,0.0,1.0,0.2,0.8
SF-L28,SF-M21,5,7,1,5,4,2,0.2,0.8,0.7142857142857143,0.2857142857142857
SF-L28,SF-L21,7,5,1,1,6,4,0.14285714285714285,0.8571428571428571,0.2,0.8
SF-L28,SF-S29,5,4,1,4,4,0,0.2,0.8,1.0,0.0
SF-L28,SF-Q30,62,43,3,4,59,39,0.04838709677419355,0.9516129032258065,0.09302325581395349,0.9069767441860465
SF-L28,SF-P30,11,9,6,4,5,5,0.5454545454545454,0.45454545454545453,0.4444444444444444,0.5555555555555556
SF-L28,SF-O30-2,13,13,6,7,7,6,0.46153846153846156,0.5384615384615384,0.5384615384615384,0.46153846153846156
SF-L28,SF-O30,15,18,13,15,2,3,0.8666666666666667,0.13333333333333333,0.8333333333333334,0.16666666666666666
SF-L28,SF-N27,55,44,37,29,18,15,0.6727272727272727,0.32727272727272727,0.6590909090909091,0.3409090909090909
SF-L28,SF-N29,5,13,4,12,1,1,0.8,0.2,0.9230769230769231,0.07692307692307693
SF-L28,SF-N28,43,58,15,34,28,24,0.3488372093023256,0.6511627906976745,0.5862068965517241,0.41379310344827586
SF-L28,SF-L30-1,24,33,20,30,4,3,0.8333333333333334,0.16666666666666666,0.9090909090909091,0.09090909090909091
SF-L28,SF-L31-1,10,6,9,5,1,1,0.9,0.1,0.8333333333333334,0.16666666666666666
SF-L28,SF-K30-2,3,7,3,5,0,2,1.0,0.0,0.7142857142857143,0.2857142857142857
SF-L28,SF-L29,54,69,35,50,19,19,0.6481481481481481,0.35185185185185186,0.7246376811594203,0.2753623188405797
SF-L28,SF-J29-1,10,10,6,9,4,1,0.6,0.4,0.9,0.1
SF-L28,SF-I30,7,6,6,4,1,2,0.8571428571428571,0.14285714285714285,0.6666666666666666,0.3333333333333333
SF-L28,SF-I29-2,4,2,1,1,3,1,0.25,0.75,0.5,0.5
SF-L28,SF-I27,6,4,2,0,4,4,0.3333333333333333,0.6666666666666666,0.0,1.0
SF-L28,SF-I28,9,7,6,4,3,3,0.6666666666666666,0.3333333333333333,0.5714285714285714,0.42857142857142855
SF-L28,SF-I30-2,8,9,5,5,3,4,0.625,0.375,0.5555555555555556,0.4444444444444444
SF-L28,SF I29-1,1,13,0,2,1,11,0.0,1.0,0.15384615384615385,0.8461538461538461
SF-L28,SF-H28,7,7,3,5,4,2,0.42857142857142855,0.5714285714285714,0.7142857142857143,0.2857142857142857
SF-L28,SF-H29,7,1,3,0,4,1,0.42857142857142855,0.5714285714285714,0.0,1.0
SF-L28,SF-S24,2,5,1,5,1,0,0.5,0.5,1.0,0.0
SF-L28,SF-R24,1,5,0,3,1,2,0.0,1.0,0.6,0.4
SF-L28,SF-P26,8,7,7,5,1,2,0.875,0.125,0.7142857142857143,0.2857142857142857
SF-L28,SF-O25-2,1,2,0,1,1,1,0.0,1.0,0.5,0.5
SF-L28,SF-N22-1B,5,3,1,3,4,0,0.2,0.8,1.0,0.0
SF-L28,SF-N26,3,4,3,4,0,0,1.0,0.0,1.0,0.0
SF-L28,SF-N25,16,1,3,0,13,1,0.1875,0.8125,0.0,1.0
SF-L28,SF-S22-1,3,2,1,0,2,2,0.3333333333333333,0.6666666666666666,0.0,1.0
SF-L28,SF-Q23-3,4,8,2,5,2,3,0.5,0.5,0.625,0.375
SF-L28,SF-Q22-1,3,2,2,1,1,1,0.6666666666666666,0.3333333333333333,0.5,0.5
SF-L28,SF-P22,2,1,0,0,2,1,0.0,1.0,0.0,1.0
SF-L28,SF-V29,3,7,0,0,3,7,0.0,1.0,0.0,1.0
SF-L28,SF-V30,1,1,0,1,1,0,0.0,1.0,1.0,0.0
SF-L28,SF-U30,1,6,0,1,1,5,0.0,1.0,0.16666666666666666,0.8333333333333334
SF-K28,SF-M26,3,5,2,2,1,3,0.6666666666666666,0.3333333333333333,0.4,0.6
SF-K28,SF-M25,3,6,2,2,1,4,0.6666666666666666,0.3333333333333333,0.3333333333333333,0.6666666666666666
SF-K28,SF-M26-2,4,18,2,14,2,4,0.5,0.5,0.7777777777777778,0.2222222222222222
SF-K28,SF-L27,16,22,8,16,8,6,0.5,0.5,0.7272727272727273,0.2727272727272727
SF-K28,SF-K26,31,25,8,11,23,14,0.25806451612903225,0.7419354838709677,0.44,0.56
SF-K28,SF-J27,5,8,0,1,5,7,0.0,1.0,0.125,0.875
SF-K28,SF-M30,3,8,1,4,2,4,0.3333333333333333,0.6666666666666666,0.5,0.5
SF-K28,SF-L27-2,16,3,16,3,0,0,1.0,0.0,1.0,0.0
SF-K28,SF-J29-3,7,11,5,10,2,1,0.7142857142857143,0.2857142857142857,0.9090909090909091,0.09090909090909091
SF-K28,SF-J29,50,22,38,17,12,5,0.76,0.24,0.7727272727272727,0.22727272727272727
SF-K28,SF-L26,14,31,8,21,6,10,0.5714285714285714,0.42857142857142855,0.6774193548387096,0.3225806451612903
SF-K28,SF-M28,19,31,19,23,0,8,1.0,0.0,0.7419354838709677,0.25806451612903225
SF-K28,SF-M27,1,4,1,4,0,0,1.0,0.0,1.0,0.0
SF-K28,SF-L25,8,9,7,7,1,2,0.875,0.125,0.7777777777777778,0.2222222222222222
SF-K28,SF-M24,2,3,1,3,1,0,0.5,0.5,1.0,0.0
SF-K28,SF-L24,3,3,2,2,1,1,0.6666666666666666,0.3333333333333333,0.6666666666666666,0.3333333333333333
SF-K28,SF-N23,5,9,3,2,2,7,0.6,0.4,0.2222222222222222,0.7777777777777778
SF-K28,SF-K27-2,11,10,9,8,2,2,0.8181818181818182,0.18181818181818182,0.8,0.2
SF-K28,SF-J26-2,9,13,6,10,3,3,0.6666666666666666,0.3333333333333333,0.7692307692307693,0.23076923076923078
SF-K28,SF-K28-3,2,14,2,12,0,2,1.0,0.0,0.8571428571428571,0.14285714285714285
SF-K28,SF-K29-1,14,7,10,4,4,3,0.7142857142857143,0.2857142857142857,0.5714285714285714,0.42857142857142855
SF-K28,SF-J28-2,18,3,13,2,5,1,0.7222222222222222,0.2777777777777778,0.6666666666666666,0.3333333333333333
SF-K28,SF-K27,2,5,1,3,1,2,0.5,0.5,0.6,0.4
SF-K28,SF-K25,3,11,2,6,1,5,0.6666666666666666,0.3333333333333333,0.5454545454545454,0.45454545454545453
SF-K28,SF-J25,5,13,4,5,1,8,0.8,0.2,0.38461538461538464,0.6153846153846154
SF-K28,SF-H26-2,9,4,7,4,2,0,0.7777777777777778,0.2222222222222222,1.0,0.0
SF-K28,SF-P24,1,6,1,4,0,2,1.0,0.0,0.6666666666666666,0.3333333333333333
SF-K28,SF-N22-1A,1,13,0,4,1,9,0.0,1.0,0.3076923076923077,0.6923076923076923
SF-K28,SF-J24,7,1,5,1,2,0,0.7142857142857143,0.2857142857142857,1.0,0.0
SF-K28,SF-O24,3,1,1,1,2,0,0.3333333333333333,0.6666666666666666,1.0,0.0
SF-K28,SF-J26,8,4,7,3,1,1,0.875,0.125,0.75,0.25
SF-K28,SF-I26-,2,2,2,1,0,1,1.0,0.0,0.5,0.5
SF-K28,SF-I25,10,16,7,1,3,15,0.7,0.3,0.0625,0.9375
SF-K28,SF-H26,25,18,16,8,9,10,0.64,0.36,0.4444444444444444,0.5555555555555556
SF-K28,SF-O23,3,4,1,2,2,2,0.3333333333333333,0.6666666666666666,0.5,0.5
SF-K28,SF-F28-2,7,6,0,3,7,3,0.0,1.0,0.5,0.5
SF-K28,SF-G27,13,8,10,5,3,3,0.7692307692307693,0.23076923076923078,0.625,0.375
SF-K28,SF-M22-2,3,5,2,4,1,1,0.6666666666666666,0.3333333333333333,0.8,0.2
SF-K28,SF-L22,4,1,1,0,3,1,0.25,0.75,0.0,1.0
SF-K28,SF-F27,5,6,2,4,3,2,0.4,0.6,0.6666666666666666,0.3333333333333333
SF-K28,SF-N22-2,5,8,0,2,5,6,0.0,1.0,0.25,0.75
SF-K28,SF-G28-2,4,1,2,0,2,1,0.5,0.5,0.0,1.0
SF-K28,SF-M22-1,1,4,0,2,1,2,0.0,1.0,0.5,0.5
SF-K28,SF-J23-2,1,1,1,0,0,1,1.0,0.0,0.0,1.0
SF-K28,SF-G24,3,3,1,1,2,2,0.3333333333333333,0.6666666666666666,0.3333333333333333,0.6666666666666666
SF-K28,SF-G25,4,1,3,0,1,1,0.75,0.25,0.0,1.0
SF-K28,SF-F23,4,5,1,1,3,4,0.25,0.75,0.2,0.8
SF-K28,SF-E23,3,1,1,0,2,1,0.3333333333333333,0.6666666666666666,0.0,1.0
SF-K28,SF-H30,11,15,7,11,4,4,0.6363636363636364,0.36363636363636365,0.7333333333333333,0.26666666666666666
SF-K28,SF-G30-2,10,7,7,5,3,2,0.7,0.3,0.7142857142857143,0.2857142857142857
SF-K28,SF-E29-1,4,9,3,7,1,2,0.75,0.25,0.7777777777777778,0.2222222222222222
SF-K28,SF-D29,2,4,1,4,1,0,0.5,0.5,1.0,0.0
SF-K28,SF-D28,2,6,1,3,1,3,0.5,0.5,0.5,0.5
SF-K28,SF-A27,6,8,4,4,2,4,0.6666666666666666,0.3333333333333333,0.5,0.5
SF-K28,SF-G29-2,10,3,5,1,5,2,0.5,0.5,0.3333333333333333,0.6666666666666666
SF-K28,SF-G29-1,1,1,0,0,1,1,0.0,1.0,0.0,1.0
SF-K28,SF-G30-1,42,34,25,16,17,18,0.5952380952380952,0.40476190476190477,0.47058823529411764,0.5294117647058824
SF-K28,SF-G29-3,4,2,1,2,3,0,0.25,0.75,1.0,0.0
SF-K28,SF-F15,1,1,1,0,0,1,1.0,0.0,0.0,1.0
SF-K28,SF-B21,2,1,0,0,2,1,0.0,1.0,0.0,1.0
SF-K28,SF-B19,1,2,0,2,1,0,0.0,1.0,1.0,0.0
SF-K28,SF-A20,8,4,3,2,5,2,0.375,0.625,0.5,0.5
SF-K28,SF-A19,2,2,2,1,0,1,1.0,0.0,0.5,0.5
SF-K28,SF-C26,2,3,1,0,1,3,0.5,0.5,0.0,1.0
SF-K28,SF-C25,2,4,2,2,0,2,1.0,0.0,0.5,0.5
SF-K28,SF-B25,4,6,1,4,3,2,0.25,0.75,0.6666666666666666,0.3333333333333333
SF-K28,SF-D27,2,5,2,2,0,3,1.0,0.0,0.4,0.6
SF-K28,SF-C28-1,1,1,1,1,0,0,1.0,0.0,1.0,0.0
SF-K28,SF-B28,3,3,3,2,0,1,1.0,0.0,0.6666666666666666,0.3333333333333333
SF-K28,SF-H25,1,2,1,1,0,1,1.0,0.0,0.5,0.5
SF-K28,SF-G26,7,5,4,3,3,2,0.5714285714285714,0.42857142857142855,0.6,0.4
SF-K28,SF-K22-1,1,4,0,1,1,3,0.0,1.0,0.25,0.75
SF-K28,SF-J23-1,11,16,5,9,6,7,0.45454545454545453,0.5454545454545454,0.5625,0.4375
SF-K28,SF-J22-1,3,4,2,3,1,1,0.6666666666666666,0.3333333333333333,0.75,0.25
SF-K28,SF-J22-2,2,2,2,0,0,2,1.0,0.0,0.0,1.0
SF-K28,SF-J21,1,3,0,3,1,0,0.0,1.0,1.0,0.0
SF-K28,SF-I21,1,3,1,3,0,0,1.0,0.0,1.0,0.0
SF-K28,SF-I23-2,1,1,1,0,0,1,1.0,0.0,0.0,1.0
SF-K28,SF-I23-1,4,1,4,0,0,1,1.0,0.0,0.0,1.0
SF-K28,SF-F26,48,3,46,2,2,1,0.9583333333333334,0.041666666666666664,0.6666666666666666,0.3333333333333333
SF-K28,SF-M13,1,1,0,0,1,1,0.0,1.0,0.0,1.0
SF-K28,SF-L19,1,1,1,1,0,0,1.0,0.0,1.0,0.0
SF-K28,SF-L20,1,1,1,0,0,1,1.0,0.0,0.0,1.0
SF-K28,SF-N20-1,1,2,1,2,0,0,1.0,0.0,1.0,0.0
SF-K28,SF-K20,2,1,2,0,0,1,1.0,0.0,0.0,1.0
SF-K28,SF-K15-,6,1,0,0,6,1,0.0,1.0,0.0,1.0
SF-K28,SF-K19,2,2,0,0,2,2,0.0,1.0,0.0,1.0
SF-K28,SF-K18,2,2,1,1,1,1,0.5,0.5,0.5,0.5
SF-K28,SF-K17,1,2,1,0,0,2,1.0,0.0,0.0,1.0
SF-K28,SF-J20,2,2,1,0,1,2,0.5,0.5,0.0,1.0
SF-K28,SF-J19,5,4,4,1,1,3,0.8,0.2,0.25,0.75
SF-K28,SF-R20,3,1,0,0,3,1,0.0,1.0,0.0,1.0
SF-K28,SF-Q21-1,8,4,0,0,8,4,0.0,1.0,0.0,1.0
SF-K28,SF-P21,19,4,2,1,17,3,0.10526315789473684,0.8947368421052632,0.25,0.75
SF-K28,SF-O18,2,1,0,0,2,1,0.0,1.0,0.0,1.0
SF-K28,SF-O19,1,1,1,0,0,1,1.0,0.0,0.0,1.0
SF-K28,SF-O21,5,9,1,5,4,4,0.2,0.8,0.5555555555555556,0.4444444444444444
SF-K28,SF-O22,3,8,1,3,2,5,0.3333333333333333,0.6666666666666666,0.375,0.625
SF-K28,SF-N21,1,3,0,0,1,3,0.0,1.0,0.0,1.0
SF-K28,SF-N20-2,1,4,0,2,1,2,0.0,1.0,0.5,0.5
SF-K28,SF-L21,3,8,1,1,2,7,0.3333333333333333,0.6666666666666666,0.125,0.875
SF-K28,SF-Q30,9,19,8,18,1,1,0.8888888888888888,0.1111111111111111,0.9473684210526315,0.05263157894736842
SF-K28,SF-P30,5,3,2,1,3,2,0.4,0.6,0.3333333333333333,0.6666666666666666
SF-K28,SF-O30-2,2,1,1,1,1,0,0.5,0.5,1.0,0.0
SF-K28,SF-O30,2,3,0,1,2,2,0.0,1.0,0.3333333333333333,0.6666666666666666
SF-K28,SF-N27,3,7,2,6,1,1,0.6666666666666666,0.3333333333333333,0.8571428571428571,0.14285714285714285
SF-K28,SF-N29,47,10,37,8,10,2,0.7872340425531915,0.2127659574468085,0.8,0.2
SF-K28,SF-N28,7,14,2,9,5,5,0.2857142857142857,0.7142857142857143,0.6428571428571429,0.35714285714285715
SF-K28,SF-L30-1,3,7,0,3,3,4,0.0,1.0,0.42857142857142855,0.5714285714285714
SF-K28,SF-L31-1,1,1,1,1,0,0,1.0,0.0,1.0,0.0
SF-K28,SF-K30-2,1,1,0,1,1,0,0.0,1.0,1.0,0.0
SF-K28,SF-L29,35,13,35,13,0,0,1.0,0.0,1.0,0.0
SF-K28,SF-J29-1,16,7,13,3,3,4,0.8125,0.1875,0.42857142857142855,0.5714285714285714
SF-K28,SF-I30,11,4,9,3,2,1,0.8181818181818182,0.18181818181818182,0.75,0.25
SF-K28,SF-I29-2,2,1,0,0,2,1,0.0,1.0,0.0,1.0
SF-K28,SF-I27,10,12,5,8,5,4,0.5,0.5,0.6666666666666666,0.3333333333333333
SF-K28,SF-I28,4,5,4,4,0,1,1.0,0.0,0.8,0.2
SF-K28,SF-I30-2,6,5,2,4,4,1,0.3333333333333333,0.6666666666666666,0.8,0.2
SF-K28,SF I29-1,8,2,2,1,6,1,0.25,0.75,0.5,0.5
SF-K28,SF-H28,19,35,12,20,7,15,0.631578947368421,0.3684210526315789,0.5714285714285714,0.42857142857142855
SF-K28,SF-S24,17,53,9,52,8,1,0.5294117647058824,0.47058823529411764,0.9811320754716981,0.018867924528301886
SF-K28,SF-R24,3,13,2,4,1,9,0.6666666666666666,0.3333333333333333,0.3076923076923077,0.6923076923076923
SF-K28,SF-P26,1,8,0,2,1,6,0.0,1.0,0.25,0.75
SF-K28,SF-O25-2,1,3,1,0,0,3,1.0,0.0,0.0,1.0
SF-K28,SF-N22-1B,4,1,0,1,4,0,0.0,1.0,1.0,0.0
SF-K28,SF-N25,3,4,3,4,0,0,1.0,0.0,1.0,0.0
SF-K28,SF-S22-1,1,2,0,1,1,1,0.0,1.0,0.5,0.5
SF-K28,SF-Q23-3,1,2,1,1,0,1,1.0,0.0,0.5,0.5
SF-K28,SF-Q22-1,7,4,1,2,6,2,0.14285714285714285,0.8571428571428571,0.5,0.5
SF-K28,SF-Q22-2,5,3,4,0,1,3,0.8,0.2,0.0,1.0
SF-K28,SF-P22,8,5,5,1,3,4,0.625,0.375,0.2,0.8
SF-K29-1,SF-M26,6,9,4,6,2,3,0.6666666666666666,0.3333333333333333,0.6666666666666666,0.3333333333333333
SF-K29-1,SF-M25,5,8,2,5,3,3,0.4,0.6,0.625,0.375
SF-K29-1,SF-M26-2,16,18,4,3,12,15,0.25,0.75,0.16666666666666666,0.8333333333333334
SF-K29-1,SF-L27,12,16,8,8,4,8,0.6666666666666666,0.3333333333333333,0.5,0.5
SF-K29-1,SF-K26,37,17,27,6,10,11,0.7297297297297297,0.2702702702702703,0.35294117647058826,0.6470588235294118
SF-K29-1,SF-J27,19,29,10,14,9,15,0.5263157894736842,0.47368421052631576,0.4827586206896552,0.5172413793103449
SF-K29-1,SF-M30,474,310,142,137,332,173,0.29957805907172996,0.70042194092827,0.44193548387096776,0.5580645161290323
SF-K29-1,SF-L27-2,7,8,3,4,4,4,0.42857142857142855,0.5714285714285714,0.5,0.5
SF-K29-1,SF-J29-3,17,25,13,22,4,3,0.7647058823529411,0.23529411764705882,0.88,0.12
SF-K29-1,SF-J29,19,37,10,27,9,10,0.5263157894736842,0.47368421052631576,0.7297297297297297,0.2702702702702703
SF-K29-1,SF-L26,18,21,4,4,14,17,0.2222222222222222,0.7777777777777778,0.19047619047619047,0.8095238095238095
SF-K29-1,SF-M28,25,47,16,22,9,25,0.64,0.36,0.46808510638297873,0.5319148936170213
SF-K29-1,SF-M27,1,2,1,0,0,2,1.0,0.0,0.0,1.0
SF-K29-1,SF-L25,15,11,9,11,6,0,0.6,0.4,1.0,0.0
SF-K29-1,SF-M24,3,12,2,8,1,4,0.6666666666666666,0.3333333333333333,0.6666666666666666,0.3333333333333333
SF-K29-1,SF-L24,5,6,2,5,3,1,0.4,0.6,0.8333333333333334,0.16666666666666666
SF-K29-1,SF-N23,2,9,0,1,2,8,0.0,1.0,0.1111111111111111,0.8888888888888888
SF-K29-1,SF-N24-2,7,3,4,0,3,3,0.5714285714285714,0.42857142857142855,0.0,1.0
SF-K29-1,SF-K27-2,31,28,22,23,9,5,0.7096774193548387,0.2903225806451613,0.8214285714285714,0.17857142857142858
SF-K29-1,SF-J26-2,13,48,10,18,3,30,0.7692307692307693,0.23076923076923078,0.375,0.625
SF-K29-1,SF-K28-3,4,14,4,14,0,0,1.0,0.0,1.0,0.0
SF-K29-1,SF-L28,174,81,127,46,47,35,0.7298850574712644,0.27011494252873564,0.5679012345679012,0.43209876543209874
SF-K29-1,SF-K28,7,14,4,10,3,4,0.5714285714285714,0.42857142857142855,0.7142857142857143,0.2857142857142857
SF-K29-1,SF-J28-2,10,6,6,3,4,3,0.6,0.4,0.5,0.5
SF-K29-1,SF-K27,3,6,3,4,0,2,1.0,0.0,0.6666666666666666,0.3333333333333333
SF-K29-1,SF-K25,19,8,4,4,15,4,0.21052631578947367,0.7894736842105263,0.5,0.5
SF-K29-1,SF-J25,57,51,26,23,31,28,0.45614035087719296,0.543859649122807,0.45098039215686275,0.5490196078431373
SF-K29-1,SF-H26-2,14,27,6,18,8,9,0.42857142857142855,0.5714285714285714,0.6666666666666666,0.3333333333333333
SF-K29-1,SF-P24,1,6,1,4,0,2,1.0,0.0,0.6666666666666666,0.3333333333333333
SF-K29-1,SF-N22-1A,1,3,0,0,1,3,0.0,1.0,0.0,1.0
SF-K29-1,SF-J24,20,18,3,7,17,11,0.15,0.85,0.3888888888888889,0.6111111111111112
SF-K29-1,SF-O24,2,1,2,0,0,1,1.0,0.0,0.0,1.0
SF-K29-1,SF-J26,8,11,3,6,5,5,0.375,0.625,0.5454545454545454,0.45454545454545453
SF-K29-1,SF-I25,66,71,9,11,57,60,0.13636363636363635,0.8636363636363636,0.15492957746478872,0.8450704225352113
SF-K29-1,SF-H26,24,37,11,16,13,21,0.4583333333333333,0.5416666666666666,0.43243243243243246,0.5675675675675675
SF-K29-1,SF-O23,8,6,1,0,7,6,0.125,0.875,0.0,1.0
SF-K29-1,SF-H27-1,25,40,12,20,13,20,0.48,0.52,0.5,0.5
SF-K29-1,SF-F28-2,35,39,16,13,19,26,0.45714285714285713,0.5428571428571428,0.3333333333333333,0.6666666666666666
SF-K29-1,SF-G27,53,56,31,29,22,27,0.5849056603773585,0.41509433962264153,0.5178571428571429,0.48214285714285715
SF-K29-1,SF-M22-2,8,13,2,1,6,12,0.25,0.75,0.07692307692307693,0.9230769230769231
SF-K29-1,SF-L22,1,7,1,2,0,5,1.0,0.0,0.2857142857142857,0.7142857142857143
SF-K29-1,SF-F27,26,35,11,21,15,14,0.4230769230769231,0.5769230769230769,0.6,0.4
SF-K29-1,SF-N22-2,22,33,12,16,10,17,0.5454545454545454,0.45454545454545453,0.48484848484848486,0.5151515151515151
SF-K29-1,SF-G28-2,21,21,4,2,17,19,0.19047619047619047,0.8095238095238095,0.09523809523809523,0.9047619047619048
SF-K29-1,SF-G28-1,7,35,4,8,3,27,0.5714285714285714,0.42857142857142855,0.22857142857142856,0.7714285714285715
SF-K29-1,SF-M22-1,5,2,1,1,4,1,0.2,0.8,0.5,0.5
SF-K29-1,SF-O25-1,5,5,4,2,1,3,0.8,0.2,0.4,0.6
SF-K29-1,SF-K22-2,4,3,1,1,3,2,0.25,0.75,0.3333333333333333,0.6666666666666666
SF-K29-1,SF-K24,13,13,5,7,8,6,0.38461538461538464,0.6153846153846154,0.5384615384615384,0.46153846153846156
SF-K29-1,SF-J23-2,1,3,1,3,0,0,1.0,0.0,1.0,0.0
SF-K29-1,SF-G23,4,2,3,2,1,0,0.75,0.25,1.0,0.0
SF-K29-1,SF-G24,35,10,21,1,14,9,0.6,0.4,0.1,0.9
SF-K29-1,SF-G25,13,9,8,2,5,7,0.6153846153846154,0.38461538461538464,0.2222222222222222,0.7777777777777778
SF-K29-1,SF-F23,122,62,109,7,13,55,0.8934426229508197,0.10655737704918032,0.11290322580645161,0.8870967741935484
SF-K29-1,SF-E23,16,9,8,2,8,7,0.5,0.5,0.2222222222222222,0.7777777777777778
SF-K29-1,SF-D24,39,2,4,0,35,2,0.10256410256410256,0.8974358974358975,0.0,1.0
SF-K29-1,SF-C22,29,40,23,1,6,39,0.7931034482758621,0.20689655172413793,0.025,0.975
SF-K29-1,SF-B22,11,28,7,19,4,9,0.6363636363636364,0.36363636363636365,0.6785714285714286,0.32142857142857145
SF-K29-1,SF-J17,2,7,1,0,1,7,0.5,0.5,0.0,1.0
SF-K29-1,SF-H20,2,3,2,2,0,1,1.0,0.0,0.6666666666666666,0.3333333333333333
SF-K29-1,SF-H18,2,2,1,1,1,1,0.5,0.5,0.5,0.5
SF-K29-1,SF-G19,3,4,2,2,1,2,0.6666666666666666,0.3333333333333333,0.5,0.5
SF-K29-1,SF-G18,4,3,1,0,3,3,0.25,0.75,0.0,1.0
SF-K29-1,SF-G20,9,3,4,1,5,2,0.4444444444444444,0.5555555555555556,0.3333333333333333,0.6666666666666666
SF-K29-1,SF-F19,3,3,0,0,3,3,0.0,1.0,0.0,1.0
SF-K29-1,SF-E20,2,3,1,0,1,3,0.5,0.5,0.0,1.0
SF-K29-1,SF-H30,88,107,63,79,25,28,0.7159090909090909,0.2840909090909091,0.7383177570093458,0.2616822429906542
SF-K29-1,SF-G30-2,51,41,38,30,13,11,0.7450980392156863,0.2549019607843137,0.7317073170731707,0.2682926829268293
SF-K29-1,SF-F30-1,47,83,30,43,17,40,0.6382978723404256,0.3617021276595745,0.5180722891566265,0.4819277108433735
SF-K29-1,SF-E29-2,180,118,59,50,121,68,0.3277777777777778,0.6722222222222223,0.423728813559322,0.576271186440678
SF-K29-1,SF-E29-1,124,158,74,114,50,44,0.5967741935483871,0.4032258064516129,0.7215189873417721,0.27848101265822783
SF-K29-1,SF-D29,105,150,45,74,60,76,0.42857142857142855,0.5714285714285714,0.49333333333333335,0.5066666666666667
SF-K29-1,SF-D28,33,40,20,25,13,15,0.6060606060606061,0.3939393939393939,0.625,0.375
SF-K29-1,SF-A27,28,54,18,39,10,15,0.6428571428571429,0.35714285714285715,0.7222222222222222,0.2777777777777778
SF-K29-1,SF-G29-2,48,31,16,21,32,10,0.3333333333333333,0.6666666666666666,0.6774193548387096,0.3225806451612903
SF-K29-1,SF-G29-1,100,87,70,62,30,25,0.7,0.3,0.7126436781609196,0.28735632183908044
SF-K29-1,SF-G30-1,47,81,31,39,16,42,0.6595744680851063,0.3404255319148936,0.48148148148148145,0.5185185185185185
SF-K29-1,SF-G29-3,68,59,41,42,27,17,0.6029411764705882,0.39705882352941174,0.711864406779661,0.288135593220339
SF-K29-1,SF-F30-2,18,25,14,12,4,13,0.7777777777777778,0.2222222222222222,0.48,0.52
SF-K29-1,SF-F29,49,47,43,38,6,9,0.8775510204081632,0.12244897959183673,0.8085106382978723,0.19148936170212766
SF-K29-1,SF-E29-3,48,16,12,9,36,7,0.25,0.75,0.5625,0.4375
SF-K29-1,SF-F28-1,14,10,5,8,9,2,0.35714285714285715,0.6428571428571429,0.8,0.2
SF-K29-1,SF-E28-2,5,4,2,3,3,1,0.4,0.6,0.75,0.25
SF-K29-1,SF-E28,15,11,12,0,3,11,0.8,0.2,0.0,1.0
SF-K29-1,SF-J12,2,1,0,0,2,1,0.0,1.0,0.0,1.0
SF-K29-1,SF-F15,1,6,0,0,1,6,0.0,1.0,0.0,1.0
SF-K29-1,SF-C20,4,5,0,2,4,3,0.0,1.0,0.4,0.6
SF-K29-1,SF-B21,4,3,2,1,2,2,0.5,0.5,0.3333333333333333,0.6666666666666666
SF-K29-1,SF-B19,12,34,7,23,5,11,0.5833333333333334,0.4166666666666667,0.6764705882352942,0.3235294117647059
SF-K29-1,SF-A20,24,26,9,16,15,10,0.375,0.625,0.6153846153846154,0.38461538461538464
SF-K29-1,SF-A19,6,10,2,5,4,5,0.3333333333333333,0.6666666666666666,0.5,0.5
SF-K29-1,SF-C26,37,69,12,15,25,54,0.32432432432432434,0.6756756756756757,0.21739130434782608,0.782608695652174
SF-K29-1,SF-C25,11,31,2,4,9,27,0.18181818181818182,0.8181818181818182,0.12903225806451613,0.8709677419354839
SF-K29-1,SF-B25,17,22,4,16,13,6,0.23529411764705882,0.7647058823529411,0.7272727272727273,0.2727272727272727
SF-K29-1,SF-E27,18,31,9,13,9,18,0.5,0.5,0.41935483870967744,0.5806451612903226
SF-K29-1,SF-B28-2,4,6,2,1,2,5,0.5,0.5,0.16666666666666666,0.8333333333333334
SF-K29-1,SF-D27,22,22,14,11,8,11,0.6363636363636364,0.36363636363636365,0.5,0.5
SF-K29-1,SF-C28-2,7,7,1,2,6,5,0.14285714285714285,0.8571428571428571,0.2857142857142857,0.7142857142857143
SF-K29-1,SF-C28-1,6,8,2,5,4,3,0.3333333333333333,0.6666666666666666,0.625,0.375
SF-K29-1,SF-B28,56,64,46,52,10,12,0.8214285714285714,0.17857142857142858,0.8125,0.1875
SF-K29-1,SF-G7,2,2,0,2,2,0,0.0,1.0,1.0,0.0
SF-K29-1,SF-H25,2,7,1,1,1,6,0.5,0.5,0.14285714285714285,0.8571428571428571
SF-K29-1,SF-G26,42,69,34,60,8,9,0.8095238095238095,0.19047619047619047,0.8695652173913043,0.13043478260869565
SF-K29-1,SF-K21,5,5,0,0,5,5,0.0,1.0,0.0,1.0
SF-K29-1,SF-K22-1,11,19,5,7,6,12,0.45454545454545453,0.5454545454545454,0.3684210526315789,0.631578947368421
SF-K29-1,SF-J23-1,57,37,23,17,34,20,0.40350877192982454,0.5964912280701754,0.4594594594594595,0.5405405405405406
SF-K29-1,SF-J22-1,7,10,2,4,5,6,0.2857142857142857,0.7142857142857143,0.4,0.6
SF-K29-1,SF-J22-2,5,5,2,2,3,3,0.4,0.6,0.4,0.6
SF-K29-1,SF-J21,7,9,1,3,6,6,0.14285714285714285,0.8571428571428571,0.3333333333333333,0.6666666666666666
SF-K29-1,SF-I21,5,8,4,2,1,6,0.8,0.2,0.25,0.75
SF-K29-1,SF-I22,1,2,0,1,1,1,0.0,1.0,0.5,0.5
SF-K29-1,SF-I23-2,5,11,3,2,2,9,0.6,0.4,0.18181818181818182,0.8181818181818182
SF-K29-1,SF-I24,9,22,2,0,7,22,0.2222222222222222,0.7777777777777778,0.0,1.0
SF-K29-1,SF-I23-1,6,9,2,2,4,7,0.3333333333333333,0.6666666666666666,0.2222222222222222,0.7777777777777778
SF-K29-1,SF-F26,29,38,12,23,17,15,0.41379310344827586,0.5862068965517241,0.6052631578947368,0.39473684210526316
SF-K29-1,SF-M13,1,3,0,0,1,3,0.0,1.0,0.0,1.0
SF-K29-1,SF-L19,2,1,0,0,2,1,0.0,1.0,0.0,1.0
SF-K29-1,SF-L20,15,3,12,0,3,3,0.8,0.2,0.0,1.0
SF-K29-1,SF-N20-1,1,7,0,0,1,7,0.0,1.0,0.0,1.0
SF-K29-1,SF-M20,3,8,1,4,2,4,0.3333333333333333,0.6666666666666666,0.5,0.5
SF-K29-1,SF-K17-2,9,3,3,1,6,2,0.3333333333333333,0.6666666666666666,0.3333333333333333,0.6666666666666666
SF-K29-1,SF-K20,5,7,1,1,4,6,0.2,0.8,0.14285714285714285,0.8571428571428571
SF-K29-1,SF-K15-,5,5,1,2,4,3,0.2,0.8,0.4,0.6
SF-K29-1,SF-K19,3,1,1,1,2,0,0.3333333333333333,0.6666666666666666,1.0,0.0
SF-K29-1,SF-K18,8,4,1,0,7,4,0.125,0.875,0.0,1.0
SF-K29-1,SF-K17,3,3,0,1,3,2,0.0,1.0,0.3333333333333333,0.6666666666666666
SF-K29-1,SF-J18,1,3,1,0,0,3,1.0,0.0,0.0,1.0
SF-K29-1,SF-J20,3,2,2,0,1,2,0.6666666666666666,0.3333333333333333,0.0,1.0
SF-K29-1,SF-J19,6,24,0,9,6,15,0.0,1.0,0.375,0.625
SF-K29-1,SF-M10,2,1,0,0,2,1,0.0,1.0,0.0,1.0
SF-K29-1,SF-M11,16,3,15,2,1,1,0.9375,0.0625,0.6666666666666666,0.3333333333333333
SF-K29-1,SF-R19,5,1,3,0,2,1,0.6,0.4,0.0,1.0
SF-K29-1,SF-Q21-2,1,2,0,1,1,1,0.0,1.0,0.5,0.5
SF-K29-1,SF-Q21-1,3,7,0,3,3,4,0.0,1.0,0.42857142857142855,0.5714285714285714
SF-K29-1,SF-P21,3,2,1,2,2,0,0.3333333333333333,0.6666666666666666,1.0,0.0
SF-K29-1,SF-O18,1,6,0,1,1,5,0.0,1.0,0.16666666666666666,0.8333333333333334
SF-K29-1,SF-O19,3,5,1,1,2,4,0.3333333333333333,0.6666666666666666,0.2,0.8
SF-K29-1,SF-O21,28,26,4,8,24,18,0.14285714285714285,0.8571428571428571,0.3076923076923077,0.6923076923076923
SF-K29-1,SF-O22,10,14,4,5,6,9,0.4,0.6,0.35714285714285715,0.6428571428571429
SF-K29-1,SF-N21,11,7,2,1,9,6,0.18181818181818182,0.8181818181818182,0.14285714285714285,0.8571428571428571
SF-K29-1,SF-N20-2,2,2,2,0,0,2,1.0,0.0,0.0,1.0
SF-K29-1,SF-M21,12,16,10,11,2,5,0.8333333333333334,0.16666666666666666,0.6875,0.3125
SF-K29-1,SF-L21,16,13,4,1,12,12,0.25,0.75,0.07692307692307693,0.9230769230769231
SF-K29-1,SF-S29,2,4,1,2,1,2,0.5,0.5,0.5,0.5
SF-K29-1,SF-S30,6,4,5,3,1,1,0.8333333333333334,0.16666666666666666,0.75,0.25
SF-K29-1,SF-Q30,215,124,29,51,186,73,0.13488372093023257,0.8651162790697674,0.4112903225806452,0.5887096774193549
SF-K29-1,SF-P30,119,158,98,134,21,24,0.8235294117647058,0.17647058823529413,0.8481012658227848,0.1518987341772152
SF-K29-1,SF-O30-2,40,29,25,21,15,8,0.625,0.375,0.7241379310344828,0.27586206896551724
SF-K29-1,SF-O30,164,173,109,113,55,60,0.6646341463414634,0.3353658536585366,0.653179190751445,0.3468208092485549
SF-K29-1,SF-N27,55,61,31,33,24,28,0.5636363636363636,0.43636363636363634,0.5409836065573771,0.45901639344262296
SF-K29-1,SF-N29,55,52,5,7,50,45,0.09090909090909091,0.9090909090909091,0.1346153846153846,0.8653846153846154
SF-K29-1,SF-N28,31,36,22,27,9,9,0.7096774193548387,0.2903225806451613,0.75,0.25
SF-K29-1,SF-L30-1,255,227,185,150,70,77,0.7254901960784313,0.27450980392156865,0.6607929515418502,0.3392070484581498
SF-K29-1,SF-L31-1,13,24,11,18,2,6,0.8461538461538461,0.15384615384615385,0.75,0.25
SF-K29-1,SF-K30-2,41,41,30,28,11,13,0.7317073170731707,0.2682926829268293,0.6829268292682927,0.3170731707317073
SF-K29-1,SF-L29,207,94,192,83,15,11,0.927536231884058,0.07246376811594203,0.8829787234042553,0.11702127659574468
SF-K29-1,SF-J29-1,16,40,12,32,4,8,0.75,0.25,0.8,0.2
SF-K29-1,SF-I30,77,52,68,45,9,7,0.8831168831168831,0.11688311688311688,0.8653846153846154,0.1346153846153846
SF-K29-1,SF-I29-2,6,23,1,17,5,6,0.16666666666666666,0.8333333333333334,0.7391304347826086,0.2608695652173913
SF-K29-1,SF-I27,18,21,13,15,5,6,0.7222222222222222,0.2777777777777778,0.7142857142857143,0.2857142857142857
SF-K29-1,SF-I28,21,17,8,12,13,5,0.38095238095238093,0.6190476190476191,0.7058823529411765,0.29411764705882354
SF-K29-1,SF-I30-2,18,31,13,11,5,20,0.7222222222222222,0.2777777777777778,0.3548387096774194,0.6451612903225806
SF-K29-1,SF I29-1,11,22,3,2,8,20,0.2727272727272727,0.7272727272727273,0.09090909090909091,0.9090909090909091
SF-K29-1,SF-H28,34,57,18,35,16,22,0.5294117647058824,0.47058823529411764,0.6140350877192983,0.38596491228070173
SF-K29-1,SF-H29,6,10,2,3,4,7,0.3333333333333333,0.6666666666666666,0.3,0.7
SF-K29-1,SF-S24,5,9,1,3,4,6,0.2,0.8,0.3333333333333333,0.6666666666666666
SF-K29-1,SF-R24,5,3,1,2,4,1,0.2,0.8,0.6666666666666666,0.3333333333333333
SF-K29-1,SF-R26,4,1,1,1,3,0,0.25,0.75,1.0,0.0
SF-K29-1,SF-Q26,12,13,2,2,10,11,0.16666666666666666,0.8333333333333334,0.15384615384615385,0.8461538461538461
SF-K29-1,SF-P26,7,3,1,0,6,3,0.14285714285714285,0.8571428571428571,0.0,1.0
SF-K29-1,SF-O25-2,1,9,0,3,1,6,0.0,1.0,0.3333333333333333,0.6666666666666666
SF-K29-1,SF-N22-1B,4,6,0,0,4,6,0.0,1.0,0.0,1.0
SF-K29-1,SF-N26,6,6,1,0,5,6,0.16666666666666666,0.8333333333333334,0.0,1.0
SF-K29-1,SF-N25,4,5,1,1,3,4,0.25,0.75,0.2,0.8
SF-K29-1,SF-Q23-3,3,2,3,2,0,0,1.0,0.0,1.0,0.0
SF-K29-1,SF-Q22-1,5,10,0,1,5,9,0.0,1.0,0.1,0.9
SF-K29-1,SF-Q22-2,7,8,1,1,6,7,0.14285714285714285,0.8571428571428571,0.125,0.875
SF-K29-1,SF-P22,9,7,3,5,6,2,0.3333333333333333,0.6666666666666666,0.7142857142857143,0.2857142857142857
SF-K29-1,SF-T20,2,3,0,0,2,3,0.0,1.0,0.0,1.0
SF-K29-1,SF-S21,1,3,1,0,0,3,1.0,0.0,0.0,1.0
SF-K29-1,SF-V29,2,3,0,1,2,2,0.0,1.0,0.3333333333333333,0.6666666666666666
SF-K29-1,SF-V31,1,1,0,0,1,1,0.0,1.0,0.0,1.0
SF-K29-1,SF-V32,3,6,2,5,1,1,0.6666666666666666,0.3333333333333333,0.8333333333333334,0.16666666666666666
SF-K29-1,SF-U30,2,1,1,1,1,0,0.5,0.5,1.0,0.0
SF-J28-2,SF-M26,4,1,3,1,1,0,0.75,0.25,1.0,0.0
SF-J28-2,SF-M25,12,8,8,2,4,6,0.6666666666666666,0.3333333333333333,0.25,0.75
SF-J28-2,SF-M26-2,41,25,23,12,18,13,0.5609756097560976,0.43902439024390244,0.48,0.52
SF-J28-2,SF-L27,4,12,2,6,2,6,0.5,0.5,0.5,0.5
SF-J28-2,SF-K26,46,62,33,43,13,19,0.717391304347826,0.2826086956521739,0.6935483870967742,0.3064516129032258
SF-J28-2,SF-J27,7,8,4,3,3,5,0.5714285714285714,0.42857142857142855,0.375,0.625
SF-J28-2,SF-M30,51,96,4,37,47,59,0.0784313725490196,0.9215686274509803,0.3854166666666667,0.6145833333333334
SF-J28-2,SF-L27-2,7,4,3,4,4,0,0.42857142857142855,0.5714285714285714,1.0,0.0
SF-J28-2,SF-J29-3,2,13,2,8,0,5,1.0,0.0,0.6153846153846154,0.38461538461538464
SF-J28-2,SF-J29,15,8,7,1,8,7,0.4666666666666667,0.5333333333333333,0.125,0.875
SF-J28-2,SF-L26,88,80,71,48,17,32,0.8068181818181818,0.19318181818181818,0.6,0.4
SF-J28-2,SF-M28,18,20,10,13,8,7,0.5555555555555556,0.4444444444444444,0.65,0.35
SF-J28-2,SF-L25,3,9,1,4,2,5,0.3333333333333333,0.6666666666666666,0.4444444444444444,0.5555555555555556
SF-J28-2,SF-M24,6,5,5,2,1,3,0.8333333333333334,0.16666666666666666,0.4,0.6
SF-J28-2,SF-L24,4,2,4,1,0,1,1.0,0.0,0.5,0.5
SF-J28-2,SF-N23,1,7,1,5,0,2,1.0,0.0,0.7142857142857143,0.2857142857142857
SF-J28-2,SF-N24-2,6,9,4,6,2,3,0.6666666666666666,0.3333333333333333,0.6666666666666666,0.3333333333333333
SF-J28-2,SF-K27-2,50,42,33,18,17,24,0.66,0.34,0.42857142857142855,0.5714285714285714
SF-J28-2,SF-J26-2,31,30,11,14,20,16,0.3548387096774194,0.6451612903225806,0.4666666666666667,0.5333333333333333
SF-J28-2,SF-K28-3,1,2,0,1,1,1,0.0,1.0,0.5,0.5
SF-J28-2,SF-L28,14,7,10,4,4,3,0.7142857142857143,0.2857142857142857,0.5714285714285714,0.42857142857142855
SF-J28-2,SF-K28,3,18,2,13,1,5,0.6666666666666666,0.3333333333333333,0.7222222222222222,0.2777777777777778
SF-J28-2,SF-K29-1,6,10,3,6,3,4,0.5,0.5,0.6,0.4
SF-J28-2,SF-K27,7,49,4,26,3,23,0.5714285714285714,0.42857142857142855,0.5306122448979592,0.46938775510204084
SF-J28-2,SF-K25,10,12,4,5,6,7,0.4,0.6,0.4166666666666667,0.5833333333333334
SF-J28-2,SF-J25,18,9,4,2,14,7,0.2222222222222222,0.7777777777777778,0.2222222222222222,0.7777777777777778
SF-J28-2,SF-H26-2,94,12,32,9,62,3,0.3404255319148936,0.6595744680851063,0.75,0.25
SF-J28-2,SF-P24,2,3,2,2,0,1,1.0,0.0,0.6666666666666666,0.3333333333333333
SF-J28-2,SF-J24,14,10,6,5,8,5,0.42857142857142855,0.5714285714285714,0.5,0.5
SF-J28-2,SF-J26,10,11,5,6,5,5,0.5,0.5,0.5454545454545454,0.45454545454545453
SF-J28-2,SF-I26-,4,4,2,3,2,1,0.5,0.5,0.75,0.25
SF-J28-2,SF-I25,9,20,5,5,4,15,0.5555555555555556,0.4444444444444444,0.25,0.75
SF-J28-2,SF-K23,1,3,1,3,0,0,1.0,0.0,1.0,0.0
SF-J28-2,SF-H26,8,21,4,6,4,15,0.5,0.5,0.2857142857142857,0.7142857142857143
SF-J28-2,SF-O23,5,10,1,7,4,3,0.2,0.8,0.7,0.3
SF-J28-2,SF-H27-1,8,8,6,4,2,4,0.75,0.25,0.5,0.5
SF-J28-2,SF-F28-2,13,11,3,8,10,3,0.23076923076923078,0.7692307692307693,0.7272727272727273,0.2727272727272727
SF-J28-2,SF-G27,22,25,8,12,14,13,0.36363636363636365,0.6363636363636364,0.48,0.52
SF-J28-2,SF-M22-2,6,3,2,1,4,2,0.3333333333333333,0.6666666666666666,0.3333333333333333,0.6666666666666666
SF-J28-2,SF-L22,2,8,0,1,2,7,0.0,1.0,0.125,0.875
SF-J28-2,SF-F27,13,12,3,2,10,10,0.23076923076923078,0.7692307692307693,0.16666666666666666,0.8333333333333334
SF-J28-2,SF-N22-2,9,11,1,0,8,11,0.1111111111111111,0.8888888888888888,0.0,1.0
SF-J28-2,SF-G28-2,6,1,1,0,5,1,0.16666666666666666,0.8333333333333334,0.0,1.0
SF-J28-2,SF-G28-1,2,2,0,0,2,2,0.0,1.0,0.0,1.0
SF-J28-2,SF-M22-1,6,2,0,0,6,2,0.0,1.0,0.0,1.0
SF-J28-2,SF-K22-2,7,7,3,2,4,5,0.42857142857142855,0.5714285714285714,0.2857142857142857,0.7142857142857143
SF-J28-2,SF-K24,8,8,5,5,3,3,0.625,0.375,0.625,0.375
SF-J28-2,SF-G23,3,6,3,4,0,2,1.0,0.0,0.6666666666666666,0.3333333333333333
SF-J28-2,SF-G24,4,7,0,0,4,7,0.0,1.0,0.0,1.0
SF-J28-2,SF-G25,8,5,5,1,3,4,0.625,0.375,0.2,0.8
SF-J28-2,SF-F23,2,6,1,0,1,6,0.5,0.5,0.0,1.0
SF-J28-2,SF-E23,20,5,1,1,19,4,0.05,0.95,0.2,0.8
SF-J28-2,SF-D24,2,2,1,0,1,2,0.5,0.5,0.0,1.0
SF-J28-2,SF-C22,2,2,0,2,2,0,0.0,1.0,1.0,0.0
SF-J28-2,SF-J17,1,3,1,1,0,2,1.0,0.0,0.3333333333333333,0.6666666666666666
SF-J28-2,SF-I19,2,2,0,1,2,1,0.0,1.0,0.5,0.5
SF-J28-2,SF-I20,1,3,0,2,1,1,0.0,1.0,0.6666666666666666,0.3333333333333333
SF-J28-2,SF-G19,1,2,0,2,1,0,0.0,1.0,1.0,0.0
SF-J28-2,SF-G17,3,2,0,0,3,2,0.0,1.0,0.0,1.0
SF-J28-2,SF-G18,2,1,0,0,2,1,0.0,1.0,0.0,1.0
SF-J28-2,SF-G20,7,8,0,0,7,8,0.0,1.0,0.0,1.0
SF-J28-2,SF-E18,3,1,0,0,3,1,0.0,1.0,0.0,1.0
SF-J28-2,SF-H30,2,6,1,4,1,2,0.5,0.5,0.6666666666666666,0.3333333333333333
SF-J28-2,SF-G30-2,23,24,7,15,16,9,0.30434782608695654,0.6956521739130435,0.625,0.375
SF-J28-2,SF-F30-1,3,3,2,3,1,0,0.6666666666666666,0.3333333333333333,1.0,0.0
SF-J28-2,SF-E29-2,23,77,12,68,11,9,0.5217391304347826,0.4782608695652174,0.8831168831168831,0.11688311688311688
SF-J28-2,SF-E29-1,30,68,11,55,19,13,0.36666666666666664,0.6333333333333333,0.8088235294117647,0.19117647058823528
SF-J28-2,SF-D29,41,51,4,17,37,34,0.0975609756097561,0.9024390243902439,0.3333333333333333,0.6666666666666666
SF-J28-2,SF-D28,35,32,11,12,24,20,0.3142857142857143,0.6857142857142857,0.375,0.625
SF-J28-2,SF-A27,1,1,1,0,0,1,1.0,0.0,0.0,1.0
SF-J28-2,SF-G29-2,23,14,7,4,16,10,0.30434782608695654,0.6956521739130435,0.2857142857142857,0.7142857142857143
SF-J28-2,SF-G29-1,3,8,2,3,1,5,0.6666666666666666,0.3333333333333333,0.375,0.625
SF-J28-2,SF-G30-1,14,11,5,3,9,8,0.35714285714285715,0.6428571428571429,0.2727272727272727,0.7272727272727273
SF-J28-2,SF-G29-3,6,4,0,0,6,4,0.0,1.0,0.0,1.0
SF-J28-2,SF-F30-2,4,5,1,3,3,2,0.25,0.75,0.6,0.4
SF-J28-2,SF-F29,2,5,1,1,1,4,0.5,0.5,0.2,0.8
SF-J28-2,SF-F28-1,7,7,0,0,7,7,0.0,1.0,0.0,1.0
SF-J28-2,SF-E28-2,2,1,1,0,1,1,0.5,0.5,0.0,1.0
SF-J28-2,SF-E28,4,1,0,0,4,1,0.0,1.0,0.0,1.0
SF-J28-2,SF-J12,1,1,0,0,1,1,0.0,1.0,0.0,1.0
SF-J28-2,SF-B19,27,2,0,1,27,1,0.0,1.0,0.5,0.5
SF-J28-2,SF-A20,5,9,3,2,2,7,0.6,0.4,0.2222222222222222,0.7777777777777778
SF-J28-2,SF-A19,1,1,0,0,1,1,0.0,1.0,0.0,1.0
SF-J28-2,SF-C26,2,13,1,2,1,11,0.5,0.5,0.15384615384615385,0.8461538461538461
SF-J28-2,SF-C25,18,38,1,0,17,38,0.05555555555555555,0.9444444444444444,0.0,1.0
SF-J28-2,SF-B25,15,16,1,7,14,9,0.06666666666666667,0.9333333333333333,0.4375,0.5625
SF-J28-2,SF-E27,2,4,0,2,2,2,0.0,1.0,0.5,0.5
SF-J28-2,SF-B28-2,2,2,0,0,2,2,0.0,1.0,0.0,1.0
SF-J28-2,SF-D27,16,16,2,7,14,9,0.125,0.875,0.4375,0.5625
SF-J28-2,SF-C28-1,3,1,2,1,1,0,0.6666666666666666,0.3333333333333333,1.0,0.0
SF-J28-2,SF-B28,4,6,1,0,3,6,0.25,0.75,0.0,1.0
SF-J28-2,SF-H0,2,2,0,0,2,2,0.0,1.0,0.0,1.0
SF-J28-2,SF-G8,1,1,0,0,1,1,0.0,1.0,0.0,1.0
SF-J28-2,SF-G26,6,25,2,7,4,18,0.3333333333333333,0.6666666666666666,0.28,0.72
SF-J28-2,SF-K21,2,6,0,0,2,6,0.0,1.0,0.0,1.0
SF-J28-2,SF-K22-1,4,2,3,0,1,2,0.75,0.25,0.0,1.0
SF-J28-2,SF-J23-1,19,22,14,11,5,11,0.7368421052631579,0.2631578947368421,0.5,0.5
SF-J28-2,SF-J22-1,4,3,2,0,2,3,0.5,0.5,0.0,1.0
SF-J28-2,SF-J22-2,6,7,4,3,2,4,0.6666666666666666,0.3333333333333333,0.42857142857142855,0.5714285714285714
SF-J28-2,SF-J21,1,2,0,1,1,1,0.0,1.0,0.5,0.5
SF-J28-2,SF-I21,1,2,0,1,1,1,0.0,1.0,0.5,0.5
SF-J28-2,SF-I22,4,7,1,1,3,6,0.25,0.75,0.14285714285714285,0.8571428571428571
SF-J28-2,SF-I23-2,2,1,1,1,1,0,0.5,0.5,1.0,0.0
SF-J28-2,SF-I24,2,7,0,0,2,7,0.0,1.0,0.0,1.0
SF-J28-2,SF-I23-1,10,6,1,3,9,3,0.1,0.9,0.5,0.5
SF-J28-2,SF-F26,12,11,5,2,7,9,0.4166666666666667,0.5833333333333334,0.18181818181818182,0.8181818181818182
SF-J28-2,SF-L20,1,5,0,0,1,5,0.0,1.0,0.0,1.0
SF-J28-2,SF-N20-1,4,1,0,0,4,1,0.0,1.0,0.0,1.0
SF-J28-2,SF-M20,6,6,0,3,6,3,0.0,1.0,0.5,0.5
SF-J28-2,SF-K20,3,3,1,0,2,3,0.3333333333333333,0.6666666666666666,0.0,1.0
SF-J28-2,SF-K15-,7,4,0,0,7,4,0.0,1.0,0.0,1.0
SF-J28-2,SF-J18,4,4,1,0,3,4,0.25,0.75,0.0,1.0
SF-J28-2,SF-R19,1,1,0,0,1,1,0.0,1.0,0.0,1.0
SF-J28-2,SF-O18,5,5,0,0,5,5,0.0,1.0,0.0,1.0
SF-J28-2,SF-O21,12,23,6,10,6,13,0.5,0.5,0.43478260869565216,0.5652173913043478
SF-J28-2,SF-O22,2,2,2,0,0,2,1.0,0.0,0.0,1.0
SF-J28-2,SF-N21,3,8,1,1,2,7,0.3333333333333333,0.6666666666666666,0.125,0.875
SF-J28-2,SF-N20-2,2,4,0,1,2,3,0.0,1.0,0.25,0.75
SF-J28-2,SF-M21,2,3,1,3,1,0,0.5,0.5,1.0,0.0
SF-J28-2,SF-L21,5,4,1,0,4,4,0.2,0.8,0.0,1.0
SF-J28-2,SF-Q30,9,13,3,5,6,8,0.3333333333333333,0.6666666666666666,0.38461538461538464,0.6153846153846154
SF-J28-2,SF-P30,13,32,2,20,11,12,0.15384615384615385,0.8461538461538461,0.625,0.375
SF-J28-2,SF-O30-2,5,3,4,2,1,1,0.8,0.2,0.6666666666666666,0.3333333333333333
SF-J28-2,SF-O30,12,19,7,10,5,9,0.5833333333333334,0.4166666666666667,0.5263157894736842,0.47368421052631576
SF-J28-2,SF-N27,17,14,6,3,11,11,0.35294117647058826,0.6470588235294118,0.21428571428571427,0.7857142857142857
SF-J28-2,SF-N29,6,6,5,5,1,1,0.8333333333333334,0.16666666666666666,0.8333333333333334,0.16666666666666666
SF-J28-2,SF-N28,23,26,7,10,16,16,0.30434782608695654,0.6956521739130435,0.38461538461538464,0.6153846153846154
SF-J28-2,SF-L30-1,31,44,17,18,14,26,0.5483870967741935,0.45161290322580644,0.4090909090909091,0.5909090909090909
SF-J28-2,SF-L31-1,2,3,1,2,1,1,0.5,0.5,0.6666666666666666,0.3333333333333333
SF-J28-2,SF-K30-2,6,3,6,2,0,1,1.0,0.0,0.6666666666666666,0.3333333333333333
SF-J28-2,SF-L29,13,24,10,18,3,6,0.7692307692307693,0.23076923076923078,0.75,0.25
SF-J28-2,SF-J29-1,4,8,4,6,0,2,1.0,0.0,0.75,0.25
SF-J28-2,SF-I30,13,10,12,9,1,1,0.9230769230769231,0.07692307692307693,0.9,0.1
SF-J28-2,SF-I29-2,12,11,7,8,5,3,0.5833333333333334,0.4166666666666667,0.7272727272727273,0.2727272727272727
SF-J28-2,SF-I27,13,15,10,6,3,9,0.7692307692307693,0.23076923076923078,0.4,0.6
SF-J28-2,SF-I28,8,6,6,5,2,1,0.75,0.25,0.8333333333333334,0.16666666666666666
SF-J28-2,SF-I30-2,32,20,26,18,6,2,0.8125,0.1875,0.9,0.1
SF-J28-2,SF I29-1,5,7,2,3,3,4,0.4,0.6,0.42857142857142855,0.5714285714285714
SF-J28-2,SF-H28,9,8,6,7,3,1,0.6666666666666666,0.3333333333333333,0.875,0.125
SF-J28-2,SF-H29,8,10,3,7,5,3,0.375,0.625,0.7,0.3
SF-J28-2,SF-R24,2,2,0,2,2,0,0.0,1.0,1.0,0.0
SF-J28-2,SF-R26,1,3,0,0,1,3,0.0,1.0,0.0,1.0
SF-J28-2,SF-P26,10,19,2,0,8,19,0.2,0.8,0.0,1.0
SF-J28-2,SF-O25-2,2,3,0,1,2,2,0.0,1.0,0.3333333333333333,0.6666666666666666
SF-J28-2,SF-N25,14,7,11,3,3,4,0.7857142857142857,0.21428571428571427,0.42857142857142855,0.5714285714285714
SF-J28-2,SF-T22,7,7,2,1,5,6,0.2857142857142857,0.7142857142857143,0.14285714285714285,0.8571428571428571
SF-J28-2,SF-S22-2,1,1,0,0,1,1,0.0,1.0,0.0,1.0
SF-J28-2,SF-Q22-1,1,7,0,1,1,6,0.0,1.0,0.14285714285714285,0.8571428571428571
SF-J28-2,SF-Q22-2,1,4,1,4,0,0,1.0,0.0,1.0,0.0
SF-J28-2,SF-P22,5,1,4,1,1,0,0.8,0.2,1.0,0.0
SF-J28-2,SF-W19,1,2,0,0,1,2,0.0,1.0,0.0,1.0
SF-K27,SF-M26,2,2,1,2,1,0,0.5,0.5,1.0,0.0
SF-K27,SF-M25,12,9,6,5,6,4,0.5,0.5,0.5555555555555556,0.4444444444444444
SF-K27,SF-M26-2,5,1,3,0,2,1,0.6,0.4,0.0,1.0
SF-K27,SF-L27,4,4,4,0,0,4,1.0,0.0,0.0,1.0
SF-K27,SF-K26,6,10,6,6,0,4,1.0,0.0,0.6,0.4
SF-K27,SF-J27,7,5,2,4,5,1,0.2857142857142857,0.7142857142857143,0.8,0.2
SF-K27,SF-M30,10,3,7,2,3,1,0.7,0.3,0.6666666666666666,0.3333333333333333
SF-K27,SF-L27-2,5,5,4,2,1,3,0.8,0.2,0.4,0.6
SF-K27,SF-J29-3,1,7,1,5,0,2,1.0,0.0,0.7142857142857143,0.2857142857142857
SF-K27,SF-J29,19,5,12,2,7,3,0.631578947368421,0.3684210526315789,0.4,0.6
SF-K27,SF-L26,2,2,1,1,1,1,0.5,0.5,0.5,0.5
SF-K27,SF-M28,12,4,8,2,4,2,0.6666666666666666,0.3333333333333333,0.5,0.5
SF-K27,SF-L25,102,60,102,58,0,2,1.0,0.0,0.9666666666666667,0.03333333333333333
SF-K27,SF-L24,6,8,5,3,1,5,0.8333333333333334,0.16666666666666666,0.375,0.625
SF-K27,SF-N23,1,1,0,0,1,1,0.0,1.0,0.0,1.0
SF-K27,SF-K27-2,12,4,10,4,2,0,0.8333333333333334,0.16666666666666666,1.0,0.0
SF-K27,SF-J26-2,7,16,3,14,4,2,0.42857142857142855,0.5714285714285714,0.875,0.125
SF-K27,SF-K28-3,2,1,2,0,0,1,1.0,0.0,0.0,1.0
SF-K27,SF-L28,22,2,6,1,16,1,0.2727272727272727,0.7272727272727273,0.5,0.5
SF-K27,SF-K28,5,2,3,1,2,1,0.6,0.4,0.5,0.5
SF-K27,SF-K29-1,6,3,4,3,2,0,0.6666666666666666,0.3333333333333333,1.0,0.0
SF-K27,SF-J28-2,49,7,26,4,23,3,0.5306122448979592,0.46938775510204084,0.5714285714285714,0.42857142857142855
SF-K27,SF-K25,2,7,1,6,1,1,0.5,0.5,0.8571428571428571,0.14285714285714285
SF-K27,SF-J25,26,42,22,36,4,6,0.8461538461538461,0.15384615384615385,0.8571428571428571,0.14285714285714285
SF-K27,SF-H26-2,9,7,2,4,7,3,0.2222222222222222,0.7777777777777778,0.5714285714285714,0.42857142857142855
SF-K27,SF-P24,4,1,2,1,2,0,0.5,0.5,1.0,0.0
SF-K27,SF-J24,5,7,4,4,1,3,0.8,0.2,0.5714285714285714,0.42857142857142855
SF-K27,SF-J26,3,4,2,3,1,1,0.6666666666666666,0.3333333333333333,0.75,0.25
SF-K27,SF-I26-,3,5,1,5,2,0,0.3333333333333333,0.6666666666666666,1.0,0.0
SF-K27,SF-I25,10,26,4,14,6,12,0.4,0.6,0.5384615384615384,0.46153846153846156
SF-K27,SF-H26,7,18,2,10,5,8,0.2857142857142857,0.7142857142857143,0.5555555555555556,0.4444444444444444
SF-K27,SF-O23,2,11,2,1,0,10,1.0,0.0,0.09090909090909091,0.9090909090909091
SF-K27,SF-F28-2,3,1,2,0,1,1,0.6666666666666666,0.3333333333333333,0.0,1.0
SF-K27,SF-G27,9,18,3,8,6,10,0.3333333333333333,0.6666666666666666,0.4444444444444444,0.5555555555555556
SF-K27,SF-M22-2,5,3,1,2,4,1,0.2,0.8,0.6666666666666666,0.3333333333333333
SF-K27,SF-L22,2,11,2,10,0,1,1.0,0.0,0.9090909090909091,0.09090909090909091
SF-K27,SF-F27,4,5,0,5,4,0,0.0,1.0,1.0,0.0
SF-K27,SF-G28-1,1,1,0,0,1,1,0.0,1.0,0.0,1.0
SF-K27,SF-M22-1,4,4,1,3,3,1,0.25,0.75,0.75,0.25
SF-K27,SF-K24,2,10,1,10,1,0,0.5,0.5,1.0,0.0
SF-K27,SF-G23,21,9,6,2,15,7,0.2857142857142857,0.7142857142857143,0.2222222222222222,0.7777777777777778
SF-K27,SF-G24,5,5,5,2,0,3,1.0,0.0,0.4,0.6
SF-K27,SF-G25,1,3,0,1,1,2,0.0,1.0,0.3333333333333333,0.6666666666666666
SF-K27,SF-F23,2,7,2,3,0,4,1.0,0.0,0.42857142857142855,0.5714285714285714
SF-K27,SF-E23,4,3,3,0,1,3,0.75,0.25,0.0,1.0
SF-K27,SF-C22,3,3,0,2,3,1,0.0,1.0,0.6666666666666666,0.3333333333333333
SF-K27,SF-B22,1,1,0,1,1,0,0.0,1.0,1.0,0.0
SF-K27,SF-J17,4,6,0,0,4,6,0.0,1.0,0.0,1.0
SF-K27,SF-H20,1,5,0,2,1,3,0.0,1.0,0.4,0.6
SF-K27,SF-G19,1,1,1,1,0,0,1.0,0.0,1.0,0.0
SF-K27,SF-H30,1,3,0,1,1,2,0.0,1.0,0.3333333333333333,0.6666666666666666
SF-K27,SF-G30-2,15,6,6,1,9,5,0.4,0.6,0.16666666666666666,0.8333333333333334
SF-K27,SF-E29-2,9,3,8,2,1,1,0.8888888888888888,0.1111111111111111,0.6666666666666666,0.3333333333333333
SF-K27,SF-E29-1,2,2,1,2,1,0,0.5,0.5,1.0,0.0
SF-K27,SF-D29,2,3,2,2,0,1,1.0,0.0,0.6666666666666666,0.3333333333333333
SF-K27,SF-D28,1,3,1,3,0,0,1.0,0.0,1.0,0.0
SF-K27,SF-G29-2,5,7,3,4,2,3,0.6,0.4,0.5714285714285714,0.42857142857142855
SF-K27,SF-G29-1,5,1,2,0,3,1,0.4,0.6,0.0,1.0
SF-K27,SF-G30-1,4,7,4,4,0,3,1.0,0.0,0.5714285714285714,0.42857142857142855
SF-K27,SF-G29-3,6,5,4,0,2,5,0.6666666666666666,0.3333333333333333,0.0,1.0
SF-K27,SF-F30-2,1,3,0,3,1,0,0.0,1.0,1.0,0.0
SF-K27,SF-F28-1,2,2,0,1,2,1,0.0,1.0,0.5,0.5
SF-K27,SF-H15,1,1,1,1,0,0,1.0,0.0,1.0,0.0
SF-K27,SF-A20,2,1,0,0,2,1,0.0,1.0,0.0,1.0
SF-K27,SF-C26,4,1,3,0,1,1,0.75,0.25,0.0,1.0
SF-K27,SF-C25,2,2,0,2,2,0,0.0,1.0,1.0,0.0
SF-K27,SF-E27,4,1,0,0,4,1,0.0,1.0,0.0,1.0
SF-K27,SF-D27,2,5,2,3,0,2,1.0,0.0,0.6,0.4
SF-K27,SF-B28,2,2,2,1,0,1,1.0,0.0,0.5,0.5
SF-K27,SF-J1,1,1,1,1,0,0,1.0,0.0,1.0,0.0
SF-K27,SF-H25,3,6,1,3,2,3,0.3333333333333333,0.6666666666666666,0.5,0.5
SF-K27,SF-G26,4,4,0,2,4,2,0.0,1.0,0.5,0.5
SF-K27,SF-K21,8,2,4,0,4,2,0.5,0.5,0.0,1.0
SF-K27,SF-K22-1,1,5,1,5,0,0,1.0,0.0,1.0,0.0
SF-K27,SF-J23-1,4,14,1,7,3,7,0.25,0.75,0.5,0.5
SF-K27,SF-J22-1,2,9,1,1,1,8,0.5,0.5,0.1111111111111111,0.8888888888888888
SF-K27,SF-J22-2,10,7,5,3,5,4,0.5,0.5,0.42857142857142855,0.5714285714285714
SF-K27,SF-J21,29,24,14,3,15,21,0.4827586206896552,0.5172413793103449,0.125,0.875
SF-K27,SF-I23-2,2,2,0,2,2,0,0.0,1.0,1.0,0.0
SF-K27,SF-I24,1,7,0,5,1,2,0.0,1.0,0.7142857142857143,0.2857142857142857
SF-K27,SF-I23-1,2,4,0,3,2,1,0.0,1.0,0.75,0.25
SF-K27,SF-F26,3,2,0,0,3,2,0.0,1.0,0.0,1.0
SF-K27,SF-L20,2,2,0,1,2,1,0.0,1.0,0.5,0.5
SF-K27,SF-N20-1,2,2,0,1,2,1,0.0,1.0,0.5,0.5
SF-K27,SF-M20,3,5,2,3,1,2,0.6666666666666666,0.3333333333333333,0.6,0.4
SF-K27,SF-K15-,10,34,10,32,0,2,1.0,0.0,0.9411764705882353,0.058823529411764705
SF-K27,SF-K19,1,3,0,1,1,2,0.0,1.0,0.3333333333333333,0.6666666666666666
SF-K27,SF-K18,9,5,1,0,8,5,0.1111111111111111,0.8888888888888888,0.0,1.0
SF-K27,SF-J18,11,7,0,0,11,7,0.0,1.0,0.0,1.0
SF-K27,SF-J19,3,4,0,1,3,3,0.0,1.0,0.25,0.75
SF-K27,SF-Q21-2,3,2,0,0,3,2,0.0,1.0,0.0,1.0
SF-K27,SF-O18,1,5,0,1,1,4,0.0,1.0,0.2,0.8
SF-K27,SF-O21,2,3,1,1,1,2,0.5,0.5,0.3333333333333333,0.6666666666666666
SF-K27,SF-O22,5,8,0,3,5,5,0.0,1.0,0.375,0.625
SF-K27,SF-N21,2,1,2,1,0,0,1.0,0.0,1.0,0.0
SF-K27,SF-M21,1,8,1,1,0,7,1.0,0.0,0.125,0.875
SF-K27,SF-L21,9,9,5,4,4,5,0.5555555555555556,0.4444444444444444,0.4444444444444444,0.5555555555555556
SF-K27,SF-Q30,10,1,2,1,8,0,0.2,0.8,1.0,0.0
SF-K27,SF-P30,5,6,2,2,3,4,0.4,0.6,0.3333333333333333,0.6666666666666666
SF-K27,SF-O30-2,2,1,0,0,2,1,0.0,1.0,0.0,1.0
SF-K27,SF-O30,7,13,5,12,2,1,0.7142857142857143,0.2857142857142857,0.9230769230769231,0.07692307692307693
SF-K27,SF-N27,5,5,5,0,0,5,1.0,0.0,0.0,1.0
SF-K27,SF-N29,8,2,7,2,1,0,0.875,0.125,1.0,0.0
SF-K27,SF-N28,6,4,3,2,3,2,0.5,0.5,0.5,0.5
SF-K27,SF-L30-1,13,36,8,18,5,18,0.6153846153846154,0.38461538461538464,0.5,0.5
SF-K27,SF-L31-1,3,2,2,1,1,1,0.6666666666666666,0.3333333333333333,0.5,0.5
SF-K27,SF-K30-2,9,3,5,2,4,1,0.5555555555555556,0.4444444444444444,0.6666666666666666,0.3333333333333333
SF-K27,SF-L29,9,6,4,3,5,3,0.4444444444444444,0.5555555555555556,0.5,0.5
SF-K27,SF-J29-1,2,3,1,2,1,1,0.5,0.5,0.6666666666666666,0.3333333333333333
SF-K27,SF-I29-2,4,1,1,1,3,0,0.25,0.75,1.0,0.0
SF-K27,SF-I27,2,4,0,3,2,1,0.0,1.0,0.75,0.25
SF-K27,SF-I28,3,3,2,1,1,2,0.6666666666666666,0.3333333333333333,0.3333333333333333,0.6666666666666666
SF-K27,SF-I30-2,15,3,11,0,4,3,0.7333333333333333,0.26666666666666666,0.0,1.0
SF-K27,SF-H28,7,7,5,5,2,2,0.7142857142857143,0.2857142857142857,0.7142857142857143,0.2857142857142857
SF-K27,SF-H29,7,2,7,2,0,0,1.0,0.0,1.0,0.0
SF-K27,SF-S24,1,4,0,2,1,2,0.0,1.0,0.5,0.5
SF-K27,SF-R24,3,3,0,0,3,3,0.0,1.0,0.0,1.0
SF-K27,SF-P26,2,1,1,0,1,1,0.5,0.5,0.0,1.0
SF-K27,SF-O25-2,1,3,1,0,0,3,1.0,0.0,0.0,1.0
SF-K27,SF-N26,4,3,3,3,1,0,0.75,0.25,1.0,0.0
SF-K27,SF-N25,4,10,3,8,1,2,0.75,0.25,0.8,0.2
SF-K27,SF-S22-2,1,1,0,0,1,1,0.0,1.0,0.0,1.0
SF-K27,SF-Q23-3,1,2,0,0,1,2,0.0,1.0,0.0,1.0
SF-K27,SF-Q22-1,2,2,0,0,2,2,0.0,1.0,0.0,1.0
SF-K27,SF-Q22-2,1,1,1,1,0,0,1.0,0.0,1.0,0.0
SF-K27,SF-P22,2,3,0,2,2,1,0.0,1.0,0.6666666666666666,0.3333333333333333
SF-K27,SF-U21,1,1,0,0,1,1,0.0,1.0,0.0,1.0
SF-K27,SF-T20,2,2,0,2,2,0,0.0,1.0,1.0,0.0
SF-K27,SF-X30,3,3,0,0,3,3,0.0,1.0,0.0,1.0
SF-K25,SF-M26,7,10,1,6,6,4,0.14285714285714285,0.8571428571428571,0.6,0.4
SF-K25,SF-M25,34,31,12,18,22,13,0.35294117647058826,0.6470588235294118,0.5806451612903226,0.41935483870967744
SF-K25,SF-M26-2,10,8,9,3,1,5,0.9,0.1,0.375,0.625
SF-K25,SF-L27,1,3,0,1,1,2,0.0,1.0,0.3333333333333333,0.6666666666666666
SF-K25,SF-K26,18,24,12,18,6,6,0.6666666666666666,0.3333333333333333,0.75,0.25
SF-K25,SF-J27,18,13,18,8,0,5,1.0,0.0,0.6153846153846154,0.38461538461538464
SF-K25,SF-M30,33,15,13,8,20,7,0.3939393939393939,0.6060606060606061,0.5333333333333333,0.4666666666666667
SF-K25,SF-L27-2,11,8,9,7,2,1,0.8181818181818182,0.18181818181818182,0.875,0.125
SF-K25,SF-J29-3,11,9,8,7,3,2,0.7272727272727273,0.2727272727272727,0.7777777777777778,0.2222222222222222
SF-K25,SF-J29,33,37,8,22,25,15,0.24242424242424243,0.7575757575757576,0.5945945945945946,0.40540540540540543
SF-K25,SF-L26,11,8,7,5,4,3,0.6363636363636364,0.36363636363636365,0.625,0.375
SF-K25,SF-M28,3,11,2,5,1,6,0.6666666666666666,0.3333333333333333,0.45454545454545453,0.5454545454545454
SF-K25,SF-M27,3,3,1,2,2,1,0.3333333333333333,0.6666666666666666,0.6666666666666666,0.3333333333333333
SF-K25,SF-L25,23,15,17,15,6,0,0.7391304347826086,0.2608695652173913,1.0,0.0
SF-K25,SF-M24,26,9,20,7,6,2,0.7692307692307693,0.23076923076923078,0.7777777777777778,0.2222222222222222
SF-K25,SF-L24,66,50,57,35,9,15,0.8636363636363636,0.13636363636363635,0.7,0.3
SF-K25,SF-N23,38,25,22,14,16,11,0.5789473684210527,0.42105263157894735,0.56,0.44
SF-K25,SF-N24-2,13,16,7,9,6,7,0.5384615384615384,0.46153846153846156,0.5625,0.4375
SF-K25,SF-K27-2,11,12,9,12,2,0,0.8181818181818182,0.18181818181818182,1.0,0.0
SF-K25,SF-J26-2,27,68,15,61,12,7,0.5555555555555556,0.4444444444444444,0.8970588235294118,0.10294117647058823
SF-K25,SF-L28,21,23,18,18,3,5,0.8571428571428571,0.14285714285714285,0.782608695652174,0.21739130434782608
SF-K25,SF-K28,11,3,6,2,5,1,0.5454545454545454,0.45454545454545453,0.6666666666666666,0.3333333333333333
SF-K25,SF-K29-1,8,19,4,4,4,15,0.5,0.5,0.21052631578947367,0.7894736842105263
SF-K25,SF-J28-2,12,10,5,4,7,6,0.4166666666666667,0.5833333333333334,0.4,0.6
SF-K25,SF-K27,7,2,6,1,1,1,0.8571428571428571,0.14285714285714285,0.5,0.5
SF-K25,SF-J25,38,35,28,20,10,15,0.7368421052631579,0.2631578947368421,0.5714285714285714,0.42857142857142855
SF-K25,SF-H26-2,124,130,99,97,25,33,0.7983870967741935,0.20161290322580644,0.7461538461538462,0.25384615384615383
SF-K25,SF-P24,7,8,4,5,3,3,0.5714285714285714,0.42857142857142855,0.625,0.375
SF-K25,SF-N22-1A,1,3,0,3,1,0,0.0,1.0,1.0,0.0
SF-K25,SF-J24,41,51,26,39,15,12,0.6341463414634146,0.36585365853658536,0.7647058823529411,0.23529411764705882
SF-K25,SF-O24,21,16,14,11,7,5,0.6666666666666666,0.3333333333333333,0.6875,0.3125
SF-K25,SF-J26,12,43,7,35,5,8,0.5833333333333334,0.4166666666666667,0.813953488372093,0.18604651162790697
SF-K25,SF-I26-,13,13,9,3,4,10,0.6923076923076923,0.3076923076923077,0.23076923076923078,0.7692307692307693
SF-K25,SF-I25,24,24,18,13,6,11,0.75,0.25,0.5416666666666666,0.4583333333333333
SF-K25,SF-K23,6,4,6,4,0,0,1.0,0.0,1.0,0.0
SF-K25,SF-H26,54,70,42,57,12,13,0.7777777777777778,0.2222222222222222,0.8142857142857143,0.18571428571428572
SF-K25,SF-O23,35,29,19,17,16,12,0.5428571428571428,0.45714285714285713,0.5862068965517241,0.41379310344827586
SF-K25,SF-H27-1,19,30,14,15,5,15,0.7368421052631579,0.2631578947368421,0.5,0.5
SF-K25,SF-F28-2,12,9,4,2,8,7,0.3333333333333333,0.6666666666666666,0.2222222222222222,0.7777777777777778
SF-K25,SF-G27,22,33,5,17,17,16,0.22727272727272727,0.7727272727272727,0.5151515151515151,0.48484848484848486
SF-K25,SF-M22-2,39,12,21,6,18,6,0.5384615384615384,0.46153846153846156,0.5,0.5
SF-K25,SF-L22,14,11,2,5,12,6,0.14285714285714285,0.8571428571428571,0.45454545454545453,0.5454545454545454
SF-K25,SF-F27,10,19,4,1,6,18,0.4,0.6,0.05263157894736842,0.9473684210526315
SF-K25,SF-N22-2,55,63,26,37,29,26,0.4727272727272727,0.5272727272727272,0.5873015873015873,0.4126984126984127
SF-K25,SF-G28-2,2,6,0,3,2,3,0.0,1.0,0.5,0.5
SF-K25,SF-G28-1,10,2,1,1,9,1,0.1,0.9,0.5,0.5
SF-K25,SF-M22-1,39,17,26,12,13,5,0.6666666666666666,0.3333333333333333,0.7058823529411765,0.29411764705882354
SF-K25,SF-O25-1,10,5,4,0,6,5,0.4,0.6,0.0,1.0
SF-K25,SF-K22-2,8,3,7,2,1,1,0.875,0.125,0.6666666666666666,0.3333333333333333
SF-K25,SF-K24,20,32,17,28,3,4,0.85,0.15,0.875,0.125
SF-K25,SF-J23-2,12,22,6,13,6,9,0.5,0.5,0.5909090909090909,0.4090909090909091
SF-K25,SF-G23,23,12,13,3,10,9,0.5652173913043478,0.43478260869565216,0.25,0.75
SF-K25,SF-G24,125,113,113,53,12,60,0.904,0.096,0.4690265486725664,0.5309734513274337
SF-K25,SF-G25,11,8,4,2,7,6,0.36363636363636365,0.6363636363636364,0.25,0.75
SF-K25,SF-F23,15,21,4,2,11,19,0.26666666666666666,0.7333333333333333,0.09523809523809523,0.9047619047619048
SF-K25,SF-E23,41,16,10,3,31,13,0.24390243902439024,0.7560975609756098,0.1875,0.8125
SF-K25,SF-D24,7,12,6,0,1,12,0.8571428571428571,0.14285714285714285,0.0,1.0
SF-K25,SF-C22,2,6,0,0,2,6,0.0,1.0,0.0,1.0
SF-K25,SF-B22,2,12,0,7,2,5,0.0,1.0,0.5833333333333334,0.4166666666666667
SF-K25,SF-J17,3,1,0,0,3,1,0.0,1.0,0.0,1.0
SF-K25,SF-I19,2,1,2,0,0,1,1.0,0.0,0.0,1.0
SF-K25,SF-I20,11,11,10,9,1,2,0.9090909090909091,0.09090909090909091,0.8181818181818182,0.18181818181818182
SF-K25,SF-H20,11,4,8,1,3,3,0.7272727272727273,0.2727272727272727,0.25,0.75
SF-K25,SF-H18,3,2,1,0,2,2,0.3333333333333333,0.6666666666666666,0.0,1.0
SF-K25,SF-G19,7,13,7,1,0,12,1.0,0.0,0.07692307692307693,0.9230769230769231
SF-K25,SF-G18,3,1,0,0,3,1,0.0,1.0,0.0,1.0
SF-K25,SF-G20,5,8,1,4,4,4,0.2,0.8,0.5,0.5
SF-K25,SF-F19,2,5,1,0,1,5,0.5,0.5,0.0,1.0
SF-K25,SF-E18,1,18,0,0,1,18,0.0,1.0,0.0,1.0
SF-K25,SF-E20,3,2,1,0,2,2,0.3333333333333333,0.6666666666666666,0.0,1.0
SF-K25,SF-H30,4,3,3,2,1,1,0.75,0.25,0.6666666666666666,0.3333333333333333
SF-K25,SF-G30-2,12,15,3,3,9,12,0.25,0.75,0.2,0.8
SF-K25,SF-F30-1,28,40,4,6,24,34,0.14285714285714285,0.8571428571428571,0.15,0.85
SF-K25,SF-E29-2,7,6,1,1,6,5,0.14285714285714285,0.8571428571428571,0.16666666666666666,0.8333333333333334
SF-K25,SF-E29-1,7,17,4,13,3,4,0.5714285714285714,0.42857142857142855,0.7647058823529411,0.23529411764705882
SF-K25,SF-D29,2,18,2,13,0,5,1.0,0.0,0.7222222222222222,0.2777777777777778
SF-K25,SF-D28,8,13,5,6,3,7,0.625,0.375,0.46153846153846156,0.5384615384615384
SF-K25,SF-A27,3,4,1,2,2,2,0.3333333333333333,0.6666666666666666,0.5,0.5
SF-K25,SF-G29-2,10,22,4,7,6,15,0.4,0.6,0.3181818181818182,0.6818181818181818
SF-K25,SF-G29-1,14,21,13,16,1,5,0.9285714285714286,0.07142857142857142,0.7619047619047619,0.23809523809523808
SF-K25,SF-G30-1,8,16,0,8,8,8,0.0,1.0,0.5,0.5
SF-K25,SF-G29-3,14,6,5,3,9,3,0.35714285714285715,0.6428571428571429,0.5,0.5
SF-K25,SF-F30-2,40,58,32,41,8,17,0.8,0.2,0.7068965517241379,0.29310344827586204
SF-K25,SF-F29,23,2,5,2,18,0,0.21739130434782608,0.782608695652174,1.0,0.0
SF-K25,SF-F28-1,5,6,3,4,2,2,0.6,0.4,0.6666666666666666,0.3333333333333333
SF-K25,SF-E28,7,3,7,3,0,0,1.0,0.0,1.0,0.0
SF-K25,SF-J10,1,2,1,0,0,2,1.0,0.0,0.0,1.0
SF-K25,SF-J13,5,1,0,0,5,1,0.0,1.0,0.0,1.0
SF-K25,SF-C21,1,2,1,1,0,1,1.0,0.0,0.5,0.5
SF-K25,SF-B21,1,1,0,0,1,1,0.0,1.0,0.0,1.0
SF-K25,SF-B19,4,6,1,2,3,4,0.25,0.75,0.3333333333333333,0.6666666666666666
SF-K25,SF-A20,2,8,0,2,2,6,0.0,1.0,0.25,0.75
SF-K25,SF-C26,3,3,2,0,1,3,0.6666666666666666,0.3333333333333333,0.0,1.0
SF-K25,SF-C25,4,6,2,4,2,2,0.5,0.5,0.6666666666666666,0.3333333333333333
SF-K25,SF-B25,1,9,0,1,1,8,0.0,1.0,0.1111111111111111,0.8888888888888888
SF-K25,SF-E27,14,11,1,3,13,8,0.07142857142857142,0.9285714285714286,0.2727272727272727,0.7272727272727273
SF-K25,SF-B28-2,4,14,3,1,1,13,0.75,0.25,0.07142857142857142,0.9285714285714286
SF-K25,SF-C28-2,1,3,1,1,0,2,1.0,0.0,0.3333333333333333,0.6666666666666666
SF-K25,SF-C28-1,1,5,0,3,1,2,0.0,1.0,0.6,0.4
SF-K25,SF-B28,7,8,6,7,1,1,0.8571428571428571,0.14285714285714285,0.875,0.125
SF-K25,SF-H0,1,1,0,0,1,1,0.0,1.0,0.0,1.0
SF-K25,SF-G7,5,1,4,0,1,1,0.8,0.2,0.0,1.0
SF-K25,SF-H25,2,5,0,4,2,1,0.0,1.0,0.8,0.2
SF-K25,SF-G26,13,16,9,7,4,9,0.6923076923076923,0.3076923076923077,0.4375,0.5625
SF-K25,SF-K21,3,4,1,0,2,4,0.3333333333333333,0.6666666666666666,0.0,1.0
SF-K25,SF-K22-1,14,15,12,11,2,4,0.8571428571428571,0.14285714285714285,0.7333333333333333,0.26666666666666666
SF-K25,SF-J23-1,28,61,21,51,7,10,0.75,0.25,0.8360655737704918,0.16393442622950818
SF-K25,SF-J22-1,7,14,3,4,4,10,0.42857142857142855,0.5714285714285714,0.2857142857142857,0.7142857142857143
SF-K25,SF-J22-2,4,25,2,15,2,10,0.5,0.5,0.6,0.4
SF-K25,SF-J21,12,17,6,8,6,9,0.5,0.5,0.47058823529411764,0.5294117647058824
SF-K25,SF-I21,5,1,3,0,2,1,0.6,0.4,0.0,1.0
SF-K25,SF-I22,11,5,6,2,5,3,0.5454545454545454,0.45454545454545453,0.4,0.6
SF-K25,SF-I23-2,8,6,4,3,4,3,0.5,0.5,0.5,0.5
SF-K25,SF-I24,11,13,10,13,1,0,0.9090909090909091,0.09090909090909091,1.0,0.0
SF-K25,SF-I23-1,37,25,18,17,19,8,0.4864864864864865,0.5135135135135135,0.68,0.32
SF-K25,SF-F26,33,31,22,11,11,20,0.6666666666666666,0.3333333333333333,0.3548387096774194,0.6451612903225806
SF-K25,SF-M13,6,8,3,1,3,7,0.5,0.5,0.125,0.875
SF-K25,SF-M15,8,4,4,0,4,4,0.5,0.5,0.0,1.0
SF-K25,SF-L19,19,10,7,6,12,4,0.3684210526315789,0.631578947368421,0.6,0.4
SF-K25,SF-L20,5,4,2,1,3,3,0.4,0.6,0.25,0.75
SF-K25,SF-N20-1,11,10,8,6,3,4,0.7272727272727273,0.2727272727272727,0.6,0.4
SF-K25,SF-M20,39,14,19,0,20,14,0.48717948717948717,0.5128205128205128,0.0,1.0
SF-K25,SF-K17-2,7,2,2,0,5,2,0.2857142857142857,0.7142857142857143,0.0,1.0
SF-K25,SF-K20,18,6,5,3,13,3,0.2777777777777778,0.7222222222222222,0.5,0.5
SF-K25,SF-K15-,9,1,3,1,6,0,0.3333333333333333,0.6666666666666666,1.0,0.0
SF-K25,SF-K19,37,23,12,2,25,21,0.32432432432432434,0.6756756756756757,0.08695652173913043,0.9130434782608695
SF-K25,SF-K18,23,6,10,0,13,6,0.43478260869565216,0.5652173913043478,0.0,1.0
SF-K25,SF-K17,9,7,2,4,7,3,0.2222222222222222,0.7777777777777778,0.5714285714285714,0.42857142857142855
SF-K25,SF-J18,17,5,8,0,9,5,0.47058823529411764,0.5294117647058824,0.0,1.0
SF-K25,SF-J20,3,10,0,4,3,6,0.0,1.0,0.4,0.6
SF-K25,SF-J19,4,16,2,7,2,9,0.5,0.5,0.4375,0.5625
SF-K25,SF-M12,5,8,1,1,4,7,0.2,0.8,0.125,0.875
SF-K25,SF-M10,2,1,1,0,1,1,0.5,0.5,0.0,1.0
SF-K25,SF-R19,25,5,5,0,20,5,0.2,0.8,0.0,1.0
SF-K25,SF-R20,1,2,0,0,1,2,0.0,1.0,0.0,1.0
SF-K25,SF-Q21-2,13,8,3,0,10,8,0.23076923076923078,0.7692307692307693,0.0,1.0
SF-K25,SF-Q21-1,7,2,4,0,3,2,0.5714285714285714,0.42857142857142855,0.0,1.0
SF-K25,SF-P21,2,8,1,4,1,4,0.5,0.5,0.5,0.5
SF-K25,SF-O19,41,35,24,16,17,19,0.5853658536585366,0.4146341463414634,0.45714285714285713,0.5428571428571428
SF-K25,SF-O21,49,42,22,20,27,22,0.4489795918367347,0.5510204081632653,0.47619047619047616,0.5238095238095238
SF-K25,SF-O22,17,18,4,11,13,7,0.23529411764705882,0.7647058823529411,0.6111111111111112,0.3888888888888889
SF-K25,SF-N21,11,9,5,4,6,5,0.45454545454545453,0.5454545454545454,0.4444444444444444,0.5555555555555556
SF-K25,SF-N20-2,4,1,2,1,2,0,0.5,0.5,1.0,0.0
SF-K25,SF-M21,6,8,2,7,4,1,0.3333333333333333,0.6666666666666666,0.875,0.125
SF-K25,SF-L21,23,24,10,14,13,10,0.43478260869565216,0.5652173913043478,0.5833333333333334,0.4166666666666667
SF-K25,SF-S29,1,1,0,0,1,1,0.0,1.0,0.0,1.0
SF-K25,SF-S30,3,13,2,9,1,4,0.6666666666666666,0.3333333333333333,0.6923076923076923,0.3076923076923077
SF-K25,SF-Q30,1,6,0,1,1,5,0.0,1.0,0.16666666666666666,0.8333333333333334
SF-K25,SF-P30,3,4,1,1,2,3,0.3333333333333333,0.6666666666666666,0.25,0.75
SF-K25,SF-O30-2,2,6,2,5,0,1,1.0,0.0,0.8333333333333334,0.16666666666666666
SF-K25,SF-O30,6,7,1,3,5,4,0.16666666666666666,0.8333333333333334,0.42857142857142855,0.5714285714285714
SF-K25,SF-N27,11,14,6,9,5,5,0.5454545454545454,0.45454545454545453,0.6428571428571429,0.35714285714285715
SF-K25,SF-N29,4,5,2,4,2,1,0.5,0.5,0.8,0.2
SF-K25,SF-N28,10,11,5,9,5,2,0.5,0.5,0.8181818181818182,0.18181818181818182
SF-K25,SF-L30-1,14,18,11,13,3,5,0.7857142857142857,0.21428571428571427,0.7222222222222222,0.2777777777777778
SF-K25,SF-L31-1,3,4,2,4,1,0,0.6666666666666666,0.3333333333333333,1.0,0.0
SF-K25,SF-K30-2,3,10,1,3,2,7,0.3333333333333333,0.6666666666666666,0.3,0.7
SF-K25,SF-L29,9,7,6,2,3,5,0.6666666666666666,0.3333333333333333,0.2857142857142857,0.7142857142857143
SF-K25,SF-J29-1,12,7,7,5,5,2,0.5833333333333334,0.4166666666666667,0.7142857142857143,0.2857142857142857
SF-K25,SF-I30,3,4,1,3,2,1,0.3333333333333333,0.6666666666666666,0.75,0.25
SF-K25,SF-I29-2,2,7,0,1,2,6,0.0,1.0,0.14285714285714285,0.8571428571428571
SF-K25,SF-I27,25,112,17,94,8,18,0.68,0.32,0.8392857142857143,0.16071428571428573
SF-K25,SF-I28,25,67,18,52,7,15,0.72,0.28,0.7761194029850746,0.22388059701492538
SF-K25,SF-I30-2,20,20,14,18,6,2,0.7,0.3,0.9,0.1
SF-K25,SF I29-1,1,6,1,1,0,5,1.0,0.0,0.16666666666666666,0.8333333333333334
SF-K25,SF-H28,20,73,7,48,13,25,0.35,0.65,0.6575342465753424,0.3424657534246575
SF-K25,SF-H29,4,20,3,4,1,16,0.75,0.25,0.2,0.8
SF-K25,SF-S24,19,18,13,12,6,6,0.6842105263157895,0.3157894736842105,0.6666666666666666,0.3333333333333333
SF-K25,SF-R24,34,17,15,9,19,8,0.4411764705882353,0.5588235294117647,0.5294117647058824,0.47058823529411764
SF-K25,SF-R26,6,3,5,1,1,2,0.8333333333333334,0.16666666666666666,0.3333333333333333,0.6666666666666666
SF-K25,SF-Q26,2,4,0,1,2,3,0.0,1.0,0.25,0.75
SF-K25,SF-P26,7,7,0,2,7,5,0.0,1.0,0.2857142857142857,0.7142857142857143
SF-K25,SF-O25-2,7,10,3,2,4,8,0.42857142857142855,0.5714285714285714,0.2,0.8
SF-K25,SF-N22-1B,9,7,5,6,4,1,0.5555555555555556,0.4444444444444444,0.8571428571428571,0.14285714285714285
SF-K25,SF-N26,8,5,1,0,7,5,0.125,0.875,0.0,1.0
SF-K25,SF-N25,2,4,1,2,1,2,0.5,0.5,0.5,0.5
SF-K25,SF-T22,10,2,2,2,8,0,0.2,0.8,1.0,0.0
SF-K25,SF-S22-2,7,2,4,0,3,2,0.5714285714285714,0.42857142857142855,0.0,1.0
SF-K25,SF-S22-1,8,9,0,0,8,9,0.0,1.0,0.0,1.0
SF-K25,SF-Q23-3,22,7,9,0,13,7,0.4090909090909091,0.5909090909090909,0.0,1.0
SF-K25,SF-Q22-1,17,10,7,3,10,7,0.4117647058823529,0.5882352941176471,0.3,0.7
SF-K25,SF-Q22-2,24,16,6,7,18,9,0.25,0.75,0.4375,0.5625
SF-K25,SF-P22,13,16,3,6,10,10,0.23076923076923078,0.7692307692307693,0.375,0.625
SF-K25,SF-T20,4,1,1,0,3,1,0.25,0.75,0.0,1.0
SF-K25,SF-V32,1,3,0,0,1,3,0.0,1.0,0.0,1.0
SF-K25,SF-U30,1,1,1,1,0,0,1.0,0.0,1.0,0.0
SF-K25,SF-W14,3,1,0,1,3,0,0.0,1.0,1.0,0.0
SF-K25,SF-Z6,1,1,0,0,1,1,0.0,1.0,0.0,1.0
SF-J25,SF-M26,6,8,3,3,3,5,0.5,0.5,0.375,0.625
SF-J25,SF-M25,37,36,14,11,23,25,0.3783783783783784,0.6216216216216216,0.3055555555555556,0.6944444444444444
SF-J25,SF-M26-2,56,45,10,11,46,34,0.17857142857142858,0.8214285714285714,0.24444444444444444,0.7555555555555555
SF-J25,SF-L27,6,3,3,2,3,1,0.5,0.5,0.6666666666666666,0.3333333333333333
SF-J25,SF-K26,57,119,28,84,29,35,0.49122807017543857,0.5087719298245614,0.7058823529411765,0.29411764705882354
SF-J25,SF-J27,18,10,11,4,7,6,0.6111111111111112,0.3888888888888889,0.4,0.6
SF-J25,SF-M30,96,32,87,18,9,14,0.90625,0.09375,0.5625,0.4375
SF-J25,SF-L27-2,7,9,6,6,1,3,0.8571428571428571,0.14285714285714285,0.6666666666666666,0.3333333333333333
SF-J25,SF-J29-3,28,18,12,13,16,5,0.42857142857142855,0.5714285714285714,0.7222222222222222,0.2777777777777778
SF-J25,SF-J29,84,107,37,58,47,49,0.44047619047619047,0.5595238095238095,0.5420560747663551,0.45794392523364486
SF-J25,SF-L26,49,74,5,21,44,53,0.10204081632653061,0.8979591836734694,0.28378378378378377,0.7162162162162162
SF-J25,SF-M28,10,18,3,6,7,12,0.3,0.7,0.3333333333333333,0.6666666666666666
SF-J25,SF-M27,3,2,2,1,1,1,0.6666666666666666,0.3333333333333333,0.5,0.5
SF-J25,SF-L25,34,55,20,33,14,22,0.5882352941176471,0.4117647058823529,0.6,0.4
SF-J25,SF-M24,21,28,11,20,10,8,0.5238095238095238,0.47619047619047616,0.7142857142857143,0.2857142857142857
SF-J25,SF-L24,43,85,25,45,18,40,0.5813953488372093,0.4186046511627907,0.5294117647058824,0.47058823529411764
SF-J25,SF-N23,12,19,5,13,7,6,0.4166666666666667,0.5833333333333334,0.6842105263157895,0.3157894736842105
SF-J25,SF-N24-2,9,14,8,11,1,3,0.8888888888888888,0.1111111111111111,0.7857142857142857,0.21428571428571427
SF-J25,SF-K27-2,22,36,13,27,9,9,0.5909090909090909,0.4090909090909091,0.75,0.25
SF-J25,SF-J26-2,64,103,39,88,25,15,0.609375,0.390625,0.8543689320388349,0.14563106796116504
SF-J25,SF-K28-3,7,1,2,1,5,0,0.2857142857142857,0.7142857142857143,1.0,0.0
SF-J25,SF-L28,24,29,16,16,8,13,0.6666666666666666,0.3333333333333333,0.5517241379310345,0.4482758620689655
SF-J25,SF-K28,13,5,5,4,8,1,0.38461538461538464,0.6153846153846154,0.8,0.2
SF-J25,SF-K29-1,51,57,23,26,28,31,0.45098039215686275,0.5490196078431373,0.45614035087719296,0.543859649122807
SF-J25,SF-J28-2,9,18,2,4,7,14,0.2222222222222222,0.7777777777777778,0.2222222222222222,0.7777777777777778
SF-J25,SF-K27,42,26,36,22,6,4,0.8571428571428571,0.14285714285714285,0.8461538461538461,0.15384615384615385
SF-J25,SF-K25,35,38,20,28,15,10,0.5714285714285714,0.42857142857142855,0.7368421052631579,0.2631578947368421
SF-J25,SF-H26-2,21,28,17,15,4,13,0.8095238095238095,0.19047619047619047,0.5357142857142857,0.4642857142857143
SF-J25,SF-P24,19,20,8,12,11,8,0.42105263157894735,0.5789473684210527,0.6,0.4
SF-J25,SF-N22-1A,3,2,3,2,0,0,1.0,0.0,1.0,0.0
SF-J25,SF-J24,88,119,43,93,45,26,0.48863636363636365,0.5113636363636364,0.7815126050420168,0.2184873949579832
SF-J25,SF-O24,11,20,2,10,9,10,0.18181818181818182,0.8181818181818182,0.5,0.5
SF-J25,SF-J26,28,11,21,6,7,5,0.75,0.25,0.5454545454545454,0.45454545454545453
SF-J25,SF-I26-,69,20,58,17,11,3,0.8405797101449275,0.15942028985507245,0.85,0.15
SF-J25,SF-I25,45,25,34,19,11,6,0.7555555555555555,0.24444444444444444,0.76,0.24
SF-J25,SF-K23,1,3,1,3,0,0,1.0,0.0,1.0,0.0
SF-J25,SF-H26,52,44,27,22,25,22,0.5192307692307693,0.4807692307692308,0.5,0.5
SF-J25,SF-O23,20,36,5,8,15,28,0.25,0.75,0.2222222222222222,0.7777777777777778
SF-J25,SF-H27-1,79,23,63,15,16,8,0.7974683544303798,0.20253164556962025,0.6521739130434783,0.34782608695652173
SF-J25,SF-F28-2,49,24,11,9,38,15,0.22448979591836735,0.7755102040816326,0.375,0.625
SF-J25,SF-G27,78,85,37,35,41,50,0.47435897435897434,0.5256410256410257,0.4117647058823529,0.5882352941176471
SF-J25,SF-M22-2,79,95,2,18,77,77,0.02531645569620253,0.9746835443037974,0.18947368421052632,0.8105263157894737
SF-J25,SF-L22,19,15,8,6,11,9,0.42105263157894735,0.5789473684210527,0.4,0.6
SF-J25,SF-F27,22,24,8,17,14,7,0.36363636363636365,0.6363636363636364,0.7083333333333334,0.2916666666666667
SF-J25,SF-N22-2,19,109,6,46,13,63,0.3157894736842105,0.6842105263157895,0.42201834862385323,0.5779816513761468
SF-J25,SF-G28-2,18,2,7,1,11,1,0.3888888888888889,0.6111111111111112,0.5,0.5
SF-J25,SF-G28-1,44,10,20,5,24,5,0.45454545454545453,0.5454545454545454,0.5,0.5
SF-J25,SF-M22-1,36,18,10,10,26,8,0.2777777777777778,0.7222222222222222,0.5555555555555556,0.4444444444444444
SF-J25,SF-O25-1,9,2,2,0,7,2,0.2222222222222222,0.7777777777777778,0.0,1.0
SF-J25,SF-K22-2,10,27,2,9,8,18,0.2,0.8,0.3333333333333333,0.6666666666666666
SF-J25,SF-K24,20,43,13,34,7,9,0.65,0.35,0.7906976744186046,0.20930232558139536
SF-J25,SF-J23-2,9,21,6,14,3,7,0.6666666666666666,0.3333333333333333,0.6666666666666666,0.3333333333333333
SF-J25,SF-G23,24,24,10,3,14,21,0.4166666666666667,0.5833333333333334,0.125,0.875
SF-J25,SF-G24,63,40,28,8,35,32,0.4444444444444444,0.5555555555555556,0.2,0.8
SF-J25,SF-G25,51,12,6,1,45,11,0.11764705882352941,0.8823529411764706,0.08333333333333333,0.9166666666666666
SF-J25,SF-F23,38,51,30,23,8,28,0.7894736842105263,0.21052631578947367,0.45098039215686275,0.5490196078431373
SF-J25,SF-E23,8,14,4,1,4,13,0.5,0.5,0.07142857142857142,0.9285714285714286
SF-J25,SF-D24,2,6,2,0,0,6,1.0,0.0,0.0,1.0
SF-J25,SF-C22,4,4,2,2,2,2,0.5,0.5,0.5,0.5
SF-J25,SF-B22,12,33,1,10,11,23,0.08333333333333333,0.9166666666666666,0.30303030303030304,0.696969696969697
SF-J25,SF-J17,46,9,14,1,32,8,0.30434782608695654,0.6956521739130435,0.1111111111111111,0.8888888888888888
SF-J25,SF-I20,8,8,5,4,3,4,0.625,0.375,0.5,0.5
SF-J25,SF-H16,3,6,2,1,1,5,0.6666666666666666,0.3333333333333333,0.16666666666666666,0.8333333333333334
SF-J25,SF-H19,1,1,1,1,0,0,1.0,0.0,1.0,0.0
SF-J25,SF-H20,43,51,37,48,6,3,0.8604651162790697,0.13953488372093023,0.9411764705882353,0.058823529411764705
SF-J25,SF-H17,2,4,2,3,0,1,1.0,0.0,0.75,0.25
SF-J25,SF-G19,19,16,6,5,13,11,0.3157894736842105,0.6842105263157895,0.3125,0.6875
SF-J25,SF-G17,2,1,0,0,2,1,0.0,1.0,0.0,1.0
SF-J25,SF-G18,5,3,2,1,3,2,0.4,0.6,0.3333333333333333,0.6666666666666666
SF-J25,SF-G20,25,16,7,6,18,10,0.28,0.72,0.375,0.625
SF-J25,SF-F19,10,13,4,5,6,8,0.4,0.6,0.38461538461538464,0.6153846153846154
SF-J25,SF-E18,17,28,16,13,1,15,0.9411764705882353,0.058823529411764705,0.4642857142857143,0.5357142857142857
SF-J25,SF-E20,2,2,1,0,1,2,0.5,0.5,0.0,1.0
SF-J25,SF-H30,15,17,5,11,10,6,0.3333333333333333,0.6666666666666666,0.6470588235294118,0.35294117647058826
SF-J25,SF-G30-2,37,24,18,7,19,17,0.4864864864864865,0.5135135135135135,0.2916666666666667,0.7083333333333334
SF-J25,SF-F30-1,26,14,19,10,7,4,0.7307692307692307,0.2692307692307692,0.7142857142857143,0.2857142857142857
SF-J25,SF-E29-2,33,29,22,25,11,4,0.6666666666666666,0.3333333333333333,0.8620689655172413,0.13793103448275862
SF-J25,SF-E29-1,42,40,18,21,24,19,0.42857142857142855,0.5714285714285714,0.525,0.475
SF-J25,SF-D29,20,14,12,11,8,3,0.6,0.4,0.7857142857142857,0.21428571428571427
SF-J25,SF-D28,8,4,3,1,5,3,0.375,0.625,0.25,0.75
SF-J25,SF-A27,47,44,44,40,3,4,0.9361702127659575,0.06382978723404255,0.9090909090909091,0.09090909090909091
SF-J25,SF-G29-2,66,40,25,21,41,19,0.3787878787878788,0.6212121212121212,0.525,0.475
SF-J25,SF-G29-1,43,17,25,12,18,5,0.5813953488372093,0.4186046511627907,0.7058823529411765,0.29411764705882354
SF-J25,SF-G30-1,19,22,7,11,12,11,0.3684210526315789,0.631578947368421,0.5,0.5
SF-J25,SF-G29-3,73,35,26,12,47,23,0.3561643835616438,0.6438356164383562,0.34285714285714286,0.6571428571428571
SF-J25,SF-F30-2,26,20,20,4,6,16,0.7692307692307693,0.23076923076923078,0.2,0.8
SF-J25,SF-F29,118,19,98,11,20,8,0.8305084745762712,0.1694915254237288,0.5789473684210527,0.42105263157894735
SF-J25,SF-E29-3,10,1,3,0,7,1,0.3,0.7,0.0,1.0
SF-J25,SF-F28-1,11,42,3,2,8,40,0.2727272727272727,0.7272727272727273,0.047619047619047616,0.9523809523809523
SF-J25,SF-E28,7,6,1,0,6,6,0.14285714285714285,0.8571428571428571,0.0,1.0
SF-J25,SF-J10,6,4,5,2,1,2,0.8333333333333334,0.16666666666666666,0.5,0.5
SF-J25,SF-J13,5,4,0,2,5,2,0.0,1.0,0.5,0.5
SF-J25,SF-J15,3,1,1,0,2,1,0.3333333333333333,0.6666666666666666,0.0,1.0
SF-J25,SF-H13,11,3,0,0,11,3,0.0,1.0,0.0,1.0
SF-J25,SF-H12,13,14,0,0,13,14,0.0,1.0,0.0,1.0
SF-J25,SF-H15,1,1,0,0,1,1,0.0,1.0,0.0,1.0
SF-J25,SF-G9,6,2,0,0,6,2,0.0,1.0,0.0,1.0
SF-J25,SF-G13,6,2,0,0,6,2,0.0,1.0,0.0,1.0
SF-J25,SF-G11,2,1,1,0,1,1,0.5,0.5,0.0,1.0
SF-J25,SF-G12,3,1,0,0,3,1,0.0,1.0,0.0,1.0
SF-J25,SF-F15,1,2,0,2,1,0,0.0,1.0,1.0,0.0
SF-J25,SF-F16,3,1,1,0,2,1,0.3333333333333333,0.6666666666666666,0.0,1.0
SF-J25,SF-C20,6,2,3,1,3,1,0.5,0.5,0.5,0.5
SF-J25,SF-B21,1,1,0,0,1,1,0.0,1.0,0.0,1.0
SF-J25,SF-B19,7,2,3,0,4,2,0.42857142857142855,0.5714285714285714,0.0,1.0
SF-J25,SF-A20,7,8,2,4,5,4,0.2857142857142857,0.7142857142857143,0.5,0.5
SF-J25,SF-A19,2,1,1,0,1,1,0.5,0.5,0.0,1.0
SF-J25,SF-C26,8,5,4,4,4,1,0.5,0.5,0.8,0.2
SF-J25,SF-C25,34,23,3,6,31,17,0.08823529411764706,0.9117647058823529,0.2608695652173913,0.7391304347826086
SF-J25,SF-B25,5,13,1,6,4,7,0.2,0.8,0.46153846153846156,0.5384615384615384
SF-J25,SF-E27,23,7,1,2,22,5,0.043478260869565216,0.9565217391304348,0.2857142857142857,0.7142857142857143
SF-J25,SF-D27,22,20,10,14,12,6,0.45454545454545453,0.5454545454545454,0.7,0.3
SF-J25,SF-B28,5,13,4,8,1,5,0.8,0.2,0.6153846153846154,0.38461538461538464
SF-J25,SF-J1,10,2,2,1,8,1,0.2,0.8,0.5,0.5
SF-J25,SF-H0,1,1,0,0,1,1,0.0,1.0,0.0,1.0
SF-J25,SF-G8,2,1,1,1,1,0,0.5,0.5,1.0,0.0
SF-J25,SF-F9,1,1,0,0,1,1,0.0,1.0,0.0,1.0
SF-J25,SF-H25,12,3,3,2,9,1,0.25,0.75,0.6666666666666666,0.3333333333333333
SF-J25,SF-G26,21,39,7,16,14,23,0.3333333333333333,0.6666666666666666,0.41025641025641024,0.5897435897435898
SF-J25,SF-K21,10,9,4,3,6,6,0.4,0.6,0.3333333333333333,0.6666666666666666
SF-J25,SF-K22-1,18,25,13,15,5,10,0.7222222222222222,0.2777777777777778,0.6,0.4
SF-J25,SF-J23-1,139,164,91,96,48,68,0.6546762589928058,0.34532374100719426,0.5853658536585366,0.4146341463414634
SF-J25,SF-J22-1,3,7,1,3,2,4,0.3333333333333333,0.6666666666666666,0.42857142857142855,0.5714285714285714
SF-J25,SF-J22-2,24,22,16,13,8,9,0.6666666666666666,0.3333333333333333,0.5909090909090909,0.4090909090909091
SF-J25,SF-J21,26,42,16,36,10,6,0.6153846153846154,0.38461538461538464,0.8571428571428571,0.14285714285714285
SF-J25,SF-I21,4,5,3,4,1,1,0.75,0.25,0.8,0.2
SF-J25,SF-I22,5,12,3,4,2,8,0.6,0.4,0.3333333333333333,0.6666666666666666
SF-J25,SF-I23-2,14,18,10,9,4,9,0.7142857142857143,0.2857142857142857,0.5,0.5
SF-J25,SF-I24,25,29,22,26,3,3,0.88,0.12,0.896551724137931,0.10344827586206896
SF-J25,SF-I23-1,16,15,8,9,8,6,0.5,0.5,0.6,0.4
SF-J25,SF-F26,39,36,15,8,24,28,0.38461538461538464,0.6153846153846154,0.2222222222222222,0.7777777777777778
SF-J25,SF-M13,4,4,1,2,3,2,0.25,0.75,0.5,0.5
SF-J25,SF-M15,19,9,5,4,14,5,0.2631578947368421,0.7368421052631579,0.4444444444444444,0.5555555555555556
SF-J25,SF-L19,15,10,9,6,6,4,0.6,0.4,0.6,0.4
SF-J25,SF-L20,12,16,8,2,4,14,0.6666666666666666,0.3333333333333333,0.125,0.875
SF-J25,SF-N20-1,2,15,1,4,1,11,0.5,0.5,0.26666666666666666,0.7333333333333333
SF-J25,SF-M20,11,25,2,2,9,23,0.18181818181818182,0.8181818181818182,0.08,0.92
SF-J25,SF-K17-2,47,2,5,0,42,2,0.10638297872340426,0.8936170212765957,0.0,1.0
SF-J25,SF-K20,26,13,16,4,10,9,0.6153846153846154,0.38461538461538464,0.3076923076923077,0.6923076923076923
SF-J25,SF-K15-,25,27,14,7,11,20,0.56,0.44,0.25925925925925924,0.7407407407407407
SF-J25,SF-K19,14,19,6,3,8,16,0.42857142857142855,0.5714285714285714,0.15789473684210525,0.8421052631578947
SF-J25,SF-K18,15,4,5,1,10,3,0.3333333333333333,0.6666666666666666,0.25,0.75
SF-J25,SF-K17,6,9,2,3,4,6,0.3333333333333333,0.6666666666666666,0.3333333333333333,0.6666666666666666
SF-J25,SF-J16,4,1,1,0,3,1,0.25,0.75,0.0,1.0
SF-J25,SF-J18,6,7,4,2,2,5,0.6666666666666666,0.3333333333333333,0.2857142857142857,0.7142857142857143
SF-J25,SF-J20,16,5,6,0,10,5,0.375,0.625,0.0,1.0
SF-J25,SF-J19,15,11,8,3,7,8,0.5333333333333333,0.4666666666666667,0.2727272727272727,0.7272727272727273
SF-J25,SF-M12,8,13,4,0,4,13,0.5,0.5,0.0,1.0
SF-J25,SF-M10,4,2,1,1,3,1,0.25,0.75,0.5,0.5
SF-J25,SF-M11,6,7,3,0,3,7,0.5,0.5,0.0,1.0
SF-J25,SF-R19,5,6,0,2,5,4,0.0,1.0,0.3333333333333333,0.6666666666666666
SF-J25,SF-R20,4,1,3,0,1,1,0.75,0.25,0.0,1.0
SF-J25,SF-Q21-2,3,5,1,0,2,5,0.3333333333333333,0.6666666666666666,0.0,1.0
SF-J25,SF-Q21-1,1,1,0,1,1,0,0.0,1.0,1.0,0.0
SF-J25,SF-P21,9,19,5,5,4,14,0.5555555555555556,0.4444444444444444,0.2631578947368421,0.7368421052631579
SF-J25,SF-O18,8,11,2,4,6,7,0.25,0.75,0.36363636363636365,0.6363636363636364
SF-J25,SF-O19,6,19,5,7,1,12,0.8333333333333334,0.16666666666666666,0.3684210526315789,0.631578947368421
SF-J25,SF-O21,68,90,40,37,28,53,0.5882352941176471,0.4117647058823529,0.4111111111111111,0.5888888888888889
SF-J25,SF-O22,16,35,6,21,10,14,0.375,0.625,0.6,0.4
SF-J25,SF-N21,10,19,5,9,5,10,0.5,0.5,0.47368421052631576,0.5263157894736842
SF-J25,SF-N20-2,2,4,0,1,2,3,0.0,1.0,0.25,0.75
SF-J25,SF-M21,3,11,1,2,2,9,0.3333333333333333,0.6666666666666666,0.18181818181818182,0.8181818181818182
SF-J25,SF-L21,66,37,43,17,23,20,0.6515151515151515,0.3484848484848485,0.4594594594594595,0.5405405405405406
SF-J25,SF-S29,1,1,1,0,0,1,1.0,0.0,0.0,1.0
SF-J25,SF-S30,10,24,4,20,6,4,0.4,0.6,0.8333333333333334,0.16666666666666666
SF-J25,SF-Q30,13,12,6,7,7,5,0.46153846153846156,0.5384615384615384,0.5833333333333334,0.4166666666666667
SF-J25,SF-P30,8,12,4,1,4,11,0.5,0.5,0.08333333333333333,0.9166666666666666
SF-J25,SF-O30-2,14,10,3,5,11,5,0.21428571428571427,0.7857142857142857,0.5,0.5
SF-J25,SF-O30,14,19,11,9,3,10,0.7857142857142857,0.21428571428571427,0.47368421052631576,0.5263157894736842
SF-J25,SF-N27,20,46,7,31,13,15,0.35,0.65,0.6739130434782609,0.32608695652173914
SF-J25,SF-N29,37,33,35,29,2,4,0.9459459459459459,0.05405405405405406,0.8787878787878788,0.12121212121212122
SF-J25,SF-N28,14,26,8,17,6,9,0.5714285714285714,0.42857142857142855,0.6538461538461539,0.34615384615384615
SF-J25,SF-L30-1,69,53,38,23,31,30,0.5507246376811594,0.4492753623188406,0.4339622641509434,0.5660377358490566
SF-J25,SF-L31-1,32,5,19,3,13,2,0.59375,0.40625,0.6,0.4
SF-J25,SF-K30-2,11,24,4,4,7,20,0.36363636363636365,0.6363636363636364,0.16666666666666666,0.8333333333333334
SF-J25,SF-L29,27,35,15,24,12,11,0.5555555555555556,0.4444444444444444,0.6857142857142857,0.3142857142857143
SF-J25,SF-J29-1,10,25,6,12,4,13,0.6,0.4,0.48,0.52
SF-J25,SF-I30,12,46,5,17,7,29,0.4166666666666667,0.5833333333333334,0.3695652173913043,0.6304347826086957
SF-J25,SF-I29-2,6,7,2,4,4,3,0.3333333333333333,0.6666666666666666,0.5714285714285714,0.42857142857142855
SF-J25,SF-I27,31,77,19,54,12,23,0.6129032258064516,0.3870967741935484,0.7012987012987013,0.2987012987012987
SF-J25,SF-I28,25,34,18,22,7,12,0.72,0.28,0.6470588235294118,0.35294117647058826
SF-J25,SF-I30-2,8,5,4,3,4,2,0.5,0.5,0.6,0.4
SF-J25,SF I29-1,16,7,3,2,13,5,0.1875,0.8125,0.2857142857142857,0.7142857142857143
SF-J25,SF-H28,22,21,14,20,8,1,0.6363636363636364,0.36363636363636365,0.9523809523809523,0.047619047619047616
SF-J25,SF-H29,4,7,3,2,1,5,0.75,0.25,0.2857142857142857,0.7142857142857143
SF-J25,SF-S24,7,9,2,4,5,5,0.2857142857142857,0.7142857142857143,0.4444444444444444,0.5555555555555556
SF-J25,SF-R24,10,28,7,13,3,15,0.7,0.3,0.4642857142857143,0.5357142857142857
SF-J25,SF-R26,17,19,16,18,1,1,0.9411764705882353,0.058823529411764705,0.9473684210526315,0.05263157894736842
SF-J25,SF-Q26,3,2,2,2,1,0,0.6666666666666666,0.3333333333333333,1.0,0.0
SF-J25,SF-P26,7,10,1,3,6,7,0.14285714285714285,0.8571428571428571,0.3,0.7
SF-J25,SF-O25-2,7,6,1,4,6,2,0.14285714285714285,0.8571428571428571,0.6666666666666666,0.3333333333333333
SF-J25,SF-N22-1B,5,10,1,2,4,8,0.2,0.8,0.2,0.8
SF-J25,SF-N25,10,7,7,4,3,3,0.7,0.3,0.5714285714285714,0.42857142857142855
SF-J25,SF-T21,6,6,2,4,4,2,0.3333333333333333,0.6666666666666666,0.6666666666666666,0.3333333333333333
SF-J25,SF-T22,16,11,2,1,14,10,0.125,0.875,0.09090909090909091,0.9090909090909091
SF-J25,SF-S22-2,1,3,1,1,0,2,1.0,0.0,0.3333333333333333,0.6666666666666666
SF-J25,SF-S22-1,6,8,2,1,4,7,0.3333333333333333,0.6666666666666666,0.125,0.875
SF-J25,SF-Q23-3,15,20,8,9,7,11,0.5333333333333333,0.4666666666666667,0.45,0.55
SF-J25,SF-Q22-1,6,17,2,10,4,7,0.3333333333333333,0.6666666666666666,0.5882352941176471,0.4117647058823529
SF-J25,SF-Q22-2,6,25,3,11,3,14,0.5,0.5,0.44,0.56
SF-J25,SF-P22,11,22,2,7,9,15,0.18181818181818182,0.8181818181818182,0.3181818181818182,0.6818181818181818
SF-J25,SF-T20,10,8,3,1,7,7,0.3,0.7,0.125,0.875
SF-J25,SF-S21,1,2,0,0,1,2,0.0,1.0,0.0,1.0
SF-J25,SF-AA28,1,1,1,1,0,0,1.0,0.0,1.0,0.0
SF-J25,SF-Y29,1,1,0,0,1,1,0.0,1.0,0.0,1.0
SF-J25,SF-V31,3,30,3,30,0,0,1.0,0.0,1.0,0.0
SF-J25,SF-V32,26,22,8,17,18,5,0.3076923076923077,0.6923076923076923,0.7727272727272727,0.22727272727272727
SF-H26-2,SF-M25,6,3,1,0,5,3,0.16666666666666666,0.8333333333333334,0.0,1.0
SF-H26-2,SF-M26-2,9,8,4,2,5,6,0.4444444444444444,0.5555555555555556,0.25,0.75
SF-H26-2,SF-L27,5,2,0,2,5,0,0.0,1.0,1.0,0.0
SF-H26-2,SF-K26,8,11,5,8,3,3,0.625,0.375,0.7272727272727273,0.2727272727272727
SF-H26-2,SF-J27,9,10,7,7,2,3,0.7777777777777778,0.2222222222222222,0.7,0.3
SF-H26-2,SF-M30,11,57,5,4,6,53,0.45454545454545453,0.5454545454545454,0.07017543859649122,0.9298245614035088
SF-H26-2,SF-J29-3,10,24,5,14,5,10,0.5,0.5,0.5833333333333334,0.4166666666666667
SF-H26-2,SF-J29,16,23,6,18,10,5,0.375,0.625,0.782608695652174,0.21739130434782608
SF-H26-2,SF-L26,3,1,0,1,3,0,0.0,1.0,1.0,0.0
SF-H26-2,SF-M28,11,12,2,1,9,11,0.18181818181818182,0.8181818181818182,0.08333333333333333,0.9166666666666666
SF-H26-2,SF-M27,2,1,0,0,2,1,0.0,1.0,0.0,1.0
SF-H26-2,SF-M24,2,8,0,5,2,3,0.0,1.0,0.625,0.375
SF-H26-2,SF-L24,7,8,1,5,6,3,0.14285714285714285,0.8571428571428571,0.625,0.375
SF-H26-2,SF-N23,4,7,0,3,4,4,0.0,1.0,0.42857142857142855,0.5714285714285714
SF-H26-2,SF-K27-2,15,14,9,6,6,8,0.6,0.4,0.42857142857142855,0.5714285714285714
SF-H26-2,SF-J26-2,39,53,7,9,32,44,0.1794871794871795,0.8205128205128205,0.16981132075471697,0.8301886792452831
SF-H26-2,SF-K28-3,3,1,2,1,1,0,0.6666666666666666,0.3333333333333333,1.0,0.0
SF-H26-2,SF-L28,7,3,2,3,5,0,0.2857142857142857,0.7142857142857143,1.0,0.0
SF-H26-2,SF-K28,4,9,4,7,0,2,1.0,0.0,0.7777777777777778,0.2222222222222222
SF-H26-2,SF-K29-1,27,14,18,6,9,8,0.6666666666666666,0.3333333333333333,0.42857142857142855,0.5714285714285714
SF-H26-2,SF-J28-2,12,94,9,32,3,62,0.75,0.25,0.3404255319148936,0.6595744680851063
SF-H26-2,SF-K27,7,9,4,2,3,7,0.5714285714285714,0.42857142857142855,0.2222222222222222,0.7777777777777778
SF-H26-2,SF-K25,130,124,97,99,33,25,0.7461538461538462,0.25384615384615383,0.7983870967741935,0.20161290322580644
SF-H26-2,SF-J25,28,21,15,17,13,4,0.5357142857142857,0.4642857142857143,0.8095238095238095,0.19047619047619047
SF-H26-2,SF-P24,1,3,0,2,1,1,0.0,1.0,0.6666666666666666,0.3333333333333333
SF-H26-2,SF-N22-1A,1,3,1,1,0,2,1.0,0.0,0.3333333333333333,0.6666666666666666
SF-H26-2,SF-J24,28,19,8,7,20,12,0.2857142857142857,0.7142857142857143,0.3684210526315789,0.631578947368421
SF-H26-2,SF-O24,3,5,2,2,1,3,0.6666666666666666,0.3333333333333333,0.4,0.6
SF-H26-2,SF-J26,10,5,2,2,8,3,0.2,0.8,0.4,0.6
SF-H26-2,SF-I26-,23,15,12,5,11,10,0.5217391304347826,0.4782608695652174,0.3333333333333333,0.6666666666666666
SF-H26-2,SF-I25,21,22,12,16,9,6,0.5714285714285714,0.42857142857142855,0.7272727272727273,0.2727272727272727
SF-H26-2,SF-H26,19,31,10,22,9,9,0.5263157894736842,0.47368421052631576,0.7096774193548387,0.2903225806451613
SF-H26-2,SF-O23,3,9,0,3,3,6,0.0,1.0,0.3333333333333333,0.6666666666666666
SF-H26-2,SF-H27-1,7,8,6,8,1,0,0.8571428571428571,0.14285714285714285,1.0,0.0
SF-H26-2,SF-F28-2,16,68,5,26,11,42,0.3125,0.6875,0.38235294117647056,0.6176470588235294
SF-H26-2,SF-G27,25,41,12,20,13,21,0.48,0.52,0.4878048780487805,0.5121951219512195
SF-H26-2,SF-M22-2,3,9,2,8,1,1,0.6666666666666666,0.3333333333333333,0.8888888888888888,0.1111111111111111
SF-H26-2,SF-L22,4,5,3,0,1,5,0.75,0.25,0.0,1.0
SF-H26-2,SF-F27,10,9,2,6,8,3,0.2,0.8,0.6666666666666666,0.3333333333333333
SF-H26-2,SF-N22-2,5,7,2,3,3,4,0.4,0.6,0.42857142857142855,0.5714285714285714
SF-H26-2,SF-G28-2,3,1,3,1,0,0,1.0,0.0,1.0,0.0
SF-H26-2,SF-G28-1,5,2,3,0,2,2,0.6,0.4,0.0,1.0
SF-H26-2,SF-M22-1,5,8,0,3,5,5,0.0,1.0,0.375,0.625
SF-H26-2,SF-K22-2,2,9,1,4,1,5,0.5,0.5,0.4444444444444444,0.5555555555555556
SF-H26-2,SF-K24,9,5,6,4,3,1,0.6666666666666666,0.3333333333333333,0.8,0.2
SF-H26-2,SF-J23-2,6,3,2,2,4,1,0.3333333333333333,0.6666666666666666,0.6666666666666666,0.3333333333333333
SF-H26-2,SF-G23,10,3,3,1,7,2,0.3,0.7,0.3333333333333333,0.6666666666666666
SF-H26-2,SF-G24,18,8,7,1,11,7,0.3888888888888889,0.6111111111111112,0.125,0.875
SF-H26-2,SF-G25,43,19,15,5,28,14,0.3488372093023256,0.6511627906976745,0.2631578947368421,0.7368421052631579
SF-H26-2,SF-F23,15,10,9,1,6,9,0.6,0.4,0.1,0.9
SF-H26-2,SF-E23,28,14,20,7,8,7,0.7142857142857143,0.2857142857142857,0.5,0.5
SF-H26-2,SF-D24,2,3,2,2,0,1,1.0,0.0,0.6666666666666666,0.3333333333333333
SF-H26-2,SF-C22,3,4,0,2,3,2,0.0,1.0,0.5,0.5
SF-H26-2,SF-B22,5,10,3,8,2,2,0.6,0.4,0.8,0.2
SF-H26-2,SF-J17,6,9,4,0,2,9,0.6666666666666666,0.3333333333333333,0.0,1.0
SF-H26-2,SF-I19,88,2,87,2,1,0,0.9886363636363636,0.011363636363636364,1.0,0.0
SF-H26-2,SF-I20,62,50,53,40,9,10,0.8548387096774194,0.14516129032258066,0.8,0.2
SF-H26-2,SF-H16,1,2,0,0,1,2,0.0,1.0,0.0,1.0
SF-H26-2,SF-H20,3,3,0,0,3,3,0.0,1.0,0.0,1.0
SF-H26-2,SF-H18,3,1,0,0,3,1,0.0,1.0,0.0,1.0
SF-H26-2,SF-G19,2,5,1,1,1,4,0.5,0.5,0.2,0.8
SF-H26-2,SF-G17,7,3,5,0,2,3,0.7142857142857143,0.2857142857142857,0.0,1.0
SF-H26-2,SF-G18,5,2,1,0,4,2,0.2,0.8,0.0,1.0
SF-H26-2,SF-G20,3,3,0,0,3,3,0.0,1.0,0.0,1.0
SF-H26-2,SF-F19,1,3,1,0,0,3,1.0,0.0,0.0,1.0
SF-H26-2,SF-E18,2,14,0,0,2,14,0.0,1.0,0.0,1.0
SF-H26-2,SF-G30-2,9,6,2,3,7,3,0.2222222222222222,0.7777777777777778,0.5,0.5
SF-H26-2,SF-F30-1,2,10,0,5,2,5,0.0,1.0,0.5,0.5
SF-H26-2,SF-E29-2,16,17,8,9,8,8,0.5,0.5,0.5294117647058824,0.47058823529411764
SF-H26-2,SF-E29-1,3,4,2,4,1,0,0.6666666666666666,0.3333333333333333,1.0,0.0
SF-H26-2,SF-D29,3,10,1,4,2,6,0.3333333333333333,0.6666666666666666,0.4,0.6
SF-H26-2,SF-D28,19,24,9,22,10,2,0.47368421052631576,0.5263157894736842,0.9166666666666666,0.08333333333333333
SF-H26-2,SF-A27,13,4,4,2,9,2,0.3076923076923077,0.6923076923076923,0.5,0.5
SF-H26-2,SF-G29-2,5,11,4,8,1,3,0.8,0.2,0.7272727272727273,0.2727272727272727
SF-H26-2,SF-G29-1,5,1,5,1,0,0,1.0,0.0,1.0,0.0
SF-H26-2,SF-G30-1,10,7,5,3,5,4,0.5,0.5,0.42857142857142855,0.5714285714285714
SF-H26-2,SF-G29-3,2,1,1,1,1,0,0.5,0.5,1.0,0.0
SF-H26-2,SF-F30-2,1,1,1,0,0,1,1.0,0.0,0.0,1.0
SF-H26-2,SF-F29,10,4,7,1,3,3,0.7,0.3,0.25,0.75
SF-H26-2,SF-E29-3,2,6,1,4,1,2,0.5,0.5,0.6666666666666666,0.3333333333333333
SF-H26-2,SF-F28-1,6,7,4,2,2,5,0.6666666666666666,0.3333333333333333,0.2857142857142857,0.7142857142857143
SF-H26-2,SF-E28-2,3,1,2,0,1,1,0.6666666666666666,0.3333333333333333,0.0,1.0
SF-H26-2,SF-E28,6,5,5,4,1,1,0.8333333333333334,0.16666666666666666,0.8,0.2
SF-H26-2,SF-J12,15,11,0,1,15,10,0.0,1.0,0.09090909090909091,0.9090909090909091
SF-H26-2,SF-H12,9,25,0,0,9,25,0.0,1.0,0.0,1.0
SF-H26-2,SF-G12,2,4,0,0,2,4,0.0,1.0,0.0,1.0
SF-H26-2,SF-C20,3,3,0,0,3,3,0.0,1.0,0.0,1.0
SF-H26-2,SF-B19,1,1,0,0,1,1,0.0,1.0,0.0,1.0
SF-H26-2,SF-A20,2,1,1,1,1,0,0.5,0.5,1.0,0.0
SF-H26-2,SF-C26,195,73,24,23,171,50,0.12307692307692308,0.8769230769230769,0.3150684931506849,0.684931506849315
SF-H26-2,SF-C25,10,4,2,1,8,3,0.2,0.8,0.25,0.75
SF-H26-2,SF-B25,45,60,1,13,44,47,0.022222222222222223,0.9777777777777777,0.21666666666666667,0.7833333333333333
SF-H26-2,SF-E27,8,5,4,2,4,3,0.5,0.5,0.4,0.6
SF-H26-2,SF-B28-2,6,2,3,1,3,1,0.5,0.5,0.5,0.5
SF-H26-2,SF-D27,17,5,12,1,5,4,0.7058823529411765,0.29411764705882354,0.2,0.8
SF-H26-2,SF-C28-1,3,2,3,2,0,0,1.0,0.0,1.0,0.0
SF-H26-2,SF-B28,2,4,2,4,0,0,1.0,0.0,1.0,0.0
SF-H26-2,SF-H25,8,13,5,10,3,3,0.625,0.375,0.7692307692307693,0.23076923076923078
SF-H26-2,SF-G26,13,19,5,14,8,5,0.38461538461538464,0.6153846153846154,0.7368421052631579,0.2631578947368421
SF-H26-2,SF-K21,72,49,11,0,61,49,0.1527777777777778,0.8472222222222222,0.0,1.0
SF-H26-2,SF-K22-1,6,6,4,3,2,3,0.6666666666666666,0.3333333333333333,0.5,0.5
SF-H26-2,SF-J23-1,35,37,17,19,18,18,0.4857142857142857,0.5142857142857142,0.5135135135135135,0.4864864864864865
SF-H26-2,SF-J22-1,19,9,3,5,16,4,0.15789473684210525,0.8421052631578947,0.5555555555555556,0.4444444444444444
SF-H26-2,SF-J22-2,6,10,4,3,2,7,0.6666666666666666,0.3333333333333333,0.3,0.7
SF-H26-2,SF-J21,88,40,59,15,29,25,0.6704545454545454,0.32954545454545453,0.375,0.625
SF-H26-2,SF-I22,13,3,6,3,7,0,0.46153846153846156,0.5384615384615384,1.0,0.0
SF-H26-2,SF-I23-2,5,13,1,6,4,7,0.2,0.8,0.46153846153846156,0.5384615384615384
SF-H26-2,SF-I24,3,4,1,2,2,2,0.3333333333333333,0.6666666666666666,0.5,0.5
SF-H26-2,SF-I23-1,10,7,7,5,3,2,0.7,0.3,0.7142857142857143,0.2857142857142857
SF-H26-2,SF-F26,20,20,7,2,13,18,0.35,0.65,0.1,0.9
SF-H26-2,SF-M15,12,2,8,0,4,2,0.6666666666666666,0.3333333333333333,0.0,1.0
SF-H26-2,SF-L19,3,2,1,0,2,2,0.3333333333333333,0.6666666666666666,0.0,1.0
SF-H26-2,SF-L20,7,2,0,0,7,2,0.0,1.0,0.0,1.0
SF-H26-2,SF-M20,6,15,3,0,3,15,0.5,0.5,0.0,1.0
SF-H26-2,SF-K17-2,8,1,0,0,8,1,0.0,1.0,0.0,1.0
SF-H26-2,SF-K20,7,3,0,0,7,3,0.0,1.0,0.0,1.0
SF-H26-2,SF-K15-,1,10,0,3,1,7,0.0,1.0,0.3,0.7
SF-H26-2,SF-K19,3,2,0,1,3,1,0.0,1.0,0.5,0.5
SF-H26-2,SF-K18,1,3,0,1,1,2,0.0,1.0,0.3333333333333333,0.6666666666666666
SF-H26-2,SF-K17,18,4,3,0,15,4,0.16666666666666666,0.8333333333333334,0.0,1.0
SF-H26-2,SF-J16,2,3,1,0,1,3,0.5,0.5,0.0,1.0
SF-H26-2,SF-J18,14,4,12,0,2,4,0.8571428571428571,0.14285714285714285,0.0,1.0
SF-H26-2,SF-J20,57,20,42,6,15,14,0.7368421052631579,0.2631578947368421,0.3,0.7
SF-H26-2,SF-J19,8,10,3,3,5,7,0.375,0.625,0.3,0.7
SF-H26-2,SF-R19,2,6,0,0,2,6,0.0,1.0,0.0,1.0
SF-H26-2,SF-Q21-2,2,3,1,0,1,3,0.5,0.5,0.0,1.0
SF-H26-2,SF-Q21-1,1,1,1,1,0,0,1.0,0.0,1.0,0.0
SF-H26-2,SF-P21,3,2,0,1,3,1,0.0,1.0,0.5,0.5
SF-H26-2,SF-O18,1,1,0,0,1,1,0.0,1.0,0.0,1.0
SF-H26-2,SF-O19,4,4,0,3,4,1,0.0,1.0,0.75,0.25
SF-H26-2,SF-O21,13,18,9,8,4,10,0.6923076923076923,0.3076923076923077,0.4444444444444444,0.5555555555555556
SF-H26-2,SF-O22,6,10,2,2,4,8,0.3333333333333333,0.6666666666666666,0.2,0.8
SF-H26-2,SF-N21,2,4,2,2,0,2,1.0,0.0,0.5,0.5
SF-H26-2,SF-N20-2,1,1,0,0,1,1,0.0,1.0,0.0,1.0
SF-H26-2,SF-M21,2,5,1,2,1,3,0.5,0.5,0.4,0.6
SF-H26-2,SF-L21,10,24,3,6,7,18,0.3,0.7,0.25,0.75
SF-H26-2,SF-O30-2,1,1,1,1,0,0,1.0,0.0,1.0,0.0
SF-H26-2,SF-O30,6,4,6,1,0,3,1.0,0.0,0.25,0.75
SF-H26-2,SF-N27,14,24,6,9,8,15,0.42857142857142855,0.5714285714285714,0.375,0.625
SF-H26-2,SF-N28,6,7,5,6,1,1,0.8333333333333334,0.16666666666666666,0.8571428571428571,0.14285714285714285
SF-H26-2,SF-L30-1,8,12,1,6,7,6,0.125,0.875,0.5,0.5
SF-H26-2,SF-L29,14,20,5,10,9,10,0.35714285714285715,0.6428571428571429,0.5,0.5
SF-H26-2,SF-J29-1,14,15,7,8,7,7,0.5,0.5,0.5333333333333333,0.4666666666666667
SF-H26-2,SF-I30,4,6,3,5,1,1,0.75,0.25,0.8333333333333334,0.16666666666666666
SF-H26-2,SF-I29-2,9,1,7,1,2,0,0.7777777777777778,0.2222222222222222,1.0,0.0
SF-H26-2,SF-I27,16,11,7,4,9,7,0.4375,0.5625,0.36363636363636365,0.6363636363636364
SF-H26-2,SF-I28,10,5,4,3,6,2,0.4,0.6,0.6,0.4
SF-H26-2,SF-I30-2,7,1,2,0,5,1,0.2857142857142857,0.7142857142857143,0.0,1.0
SF-H26-2,SF I29-1,1,4,1,1,0,3,1.0,0.0,0.25,0.75
SF-H26-2,SF-H28,14,6,8,3,6,3,0.5714285714285714,0.42857142857142855,0.5,0.5
SF-H26-2,SF-H29,4,1,3,1,1,0,0.75,0.25,1.0,0.0
SF-H26-2,SF-S24,7,6,0,3,7,3,0.0,1.0,0.5,0.5
SF-H26-2,SF-R24,38,21,4,2,34,19,0.10526315789473684,0.8947368421052632,0.09523809523809523,0.9047619047619048
SF-H26-2,SF-Q26,1,1,1,0,0,1,1.0,0.0,0.0,1.0
SF-H26-2,SF-O25-2,1,2,0,1,1,1,0.0,1.0,0.5,0.5
SF-H26-2,SF-N22-1B,5,1,5,0,0,1,1.0,0.0,0.0,1.0
SF-H26-2,SF-N26,2,2,2,1,0,1,1.0,0.0,0.5,0.5
SF-H26-2,SF-T21,4,3,4,2,0,1,1.0,0.0,0.6666666666666666,0.3333333333333333
SF-H26-2,SF-T22,1,2,0,1,1,1,0.0,1.0,0.5,0.5
SF-H26-2,SF-S22-1,3,6,0,2,3,4,0.0,1.0,0.3333333333333333,0.6666666666666666
SF-H26-2,SF-Q23-3,14,3,8,2,6,1,0.5714285714285714,0.42857142857142855,0.6666666666666666,0.3333333333333333
SF-H26-2,SF-Q22-1,1,3,0,1,1,2,0.0,1.0,0.3333333333333333,0.6666666666666666
SF-H26-2,SF-Q22-2,4,2,2,0,2,2,0.5,0.5,0.0,1.0
SF-H26-2,SF-P22,2,2,1,1,1,1,0.5,0.5,0.5,0.5
SF-H26-2,SF-T20,2,4,1,0,1,4,0.5,0.5,0.0,1.0
SF-H26-2,SF-X19,1,2,1,1,0,1,1.0,0.0,0.5,0.5
SF-P24,SF-M25,4,9,3,2,1,7,0.75,0.25,0.2222222222222222,0.7777777777777778
SF-P24,SF-M26-2,12,12,3,5,9,7,0.25,0.75,0.4166666666666667,0.5833333333333334
SF-P24,SF-K26,15,10,9,10,6,0,0.6,0.4,1.0,0.0
SF-P24,SF-J27,3,2,1,1,2,1,0.3333333333333333,0.6666666666666666,0.5,0.5
SF-P24,SF-M30,23,21,6,4,17,17,0.2608695652173913,0.7391304347826086,0.19047619047619047,0.8095238095238095
SF-P24,SF-J29-3,4,3,3,1,1,2,0.75,0.25,0.3333333333333333,0.6666666666666666
SF-P24,SF-J29,6,11,2,9,4,2,0.3333333333333333,0.6666666666666666,0.8181818181818182,0.18181818181818182
SF-P24,SF-L26,24,21,6,5,18,16,0.25,0.75,0.23809523809523808,0.7619047619047619
SF-P24,SF-M28,2,5,0,0,2,5,0.0,1.0,0.0,1.0
SF-P24,SF-L25,9,6,7,4,2,2,0.7777777777777778,0.2222222222222222,0.6666666666666666,0.3333333333333333
SF-P24,SF-M24,17,21,14,11,3,10,0.8235294117647058,0.17647058823529413,0.5238095238095238,0.47619047619047616
SF-P24,SF-L24,13,18,8,6,5,12,0.6153846153846154,0.38461538461538464,0.3333333333333333,0.6666666666666666
SF-P24,SF-N23,8,15,6,9,2,6,0.75,0.25,0.6,0.4
SF-P24,SF-N24-2,47,46,25,29,22,17,0.5319148936170213,0.46808510638297873,0.6304347826086957,0.3695652173913043
SF-P24,SF-K27-2,13,7,6,3,7,4,0.46153846153846156,0.5384615384615384,0.42857142857142855,0.5714285714285714
SF-P24,SF-J26-2,5,20,4,4,1,16,0.8,0.2,0.2,0.8
SF-P24,SF-L28,7,4,4,2,3,2,0.5714285714285714,0.42857142857142855,0.5,0.5
SF-P24,SF-K28,6,1,4,1,2,0,0.6666666666666666,0.3333333333333333,1.0,0.0
SF-P24,SF-K29-1,6,1,4,1,2,0,0.6666666666666666,0.3333333333333333,1.0,0.0
SF-P24,SF-J28-2,3,2,2,2,1,0,0.6666666666666666,0.3333333333333333,1.0,0.0
SF-P24,SF-K27,1,4,1,2,0,2,1.0,0.0,0.5,0.5
SF-P24,SF-K25,8,7,5,4,3,3,0.625,0.375,0.5714285714285714,0.42857142857142855
SF-P24,SF-J25,20,19,12,8,8,11,0.6,0.4,0.42105263157894735,0.5789473684210527
SF-P24,SF-H26-2,3,1,2,0,1,1,0.6666666666666666,0.3333333333333333,0.0,1.0
SF-P24,SF-N22-1A,2,1,2,1,0,0,1.0,0.0,1.0,0.0
SF-P24,SF-J24,9,5,6,1,3,4,0.6666666666666666,0.3333333333333333,0.2,0.8
SF-P24,SF-O24,11,21,10,11,1,10,0.9090909090909091,0.09090909090909091,0.5238095238095238,0.47619047619047616
SF-P24,SF-J26,3,9,2,4,1,5,0.6666666666666666,0.3333333333333333,0.4444444444444444,0.5555555555555556
SF-P24,SF-I26-,7,1,2,0,5,1,0.2857142857142857,0.7142857142857143,0.0,1.0
SF-P24,SF-I25,3,3,1,2,2,1,0.3333333333333333,0.6666666666666666,0.6666666666666666,0.3333333333333333
SF-P24,SF-H26,16,13,11,5,5,8,0.6875,0.3125,0.38461538461538464,0.6153846153846154
SF-P24,SF-O23,12,36,11,17,1,19,0.9166666666666666,0.08333333333333333,0.4722222222222222,0.5277777777777778
SF-P24,SF-H27-1,11,3,11,1,0,2,1.0,0.0,0.3333333333333333,0.6666666666666666
SF-P24,SF-F28-2,25,21,12,10,13,11,0.48,0.52,0.47619047619047616,0.5238095238095238
SF-P24,SF-G27,14,40,6,7,8,33,0.42857142857142855,0.5714285714285714,0.175,0.825
SF-P24,SF-M22-2,23,40,13,27,10,13,0.5652173913043478,0.43478260869565216,0.675,0.325
SF-P24,SF-L22,21,10,11,4,10,6,0.5238095238095238,0.47619047619047616,0.4,0.6
SF-P24,SF-F27,8,1,1,0,7,1,0.125,0.875,0.0,1.0
SF-P24,SF-N22-2,28,28,18,11,10,17,0.6428571428571429,0.35714285714285715,0.39285714285714285,0.6071428571428571
SF-P24,SF-G28-2,2,1,0,0,2,1,0.0,1.0,0.0,1.0
SF-P24,SF-G28-1,3,1,1,1,2,0,0.3333333333333333,0.6666666666666666,1.0,0.0
SF-P24,SF-M22-1,7,4,3,3,4,1,0.42857142857142855,0.5714285714285714,0.75,0.25
SF-P24,SF-O25-1,6,5,2,4,4,1,0.3333333333333333,0.6666666666666666,0.8,0.2
SF-P24,SF-K22-2,8,9,7,7,1,2,0.875,0.125,0.7777777777777778,0.2222222222222222
SF-P24,SF-K24,42,52,37,51,5,1,0.8809523809523809,0.11904761904761904,0.9807692307692307,0.019230769230769232
SF-P24,SF-J23-2,6,11,3,7,3,4,0.5,0.5,0.6363636363636364,0.36363636363636365
SF-P24,SF-G23,3,2,0,0,3,2,0.0,1.0,0.0,1.0
SF-P24,SF-G24,5,5,1,1,4,4,0.2,0.8,0.2,0.8
SF-P24,SF-G25,4,20,1,1,3,19,0.25,0.75,0.05,0.95
SF-P24,SF-F23,9,6,5,2,4,4,0.5555555555555556,0.4444444444444444,0.3333333333333333,0.6666666666666666
SF-P24,SF-E23,7,13,3,3,4,10,0.42857142857142855,0.5714285714285714,0.23076923076923078,0.7692307692307693
SF-P24,SF-J17,6,9,3,5,3,4,0.5,0.5,0.5555555555555556,0.4444444444444444
SF-P24,SF-I19,5,1,1,0,4,1,0.2,0.8,0.0,1.0
SF-P24,SF-H19,2,2,1,1,1,1,0.5,0.5,0.5,0.5
SF-P24,SF-H20,1,1,0,0,1,1,0.0,1.0,0.0,1.0
SF-P24,SF-H18,1,1,0,0,1,1,0.0,1.0,0.0,1.0
SF-P24,SF-H17,1,2,0,0,1,2,0.0,1.0,0.0,1.0
SF-P24,SF-G19,3,3,0,0,3,3,0.0,1.0,0.0,1.0
SF-P24,SF-G18,6,3,1,0,5,3,0.16666666666666666,0.8333333333333334,0.0,1.0
SF-P24,SF-G20,6,4,3,1,3,3,0.5,0.5,0.25,0.75
SF-P24,SF-F19,3,5,0,1,3,4,0.0,1.0,0.2,0.8
SF-P24,SF-E18,9,4,4,3,5,1,0.4444444444444444,0.5555555555555556,0.75,0.25
SF-P24,SF-E20,5,4,2,3,3,1,0.4,0.6,0.75,0.25
SF-P24,SF-H30,2,11,1,3,1,8,0.5,0.5,0.2727272727272727,0.7272727272727273
SF-P24,SF-G30-2,8,8,1,2,7,6,0.125,0.875,0.25,0.75
SF-P24,SF-F30-1,2,1,0,0,2,1,0.0,1.0,0.0,1.0
SF-P24,SF-E29-2,4,1,1,0,3,1,0.25,0.75,0.0,1.0
SF-P24,SF-E29-1,4,12,2,5,2,7,0.5,0.5,0.4166666666666667,0.5833333333333334
SF-P24,SF-D29,5,9,1,6,4,3,0.2,0.8,0.6666666666666666,0.3333333333333333
SF-P24,SF-G29-2,8,6,4,2,4,4,0.5,0.5,0.3333333333333333,0.6666666666666666
SF-P24,SF-G29-1,10,5,2,2,8,3,0.2,0.8,0.4,0.6
SF-P24,SF-G30-1,2,3,0,0,2,3,0.0,1.0,0.0,1.0
SF-P24,SF-F30-2,3,5,2,2,1,3,0.6666666666666666,0.3333333333333333,0.4,0.6
SF-P24,SF-E29-3,65,55,1,2,64,53,0.015384615384615385,0.9846153846153847,0.03636363636363636,0.9636363636363636
SF-P24,SF-F28-1,4,2,1,1,3,1,0.25,0.75,0.5,0.5
SF-P24,SF-E28-2,4,2,1,0,3,2,0.25,0.75,0.0,1.0
SF-P24,SF-E28,3,2,2,2,1,0,0.6666666666666666,0.3333333333333333,1.0,0.0
SF-P24,SF-J12,3,3,2,1,1,2,0.6666666666666666,0.3333333333333333,0.3333333333333333,0.6666666666666666
SF-P24,SF-J15,5,1,1,0,4,1,0.2,0.8,0.0,1.0
SF-P24,SF-H13,1,4,0,0,1,4,0.0,1.0,0.0,1.0
SF-P24,SF-H15,2,1,0,0,2,1,0.0,1.0,0.0,1.0
SF-P24,SF-F15,1,1,0,0,1,1,0.0,1.0,0.0,1.0
SF-P24,SF-C21,2,1,2,1,0,0,1.0,0.0,1.0,0.0
SF-P24,SF-A20,1,4,0,3,1,1,0.0,1.0,0.75,0.25
SF-P24,SF-C25,10,2,2,0,8,2,0.2,0.8,0.0,1.0
SF-P24,SF-D27,3,1,1,1,2,0,0.3333333333333333,0.6666666666666666,1.0,0.0
SF-P24,SF-J1,16,11,3,7,13,4,0.1875,0.8125,0.6363636363636364,0.36363636363636365
SF-P24,SF-H25,34,33,33,32,1,1,0.9705882352941176,0.029411764705882353,0.9696969696969697,0.030303030303030304
SF-P24,SF-G26,7,6,2,1,5,5,0.2857142857142857,0.7142857142857143,0.16666666666666666,0.8333333333333334
SF-P24,SF-K21,12,7,2,1,10,6,0.16666666666666666,0.8333333333333334,0.14285714285714285,0.8571428571428571
SF-P24,SF-K22-1,8,5,7,2,1,3,0.875,0.125,0.4,0.6
SF-P24,SF-J23-1,31,23,17,9,14,14,0.5483870967741935,0.45161290322580644,0.391304347826087,0.6086956521739131
SF-P24,SF-J22-1,12,11,4,6,8,5,0.3333333333333333,0.6666666666666666,0.5454545454545454,0.45454545454545453
SF-P24,SF-J22-2,18,13,5,5,13,8,0.2777777777777778,0.7222222222222222,0.38461538461538464,0.6153846153846154
SF-P24,SF-J21,8,14,5,7,3,7,0.625,0.375,0.5,0.5
SF-P24,SF-I21,2,3,0,1,2,2,0.0,1.0,0.3333333333333333,0.6666666666666666
SF-P24,SF-I22,3,1,0,0,3,1,0.0,1.0,0.0,1.0
SF-P24,SF-I23-2,5,7,4,5,1,2,0.8,0.2,0.7142857142857143,0.2857142857142857
SF-P24,SF-I24,3,2,3,1,0,1,1.0,0.0,0.5,0.5
SF-P24,SF-I23-1,2,14,2,13,0,1,1.0,0.0,0.9285714285714286,0.07142857142857142
SF-P24,SF-F26,31,12,2,3,29,9,0.06451612903225806,0.9354838709677419,0.25,0.75
SF-P24,SF-M13,6,6,2,5,4,1,0.3333333333333333,0.6666666666666666,0.8333333333333334,0.16666666666666666
SF-P24,SF-M15,48,19,8,1,40,18,0.16666666666666666,0.8333333333333334,0.05263157894736842,0.9473684210526315
SF-P24,SF-L19,12,22,7,3,5,19,0.5833333333333334,0.4166666666666667,0.13636363636363635,0.8636363636363636
SF-P24,SF-L20,10,10,3,4,7,6,0.3,0.7,0.4,0.6
SF-P24,SF-N20-1,7,5,3,2,4,3,0.42857142857142855,0.5714285714285714,0.4,0.6
SF-P24,SF-M20,27,21,13,12,14,9,0.48148148148148145,0.5185185185185185,0.5714285714285714,0.42857142857142855
SF-P24,SF-K17-2,2,2,1,0,1,2,0.5,0.5,0.0,1.0
SF-P24,SF-K20,20,8,8,3,12,5,0.4,0.6,0.375,0.625
SF-P24,SF-K15-,14,11,8,0,6,11,0.5714285714285714,0.42857142857142855,0.0,1.0
SF-P24,SF-K19,11,3,2,1,9,2,0.18181818181818182,0.8181818181818182,0.3333333333333333,0.6666666666666666
SF-P24,SF-K18,52,58,9,2,43,56,0.17307692307692307,0.8269230769230769,0.034482758620689655,0.9655172413793104
SF-P24,SF-K17,7,4,1,1,6,3,0.14285714285714285,0.8571428571428571,0.25,0.75
SF-P24,SF-J16,1,6,0,0,1,6,0.0,1.0,0.0,1.0
SF-P24,SF-J18,44,57,1,0,43,57,0.022727272727272728,0.9772727272727273,0.0,1.0
SF-P24,SF-J20,1,1,1,0,0,1,1.0,0.0,0.0,1.0
SF-P24,SF-J19,9,4,7,1,2,3,0.7777777777777778,0.2222222222222222,0.25,0.75
SF-P24,SF-O12,13,10,0,0,13,10,0.0,1.0,0.0,1.0
SF-P24,SF-M12,23,5,1,0,22,5,0.043478260869565216,0.9565217391304348,0.0,1.0
SF-P24,SF-M10,6,3,5,2,1,1,0.8333333333333334,0.16666666666666666,0.6666666666666666,0.3333333333333333
SF-P24,SF-M11,5,4,3,0,2,4,0.6,0.4,0.0,1.0
SF-P24,SF-R19,14,5,8,3,6,2,0.5714285714285714,0.42857142857142855,0.6,0.4
SF-P24,SF-R20,6,5,3,1,3,4,0.5,0.5,0.2,0.8
SF-P24,SF-Q21-2,8,16,4,9,4,7,0.5,0.5,0.5625,0.4375
SF-P24,SF-Q21-1,125,100,119,94,6,6,0.952,0.048,0.94,0.06
SF-P24,SF-P21,16,17,7,5,9,12,0.4375,0.5625,0.29411764705882354,0.7058823529411765
SF-P24,SF-O18,12,8,4,2,8,6,0.3333333333333333,0.6666666666666666,0.25,0.75
SF-P24,SF-O19,17,21,7,7,10,14,0.4117647058823529,0.5882352941176471,0.3333333333333333,0.6666666666666666
SF-P24,SF-O21,19,35,7,18,12,17,0.3684210526315789,0.631578947368421,0.5142857142857142,0.4857142857142857
SF-P24,SF-O22,179,40,173,33,6,7,0.9664804469273743,0.0335195530726257,0.825,0.175
SF-P24,SF-N21,10,10,5,6,5,4,0.5,0.5,0.6,0.4
SF-P24,SF-N20-2,8,13,2,9,6,4,0.25,0.75,0.6923076923076923,0.3076923076923077
SF-P24,SF-M21,27,15,12,4,15,11,0.4444444444444444,0.5555555555555556,0.26666666666666666,0.7333333333333333
SF-P24,SF-L21,13,8,9,1,4,7,0.6923076923076923,0.3076923076923077,0.125,0.875
SF-P24,SF-S29,1,3,1,0,0,3,1.0,0.0,0.0,1.0
SF-P24,SF-Q30,2,3,0,0,2,3,0.0,1.0,0.0,1.0
SF-P24,SF-P30,10,4,1,0,9,4,0.1,0.9,0.0,1.0
SF-P24,SF-O30,12,18,1,3,11,15,0.08333333333333333,0.9166666666666666,0.16666666666666666,0.8333333333333334
SF-P24,SF-N27,33,38,5,7,28,31,0.15151515151515152,0.8484848484848485,0.18421052631578946,0.8157894736842105
SF-P24,SF-N29,6,10,5,3,1,7,0.8333333333333334,0.16666666666666666,0.3,0.7
SF-P24,SF-N28,7,14,4,9,3,5,0.5714285714285714,0.42857142857142855,0.6428571428571429,0.35714285714285715
SF-P24,SF-L30-1,10,10,2,4,8,6,0.2,0.8,0.4,0.6
SF-P24,SF-L31-1,3,3,2,2,1,1,0.6666666666666666,0.3333333333333333,0.6666666666666666,0.3333333333333333
SF-P24,SF-K30-2,2,1,0,0,2,1,0.0,1.0,0.0,1.0
SF-P24,SF-L29,3,3,3,2,0,1,1.0,0.0,0.6666666666666666,0.3333333333333333
SF-P24,SF-J29-1,3,3,0,0,3,3,0.0,1.0,0.0,1.0
SF-P24,SF-I30,2,3,0,2,2,1,0.0,1.0,0.6666666666666666,0.3333333333333333
SF-P24,SF-I29-2,2,1,2,0,0,1,1.0,0.0,0.0,1.0
SF-P24,SF-I27,1,3,0,2,1,1,0.0,1.0,0.6666666666666666,0.3333333333333333
SF-P24,SF-I28,4,3,1,2,3,1,0.25,0.75,0.6666666666666666,0.3333333333333333
SF-P24,SF-I30-2,3,1,0,0,3,1,0.0,1.0,0.0,1.0
SF-P24,SF I29-1,3,4,0,0,3,4,0.0,1.0,0.0,1.0
SF-P24,SF-H28,3,2,0,2,3,0,0.0,1.0,1.0,0.0
SF-P24,SF-S24,58,38,31,22,27,16,0.5344827586206896,0.46551724137931033,0.5789473684210527,0.42105263157894735
SF-P24,SF-R24,71,45,58,29,13,16,0.8169014084507042,0.18309859154929578,0.6444444444444445,0.35555555555555557
SF-P24,SF-R26,7,5,4,4,3,1,0.5714285714285714,0.42857142857142855,0.8,0.2
SF-P24,SF-Q26,4,11,1,7,3,4,0.25,0.75,0.6363636363636364,0.36363636363636365
SF-P24,SF-P26,12,4,9,2,3,2,0.75,0.25,0.5,0.5
SF-P24,SF-O25-2,25,14,20,4,5,10,0.8,0.2,0.2857142857142857,0.7142857142857143
SF-P24,SF-N22-1B,10,8,6,5,4,3,0.6,0.4,0.625,0.375
SF-P24,SF-N26,7,6,4,5,3,1,0.5714285714285714,0.42857142857142855,0.8333333333333334,0.16666666666666666
SF-P24,SF-N25,24,25,11,6,13,19,0.4583333333333333,0.5416666666666666,0.24,0.76
SF-P24,SF-T21,2,3,2,3,0,0,1.0,0.0,1.0,0.0
SF-P24,SF-T22,10,15,4,6,6,9,0.4,0.6,0.4,0.6
SF-P24,SF-S22-2,1,2,1,2,0,0,1.0,0.0,1.0,0.0
SF-P24,SF-S22-1,5,7,4,4,1,3,0.8,0.2,0.5714285714285714,0.42857142857142855
SF-P24,SF-Q23-3,17,23,8,15,9,8,0.47058823529411764,0.5294117647058824,0.6521739130434783,0.34782608695652173
SF-P24,SF-Q22-1,10,19,6,10,4,9,0.6,0.4,0.5263157894736842,0.47368421052631576
SF-P24,SF-Q22-2,24,34,23,26,1,8,0.9583333333333334,0.041666666666666664,0.7647058823529411,0.23529411764705882
SF-P24,SF-P22,15,18,10,13,5,5,0.6666666666666666,0.3333333333333333,0.7222222222222222,0.2777777777777778
SF-P24,SF-W19-2,3,1,2,1,1,0,0.6666666666666666,0.3333333333333333,1.0,0.0
SF-P24,SF-U21,2,3,1,0,1,3,0.5,0.5,0.0,1.0
SF-P24,SF-T20,11,8,4,2,7,6,0.36363636363636365,0.6363636363636364,0.25,0.75
SF-P24,SF-S21,1,2,1,0,0,2,1.0,0.0,0.0,1.0
SF-P24,SF-X29,4,2,4,2,0,0,1.0,0.0,1.0,0.0
SF-P24,SF-V28,4,1,3,0,1,1,0.75,0.25,0.0,1.0
SF-P24,SF-AA15,1,1,1,1,0,0,1.0,0.0,1.0,0.0
SF-P24,SF-X19,1,1,1,1,0,0,1.0,0.0,1.0,0.0
SF-N22-1A,SF-M25,10,7,3,2,7,5,0.3,0.7,0.2857142857142857,0.7142857142857143
SF-N22-1A,SF-L27,1,1,0,0,1,1,0.0,1.0,0.0,1.0
SF-N22-1A,SF-K26,1,1,1,0,0,1,1.0,0.0,0.0,1.0
SF-N22-1A,SF-J29,5,7,1,0,4,7,0.2,0.8,0.0,1.0
SF-N22-1A,SF-L26,3,2,1,1,2,1,0.3333333333333333,0.6666666666666666,0.5,0.5
SF-N22-1A,SF-M28,3,1,1,1,2,0,0.3333333333333333,0.6666666666666666,1.0,0.0
SF-N22-1A,SF-M27,1,1,0,1,1,0,0.0,1.0,1.0,0.0
SF-N22-1A,SF-M24,6,9,0,4,6,5,0.0,1.0,0.4444444444444444,0.5555555555555556
SF-N22-1A,SF-L24,12,6,10,2,2,4,0.8333333333333334,0.16666666666666666,0.3333333333333333,0.6666666666666666
SF-N22-1A,SF-N23,3,1,1,1,2,0,0.3333333333333333,0.6666666666666666,1.0,0.0
SF-N22-1A,SF-N24-2,3,6,1,2,2,4,0.3333333333333333,0.6666666666666666,0.3333333333333333,0.6666666666666666
SF-N22-1A,SF-K28,13,1,4,0,9,1,0.3076923076923077,0.6923076923076923,0.0,1.0
SF-N22-1A,SF-K29-1,3,1,0,0,3,1,0.0,1.0,0.0,1.0
SF-N22-1A,SF-K25,3,1,3,0,0,1,1.0,0.0,0.0,1.0
SF-N22-1A,SF-J25,2,3,2,3,0,0,1.0,0.0,1.0,0.0
SF-N22-1A,SF-H26-2,3,1,1,1,2,0,0.3333333333333333,0.6666666666666666,1.0,0.0
SF-N22-1A,SF-P24,1,2,1,2,0,0,1.0,0.0,1.0,0.0
SF-N22-1A,SF-O24,2,4,2,2,0,2,1.0,0.0,0.5,0.5
SF-N22-1A,SF-I26-,3,1,3,1,0,0,1.0,0.0,1.0,0.0
SF-N22-1A,SF-I25,1,1,0,0,1,1,0.0,1.0,0.0,1.0
SF-N22-1A,SF-H26,5,6,5,5,0,1,1.0,0.0,0.8333333333333334,0.16666666666666666
SF-N22-1A,SF-O23,51,8,49,7,2,1,0.9607843137254902,0.0392156862745098,0.875,0.125
SF-N22-1A,SF-G27,1,1,1,0,0,1,1.0,0.0,0.0,1.0
SF-N22-1A,SF-M22-2,2,2,1,2,1,0,0.5,0.5,1.0,0.0
SF-N22-1A,SF-L22,6,2,4,0,2,2,0.6666666666666666,0.3333333333333333,0.0,1.0
SF-N22-1A,SF-F27,1,3,1,2,0,1,1.0,0.0,0.6666666666666666,0.3333333333333333
SF-N22-1A,SF-N22-2,2,8,2,5,0,3,1.0,0.0,0.625,0.375
SF-N22-1A,SF-M22-1,3,1,2,1,1,0,0.6666666666666666,0.3333333333333333,1.0,0.0
SF-N22-1A,SF-O25-1,9,1,3,0,6,1,0.3333333333333333,0.6666666666666666,0.0,1.0
SF-N22-1A,SF-J23-2,8,1,7,1,1,0,0.875,0.125,1.0,0.0
SF-N22-1A,SF-G24,11,1,0,0,11,1,0.0,1.0,0.0,1.0
SF-N22-1A,SF-G25,5,1,1,0,4,1,0.2,0.8,0.0,1.0
SF-N22-1A,SF-D24,1,1,0,0,1,1,0.0,1.0,0.0,1.0
SF-N22-1A,SF-H20,1,1,1,1,0,0,1.0,0.0,1.0,0.0
SF-N22-1A,SF-G30-2,2,2,0,0,2,2,0.0,1.0,0.0,1.0
SF-N22-1A,SF-F28-1,1,1,1,1,0,0,1.0,0.0,1.0,0.0
SF-N22-1A,SF-C25,1,2,0,0,1,2,0.0,1.0,0.0,1.0
SF-N22-1A,SF-H25,1,3,1,0,0,3,1.0,0.0,0.0,1.0
SF-N22-1A,SF-K21,3,2,1,0,2,2,0.3333333333333333,0.6666666666666666,0.0,1.0
SF-N22-1A,SF-J23-1,5,6,5,3,0,3,1.0,0.0,0.5,0.5
SF-N22-1A,SF-I23-2,5,1,5,1,0,0,1.0,0.0,1.0,0.0
SF-N22-1A,SF-I23-1,10,4,0,0,10,4,0.0,1.0,0.0,1.0
SF-N22-1A,SF-L20,11,3,5,2,6,1,0.45454545454545453,0.5454545454545454,0.6666666666666666,0.3333333333333333
SF-N22-1A,SF-N20-1,1,4,1,1,0,3,1.0,0.0,0.25,0.75
SF-N22-1A,SF-M20,2,2,0,1,2,1,0.0,1.0,0.5,0.5
SF-N22-1A,SF-K17-2,5,2,2,0,3,2,0.4,0.6,0.0,1.0
SF-N22-1A,SF-K20,1,5,0,1,1,4,0.0,1.0,0.2,0.8
SF-N22-1A,SF-K19,5,3,1,0,4,3,0.2,0.8,0.0,1.0
SF-N22-1A,SF-K18,10,5,2,0,8,5,0.2,0.8,0.0,1.0
SF-N22-1A,SF-K17,1,3,0,0,1,3,0.0,1.0,0.0,1.0
SF-N22-1A,SF-J16,3,1,0,0,3,1,0.0,1.0,0.0,1.0
SF-N22-1A,SF-J19,2,1,0,0,2,1,0.0,1.0,0.0,1.0
SF-N22-1A,SF-P21,4,7,1,3,3,4,0.25,0.75,0.42857142857142855,0.5714285714285714
SF-N22-1A,SF-O18,2,1,2,0,0,1,1.0,0.0,0.0,1.0
SF-N22-1A,SF-O19,3,2,2,1,1,1,0.6666666666666666,0.3333333333333333,0.5,0.5
SF-N22-1A,SF-O21,8,10,4,1,4,9,0.5,0.5,0.1,0.9
SF-N22-1A,SF-O22,5,5,5,4,0,1,1.0,0.0,0.8,0.2
SF-N22-1A,SF-N21,1,3,0,3,1,0,0.0,1.0,1.0,0.0
SF-N22-1A,SF-N20-2,1,9,0,0,1,9,0.0,1.0,0.0,1.0
SF-N22-1A,SF-M21,3,6,1,0,2,6,0.3333333333333333,0.6666666666666666,0.0,1.0
SF-N22-1A,SF-L21,10,11,6,2,4,9,0.6,0.4,0.18181818181818182,0.8181818181818182
SF-N22-1A,SF-O30,2,6,0,3,2,3,0.0,1.0,0.5,0.5
SF-N22-1A,SF-N27,8,4,1,0,7,4,0.125,0.875,0.0,1.0
SF-N22-1A,SF-N29,2,1,1,0,1,1,0.5,0.5,0.0,1.0
SF-N22-1A,SF-N28,4,3,2,2,2,1,0.5,0.5,0.6666666666666666,0.3333333333333333
SF-N22-1A,SF-L29,3,1,2,0,1,1,0.6666666666666666,0.3333333333333333,0.0,1.0
SF-N22-1A,SF-H28,3,1,2,0,1,1,0.6666666666666666,0.3333333333333333,0.0,1.0
SF-N22-1A,SF-R24,4,5,3,2,1,3,0.75,0.25,0.4,0.6
SF-N22-1A,SF-P26,2,2,0,1,2,1,0.0,1.0,0.5,0.5
SF-N22-1A,SF-O25-2,7,2,5,1,2,1,0.7142857142857143,0.2857142857142857,0.5,0.5
SF-N22-1A,SF-N26,3,3,2,2,1,1,0.6666666666666666,0.3333333333333333,0.6666666666666666,0.3333333333333333
SF-N22-1A,SF-N25,6,2,4,2,2,0,0.6666666666666666,0.3333333333333333,1.0,0.0
SF-N22-1A,SF-Q23-3,5,3,4,3,1,0,0.8,0.2,1.0,0.0
SF-N22-1A,SF-P22,1,3,0,1,1,2,0.0,1.0,0.3333333333333333,0.6666666666666666
SF-J24,SF-M26,4,15,4,13,0,2,1.0,0.0,0.8666666666666667,0.13333333333333333
SF-J24,SF-M25,21,28,8,12,13,16,0.38095238095238093,0.6190476190476191,0.42857142857142855,0.5714285714285714
SF-J24,SF-M26-2,3,25,2,9,1,16,0.6666666666666666,0.3333333333333333,0.36,0.64
SF-J24,SF-L27,8,9,4,7,4,2,0.5,0.5,0.7777777777777778,0.2222222222222222
SF-J24,SF-K26,57,112,22,75,35,37,0.38596491228070173,0.6140350877192983,0.6696428571428571,0.33035714285714285
SF-J24,SF-J27,28,19,13,10,15,9,0.4642857142857143,0.5357142857142857,0.5263157894736842,0.47368421052631576
SF-J24,SF-M30,71,126,44,72,27,54,0.6197183098591549,0.38028169014084506,0.5714285714285714,0.42857142857142855
SF-J24,SF-L27-2,3,6,3,5,0,1,1.0,0.0,0.8333333333333334,0.16666666666666666
SF-J24,SF-J29-3,9,8,2,5,7,3,0.2222222222222222,0.7777777777777778,0.625,0.375
SF-J24,SF-J29,45,89,31,48,14,41,0.6888888888888889,0.3111111111111111,0.5393258426966292,0.4606741573033708
SF-J24,SF-L26,10,20,8,13,2,7,0.8,0.2,0.65,0.35
SF-J24,SF-M28,30,30,9,11,21,19,0.3,0.7,0.36666666666666664,0.6333333333333333
SF-J24,SF-M27,2,3,0,2,2,1,0.0,1.0,0.6666666666666666,0.3333333333333333
SF-J24,SF-L25,6,12,6,11,0,1,1.0,0.0,0.9166666666666666,0.08333333333333333
SF-J24,SF-M24,15,14,10,11,5,3,0.6666666666666666,0.3333333333333333,0.7857142857142857,0.21428571428571427
SF-J24,SF-L24,29,26,21,14,8,12,0.7241379310344828,0.27586206896551724,0.5384615384615384,0.46153846153846156
SF-J24,SF-N23,19,11,13,6,6,5,0.6842105263157895,0.3157894736842105,0.5454545454545454,0.45454545454545453
SF-J24,SF-N24-2,15,28,9,19,6,9,0.6,0.4,0.6785714285714286,0.32142857142857145
SF-J24,SF-K27-2,13,27,5,20,8,7,0.38461538461538464,0.6153846153846154,0.7407407407407407,0.25925925925925924
SF-J24,SF-J26-2,40,52,31,44,9,8,0.775,0.225,0.8461538461538461,0.15384615384615385
SF-J24,SF-K28-3,2,2,2,2,0,0,1.0,0.0,1.0,0.0
SF-J24,SF-L28,14,5,7,3,7,2,0.5,0.5,0.6,0.4
SF-J24,SF-K28,1,7,1,5,0,2,1.0,0.0,0.7142857142857143,0.2857142857142857
SF-J24,SF-K29-1,18,20,7,3,11,17,0.3888888888888889,0.6111111111111112,0.15,0.85
SF-J24,SF-J28-2,10,14,5,6,5,8,0.5,0.5,0.42857142857142855,0.5714285714285714
SF-J24,SF-K27,7,5,4,4,3,1,0.5714285714285714,0.42857142857142855,0.8,0.2
SF-J24,SF-K25,51,41,39,26,12,15,0.7647058823529411,0.23529411764705882,0.6341463414634146,0.36585365853658536
SF-J24,SF-J25,119,88,93,43,26,45,0.7815126050420168,0.2184873949579832,0.48863636363636365,0.5113636363636364
SF-J24,SF-H26-2,19,28,7,8,12,20,0.3684210526315789,0.631578947368421,0.2857142857142857,0.7142857142857143
SF-J24,SF-P24,5,9,1,6,4,3,0.2,0.8,0.6666666666666666,0.3333333333333333
SF-J24,SF-O24,5,5,3,2,2,3,0.6,0.4,0.4,0.6
SF-J24,SF-J26,28,26,11,21,17,5,0.39285714285714285,0.6071428571428571,0.8076923076923077,0.19230769230769232
SF-J24,SF-I26-,11,12,5,7,6,5,0.45454545454545453,0.5454545454545454,0.5833333333333334,0.4166666666666667
SF-J24,SF-I25,33,33,21,19,12,14,0.6363636363636364,0.36363636363636365,0.5757575757575758,0.42424242424242425
SF-J24,SF-K23,1,1,0,1,1,0,0.0,1.0,1.0,0.0
SF-J24,SF-H26,32,34,15,18,17,16,0.46875,0.53125,0.5294117647058824,0.47058823529411764
SF-J24,SF-O23,12,12,5,2,7,10,0.4166666666666667,0.5833333333333334,0.16666666666666666,0.8333333333333334
SF-J24,SF-H27-1,16,12,11,2,5,10,0.6875,0.3125,0.16666666666666666,0.8333333333333334
SF-J24,SF-F28-2,15,15,13,13,2,2,0.8666666666666667,0.13333333333333333,0.8666666666666667,0.13333333333333333
SF-J24,SF-G27,37,28,16,12,21,16,0.43243243243243246,0.5675675675675675,0.42857142857142855,0.5714285714285714
SF-J24,SF-M22-2,15,18,3,1,12,17,0.2,0.8,0.05555555555555555,0.9444444444444444
SF-J24,SF-L22,13,3,4,0,9,3,0.3076923076923077,0.6923076923076923,0.0,1.0
SF-J24,SF-F27,12,11,4,7,8,4,0.3333333333333333,0.6666666666666666,0.6363636363636364,0.36363636363636365
SF-J24,SF-N22-2,21,26,9,14,12,12,0.42857142857142855,0.5714285714285714,0.5384615384615384,0.46153846153846156
SF-J24,SF-G28-2,19,12,9,10,10,2,0.47368421052631576,0.5263157894736842,0.8333333333333334,0.16666666666666666
SF-J24,SF-G28-1,7,2,3,0,4,2,0.42857142857142855,0.5714285714285714,0.0,1.0
SF-J24,SF-M22-1,10,7,1,2,9,5,0.1,0.9,0.2857142857142857,0.7142857142857143
SF-J24,SF-O25-1,2,12,1,3,1,9,0.5,0.5,0.25,0.75
SF-J24,SF-K22-2,10,2,5,1,5,1,0.5,0.5,0.5,0.5
SF-J24,SF-K24,98,93,94,88,4,5,0.9591836734693877,0.04081632653061224,0.946236559139785,0.053763440860215055
SF-J24,SF-J23-2,11,12,6,10,5,2,0.5454545454545454,0.45454545454545453,0.8333333333333334,0.16666666666666666
SF-J24,SF-G23,12,10,7,0,5,10,0.5833333333333334,0.4166666666666667,0.0,1.0
SF-J24,SF-G24,38,25,15,1,23,24,0.39473684210526316,0.6052631578947368,0.04,0.96
SF-J24,SF-G25,13,9,7,3,6,6,0.5384615384615384,0.46153846153846156,0.3333333333333333,0.6666666666666666
SF-J24,SF-F23,7,11,2,3,5,8,0.2857142857142857,0.7142857142857143,0.2727272727272727,0.7272727272727273
SF-J24,SF-E23,29,9,18,1,11,8,0.6206896551724138,0.3793103448275862,0.1111111111111111,0.8888888888888888
SF-J24,SF-D24,1,2,0,0,1,2,0.0,1.0,0.0,1.0
SF-J24,SF-C22,7,7,3,1,4,6,0.42857142857142855,0.5714285714285714,0.14285714285714285,0.8571428571428571
SF-J24,SF-B22,6,2,1,0,5,2,0.16666666666666666,0.8333333333333334,0.0,1.0
SF-J24,SF-J17,8,2,3,0,5,2,0.375,0.625,0.0,1.0
SF-J24,SF-I20,9,4,5,0,4,4,0.5555555555555556,0.4444444444444444,0.0,1.0
SF-J24,SF-H20,21,11,9,5,12,6,0.42857142857142855,0.5714285714285714,0.45454545454545453,0.5454545454545454
SF-J24,SF-G19,5,2,0,0,5,2,0.0,1.0,0.0,1.0
SF-J24,SF-G20,12,8,3,2,9,6,0.25,0.75,0.25,0.75
SF-J24,SF-F19,4,5,1,1,3,4,0.25,0.75,0.2,0.8
SF-J24,SF-E18,72,27,1,0,71,27,0.013888888888888888,0.9861111111111112,0.0,1.0
SF-J24,SF-H30,6,29,1,7,5,22,0.16666666666666666,0.8333333333333334,0.2413793103448276,0.7586206896551724
SF-J24,SF-G30-2,17,14,3,5,14,9,0.17647058823529413,0.8235294117647058,0.35714285714285715,0.6428571428571429
SF-J24,SF-F30-1,7,14,2,2,5,12,0.2857142857142857,0.7142857142857143,0.14285714285714285,0.8571428571428571
SF-J24,SF-E29-2,9,12,1,8,8,4,0.1111111111111111,0.8888888888888888,0.6666666666666666,0.3333333333333333
SF-J24,SF-E29-1,8,18,2,9,6,9,0.25,0.75,0.5,0.5
SF-J24,SF-D29,4,7,0,5,4,2,0.0,1.0,0.7142857142857143,0.2857142857142857
SF-J24,SF-A27,5,8,4,4,1,4,0.8,0.2,0.5,0.5
SF-J24,SF-G29-2,23,22,12,9,11,13,0.5217391304347826,0.4782608695652174,0.4090909090909091,0.5909090909090909
SF-J24,SF-G29-1,37,39,36,36,1,3,0.972972972972973,0.02702702702702703,0.9230769230769231,0.07692307692307693
SF-J24,SF-G30-1,4,10,0,4,4,6,0.0,1.0,0.4,0.6
SF-J24,SF-G29-3,20,42,7,5,13,37,0.35,0.65,0.11904761904761904,0.8809523809523809
SF-J24,SF-F30-2,8,7,1,3,7,4,0.125,0.875,0.42857142857142855,0.5714285714285714
SF-J24,SF-F29,8,4,3,4,5,0,0.375,0.625,1.0,0.0
SF-J24,SF-E29-3,3,3,2,1,1,2,0.6666666666666666,0.3333333333333333,0.3333333333333333,0.6666666666666666
SF-J24,SF-F28-1,7,4,6,4,1,0,0.8571428571428571,0.14285714285714285,1.0,0.0
SF-J24,SF-E28-2,1,6,1,3,0,3,1.0,0.0,0.5,0.5
SF-J24,SF-E28,1,3,1,1,0,2,1.0,0.0,0.3333333333333333,0.6666666666666666
SF-J24,SF-J10,4,2,0,0,4,2,0.0,1.0,0.0,1.0
SF-J24,SF-J13,1,2,0,1,1,1,0.0,1.0,0.5,0.5
SF-J24,SF-H12,2,1,0,0,2,1,0.0,1.0,0.0,1.0
SF-J24,SF-H15,3,2,0,0,3,2,0.0,1.0,0.0,1.0
SF-J24,SF-G13,1,1,0,0,1,1,0.0,1.0,0.0,1.0
SF-J24,SF-F15,1,2,1,1,0,1,1.0,0.0,0.5,0.5
SF-J24,SF-C21,3,4,1,0,2,4,0.3333333333333333,0.6666666666666666,0.0,1.0
SF-J24,SF-C20,4,3,0,2,4,1,0.0,1.0,0.6666666666666666,0.3333333333333333
SF-J24,SF-A19,2,1,0,1,2,0,0.0,1.0,1.0,0.0
SF-J24,SF-C26,2,5,1,1,1,4,0.5,0.5,0.2,0.8
SF-J24,SF-C25,4,6,0,3,4,3,0.0,1.0,0.5,0.5
SF-J24,SF-B25,14,19,1,4,13,15,0.07142857142857142,0.9285714285714286,0.21052631578947367,0.7894736842105263
SF-J24,SF-E27,3,4,2,2,1,2,0.6666666666666666,0.3333333333333333,0.5,0.5
SF-J24,SF-D27,30,21,2,2,28,19,0.06666666666666667,0.9333333333333333,0.09523809523809523,0.9047619047619048
SF-J24,SF-B28,5,8,1,6,4,2,0.2,0.8,0.75,0.25
SF-J24,SF-G7,1,2,0,0,1,2,0.0,1.0,0.0,1.0
SF-J24,SF-F9,1,4,0,0,1,4,0.0,1.0,0.0,1.0
SF-J24,SF-H25,12,8,0,1,12,7,0.0,1.0,0.125,0.875
SF-J24,SF-G26,21,26,6,15,15,11,0.2857142857142857,0.7142857142857143,0.5769230769230769,0.4230769230769231
SF-J24,SF-K21,5,3,2,1,3,2,0.4,0.6,0.3333333333333333,0.6666666666666666
SF-J24,SF-K22-1,8,16,1,11,7,5,0.125,0.875,0.6875,0.3125
SF-J24,SF-J23-1,66,39,37,19,29,20,0.5606060606060606,0.4393939393939394,0.48717948717948717,0.5128205128205128
SF-J24,SF-J22-1,2,7,1,3,1,4,0.5,0.5,0.42857142857142855,0.5714285714285714
SF-J24,SF-J22-2,22,15,14,3,8,12,0.6363636363636364,0.36363636363636365,0.2,0.8
SF-J24,SF-J21,21,23,14,12,7,11,0.6666666666666666,0.3333333333333333,0.5217391304347826,0.4782608695652174
SF-J24,SF-I21,3,5,2,5,1,0,0.6666666666666666,0.3333333333333333,1.0,0.0
SF-J24,SF-I22,11,7,7,2,4,5,0.6363636363636364,0.36363636363636365,0.2857142857142857,0.7142857142857143
SF-J24,SF-I23-2,8,15,3,5,5,10,0.375,0.625,0.3333333333333333,0.6666666666666666
SF-J24,SF-I24,17,14,15,9,2,5,0.8823529411764706,0.11764705882352941,0.6428571428571429,0.35714285714285715
SF-J24,SF-I23-1,13,15,8,7,5,8,0.6153846153846154,0.38461538461538464,0.4666666666666667,0.5333333333333333
SF-J24,SF-F26,26,15,12,8,14,7,0.46153846153846156,0.5384615384615384,0.5333333333333333,0.4666666666666667
SF-J24,SF-M13,7,1,1,1,6,0,0.14285714285714285,0.8571428571428571,1.0,0.0
SF-J24,SF-M15,13,4,0,0,13,4,0.0,1.0,0.0,1.0
SF-J24,SF-L19,16,3,7,1,9,2,0.4375,0.5625,0.3333333333333333,0.6666666666666666
SF-J24,SF-L20,9,8,2,3,7,5,0.2222222222222222,0.7777777777777778,0.375,0.625
SF-J24,SF-N20-1,9,2,0,0,9,2,0.0,1.0,0.0,1.0
SF-J24,SF-M20,22,9,10,2,12,7,0.45454545454545453,0.5454545454545454,0.2222222222222222,0.7777777777777778
SF-J24,SF-K17-2,18,1,1,1,17,0,0.05555555555555555,0.9444444444444444,1.0,0.0
SF-J24,SF-K20,8,4,5,0,3,4,0.625,0.375,0.0,1.0
SF-J24,SF-K15-,5,14,1,3,4,11,0.2,0.8,0.21428571428571427,0.7857142857142857
SF-J24,SF-K19,20,7,8,1,12,6,0.4,0.6,0.14285714285714285,0.8571428571428571
SF-J24,SF-K18,9,2,2,0,7,2,0.2222222222222222,0.7777777777777778,0.0,1.0
SF-J24,SF-K17,3,9,0,4,3,5,0.0,1.0,0.4444444444444444,0.5555555555555556
SF-J24,SF-J18,7,9,4,1,3,8,0.5714285714285714,0.42857142857142855,0.1111111111111111,0.8888888888888888
SF-J24,SF-J20,8,3,4,2,4,1,0.5,0.5,0.6666666666666666,0.3333333333333333
SF-J24,SF-J19,10,7,5,1,5,6,0.5,0.5,0.14285714285714285,0.8571428571428571
SF-J24,SF-M12,10,15,0,0,10,15,0.0,1.0,0.0,1.0
SF-J24,SF-M10,3,1,0,0,3,1,0.0,1.0,0.0,1.0
SF-J24,SF-R19,1,5,0,2,1,3,0.0,1.0,0.4,0.6
SF-J24,SF-Q21-2,2,3,1,0,1,3,0.5,0.5,0.0,1.0
SF-J24,SF-Q21-1,7,4,6,4,1,0,0.8571428571428571,0.14285714285714285,1.0,0.0
SF-J24,SF-P21,5,5,3,0,2,5,0.6,0.4,0.0,1.0
SF-J24,SF-O18,5,3,1,1,4,2,0.2,0.8,0.3333333333333333,0.6666666666666666
SF-J24,SF-O19,7,13,1,3,6,10,0.14285714285714285,0.8571428571428571,0.23076923076923078,0.7692307692307693
SF-J24,SF-O21,35,39,24,5,11,34,0.6857142857142857,0.3142857142857143,0.1282051282051282,0.8717948717948718
SF-J24,SF-O22,25,23,14,10,11,13,0.56,0.44,0.43478260869565216,0.5652173913043478
SF-J24,SF-N21,6,13,5,5,1,8,0.8333333333333334,0.16666666666666666,0.38461538461538464,0.6153846153846154
SF-J24,SF-N20-2,8,5,3,0,5,5,0.375,0.625,0.0,1.0
SF-J24,SF-M21,10,8,4,2,6,6,0.4,0.6,0.25,0.75
SF-J24,SF-L21,22,6,10,1,12,5,0.45454545454545453,0.5454545454545454,0.16666666666666666,0.8333333333333334
SF-J24,SF-S29,1,5,1,4,0,1,1.0,0.0,0.8,0.2
SF-J24,SF-Q30,11,11,1,0,10,11,0.09090909090909091,0.9090909090909091,0.0,1.0
SF-J24,SF-P30,8,11,5,4,3,7,0.625,0.375,0.36363636363636365,0.6363636363636364
SF-J24,SF-O30-2,4,9,3,5,1,4,0.75,0.25,0.5555555555555556,0.4444444444444444
SF-J24,SF-O30,13,14,10,8,3,6,0.7692307692307693,0.23076923076923078,0.5714285714285714,0.42857142857142855
SF-J24,SF-N27,47,34,6,15,41,19,0.1276595744680851,0.8723404255319149,0.4411764705882353,0.5588235294117647
SF-J24,SF-N29,3,3,3,3,0,0,1.0,0.0,1.0,0.0
SF-J24,SF-N28,7,19,2,14,5,5,0.2857142857142857,0.7142857142857143,0.7368421052631579,0.2631578947368421
SF-J24,SF-L30-1,31,30,15,17,16,13,0.4838709677419355,0.5161290322580645,0.5666666666666667,0.43333333333333335
SF-J24,SF-L31-1,2,6,1,2,1,4,0.5,0.5,0.3333333333333333,0.6666666666666666
SF-J24,SF-K30-2,2,7,1,5,1,2,0.5,0.5,0.7142857142857143,0.2857142857142857
SF-J24,SF-L29,17,33,7,14,10,19,0.4117647058823529,0.5882352941176471,0.42424242424242425,0.5757575757575758
SF-J24,SF-J29-1,23,24,14,20,9,4,0.6086956521739131,0.391304347826087,0.8333333333333334,0.16666666666666666
SF-J24,SF-I30,17,8,15,7,2,1,0.8823529411764706,0.11764705882352941,0.875,0.125
SF-J24,SF-I27,22,41,8,29,14,12,0.36363636363636365,0.6363636363636364,0.7073170731707317,0.2926829268292683
SF-J24,SF-I28,15,17,6,9,9,8,0.4,0.6,0.5294117647058824,0.47058823529411764
SF-J24,SF-I30-2,13,10,3,4,10,6,0.23076923076923078,0.7692307692307693,0.4,0.6
SF-J24,SF I29-1,8,19,0,2,8,17,0.0,1.0,0.10526315789473684,0.8947368421052632
SF-J24,SF-H28,38,35,17,16,21,19,0.4473684210526316,0.5526315789473685,0.45714285714285713,0.5428571428571428
SF-J24,SF-H29,5,8,3,6,2,2,0.6,0.4,0.75,0.25
SF-J24,SF-S24,36,22,4,1,32,21,0.1111111111111111,0.8888888888888888,0.045454545454545456,0.9545454545454546
SF-J24,SF-R24,5,6,0,2,5,4,0.0,1.0,0.3333333333333333,0.6666666666666666
SF-J24,SF-Q26,3,4,0,2,3,2,0.0,1.0,0.5,0.5
SF-J24,SF-P26,37,19,10,2,27,17,0.2702702702702703,0.7297297297297297,0.10526315789473684,0.8947368421052632
SF-J24,SF-O25-2,4,18,1,2,3,16,0.25,0.75,0.1111111111111111,0.8888888888888888
SF-J24,SF-N22-1B,3,6,0,2,3,4,0.0,1.0,0.3333333333333333,0.6666666666666666
SF-J24,SF-N26,4,4,4,3,0,1,1.0,0.0,0.75,0.25
SF-J24,SF-N25,12,6,9,3,3,3,0.75,0.25,0.5,0.5
SF-J24,SF-T21,3,1,2,0,1,1,0.6666666666666666,0.3333333333333333,0.0,1.0
SF-J24,SF-T22,1,4,0,0,1,4,0.0,1.0,0.0,1.0
SF-J24,SF-S22-2,1,2,1,1,0,1,1.0,0.0,0.5,0.5
SF-J24,SF-S22-1,1,1,0,1,1,0,0.0,1.0,1.0,0.0
SF-J24,SF-Q23-3,4,4,2,1,2,3,0.5,0.5,0.25,0.75
SF-J24,SF-Q22-1,19,19,8,5,11,14,0.42105263157894735,0.5789473684210527,0.2631578947368421,0.7368421052631579
SF-J24,SF-Q22-2,6,8,1,4,5,4,0.16666666666666666,0.8333333333333334,0.5,0.5
SF-J24,SF-P22,24,17,18,9,6,8,0.75,0.25,0.5294117647058824,0.47058823529411764
SF-J24,SF-W19,1,2,1,1,0,1,1.0,0.0,0.5,0.5
SF-J24,SF-W19-2,1,2,0,0,1,2,0.0,1.0,0.0,1.0
SF-J24,SF-T20,2,3,1,2,1,1,0.5,0.5,0.6666666666666666,0.3333333333333333
SF-J24,SF-S21,1,1,0,0,1,1,0.0,1.0,0.0,1.0
SF-O24,SF-M25,5,5,2,2,3,3,0.4,0.6,0.4,0.6
SF-O24,SF-K26,5,3,3,2,2,1,0.6,0.4,0.6666666666666666,0.3333333333333333
SF-O24,SF-J27,1,2,1,0,0,2,1.0,0.0,0.0,1.0
SF-O24,SF-M30,10,15,4,9,6,6,0.4,0.6,0.6,0.4
SF-O24,SF-J29,2,2,1,2,1,0,0.5,0.5,1.0,0.0
SF-O24,SF-L26,2,15,1,5,1,10,0.5,0.5,0.3333333333333333,0.6666666666666666
SF-O24,SF-L25,4,8,3,6,1,2,0.75,0.25,0.75,0.25
SF-O24,SF-M24,10,30,8,24,2,6,0.8,0.2,0.8,0.2
SF-O24,SF-L24,33,36,20,22,13,14,0.6060606060606061,0.3939393939393939,0.6111111111111112,0.3888888888888889
SF-O24,SF-N23,10,19,7,15,3,4,0.7,0.3,0.7894736842105263,0.21052631578947367
SF-O24,SF-N24-2,10,17,7,13,3,4,0.7,0.3,0.7647058823529411,0.23529411764705882
SF-O24,SF-K27-2,15,16,15,13,0,3,1.0,0.0,0.8125,0.1875
SF-O24,SF-J26-2,13,19,1,6,12,13,0.07692307692307693,0.9230769230769231,0.3157894736842105,0.6842105263157895
SF-O24,SF-L28,5,1,3,1,2,0,0.6,0.4,1.0,0.0
SF-O24,SF-K28,1,3,1,1,0,2,1.0,0.0,0.3333333333333333,0.6666666666666666
SF-O24,SF-K29-1,1,2,0,2,1,0,0.0,1.0,1.0,0.0
SF-O24,SF-K25,16,21,11,14,5,7,0.6875,0.3125,0.6666666666666666,0.3333333333333333
SF-O24,SF-J25,20,11,10,2,10,9,0.5,0.5,0.18181818181818182,0.8181818181818182
SF-O24,SF-H26-2,5,3,2,2,3,1,0.4,0.6,0.6666666666666666,0.3333333333333333
SF-O24,SF-P24,21,11,11,10,10,1,0.5238095238095238,0.47619047619047616,0.9090909090909091,0.09090909090909091
SF-O24,SF-N22-1A,4,2,2,2,2,0,0.5,0.5,1.0,0.0
SF-O24,SF-J24,5,5,2,3,3,2,0.4,0.6,0.6,0.4
SF-O24,SF-J26,5,7,2,5,3,2,0.4,0.6,0.7142857142857143,0.2857142857142857
SF-O24,SF-I26-,4,2,1,1,3,1,0.25,0.75,0.5,0.5
SF-O24,SF-I25,9,3,1,3,8,0,0.1111111111111111,0.8888888888888888,1.0,0.0
SF-O24,SF-H26,13,11,10,9,3,2,0.7692307692307693,0.23076923076923078,0.8181818181818182,0.18181818181818182
SF-O24,SF-O23,28,15,19,11,9,4,0.6785714285714286,0.32142857142857145,0.7333333333333333,0.26666666666666666
SF-O24,SF-H27-1,11,9,6,1,5,8,0.5454545454545454,0.45454545454545453,0.1111111111111111,0.8888888888888888
SF-O24,SF-F28-2,6,5,4,3,2,2,0.6666666666666666,0.3333333333333333,0.6,0.4
SF-O24,SF-G27,5,15,3,8,2,7,0.6,0.4,0.5333333333333333,0.4666666666666667
SF-O24,SF-M22-2,8,11,6,8,2,3,0.75,0.25,0.7272727272727273,0.2727272727272727
SF-O24,SF-L22,7,10,1,3,6,7,0.14285714285714285,0.8571428571428571,0.3,0.7
SF-O24,SF-F27,6,7,5,1,1,6,0.8333333333333334,0.16666666666666666,0.14285714285714285,0.8571428571428571
SF-O24,SF-N22-2,6,17,4,7,2,10,0.6666666666666666,0.3333333333333333,0.4117647058823529,0.5882352941176471
SF-O24,SF-M22-1,9,8,8,6,1,2,0.8888888888888888,0.1111111111111111,0.75,0.25
SF-O24,SF-O25-1,9,3,8,1,1,2,0.8888888888888888,0.1111111111111111,0.3333333333333333,0.6666666666666666
SF-O24,SF-K22-2,2,4,2,3,0,1,1.0,0.0,0.75,0.25
SF-O24,SF-K24,13,13,5,9,8,4,0.38461538461538464,0.6153846153846154,0.6923076923076923,0.3076923076923077
SF-O24,SF-J23-2,5,5,4,4,1,1,0.8,0.2,0.8,0.2
SF-O24,SF-G23,5,2,3,2,2,0,0.6,0.4,1.0,0.0
SF-O24,SF-G24,50,5,7,2,43,3,0.14,0.86,0.4,0.6
SF-O24,SF-G25,16,20,1,1,15,19,0.0625,0.9375,0.05,0.95
SF-O24,SF-F23,35,2,25,1,10,1,0.7142857142857143,0.2857142857142857,0.5,0.5
SF-O24,SF-E23,49,20,10,0,39,20,0.20408163265306123,0.7959183673469388,0.0,1.0
SF-O24,SF-D24,2,1,1,0,1,1,0.5,0.5,0.0,1.0
SF-O24,SF-B22,11,4,0,2,11,2,0.0,1.0,0.5,0.5
SF-O24,SF-J17,2,3,0,0,2,3,0.0,1.0,0.0,1.0
SF-O24,SF-H16,1,2,1,0,0,2,1.0,0.0,0.0,1.0
SF-O24,SF-G19,1,1,0,0,1,1,0.0,1.0,0.0,1.0
SF-O24,SF-G17,1,1,0,0,1,1,0.0,1.0,0.0,1.0
SF-O24,SF-G18,1,1,1,1,0,0,1.0,0.0,1.0,0.0
SF-O24,SF-F19,2,1,0,1,2,0,0.0,1.0,1.0,0.0
SF-O24,SF-E20,13,8,0,0,13,8,0.0,1.0,0.0,1.0
SF-O24,SF-H30,2,6,0,2,2,4,0.0,1.0,0.3333333333333333,0.6666666666666666
SF-O24,SF-G30-2,6,5,1,0,5,5,0.16666666666666666,0.8333333333333334,0.0,1.0
SF-O24,SF-F30-1,5,2,0,1,5,1,0.0,1.0,0.5,0.5
SF-O24,SF-E29-2,5,3,0,2,5,1,0.0,1.0,0.6666666666666666,0.3333333333333333
SF-O24,SF-E29-1,5,9,2,5,3,4,0.4,0.6,0.5555555555555556,0.4444444444444444
SF-O24,SF-D29,5,6,3,3,2,3,0.6,0.4,0.5,0.5
SF-O24,SF-G29-2,2,7,0,0,2,7,0.0,1.0,0.0,1.0
SF-O24,SF-G29-1,1,1,0,0,1,1,0.0,1.0,0.0,1.0
SF-O24,SF-G29-3,3,3,3,2,0,1,1.0,0.0,0.6666666666666666,0.3333333333333333
SF-O24,SF-F30-2,9,10,2,1,7,9,0.2222222222222222,0.7777777777777778,0.1,0.9
SF-O24,SF-F29,2,1,0,0,2,1,0.0,1.0,0.0,1.0
SF-O24,SF-E29-3,19,43,0,0,19,43,0.0,1.0,0.0,1.0
SF-O24,SF-E28-2,2,1,0,0,2,1,0.0,1.0,0.0,1.0
SF-O24,SF-E28,1,1,1,0,0,1,1.0,0.0,0.0,1.0
SF-O24,SF-J10,2,2,1,1,1,1,0.5,0.5,0.5,0.5
SF-O24,SF-J12,2,5,0,0,2,5,0.0,1.0,0.0,1.0
SF-O24,SF-H13,13,8,0,0,13,8,0.0,1.0,0.0,1.0
SF-O24,SF-I16,2,1,0,0,2,1,0.0,1.0,0.0,1.0
SF-O24,SF-F15,1,2,0,0,1,2,0.0,1.0,0.0,1.0
SF-O24,SF-B19,1,1,0,0,1,1,0.0,1.0,0.0,1.0
SF-O24,SF-C25,2,4,2,1,0,3,1.0,0.0,0.25,0.75
SF-O24,SF-B25,1,3,1,0,0,3,1.0,0.0,0.0,1.0
SF-O24,SF-B28-2,6,2,1,0,5,2,0.16666666666666666,0.8333333333333334,0.0,1.0
SF-O24,SF-D27,1,3,0,1,1,2,0.0,1.0,0.3333333333333333,0.6666666666666666
SF-O24,SF-C28-2,1,2,1,0,0,2,1.0,0.0,0.0,1.0
SF-O24,SF-J1,3,1,0,0,3,1,0.0,1.0,0.0,1.0
SF-O24,SF-H25,4,1,0,0,4,1,0.0,1.0,0.0,1.0
SF-O24,SF-G26,2,3,0,3,2,0,0.0,1.0,1.0,0.0
SF-O24,SF-K21,3,1,2,0,1,1,0.6666666666666666,0.3333333333333333,0.0,1.0
SF-O24,SF-J23-1,21,37,14,29,7,8,0.6666666666666666,0.3333333333333333,0.7837837837837838,0.21621621621621623
SF-O24,SF-J22-1,6,8,4,4,2,4,0.6666666666666666,0.3333333333333333,0.5,0.5
SF-O24,SF-J22-2,7,8,3,1,4,7,0.42857142857142855,0.5714285714285714,0.125,0.875
SF-O24,SF-J21,4,5,1,3,3,2,0.25,0.75,0.6,0.4
SF-O24,SF-I23-2,4,1,3,0,1,1,0.75,0.25,0.0,1.0
SF-O24,SF-I23-1,2,4,1,3,1,1,0.5,0.5,0.75,0.25
SF-O24,SF-F26,41,18,6,3,35,15,0.14634146341463414,0.8536585365853658,0.16666666666666666,0.8333333333333334
SF-O24,SF-M13,20,9,0,0,20,9,0.0,1.0,0.0,1.0
SF-O24,SF-M15,62,28,10,0,52,28,0.16129032258064516,0.8387096774193549,0.0,1.0
SF-O24,SF-L19,3,13,1,2,2,11,0.3333333333333333,0.6666666666666666,0.15384615384615385,0.8461538461538461
SF-O24,SF-L20,3,4,1,1,2,3,0.3333333333333333,0.6666666666666666,0.25,0.75
SF-O24,SF-N20-1,2,3,1,2,1,1,0.5,0.5,0.6666666666666666,0.3333333333333333
SF-O24,SF-M20,15,5,8,2,7,3,0.5333333333333333,0.4666666666666667,0.4,0.6
SF-O24,SF-K17-2,4,1,2,0,2,1,0.5,0.5,0.0,1.0
SF-O24,SF-K20,7,2,3,1,4,1,0.42857142857142855,0.5714285714285714,0.5,0.5
SF-O24,SF-K15-,3,9,1,4,2,5,0.3333333333333333,0.6666666666666666,0.4444444444444444,0.5555555555555556
SF-O24,SF-K19,17,12,12,9,5,3,0.7058823529411765,0.29411764705882354,0.75,0.25
SF-O24,SF-K18,4,4,2,0,2,4,0.5,0.5,0.0,1.0
SF-O24,SF-K17,4,4,3,3,1,1,0.75,0.25,0.75,0.25
SF-O24,SF-J18,4,5,1,0,3,5,0.25,0.75,0.0,1.0
SF-O24,SF-J19,6,6,4,0,2,6,0.6666666666666666,0.3333333333333333,0.0,1.0
SF-O24,SF-M12,4,2,1,0,3,2,0.25,0.75,0.0,1.0
SF-O24,SF-R19,3,3,2,2,1,1,0.6666666666666666,0.3333333333333333,0.6666666666666666,0.3333333333333333
SF-O24,SF-Q21-2,12,10,6,0,6,10,0.5,0.5,0.0,1.0
SF-O24,SF-Q21-1,8,9,7,7,1,2,0.875,0.125,0.7777777777777778,0.2222222222222222
SF-O24,SF-P21,2,2,2,0,0,2,1.0,0.0,0.0,1.0
SF-O24,SF-O18,10,2,5,0,5,2,0.5,0.5,0.0,1.0
SF-O24,SF-O19,6,12,2,2,4,10,0.3333333333333333,0.6666666666666666,0.16666666666666666,0.8333333333333334
SF-O24,SF-O21,17,24,14,14,3,10,0.8235294117647058,0.17647058823529413,0.5833333333333334,0.4166666666666667
SF-O24,SF-O22,28,18,16,11,12,7,0.5714285714285714,0.42857142857142855,0.6111111111111112,0.3888888888888889
SF-O24,SF-N21,4,3,2,1,2,2,0.5,0.5,0.3333333333333333,0.6666666666666666
SF-O24,SF-N20-2,3,5,2,3,1,2,0.6666666666666666,0.3333333333333333,0.6,0.4
SF-O24,SF-M21,13,8,8,4,5,4,0.6153846153846154,0.38461538461538464,0.5,0.5
SF-O24,SF-L21,8,6,2,1,6,5,0.25,0.75,0.16666666666666666,0.8333333333333334
SF-O24,SF-S30,3,1,1,0,2,1,0.3333333333333333,0.6666666666666666,0.0,1.0
SF-O24,SF-Q30,6,2,1,0,5,2,0.16666666666666666,0.8333333333333334,0.0,1.0
SF-O24,SF-P30,7,2,2,0,5,2,0.2857142857142857,0.7142857142857143,0.0,1.0
SF-O24,SF-O30-2,1,3,0,1,1,2,0.0,1.0,0.3333333333333333,0.6666666666666666
SF-O24,SF-O30,6,6,0,0,6,6,0.0,1.0,0.0,1.0
SF-O24,SF-N27,7,10,4,3,3,7,0.5714285714285714,0.42857142857142855,0.3,0.7
SF-O24,SF-N28,10,8,8,3,2,5,0.8,0.2,0.375,0.625
SF-O24,SF-L30-1,3,6,0,2,3,4,0.0,1.0,0.3333333333333333,0.6666666666666666
SF-O24,SF-L31-1,1,2,0,0,1,2,0.0,1.0,0.0,1.0
SF-O24,SF-J29-1,2,5,0,0,2,5,0.0,1.0,0.0,1.0
SF-O24,SF-I30,5,1,1,1,4,0,0.2,0.8,1.0,0.0
SF-O24,SF-I29-2,1,3,0,0,1,3,0.0,1.0,0.0,1.0
SF-O24,SF-I27,8,18,1,11,7,7,0.125,0.875,0.6111111111111112,0.3888888888888889
SF-O24,SF-I28,1,4,0,2,1,2,0.0,1.0,0.5,0.5
SF-O24,SF-H28,1,5,1,3,0,2,1.0,0.0,0.6,0.4
SF-O24,SF-S24,22,35,9,15,13,20,0.4090909090909091,0.5909090909090909,0.42857142857142855,0.5714285714285714
SF-O24,SF-R24,36,24,25,14,11,10,0.6944444444444444,0.3055555555555556,0.5833333333333334,0.4166666666666667
SF-O24,SF-R26,7,1,5,1,2,0,0.7142857142857143,0.2857142857142857,1.0,0.0
SF-O24,SF-P26,3,4,2,1,1,3,0.6666666666666666,0.3333333333333333,0.25,0.75
SF-O24,SF-O25-2,3,8,2,7,1,1,0.6666666666666666,0.3333333333333333,0.875,0.125
SF-O24,SF-N22-1B,24,19,19,16,5,3,0.7916666666666666,0.20833333333333334,0.8421052631578947,0.15789473684210525
SF-O24,SF-N26,4,3,4,2,0,1,1.0,0.0,0.6666666666666666,0.3333333333333333
SF-O24,SF-N25,5,5,3,5,2,0,0.6,0.4,1.0,0.0
SF-O24,SF-T21,1,3,1,0,0,3,1.0,0.0,0.0,1.0
SF-O24,SF-T22,4,5,0,2,4,3,0.0,1.0,0.4,0.6
SF-O24,SF-S22-2,1,2,1,0,0,2,1.0,0.0,0.0,1.0
SF-O24,SF-S22-1,5,3,2,2,3,1,0.4,0.6,0.6666666666666666,0.3333333333333333
SF-O24,SF-Q23-3,10,5,9,3,1,2,0.9,0.1,0.6,0.4
SF-O24,SF-Q22-1,19,13,11,10,8,3,0.5789473684210527,0.42105263157894735,0.7692307692307693,0.23076923076923078
SF-O24,SF-Q22-2,16,16,14,12,2,4,0.875,0.125,0.75,0.25
SF-O24,SF-P22,2,6,2,4,0,2,1.0,0.0,0.6666666666666666,0.3333333333333333
SF-O24,SF-U21,1,3,0,0,1,3,0.0,1.0,0.0,1.0
SF-O24,SF-T20,9,2,1,1,8,1,0.1111111111111111,0.8888888888888888,0.5,0.5
SF-O24,SF-S21,8,4,4,0,4,4,0.5,0.5,0.0,1.0
SF-O24,SF-V32,1,1,0,0,1,1,0.0,1.0,0.0,1.0
SF-J26,SF-M26,2,1,1,0,1,1,0.5,0.5,0.0,1.0
SF-J26,SF-M25,5,6,1,1,4,5,0.2,0.8,0.16666666666666666,0.8333333333333334
SF-J26,SF-M26-2,9,15,3,11,6,4,0.3333333333333333,0.6666666666666666,0.7333333333333333,0.26666666666666666
SF-J26,SF-L27,17,24,10,10,7,14,0.5882352941176471,0.4117647058823529,0.4166666666666667,0.5833333333333334
SF-J26,SF-K26,13,14,5,5,8,9,0.38461538461538464,0.6153846153846154,0.35714285714285715,0.6428571428571429
SF-J26,SF-J27,12,7,9,3,3,4,0.75,0.25,0.42857142857142855,0.5714285714285714
SF-J26,SF-M30,21,19,4,3,17,16,0.19047619047619047,0.8095238095238095,0.15789473684210525,0.8421052631578947
SF-J26,SF-J29-3,8,4,4,1,4,3,0.5,0.5,0.25,0.75
SF-J26,SF-J29,14,20,9,7,5,13,0.6428571428571429,0.35714285714285715,0.35,0.65
SF-J26,SF-L26,56,38,26,13,30,25,0.4642857142857143,0.5357142857142857,0.34210526315789475,0.6578947368421053
SF-J26,SF-M28,6,92,3,16,3,76,0.5,0.5,0.17391304347826086,0.8260869565217391
SF-J26,SF-M27,3,4,3,3,0,1,1.0,0.0,0.75,0.25
SF-J26,SF-L25,14,9,4,1,10,8,0.2857142857142857,0.7142857142857143,0.1111111111111111,0.8888888888888888
SF-J26,SF-M24,12,9,3,4,9,5,0.25,0.75,0.4444444444444444,0.5555555555555556
SF-J26,SF-L24,26,17,15,7,11,10,0.5769230769230769,0.4230769230769231,0.4117647058823529,0.5882352941176471
SF-J26,SF-N23,13,4,4,1,9,3,0.3076923076923077,0.6923076923076923,0.25,0.75
SF-J26,SF-N24-2,1,1,0,1,1,0,0.0,1.0,1.0,0.0
SF-J26,SF-K27-2,6,4,4,1,2,3,0.6666666666666666,0.3333333333333333,0.25,0.75
SF-J26,SF-J26-2,37,21,27,11,10,10,0.7297297297297297,0.2702702702702703,0.5238095238095238,0.47619047619047616
SF-J26,SF-K28-3,1,2,0,2,1,0,0.0,1.0,1.0,0.0
SF-J26,SF-L28,5,2,3,2,2,0,0.6,0.4,1.0,0.0
SF-J26,SF-K28,4,8,3,7,1,1,0.75,0.25,0.875,0.125
SF-J26,SF-K29-1,11,8,6,3,5,5,0.5454545454545454,0.45454545454545453,0.375,0.625
SF-J26,SF-J28-2,11,10,6,5,5,5,0.5454545454545454,0.45454545454545453,0.5,0.5
SF-J26,SF-K27,4,3,3,2,1,1,0.75,0.25,0.6666666666666666,0.3333333333333333
SF-J26,SF-K25,43,12,35,7,8,5,0.813953488372093,0.18604651162790697,0.5833333333333334,0.4166666666666667
SF-J26,SF-J25,11,28,6,21,5,7,0.5454545454545454,0.45454545454545453,0.75,0.25
SF-J26,SF-H26-2,5,10,2,2,3,8,0.4,0.6,0.2,0.8
SF-J26,SF-P24,9,3,4,2,5,1,0.4444444444444444,0.5555555555555556,0.6666666666666666,0.3333333333333333
SF-J26,SF-J24,26,28,21,11,5,17,0.8076923076923077,0.19230769230769232,0.39285714285714285,0.6071428571428571
SF-J26,SF-O24,7,5,5,2,2,3,0.7142857142857143,0.2857142857142857,0.4,0.6
SF-J26,SF-I26-,13,10,10,4,3,6,0.7692307692307693,0.23076923076923078,0.4,0.6
SF-J26,SF-I25,13,16,6,10,7,6,0.46153846153846156,0.5384615384615384,0.625,0.375
SF-J26,SF-H26,24,27,22,21,2,6,0.9166666666666666,0.08333333333333333,0.7777777777777778,0.2222222222222222
SF-J26,SF-O23,6,10,3,8,3,2,0.5,0.5,0.8,0.2
SF-J26,SF-H27-1,7,11,6,9,1,2,0.8571428571428571,0.14285714285714285,0.8181818181818182,0.18181818181818182
SF-J26,SF-F28-2,5,12,2,5,3,7,0.4,0.6,0.4166666666666667,0.5833333333333334
SF-J26,SF-G27,22,34,13,20,9,14,0.5909090909090909,0.4090909090909091,0.5882352941176471,0.4117647058823529
SF-J26,SF-M22-2,11,3,4,0,7,3,0.36363636363636365,0.6363636363636364,0.0,1.0
SF-J26,SF-L22,6,6,3,3,3,3,0.5,0.5,0.5,0.5
SF-J26,SF-F27,5,11,2,2,3,9,0.4,0.6,0.18181818181818182,0.8181818181818182
SF-J26,SF-N22-2,12,2,2,1,10,1,0.16666666666666666,0.8333333333333334,0.5,0.5
SF-J26,SF-G28-2,3,2,1,2,2,0,0.3333333333333333,0.6666666666666666,1.0,0.0
SF-J26,SF-M22-1,6,1,5,1,1,0,0.8333333333333334,0.16666666666666666,1.0,0.0
SF-J26,SF-K22-2,7,7,5,3,2,4,0.7142857142857143,0.2857142857142857,0.42857142857142855,0.5714285714285714
SF-J26,SF-K24,4,11,1,9,3,2,0.25,0.75,0.8181818181818182,0.18181818181818182
SF-J26,SF-J23-2,11,4,4,1,7,3,0.36363636363636365,0.6363636363636364,0.25,0.75
SF-J26,SF-G23,5,1,3,0,2,1,0.6,0.4,0.0,1.0
SF-J26,SF-G24,7,3,1,2,6,1,0.14285714285714285,0.8571428571428571,0.6666666666666666,0.3333333333333333
SF-J26,SF-G25,6,3,4,1,2,2,0.6666666666666666,0.3333333333333333,0.3333333333333333,0.6666666666666666
SF-J26,SF-F23,10,7,4,3,6,4,0.4,0.6,0.42857142857142855,0.5714285714285714
SF-J26,SF-E23,10,3,4,0,6,3,0.4,0.6,0.0,1.0
SF-J26,SF-B22,2,1,1,1,1,0,0.5,0.5,1.0,0.0
SF-J26,SF-J17,1,3,0,1,1,2,0.0,1.0,0.3333333333333333,0.6666666666666666
SF-J26,SF-I19,1,1,1,0,0,1,1.0,0.0,0.0,1.0
SF-J26,SF-I20,2,1,1,0,1,1,0.5,0.5,0.0,1.0
SF-J26,SF-H20,4,2,1,1,3,1,0.25,0.75,0.5,0.5
SF-J26,SF-G19,2,1,1,0,1,1,0.5,0.5,0.0,1.0
SF-J26,SF-G17,1,2,0,0,1,2,0.0,1.0,0.0,1.0
SF-J26,SF-G18,1,3,1,0,0,3,1.0,0.0,0.0,1.0
SF-J26,SF-G20,1,1,0,0,1,1,0.0,1.0,0.0,1.0
SF-J26,SF-F19,2,1,1,0,1,1,0.5,0.5,0.0,1.0
SF-J26,SF-E18,44,27,40,0,4,27,0.9090909090909091,0.09090909090909091,0.0,1.0
SF-J26,SF-E20,7,2,6,1,1,1,0.8571428571428571,0.14285714285714285,0.5,0.5
SF-J26,SF-G30-2,11,1,3,0,8,1,0.2727272727272727,0.7272727272727273,0.0,1.0
SF-J26,SF-F30-1,10,9,1,5,9,4,0.1,0.9,0.5555555555555556,0.4444444444444444
SF-J26,SF-E29-2,4,3,3,1,1,2,0.75,0.25,0.3333333333333333,0.6666666666666666
SF-J26,SF-E29-1,10,11,1,3,9,8,0.1,0.9,0.2727272727272727,0.7272727272727273
SF-J26,SF-D29,9,5,3,3,6,2,0.3333333333333333,0.6666666666666666,0.6,0.4
SF-J26,SF-D28,2,1,2,0,0,1,1.0,0.0,0.0,1.0
SF-J26,SF-A27,77,8,1,1,76,7,0.012987012987012988,0.987012987012987,0.125,0.875
SF-J26,SF-G29-2,24,17,11,6,13,11,0.4583333333333333,0.5416666666666666,0.35294117647058826,0.6470588235294118
SF-J26,SF-G29-1,19,12,9,7,10,5,0.47368421052631576,0.5263157894736842,0.5833333333333334,0.4166666666666667
SF-J26,SF-G30-1,5,15,1,7,4,8,0.2,0.8,0.4666666666666667,0.5333333333333333
SF-J26,SF-G29-3,8,9,3,2,5,7,0.375,0.625,0.2222222222222222,0.7777777777777778
SF-J26,SF-F30-2,1,3,1,2,0,1,1.0,0.0,0.6666666666666666,0.3333333333333333
SF-J26,SF-F29,13,3,10,2,3,1,0.7692307692307693,0.23076923076923078,0.6666666666666666,0.3333333333333333
SF-J26,SF-E29-3,1,3,0,2,1,1,0.0,1.0,0.6666666666666666,0.3333333333333333
SF-J26,SF-F28-1,1,2,1,0,0,2,1.0,0.0,0.0,1.0
SF-J26,SF-E28-2,3,1,3,1,0,0,1.0,0.0,1.0,0.0
SF-J26,SF-E28,7,3,5,2,2,1,0.7142857142857143,0.2857142857142857,0.6666666666666666,0.3333333333333333
SF-J26,SF-G12,1,4,0,0,1,4,0.0,1.0,0.0,1.0
SF-J26,SF-C20,4,2,0,1,4,1,0.0,1.0,0.5,0.5
SF-J26,SF-B19,1,2,0,2,1,0,0.0,1.0,1.0,0.0
SF-J26,SF-A20,2,2,1,1,1,1,0.5,0.5,0.5,0.5
SF-J26,SF-C26,2,2,2,2,0,0,1.0,0.0,1.0,0.0
SF-J26,SF-C25,6,5,3,2,3,3,0.5,0.5,0.4,0.6
SF-J26,SF-B25,2,2,1,0,1,2,0.5,0.5,0.0,1.0
SF-J26,SF-E27,3,5,0,1,3,4,0.0,1.0,0.2,0.8
SF-J26,SF-B28-2,9,3,1,3,8,0,0.1111111111111111,0.8888888888888888,1.0,0.0
SF-J26,SF-D27,3,9,2,4,1,5,0.6666666666666666,0.3333333333333333,0.4444444444444444,0.5555555555555556
SF-J26,SF-C28-1,1,2,1,2,0,0,1.0,0.0,1.0,0.0
SF-J26,SF-B28,33,7,7,1,26,6,0.21212121212121213,0.7878787878787878,0.14285714285714285,0.8571428571428571
SF-J26,SF-J1,6,3,0,2,6,1,0.0,1.0,0.6666666666666666,0.3333333333333333
SF-J26,SF-H25,5,6,0,1,5,5,0.0,1.0,0.16666666666666666,0.8333333333333334
SF-J26,SF-G26,4,10,1,3,3,7,0.25,0.75,0.3,0.7
SF-J26,SF-K21,10,5,3,0,7,5,0.3,0.7,0.0,1.0
SF-J26,SF-K22-1,11,8,6,5,5,3,0.5454545454545454,0.45454545454545453,0.625,0.375
SF-J26,SF-J23-1,55,22,33,12,22,10,0.6,0.4,0.5454545454545454,0.45454545454545453
SF-J26,SF-J22-1,3,4,0,0,3,4,0.0,1.0,0.0,1.0
SF-J26,SF-J22-2,8,9,2,2,6,7,0.25,0.75,0.2222222222222222,0.7777777777777778
SF-J26,SF-J21,14,7,10,7,4,0,0.7142857142857143,0.2857142857142857,1.0,0.0
SF-J26,SF-I21,3,2,2,1,1,1,0.6666666666666666,0.3333333333333333,0.5,0.5
SF-J26,SF-I22,1,1,0,0,1,1,0.0,1.0,0.0,1.0
SF-J26,SF-I23-2,4,1,1,1,3,0,0.25,0.75,1.0,0.0
SF-J26,SF-I24,1,9,0,5,1,4,0.0,1.0,0.5555555555555556,0.4444444444444444
SF-J26,SF-F26,13,19,6,3,7,16,0.46153846153846156,0.5384615384615384,0.15789473684210525,0.8421052631578947
SF-J26,SF-M15,5,1,0,0,5,1,0.0,1.0,0.0,1.0
SF-J26,SF-L19,4,4,0,1,4,3,0.0,1.0,0.25,0.75
SF-J26,SF-L20,2,2,0,0,2,2,0.0,1.0,0.0,1.0
SF-J26,SF-N20-1,4,5,3,2,1,3,0.75,0.25,0.4,0.6
SF-J26,SF-M20,10,6,2,1,8,5,0.2,0.8,0.16666666666666666,0.8333333333333334
SF-J26,SF-K20,7,3,3,2,4,1,0.42857142857142855,0.5714285714285714,0.6666666666666666,0.3333333333333333
SF-J26,SF-K15-,9,7,4,0,5,7,0.4444444444444444,0.5555555555555556,0.0,1.0
SF-J26,SF-K19,2,1,1,0,1,1,0.5,0.5,0.0,1.0
SF-J26,SF-K17,1,1,0,0,1,1,0.0,1.0,0.0,1.0
SF-J26,SF-J20,2,1,1,1,1,0,0.5,0.5,1.0,0.0
SF-J26,SF-J19,8,7,2,2,6,5,0.25,0.75,0.2857142857142857,0.7142857142857143
SF-J26,SF-Q21-2,1,1,0,0,1,1,0.0,1.0,0.0,1.0
SF-J26,SF-O18,4,1,1,0,3,1,0.25,0.75,0.0,1.0
SF-J26,SF-O19,13,10,4,4,9,6,0.3076923076923077,0.6923076923076923,0.4,0.6
SF-J26,SF-O21,47,11,6,7,41,4,0.1276595744680851,0.8723404255319149,0.6363636363636364,0.36363636363636365
SF-J26,SF-O22,7,6,1,2,6,4,0.14285714285714285,0.8571428571428571,0.3333333333333333,0.6666666666666666
SF-J26,SF-N21,71,50,4,2,67,48,0.056338028169014086,0.9436619718309859,0.04,0.96
SF-J26,SF-M21,7,9,2,1,5,8,0.2857142857142857,0.7142857142857143,0.1111111111111111,0.8888888888888888
SF-J26,SF-L21,30,11,16,4,14,7,0.5333333333333333,0.4666666666666667,0.36363636363636365,0.6363636363636364
SF-J26,SF-Q30,2,3,1,2,1,1,0.5,0.5,0.6666666666666666,0.3333333333333333
SF-J26,SF-P30,4,5,2,1,2,4,0.5,0.5,0.2,0.8
SF-J26,SF-O30-2,6,1,1,1,5,0,0.16666666666666666,0.8333333333333334,1.0,0.0
SF-J26,SF-O30,3,6,1,2,2,4,0.3333333333333333,0.6666666666666666,0.3333333333333333,0.6666666666666666
SF-J26,SF-N27,12,20,9,12,3,8,0.75,0.25,0.6,0.4
SF-J26,SF-N29,1,5,1,3,0,2,1.0,0.0,0.6,0.4
SF-J26,SF-N28,6,6,2,2,4,4,0.3333333333333333,0.6666666666666666,0.3333333333333333,0.6666666666666666
SF-J26,SF-L30-1,72,31,39,13,33,18,0.5416666666666666,0.4583333333333333,0.41935483870967744,0.5806451612903226
SF-J26,SF-L31-1,3,14,3,1,0,13,1.0,0.0,0.07142857142857142,0.9285714285714286
SF-J26,SF-K30-2,33,42,24,33,9,9,0.7272727272727273,0.2727272727272727,0.7857142857142857,0.21428571428571427
SF-J26,SF-L29,21,19,5,8,16,11,0.23809523809523808,0.7619047619047619,0.42105263157894735,0.5789473684210527
SF-J26,SF-J29-1,6,3,4,2,2,1,0.6666666666666666,0.3333333333333333,0.6666666666666666,0.3333333333333333
SF-J26,SF-I30,6,4,2,3,4,1,0.3333333333333333,0.6666666666666666,0.75,0.25
SF-J26,SF-I29-2,6,6,5,3,1,3,0.8333333333333334,0.16666666666666666,0.5,0.5
SF-J26,SF-I27,7,37,6,16,1,21,0.8571428571428571,0.14285714285714285,0.43243243243243246,0.5675675675675675
SF-J26,SF-I28,16,37,13,29,3,8,0.8125,0.1875,0.7837837837837838,0.21621621621621623
SF-J26,SF-I30-2,1,3,1,0,0,3,1.0,0.0,0.0,1.0
SF-J26,SF I29-1,4,4,1,1,3,3,0.25,0.75,0.25,0.75
SF-J26,SF-H28,23,33,15,20,8,13,0.6521739130434783,0.34782608695652173,0.6060606060606061,0.3939393939393939
SF-J26,SF-H29,2,5,1,4,1,1,0.5,0.5,0.8,0.2
SF-J26,SF-S24,3,5,1,2,2,3,0.3333333333333333,0.6666666666666666,0.4,0.6
SF-J26,SF-R24,5,3,1,1,4,2,0.2,0.8,0.3333333333333333,0.6666666666666666
SF-J26,SF-N22-1B,3,3,2,2,1,1,0.6666666666666666,0.3333333333333333,0.6666666666666666,0.3333333333333333
SF-J26,SF-N26,3,5,3,0,0,5,1.0,0.0,0.0,1.0
SF-J26,SF-T21,9,4,8,2,1,2,0.8888888888888888,0.1111111111111111,0.5,0.5
SF-J26,SF-S22-2,3,1,1,0,2,1,0.3333333333333333,0.6666666666666666,0.0,1.0
SF-J26,SF-S22-1,6,2,4,0,2,2,0.6666666666666666,0.3333333333333333,0.0,1.0
SF-J26,SF-Q23-3,4,5,1,0,3,5,0.25,0.75,0.0,1.0
SF-J26,SF-Q22-1,4,4,4,4,0,0,1.0,0.0,1.0,0.0
SF-J26,SF-Q22-2,6,2,3,0,3,2,0.5,0.5,0.0,1.0
SF-J26,SF-P22,4,5,3,3,1,2,0.75,0.25,0.6,0.4
SF-J26,SF-W19-2,18,7,4,4,14,3,0.2222222222222222,0.7777777777777778,0.5714285714285714,0.42857142857142855
SF-J26,SF-T20,13,8,0,0,13,8,0.0,1.0,0.0,1.0
SF-J26,SF-V28,17,2,0,0,17,2,0.0,1.0,0.0,1.0
SF-I26-,SF-M25,10,10,3,5,7,5,0.3,0.7,0.5,0.5
SF-I26-,SF-M26-2,2,6,2,3,0,3,1.0,0.0,0.5,0.5
SF-I26-,SF-K26,5,4,0,2,5,2,0.0,1.0,0.5,0.5
SF-I26-,SF-J27,5,2,2,2,3,0,0.4,0.6,1.0,0.0
SF-I26-,SF-M30,17,20,3,9,14,11,0.17647058823529413,0.8235294117647058,0.45,0.55
SF-I26-,SF-L27-2,4,1,2,0,2,1,0.5,0.5,0.0,1.0
SF-I26-,SF-J29-3,4,2,2,2,2,0,0.5,0.5,1.0,0.0
SF-I26-,SF-J29,15,18,8,17,7,1,0.5333333333333333,0.4666666666666667,0.9444444444444444,0.05555555555555555
SF-I26-,SF-L26,2,10,1,2,1,8,0.5,0.5,0.2,0.8
SF-I26-,SF-M28,6,1,3,0,3,1,0.5,0.5,0.0,1.0
SF-I26-,SF-L25,15,24,2,17,13,7,0.13333333333333333,0.8666666666666667,0.7083333333333334,0.2916666666666667
SF-I26-,SF-M24,3,4,0,2,3,2,0.0,1.0,0.5,0.5
SF-I26-,SF-L24,8,14,5,10,3,4,0.625,0.375,0.7142857142857143,0.2857142857142857
SF-I26-,SF-N23,6,5,0,4,6,1,0.0,1.0,0.8,0.2
SF-I26-,SF-N24-2,1,3,0,2,1,1,0.0,1.0,0.6666666666666666,0.3333333333333333
SF-I26-,SF-K27-2,7,8,4,1,3,7,0.5714285714285714,0.42857142857142855,0.125,0.875
SF-I26-,SF-J26-2,8,9,2,7,6,2,0.25,0.75,0.7777777777777778,0.2222222222222222
SF-I26-,SF-K28-3,1,1,1,0,0,1,1.0,0.0,0.0,1.0
SF-I26-,SF-K28,2,2,1,2,1,0,0.5,0.5,1.0,0.0
SF-I26-,SF-J28-2,4,4,3,2,1,2,0.75,0.25,0.5,0.5
SF-I26-,SF-K27,5,3,5,1,0,2,1.0,0.0,0.3333333333333333,0.6666666666666666
SF-I26-,SF-K25,13,13,3,9,10,4,0.23076923076923078,0.7692307692307693,0.6923076923076923,0.3076923076923077
SF-I26-,SF-J25,20,69,17,58,3,11,0.85,0.15,0.8405797101449275,0.15942028985507245
SF-I26-,SF-H26-2,15,23,5,12,10,11,0.3333333333333333,0.6666666666666666,0.5217391304347826,0.4782608695652174
SF-I26-,SF-P24,1,7,0,2,1,5,0.0,1.0,0.2857142857142857,0.7142857142857143
SF-I26-,SF-N22-1A,1,3,1,3,0,0,1.0,0.0,1.0,0.0
SF-I26-,SF-J24,12,11,7,5,5,6,0.5833333333333334,0.4166666666666667,0.45454545454545453,0.5454545454545454
SF-I26-,SF-O24,2,4,1,1,1,3,0.5,0.5,0.25,0.75
SF-I26-,SF-J26,10,13,4,10,6,3,0.4,0.6,0.7692307692307693,0.23076923076923078
SF-I26-,SF-I25,11,19,4,14,7,5,0.36363636363636365,0.6363636363636364,0.7368421052631579,0.2631578947368421
SF-I26-,SF-K23,2,5,2,4,0,1,1.0,0.0,0.8,0.2
SF-I26-,SF-H26,24,22,18,19,6,3,0.75,0.25,0.8636363636363636,0.13636363636363635
SF-I26-,SF-O23,6,3,2,0,4,3,0.3333333333333333,0.6666666666666666,0.0,1.0
SF-I26-,SF-H27-1,33,14,24,9,9,5,0.7272727272727273,0.2727272727272727,0.6428571428571429,0.35714285714285715
SF-I26-,SF-F28-2,19,8,4,5,15,3,0.21052631578947367,0.7894736842105263,0.625,0.375
SF-I26-,SF-G27,24,34,9,21,15,13,0.375,0.625,0.6176470588235294,0.38235294117647056
SF-I26-,SF-M22-2,4,10,3,4,1,6,0.75,0.25,0.4,0.6
SF-I26-,SF-L22,1,2,0,0,1,2,0.0,1.0,0.0,1.0
SF-I26-,SF-F27,12,10,6,6,6,4,0.5,0.5,0.6,0.4
SF-I26-,SF-N22-2,11,13,7,11,4,2,0.6363636363636364,0.36363636363636365,0.8461538461538461,0.15384615384615385
SF-I26-,SF-G28-1,12,2,12,2,0,0,1.0,0.0,1.0,0.0
SF-I26-,SF-M22-1,1,3,0,2,1,1,0.0,1.0,0.6666666666666666,0.3333333333333333
SF-I26-,SF-K22-2,3,12,3,10,0,2,1.0,0.0,0.8333333333333334,0.16666666666666666
SF-I26-,SF-K24,2,9,1,8,1,1,0.5,0.5,0.8888888888888888,0.1111111111111111
SF-I26-,SF-J23-2,5,4,2,2,3,2,0.4,0.6,0.5,0.5
SF-I26-,SF-G23,4,16,3,14,1,2,0.75,0.25,0.875,0.125
SF-I26-,SF-G25,6,4,6,3,0,1,1.0,0.0,0.75,0.25
SF-I26-,SF-F23,11,38,7,33,4,5,0.6363636363636364,0.36363636363636365,0.868421052631579,0.13157894736842105
SF-I26-,SF-E23,2,7,1,3,1,4,0.5,0.5,0.42857142857142855,0.5714285714285714
SF-I26-,SF-D24,1,2,0,2,1,0,0.0,1.0,1.0,0.0
SF-I26-,SF-B22,3,2,0,2,3,0,0.0,1.0,1.0,0.0
SF-I26-,SF-J17,2,2,1,0,1,2,0.5,0.5,0.0,1.0
SF-I26-,SF-I20,3,6,1,2,2,4,0.3333333333333333,0.6666666666666666,0.3333333333333333,0.6666666666666666
SF-I26-,SF-H20,5,7,3,3,2,4,0.6,0.4,0.42857142857142855,0.5714285714285714
SF-I26-,SF-G19,2,1,0,0,2,1,0.0,1.0,0.0,1.0
SF-I26-,SF-G18,2,4,2,2,0,2,1.0,0.0,0.5,0.5
SF-I26-,SF-G20,12,4,3,0,9,4,0.25,0.75,0.0,1.0
SF-I26-,SF-F19,1,1,0,0,1,1,0.0,1.0,0.0,1.0
SF-I26-,SF-F30-1,13,13,9,10,4,3,0.6923076923076923,0.3076923076923077,0.7692307692307693,0.23076923076923078
SF-I26-,SF-E29-2,2,2,1,1,1,1,0.5,0.5,0.5,0.5
SF-I26-,SF-E29-1,5,5,4,4,1,1,0.8,0.2,0.8,0.2
SF-I26-,SF-D29,4,4,2,3,2,1,0.5,0.5,0.75,0.25
SF-I26-,SF-D28,9,1,4,0,5,1,0.4444444444444444,0.5555555555555556,0.0,1.0
SF-I26-,SF-A27,2,1,1,1,1,0,0.5,0.5,1.0,0.0
SF-I26-,SF-G29-2,27,14,11,4,16,10,0.4074074074074074,0.5925925925925926,0.2857142857142857,0.7142857142857143
SF-I26-,SF-G29-1,7,2,6,0,1,2,0.8571428571428571,0.14285714285714285,0.0,1.0
SF-I26-,SF-G30-1,13,4,10,1,3,3,0.7692307692307693,0.23076923076923078,0.25,0.75
SF-I26-,SF-G29-3,10,2,8,1,2,1,0.8,0.2,0.5,0.5
SF-I26-,SF-F30-2,9,10,6,5,3,5,0.6666666666666666,0.3333333333333333,0.5,0.5
SF-I26-,SF-F29,31,12,26,12,5,0,0.8387096774193549,0.16129032258064516,1.0,0.0
SF-I26-,SF-E29-3,3,3,1,2,2,1,0.3333333333333333,0.6666666666666666,0.6666666666666666,0.3333333333333333
SF-I26-,SF-F28-1,2,3,0,0,2,3,0.0,1.0,0.0,1.0
SF-I26-,SF-E28-2,5,4,1,0,4,4,0.2,0.8,0.0,1.0
SF-I26-,SF-E28,4,2,3,2,1,0,0.75,0.25,1.0,0.0
SF-I26-,SF-J15,1,1,0,0,1,1,0.0,1.0,0.0,1.0
SF-I26-,SF-B21,1,1,0,0,1,1,0.0,1.0,0.0,1.0
SF-I26-,SF-B19,2,3,0,0,2,3,0.0,1.0,0.0,1.0
SF-I26-,SF-A20,4,1,0,0,4,1,0.0,1.0,0.0,1.0
SF-I26-,SF-C26,19,7,10,5,9,2,0.5263157894736842,0.47368421052631576,0.7142857142857143,0.2857142857142857
SF-I26-,SF-C25,8,4,6,3,2,1,0.75,0.25,0.75,0.25
SF-I26-,SF-B25,3,2,0,1,3,1,0.0,1.0,0.5,0.5
SF-I26-,SF-E27,2,2,0,1,2,1,0.0,1.0,0.5,0.5
SF-I26-,SF-D27,5,7,2,0,3,7,0.4,0.6,0.0,1.0
SF-I26-,SF-C28-2,1,2,1,0,0,2,1.0,0.0,0.0,1.0
SF-I26-,SF-C28-1,1,2,0,2,1,0,0.0,1.0,1.0,0.0
SF-I26-,SF-H25,7,14,4,7,3,7,0.5714285714285714,0.42857142857142855,0.5,0.5
SF-I26-,SF-G26,20,14,17,4,3,10,0.85,0.15,0.2857142857142857,0.7142857142857143
SF-I26-,SF-K21,4,10,1,1,3,9,0.25,0.75,0.1,0.9
SF-I26-,SF-K22-1,1,8,0,5,1,3,0.0,1.0,0.625,0.375
SF-I26-,SF-J23-1,13,26,7,11,6,15,0.5384615384615384,0.46153846153846156,0.4230769230769231,0.5769230769230769
SF-I26-,SF-J22-1,3,4,2,2,1,2,0.6666666666666666,0.3333333333333333,0.5,0.5
SF-I26-,SF-J22-2,19,11,4,3,15,8,0.21052631578947367,0.7894736842105263,0.2727272727272727,0.7272727272727273
SF-I26-,SF-J21,5,8,1,1,4,7,0.2,0.8,0.125,0.875
SF-I26-,SF-I24,4,6,2,5,2,1,0.5,0.5,0.8333333333333334,0.16666666666666666
SF-I26-,SF-I23-1,16,11,9,7,7,4,0.5625,0.4375,0.6363636363636364,0.36363636363636365
SF-I26-,SF-F26,21,22,10,3,11,19,0.47619047619047616,0.5238095238095238,0.13636363636363635,0.8636363636363636
SF-I26-,SF-M13,1,5,0,0,1,5,0.0,1.0,0.0,1.0
SF-I26-,SF-L19,2,4,1,3,1,1,0.5,0.5,0.75,0.25
SF-I26-,SF-L20,1,3,0,1,1,2,0.0,1.0,0.3333333333333333,0.6666666666666666
SF-I26-,SF-N20-1,21,1,0,0,21,1,0.0,1.0,0.0,1.0
SF-I26-,SF-M20,4,11,3,3,1,8,0.75,0.25,0.2727272727272727,0.7272727272727273
SF-I26-,SF-K20,2,3,0,3,2,0,0.0,1.0,1.0,0.0
SF-I26-,SF-K15-,7,7,5,1,2,6,0.7142857142857143,0.2857142857142857,0.14285714285714285,0.8571428571428571
SF-I26-,SF-K19,3,3,0,1,3,2,0.0,1.0,0.3333333333333333,0.6666666666666666
SF-I26-,SF-K18,2,2,0,1,2,1,0.0,1.0,0.5,0.5
SF-I26-,SF-K17,1,2,1,1,0,1,1.0,0.0,0.5,0.5
SF-I26-,SF-J18,1,1,1,0,0,1,1.0,0.0,0.0,1.0
SF-I26-,SF-J20,1,3,0,2,1,1,0.0,1.0,0.6666666666666666,0.3333333333333333
SF-I26-,SF-J19,4,5,1,4,3,1,0.25,0.75,0.8,0.2
SF-I26-,SF-M12,1,2,1,0,0,2,1.0,0.0,0.0,1.0
SF-I26-,SF-P21,1,1,0,1,1,0,0.0,1.0,1.0,0.0
SF-I26-,SF-O18,2,3,0,1,2,2,0.0,1.0,0.3333333333333333,0.6666666666666666
SF-I26-,SF-O19,6,3,2,0,4,3,0.3333333333333333,0.6666666666666666,0.0,1.0
SF-I26-,SF-O21,4,13,1,7,3,6,0.25,0.75,0.5384615384615384,0.46153846153846156
SF-I26-,SF-O22,6,9,1,4,5,5,0.16666666666666666,0.8333333333333334,0.4444444444444444,0.5555555555555556
SF-I26-,SF-N21,4,5,0,4,4,1,0.0,1.0,0.8,0.2
SF-I26-,SF-M21,1,6,0,3,1,3,0.0,1.0,0.5,0.5
SF-I26-,SF-L21,5,29,1,18,4,11,0.2,0.8,0.6206896551724138,0.3793103448275862
SF-I26-,SF-O30-2,1,1,1,1,0,0,1.0,0.0,1.0,0.0
SF-I26-,SF-O30,2,1,1,1,1,0,0.5,0.5,1.0,0.0
SF-I26-,SF-N27,6,5,4,3,2,2,0.6666666666666666,0.3333333333333333,0.6,0.4
SF-I26-,SF-N28,15,20,13,16,2,4,0.8666666666666667,0.13333333333333333,0.8,0.2
SF-I26-,SF-L30-1,4,8,1,6,3,2,0.25,0.75,0.75,0.25
SF-I26-,SF-L29,4,1,3,0,1,1,0.75,0.25,0.0,1.0
SF-I26-,SF-J29-1,6,3,4,2,2,1,0.6666666666666666,0.3333333333333333,0.6666666666666666,0.3333333333333333
SF-I26-,SF-I30,2,1,2,1,0,0,1.0,0.0,1.0,0.0
SF-I26-,SF-I29-2,5,1,3,0,2,1,0.6,0.4,0.0,1.0
SF-I26-,SF-I27,17,19,7,17,10,2,0.4117647058823529,0.5882352941176471,0.8947368421052632,0.10526315789473684
SF-I26-,SF-I28,9,7,7,5,2,2,0.7777777777777778,0.2222222222222222,0.7142857142857143,0.2857142857142857
SF-I26-,SF I29-1,3,2,1,2,2,0,0.3333333333333333,0.6666666666666666,1.0,0.0
SF-I26-,SF-H28,6,4,4,3,2,1,0.6666666666666666,0.3333333333333333,0.75,0.25
SF-I26-,SF-H29,4,1,1,0,3,1,0.25,0.75,0.0,1.0
SF-I26-,SF-R24,6,15,3,2,3,13,0.5,0.5,0.13333333333333333,0.8666666666666667
SF-I26-,SF-N22-1B,1,6,0,5,1,1,0.0,1.0,0.8333333333333334,0.16666666666666666
SF-I26-,SF-N25,1,4,1,1,0,3,1.0,0.0,0.25,0.75
SF-I26-,SF-S22-2,5,1,0,0,5,1,0.0,1.0,0.0,1.0
SF-I26-,SF-S22-1,4,7,2,3,2,4,0.5,0.5,0.42857142857142855,0.5714285714285714
SF-I26-,SF-Q22-1,2,3,1,2,1,1,0.5,0.5,0.6666666666666666,0.3333333333333333
SF-I26-,SF-T20,28,11,0,0,28,11,0.0,1.0,0.0,1.0
SF-I25,SF-M26,3,1,0,0,3,1,0.0,1.0,0.0,1.0
SF-I25,SF-M25,8,5,5,3,3,2,0.625,0.375,0.6,0.4
SF-I25,SF-M26-2,10,125,5,46,5,79,0.5,0.5,0.368,0.632
SF-I25,SF-L27,11,2,4,2,7,0,0.36363636363636365,0.6363636363636364,1.0,0.0
SF-I25,SF-K26,57,69,12,27,45,42,0.21052631578947367,0.7894736842105263,0.391304347826087,0.6086956521739131
SF-I25,SF-J27,17,8,5,3,12,5,0.29411764705882354,0.7058823529411765,0.375,0.625
SF-I25,SF-M30,46,12,10,0,36,12,0.21739130434782608,0.782608695652174,0.0,1.0
SF-I25,SF-L27-2,11,5,4,4,7,1,0.36363636363636365,0.6363636363636364,0.8,0.2
SF-I25,SF-J29-3,28,11,8,7,20,4,0.2857142857142857,0.7142857142857143,0.6363636363636364,0.36363636363636365
SF-I25,SF-J29,94,31,8,18,86,13,0.0851063829787234,0.9148936170212766,0.5806451612903226,0.41935483870967744
SF-I25,SF-L26,116,158,49,67,67,91,0.4224137931034483,0.5775862068965517,0.4240506329113924,0.5759493670886076
SF-I25,SF-M28,21,23,10,11,11,12,0.47619047619047616,0.5238095238095238,0.4782608695652174,0.5217391304347826
SF-I25,SF-M27,12,1,5,1,7,0,0.4166666666666667,0.5833333333333334,1.0,0.0
SF-I25,SF-L25,75,92,66,76,9,16,0.88,0.12,0.8260869565217391,0.17391304347826086
SF-I25,SF-M24,13,7,8,6,5,1,0.6153846153846154,0.38461538461538464,0.8571428571428571,0.14285714285714285
SF-I25,SF-L24,17,10,15,5,2,5,0.8823529411764706,0.11764705882352941,0.5,0.5
SF-I25,SF-N23,6,10,3,7,3,3,0.5,0.5,0.7,0.3
SF-I25,SF-N24-2,1,5,1,3,0,2,1.0,0.0,0.6,0.4
SF-I25,SF-K27-2,28,21,14,10,14,11,0.5,0.5,0.47619047619047616,0.5238095238095238
SF-I25,SF-J26-2,38,25,24,14,14,11,0.631578947368421,0.3684210526315789,0.56,0.44
SF-I25,SF-L28,15,2,7,2,8,0,0.4666666666666667,0.5333333333333333,1.0,0.0
SF-I25,SF-K28,16,10,1,7,15,3,0.0625,0.9375,0.7,0.3
SF-I25,SF-K29-1,71,66,11,9,60,57,0.15492957746478872,0.8450704225352113,0.13636363636363635,0.8636363636363636
SF-I25,SF-J28-2,20,9,5,5,15,4,0.25,0.75,0.5555555555555556,0.4444444444444444
SF-I25,SF-K27,26,10,14,4,12,6,0.5384615384615384,0.46153846153846156,0.4,0.6
SF-I25,SF-K25,24,24,13,18,11,6,0.5416666666666666,0.4583333333333333,0.75,0.25
SF-I25,SF-J25,25,45,19,34,6,11,0.76,0.24,0.7555555555555555,0.24444444444444444
SF-I25,SF-H26-2,22,21,16,12,6,9,0.7272727272727273,0.2727272727272727,0.5714285714285714,0.42857142857142855
SF-I25,SF-P24,3,3,2,1,1,2,0.6666666666666666,0.3333333333333333,0.3333333333333333,0.6666666666666666
SF-I25,SF-N22-1A,1,1,0,0,1,1,0.0,1.0,0.0,1.0
SF-I25,SF-J24,33,33,19,21,14,12,0.5757575757575758,0.42424242424242425,0.6363636363636364,0.36363636363636365
SF-I25,SF-O24,3,9,3,1,0,8,1.0,0.0,0.1111111111111111,0.8888888888888888
SF-I25,SF-J26,16,13,10,6,6,7,0.625,0.375,0.46153846153846156,0.5384615384615384
SF-I25,SF-I26-,19,11,14,4,5,7,0.7368421052631579,0.2631578947368421,0.36363636363636365,0.6363636363636364
SF-I25,SF-K23,5,2,5,2,0,0,1.0,0.0,1.0,0.0
SF-I25,SF-H26,97,124,69,97,28,27,0.711340206185567,0.28865979381443296,0.782258064516129,0.21774193548387097
SF-I25,SF-O23,8,3,4,1,4,2,0.5,0.5,0.3333333333333333,0.6666666666666666
SF-I25,SF-H27-1,6,13,2,7,4,6,0.3333333333333333,0.6666666666666666,0.5384615384615384,0.46153846153846156
SF-I25,SF-F28-2,48,76,27,51,21,25,0.5625,0.4375,0.6710526315789473,0.32894736842105265
SF-I25,SF-G27,179,209,121,160,58,49,0.6759776536312849,0.3240223463687151,0.7655502392344498,0.23444976076555024
SF-I25,SF-M22-2,133,107,99,72,34,35,0.7443609022556391,0.2556390977443609,0.6728971962616822,0.32710280373831774
SF-I25,SF-L22,31,15,21,11,10,4,0.6774193548387096,0.3225806451612903,0.7333333333333333,0.26666666666666666
SF-I25,SF-F27,34,46,23,25,11,21,0.6764705882352942,0.3235294117647059,0.5434782608695652,0.45652173913043476
SF-I25,SF-N22-2,29,32,13,11,16,21,0.4482758620689655,0.5517241379310345,0.34375,0.65625
SF-I25,SF-G28-2,7,15,2,13,5,2,0.2857142857142857,0.7142857142857143,0.8666666666666667,0.13333333333333333
SF-I25,SF-G28-1,5,5,5,3,0,2,1.0,0.0,0.6,0.4
SF-I25,SF-M22-1,7,7,6,3,1,4,0.8571428571428571,0.14285714285714285,0.42857142857142855,0.5714285714285714
SF-I25,SF-O25-1,1,4,1,0,0,4,1.0,0.0,0.0,1.0
SF-I25,SF-K22-2,25,14,18,8,7,6,0.72,0.28,0.5714285714285714,0.42857142857142855
SF-I25,SF-K24,38,34,32,33,6,1,0.8421052631578947,0.15789473684210525,0.9705882352941176,0.029411764705882353
SF-I25,SF-J23-2,40,24,31,20,9,4,0.775,0.225,0.8333333333333334,0.16666666666666666
SF-I25,SF-G23,18,13,14,8,4,5,0.7777777777777778,0.2222222222222222,0.6153846153846154,0.38461538461538464
SF-I25,SF-G24,52,49,36,9,16,40,0.6923076923076923,0.3076923076923077,0.1836734693877551,0.8163265306122449
SF-I25,SF-G25,138,60,120,34,18,26,0.8695652173913043,0.13043478260869565,0.5666666666666667,0.43333333333333335
SF-I25,SF-F23,23,17,10,11,13,6,0.43478260869565216,0.5652173913043478,0.6470588235294118,0.35294117647058826
SF-I25,SF-E23,24,24,17,8,7,16,0.7083333333333334,0.2916666666666667,0.3333333333333333,0.6666666666666666
SF-I25,SF-D24,22,6,9,0,13,6,0.4090909090909091,0.5909090909090909,0.0,1.0
SF-I25,SF-C22,6,13,2,6,4,7,0.3333333333333333,0.6666666666666666,0.46153846153846156,0.5384615384615384
SF-I25,SF-B22,7,9,4,6,3,3,0.5714285714285714,0.42857142857142855,0.6666666666666666,0.3333333333333333
SF-I25,SF-J17,23,16,18,4,5,12,0.782608695652174,0.21739130434782608,0.25,0.75
SF-I25,SF-I19,47,4,47,0,0,4,1.0,0.0,0.0,1.0
SF-I25,SF-I20,20,43,9,36,11,7,0.45,0.55,0.8372093023255814,0.16279069767441862
SF-I25,SF-H20,9,16,5,7,4,9,0.5555555555555556,0.4444444444444444,0.4375,0.5625
SF-I25,SF-H18,1,2,0,2,1,0,0.0,1.0,1.0,0.0
SF-I25,SF-H17,3,1,2,1,1,0,0.6666666666666666,0.3333333333333333,1.0,0.0
SF-I25,SF-G19,7,2,5,1,2,1,0.7142857142857143,0.2857142857142857,0.5,0.5
SF-I25,SF-G18,2,4,1,0,1,4,0.5,0.5,0.0,1.0
SF-I25,SF-G20,19,11,13,9,6,2,0.6842105263157895,0.3157894736842105,0.8181818181818182,0.18181818181818182
SF-I25,SF-F19,6,5,5,1,1,4,0.8333333333333334,0.16666666666666666,0.2,0.8
SF-I25,SF-E18,1,5,0,0,1,5,0.0,1.0,0.0,1.0
SF-I25,SF-E20,1,2,1,1,0,1,1.0,0.0,0.5,0.5
SF-I25,SF-H30,5,3,1,2,4,1,0.2,0.8,0.6666666666666666,0.3333333333333333
SF-I25,SF-G30-2,10,14,3,8,7,6,0.3,0.7,0.5714285714285714,0.42857142857142855
SF-I25,SF-F30-1,3,18,2,18,1,0,0.6666666666666666,0.3333333333333333,1.0,0.0
SF-I25,SF-E29-2,81,100,55,72,26,28,0.6790123456790124,0.32098765432098764,0.72,0.28
SF-I25,SF-E29-1,43,51,19,40,24,11,0.4418604651162791,0.5581395348837209,0.7843137254901961,0.21568627450980393
SF-I25,SF-D29,24,14,20,6,4,8,0.8333333333333334,0.16666666666666666,0.42857142857142855,0.5714285714285714
SF-I25,SF-D28,10,9,8,3,2,6,0.8,0.2,0.3333333333333333,0.6666666666666666
SF-I25,SF-A27,19,10,16,6,3,4,0.8421052631578947,0.15789473684210525,0.6,0.4
SF-I25,SF-G29-2,28,10,9,4,19,6,0.32142857142857145,0.6785714285714286,0.4,0.6
SF-I25,SF-G29-1,15,56,8,22,7,34,0.5333333333333333,0.4666666666666667,0.39285714285714285,0.6071428571428571
SF-I25,SF-G30-1,20,18,13,9,7,9,0.65,0.35,0.5,0.5
SF-I25,SF-G29-3,8,15,7,8,1,7,0.875,0.125,0.5333333333333333,0.4666666666666667
SF-I25,SF-F30-2,4,8,4,5,0,3,1.0,0.0,0.625,0.375
SF-I25,SF-F29,8,53,7,47,1,6,0.875,0.125,0.8867924528301887,0.11320754716981132
SF-I25,SF-E29-3,31,46,23,28,8,18,0.7419354838709677,0.25806451612903225,0.6086956521739131,0.391304347826087
SF-I25,SF-F28-1,30,61,16,32,14,29,0.5333333333333333,0.4666666666666667,0.5245901639344263,0.47540983606557374
SF-I25,SF-E28,6,9,6,4,0,5,1.0,0.0,0.4444444444444444,0.5555555555555556
SF-I25,SF-J12,5,3,1,2,4,1,0.2,0.8,0.6666666666666666,0.3333333333333333
SF-I25,SF-J13,2,1,0,0,2,1,0.0,1.0,0.0,1.0
SF-I25,SF-J15,9,1,5,0,4,1,0.5555555555555556,0.4444444444444444,0.0,1.0
SF-I25,SF-I16,2,2,1,0,1,2,0.5,0.5,0.0,1.0
SF-I25,SF-H12,4,7,2,0,2,7,0.5,0.5,0.0,1.0
SF-I25,SF-G13,2,3,0,0,2,3,0.0,1.0,0.0,1.0
SF-I25,SF-G11,1,2,1,0,0,2,1.0,0.0,0.0,1.0
SF-I25,SF-F15,9,5,1,3,8,2,0.1111111111111111,0.8888888888888888,0.6,0.4
SF-I25,SF-F16,4,3,0,0,4,3,0.0,1.0,0.0,1.0
SF-I25,SF-C20,2,4,0,2,2,2,0.0,1.0,0.5,0.5
SF-I25,SF-B19,5,8,2,3,3,5,0.4,0.6,0.375,0.625
SF-I25,SF-A20,11,11,5,9,6,2,0.45454545454545453,0.5454545454545454,0.8181818181818182,0.18181818181818182
SF-I25,SF-C26,21,17,11,6,10,11,0.5238095238095238,0.47619047619047616,0.35294117647058826,0.6470588235294118
SF-I25,SF-C25,19,21,11,10,8,11,0.5789473684210527,0.42105263157894735,0.47619047619047616,0.5238095238095238
SF-I25,SF-B25,13,26,8,20,5,6,0.6153846153846154,0.38461538461538464,0.7692307692307693,0.23076923076923078
SF-I25,SF-E27,10,11,7,6,3,5,0.7,0.3,0.5454545454545454,0.45454545454545453
SF-I25,SF-B28-2,5,6,4,4,1,2,0.8,0.2,0.6666666666666666,0.3333333333333333
SF-I25,SF-D27,28,92,16,58,12,34,0.5714285714285714,0.42857142857142855,0.6304347826086957,0.3695652173913043
SF-I25,SF-C28-2,1,8,0,4,1,4,0.0,1.0,0.5,0.5
SF-I25,SF-C28-1,1,1,0,1,1,0,0.0,1.0,1.0,0.0
SF-I25,SF-B28,5,15,2,13,3,2,0.4,0.6,0.8666666666666667,0.13333333333333333
SF-I25,SF-J1,2,2,0,1,2,1,0.0,1.0,0.5,0.5
SF-I25,SF-J5,4,1,2,0,2,1,0.5,0.5,0.0,1.0
SF-I25,SF-G8,2,2,2,0,0,2,1.0,0.0,0.0,1.0
SF-I25,SF-H25,17,14,7,6,10,8,0.4117647058823529,0.5882352941176471,0.42857142857142855,0.5714285714285714
SF-I25,SF-G26,33,25,25,12,8,13,0.7575757575757576,0.24242424242424243,0.48,0.52
SF-I25,SF-K21,55,18,27,1,28,17,0.4909090909090909,0.509090909090909,0.05555555555555555,0.9444444444444444
SF-I25,SF-K22-1,27,69,20,51,7,18,0.7407407407407407,0.25925925925925924,0.7391304347826086,0.2608695652173913
SF-I25,SF-J23-1,227,289,174,219,53,70,0.7665198237885462,0.23348017621145375,0.7577854671280276,0.2422145328719723
SF-I25,SF-J22-1,46,41,36,25,10,16,0.782608695652174,0.21739130434782608,0.6097560975609756,0.3902439024390244
SF-I25,SF-J22-2,28,37,15,29,13,8,0.5357142857142857,0.4642857142857143,0.7837837837837838,0.21621621621621623
SF-I25,SF-J21,38,57,25,37,13,20,0.6578947368421053,0.34210526315789475,0.6491228070175439,0.3508771929824561
SF-I25,SF-I21,16,13,16,11,0,2,1.0,0.0,0.8461538461538461,0.15384615384615385
SF-I25,SF-I22,13,17,11,10,2,7,0.8461538461538461,0.15384615384615385,0.5882352941176471,0.4117647058823529
SF-I25,SF-I23-2,20,36,15,27,5,9,0.75,0.25,0.75,0.25
SF-I25,SF-I24,24,42,16,29,8,13,0.6666666666666666,0.3333333333333333,0.6904761904761905,0.30952380952380953
SF-I25,SF-I23-1,33,34,29,27,4,7,0.8787878787878788,0.12121212121212122,0.7941176470588235,0.20588235294117646
SF-I25,SF-F26,46,56,31,35,15,21,0.6739130434782609,0.32608695652173914,0.625,0.375
SF-I25,SF-M13,39,22,15,12,24,10,0.38461538461538464,0.6153846153846154,0.5454545454545454,0.45454545454545453
SF-I25,SF-M15,18,5,4,1,14,4,0.2222222222222222,0.7777777777777778,0.2,0.8
SF-I25,SF-L19,10,11,3,4,7,7,0.3,0.7,0.36363636363636365,0.6363636363636364
SF-I25,SF-L20,21,16,10,11,11,5,0.47619047619047616,0.5238095238095238,0.6875,0.3125
SF-I25,SF-N20-1,13,10,5,2,8,8,0.38461538461538464,0.6153846153846154,0.2,0.8
SF-I25,SF-M20,52,46,25,11,27,35,0.4807692307692308,0.5192307692307693,0.2391304347826087,0.7608695652173914
SF-I25,SF-K17-2,17,12,9,2,8,10,0.5294117647058824,0.47058823529411764,0.16666666666666666,0.8333333333333334
SF-I25,SF-K20,27,19,15,8,12,11,0.5555555555555556,0.4444444444444444,0.42105263157894735,0.5789473684210527
SF-I25,SF-K15-,25,41,15,28,10,13,0.6,0.4,0.6829268292682927,0.3170731707317073
SF-I25,SF-K19,37,27,8,4,29,23,0.21621621621621623,0.7837837837837838,0.14814814814814814,0.8518518518518519
SF-I25,SF-K18,216,6,90,0,126,6,0.4166666666666667,0.5833333333333334,0.0,1.0
SF-I25,SF-K17,30,35,22,13,8,22,0.7333333333333333,0.26666666666666666,0.37142857142857144,0.6285714285714286
SF-I25,SF-J16,6,6,1,0,5,6,0.16666666666666666,0.8333333333333334,0.0,1.0
SF-I25,SF-J18,38,10,26,1,12,9,0.6842105263157895,0.3157894736842105,0.1,0.9
SF-I25,SF-J20,34,21,26,17,8,4,0.7647058823529411,0.23529411764705882,0.8095238095238095,0.19047619047619047
SF-I25,SF-J19,56,42,36,33,20,9,0.6428571428571429,0.35714285714285715,0.7857142857142857,0.21428571428571427
SF-I25,SF-M12,5,1,1,0,4,1,0.2,0.8,0.0,1.0
SF-I25,SF-M10,5,4,3,0,2,4,0.6,0.4,0.0,1.0
SF-I25,SF-M11,2,4,0,2,2,2,0.0,1.0,0.5,0.5
SF-I25,SF-R19,18,8,3,0,15,8,0.16666666666666666,0.8333333333333334,0.0,1.0
SF-I25,SF-R20,2,5,0,0,2,5,0.0,1.0,0.0,1.0
SF-I25,SF-Q21-2,7,7,0,2,7,5,0.0,1.0,0.2857142857142857,0.7142857142857143
SF-I25,SF-Q21-1,2,2,2,1,0,1,1.0,0.0,0.5,0.5
SF-I25,SF-P21,36,26,24,8,12,18,0.6666666666666666,0.3333333333333333,0.3076923076923077,0.6923076923076923
SF-I25,SF-O18,10,13,3,2,7,11,0.3,0.7,0.15384615384615385,0.8461538461538461
SF-I25,SF-O19,19,18,6,4,13,14,0.3157894736842105,0.6842105263157895,0.2222222222222222,0.7777777777777778
SF-I25,SF-O21,41,48,13,29,28,19,0.3170731707317073,0.6829268292682927,0.6041666666666666,0.3958333333333333
SF-I25,SF-O22,19,32,7,19,12,13,0.3684210526315789,0.631578947368421,0.59375,0.40625
SF-I25,SF-N21,4,10,1,1,3,9,0.25,0.75,0.1,0.9
SF-I25,SF-N20-2,13,5,10,2,3,3,0.7692307692307693,0.23076923076923078,0.4,0.6
SF-I25,SF-M21,8,9,3,2,5,7,0.375,0.625,0.2222222222222222,0.7777777777777778
SF-I25,SF-L21,104,124,70,62,34,62,0.6730769230769231,0.3269230769230769,0.5,0.5
SF-I25,SF-S29,2,1,1,1,1,0,0.5,0.5,1.0,0.0
SF-I25,SF-Q30,11,13,1,2,10,11,0.09090909090909091,0.9090909090909091,0.15384615384615385,0.8461538461538461
SF-I25,SF-P30,17,3,3,1,14,2,0.17647058823529413,0.8235294117647058,0.3333333333333333,0.6666666666666666
SF-I25,SF-O30,21,7,11,3,10,4,0.5238095238095238,0.47619047619047616,0.42857142857142855,0.5714285714285714
SF-I25,SF-N27,20,8,10,5,10,3,0.5,0.5,0.625,0.375
SF-I25,SF-N29,7,5,3,3,4,2,0.42857142857142855,0.5714285714285714,0.6,0.4
SF-I25,SF-N28,45,34,23,8,22,26,0.5111111111111111,0.4888888888888889,0.23529411764705882,0.7647058823529411
SF-I25,SF-L30-1,43,21,7,12,36,9,0.16279069767441862,0.8372093023255814,0.5714285714285714,0.42857142857142855
SF-I25,SF-L31-1,4,5,2,5,2,0,0.5,0.5,1.0,0.0
SF-I25,SF-K30-2,7,5,3,2,4,3,0.42857142857142855,0.5714285714285714,0.4,0.6
SF-I25,SF-L29,36,13,15,6,21,7,0.4166666666666667,0.5833333333333334,0.46153846153846156,0.5384615384615384
SF-I25,SF-J29-1,5,10,2,5,3,5,0.4,0.6,0.5,0.5
SF-I25,SF-I30,4,6,4,4,0,2,1.0,0.0,0.6666666666666666,0.3333333333333333
SF-I25,SF-I29-2,2,10,2,5,0,5,1.0,0.0,0.5,0.5
SF-I25,SF-I27,20,28,7,15,13,13,0.35,0.65,0.5357142857142857,0.4642857142857143
SF-I25,SF-I28,16,20,8,15,8,5,0.5,0.5,0.75,0.25
SF-I25,SF-I30-2,6,7,4,6,2,1,0.6666666666666666,0.3333333333333333,0.8571428571428571,0.14285714285714285
SF-I25,SF I29-1,10,38,2,10,8,28,0.2,0.8,0.2631578947368421,0.7368421052631579
SF-I25,SF-H28,11,16,9,11,2,5,0.8181818181818182,0.18181818181818182,0.6875,0.3125
SF-I25,SF-S24,8,4,3,2,5,2,0.375,0.625,0.5,0.5
SF-I25,SF-R24,14,13,7,7,7,6,0.5,0.5,0.5384615384615384,0.46153846153846156
SF-I25,SF-R26,1,2,0,0,1,2,0.0,1.0,0.0,1.0
SF-I25,SF-Q26,5,1,1,0,4,1,0.2,0.8,0.0,1.0
SF-I25,SF-P26,10,8,6,4,4,4,0.6,0.4,0.5,0.5
SF-I25,SF-O25-2,3,8,2,4,1,4,0.6666666666666666,0.3333333333333333,0.5,0.5
SF-I25,SF-N22-1B,7,9,3,4,4,5,0.42857142857142855,0.5714285714285714,0.4444444444444444,0.5555555555555556
SF-I25,SF-N26,8,5,5,2,3,3,0.625,0.375,0.4,0.6
SF-I25,SF-N25,13,11,6,7,7,4,0.46153846153846156,0.5384615384615384,0.6363636363636364,0.36363636363636365
SF-I25,SF-T21,5,3,2,3,3,0,0.4,0.6,1.0,0.0
SF-I25,SF-T22,3,4,2,1,1,3,0.6666666666666666,0.3333333333333333,0.25,0.75
SF-I25,SF-S22-2,5,1,0,0,5,1,0.0,1.0,0.0,1.0
SF-I25,SF-S22-1,11,10,6,6,5,4,0.5454545454545454,0.45454545454545453,0.6,0.4
SF-I25,SF-Q23-3,45,25,2,6,43,19,0.044444444444444446,0.9555555555555556,0.24,0.76
SF-I25,SF-Q22-1,13,15,5,6,8,9,0.38461538461538464,0.6153846153846154,0.4,0.6
SF-I25,SF-Q22-2,45,53,35,42,10,11,0.7777777777777778,0.2222222222222222,0.7924528301886793,0.20754716981132076
SF-I25,SF-P22,12,13,5,9,7,4,0.4166666666666667,0.5833333333333334,0.6923076923076923,0.3076923076923077
SF-I25,SF-W19,2,1,1,0,1,1,0.5,0.5,0.0,1.0
SF-I25,SF-T20,8,21,2,0,6,21,0.25,0.75,0.0,1.0
SF-I25,SF-S21,1,3,1,1,0,2,1.0,0.0,0.3333333333333333,0.6666666666666666
SF-I25,SF-Y27,1,1,0,0,1,1,0.0,1.0,0.0,1.0
SF-I25,SF-W29,1,1,1,1,0,0,1.0,0.0,1.0,0.0
SF-I25,SF-AA15,1,2,1,2,0,0,1.0,0.0,1.0,0.0
SF-K23,SF-M25,3,5,1,3,2,2,0.3333333333333333,0.6666666666666666,0.6,0.4
SF-K23,SF-K26,4,3,4,3,0,0,1.0,0.0,1.0,0.0
SF-K23,SF-M30,3,1,1,1,2,0,0.3333333333333333,0.6666666666666666,1.0,0.0
SF-K23,SF-J29,2,1,2,1,0,0,1.0,0.0,1.0,0.0
SF-K23,SF-L26,11,6,10,5,1,1,0.9090909090909091,0.09090909090909091,0.8333333333333334,0.16666666666666666
SF-K23,SF-L25,2,2,2,1,0,1,1.0,0.0,0.5,0.5
SF-K23,SF-L24,3,4,2,0,1,4,0.6666666666666666,0.3333333333333333,0.0,1.0
SF-K23,SF-N23,2,1,1,0,1,1,0.5,0.5,0.0,1.0
SF-K23,SF-N24-2,2,2,1,1,1,1,0.5,0.5,0.5,0.5
SF-K23,SF-K27-2,3,1,3,1,0,0,1.0,0.0,1.0,0.0
SF-K23,SF-J28-2,3,1,3,1,0,0,1.0,0.0,1.0,0.0
SF-K23,SF-K25,4,6,4,6,0,0,1.0,0.0,1.0,0.0
SF-K23,SF-J25,3,1,3,1,0,0,1.0,0.0,1.0,0.0
SF-K23,SF-J24,1,1,1,0,0,1,1.0,0.0,0.0,1.0
SF-K23,SF-I26-,5,2,4,2,1,0,0.8,0.2,1.0,0.0
SF-K23,SF-I25,2,5,2,5,0,0,1.0,0.0,1.0,0.0
SF-K23,SF-H26,3,2,3,2,0,0,1.0,0.0,1.0,0.0
SF-K23,SF-O23,3,5,1,3,2,2,0.3333333333333333,0.6666666666666666,0.6,0.4
SF-K23,SF-F28-2,1,6,0,1,1,5,0.0,1.0,0.16666666666666666,0.8333333333333334
SF-K23,SF-G27,6,3,3,3,3,0,0.5,0.5,1.0,0.0
SF-K23,SF-M22-2,8,3,2,2,6,1,0.25,0.75,0.6666666666666666,0.3333333333333333
SF-K23,SF-L22,2,2,2,2,0,0,1.0,0.0,1.0,0.0
SF-K23,SF-F27,2,3,1,3,1,0,0.5,0.5,1.0,0.0
SF-K23,SF-N22-2,6,5,5,3,1,2,0.8333333333333334,0.16666666666666666,0.6,0.4
SF-K23,SF-G28-2,1,1,1,1,0,0,1.0,0.0,1.0,0.0
SF-K23,SF-M22-1,1,1,1,1,0,0,1.0,0.0,1.0,0.0
SF-K23,SF-K22-2,4,13,2,11,2,2,0.5,0.5,0.8461538461538461,0.15384615384615385
SF-K23,SF-K24,5,5,4,3,1,2,0.8,0.2,0.6,0.4
SF-K23,SF-G23,6,1,5,1,1,0,0.8333333333333334,0.16666666666666666,1.0,0.0
SF-K23,SF-G24,6,2,2,0,4,2,0.3333333333333333,0.6666666666666666,0.0,1.0
SF-K23,SF-G25,18,5,15,1,3,4,0.8333333333333334,0.16666666666666666,0.2,0.8
SF-K23,SF-E23,3,1,1,0,2,1,0.3333333333333333,0.6666666666666666,0.0,1.0
SF-K23,SF-C22,3,3,0,0,3,3,0.0,1.0,0.0,1.0
SF-K23,SF-J17,1,2,0,0,1,2,0.0,1.0,0.0,1.0
SF-K23,SF-G20,2,1,0,0,2,1,0.0,1.0,0.0,1.0
SF-K23,SF-E18,1,1,0,0,1,1,0.0,1.0,0.0,1.0
SF-K23,SF-E29-2,1,8,0,1,1,7,0.0,1.0,0.125,0.875
SF-K23,SF-D28,1,2,0,0,1,2,0.0,1.0,0.0,1.0
SF-K23,SF-G29-2,4,2,2,2,2,0,0.5,0.5,1.0,0.0
SF-K23,SF-G29-1,4,2,1,2,3,0,0.25,0.75,1.0,0.0
SF-K23,SF-G29-3,1,5,0,3,1,2,0.0,1.0,0.6,0.4
SF-K23,SF-I16,1,1,0,0,1,1,0.0,1.0,0.0,1.0
SF-K23,SF-H12,1,2,1,0,0,2,1.0,0.0,0.0,1.0
SF-K23,SF-G10-1,1,1,0,0,1,1,0.0,1.0,0.0,1.0
SF-K23,SF-B21,4,1,0,1,4,0,0.0,1.0,1.0,0.0
SF-K23,SF-C26,1,1,0,0,1,1,0.0,1.0,0.0,1.0
SF-K23,SF-D27,2,6,1,5,1,1,0.5,0.5,0.8333333333333334,0.16666666666666666
SF-K23,SF-H25,2,2,2,2,0,0,1.0,0.0,1.0,0.0
SF-K23,SF-G26,1,3,1,3,0,0,1.0,0.0,1.0,0.0
SF-K23,SF-K22-1,3,6,3,5,0,1,1.0,0.0,0.8333333333333334,0.16666666666666666
SF-K23,SF-J23-1,9,11,7,8,2,3,0.7777777777777778,0.2222222222222222,0.7272727272727273,0.2727272727272727
SF-K23,SF-J22-1,19,13,13,8,6,5,0.6842105263157895,0.3157894736842105,0.6153846153846154,0.38461538461538464
SF-K23,SF-J22-2,1,7,1,2,0,5,1.0,0.0,0.2857142857142857,0.7142857142857143
SF-K23,SF-J21,8,10,7,6,1,4,0.875,0.125,0.6,0.4
SF-K23,SF-I23-2,3,2,2,1,1,1,0.6666666666666666,0.3333333333333333,0.5,0.5
SF-K23,SF-I24,4,9,3,6,1,3,0.75,0.25,0.6666666666666666,0.3333333333333333
SF-K23,SF-F26,6,3,1,1,5,2,0.16666666666666666,0.8333333333333334,0.3333333333333333,0.6666666666666666
SF-K23,SF-M13,5,4,1,0,4,4,0.2,0.8,0.0,1.0
SF-K23,SF-M15,5,3,4,1,1,2,0.8,0.2,0.3333333333333333,0.6666666666666666
SF-K23,SF-L19,4,26,3,24,1,2,0.75,0.25,0.9230769230769231,0.07692307692307693
SF-K23,SF-L20,5,6,4,3,1,3,0.8,0.2,0.5,0.5
SF-K23,SF-N20-1,5,1,2,0,3,1,0.4,0.6,0.0,1.0
SF-K23,SF-M20,3,12,3,1,0,11,1.0,0.0,0.08333333333333333,0.9166666666666666
SF-K23,SF-K20,3,4,3,1,0,3,1.0,0.0,0.25,0.75
SF-K23,SF-K15-,1,1,0,0,1,1,0.0,1.0,0.0,1.0
SF-K23,SF-K18,6,2,0,0,6,2,0.0,1.0,0.0,1.0
SF-K23,SF-K17,2,2,0,1,2,1,0.0,1.0,0.5,0.5
SF-K23,SF-J18,3,3,0,0,3,3,0.0,1.0,0.0,1.0
SF-K23,SF-J20,2,2,1,0,1,2,0.5,0.5,0.0,1.0
SF-K23,SF-J19,2,6,0,0,2,6,0.0,1.0,0.0,1.0
SF-K23,SF-M10,1,2,0,1,1,1,0.0,1.0,0.5,0.5
SF-K23,SF-R19,2,1,0,1,2,0,0.0,1.0,1.0,0.0
SF-K23,SF-Q21-1,1,3,0,1,1,2,0.0,1.0,0.3333333333333333,0.6666666666666666
SF-K23,SF-O18,2,3,1,3,1,0,0.5,0.5,1.0,0.0
SF-K23,SF-O19,3,1,1,0,2,1,0.3333333333333333,0.6666666666666666,0.0,1.0
SF-K23,SF-O21,11,10,7,7,4,3,0.6363636363636364,0.36363636363636365,0.7,0.3
SF-K23,SF-O22,3,13,2,10,1,3,0.6666666666666666,0.3333333333333333,0.7692307692307693,0.23076923076923078
SF-K23,SF-N21,2,4,2,3,0,1,1.0,0.0,0.75,0.25
SF-K23,SF-M21,2,13,1,8,1,5,0.5,0.5,0.6153846153846154,0.38461538461538464
SF-K23,SF-L21,5,9,4,5,1,4,0.8,0.2,0.5555555555555556,0.4444444444444444
SF-K23,SF-O30,3,2,2,1,1,1,0.6666666666666666,0.3333333333333333,0.5,0.5
SF-K23,SF-N28,4,2,1,1,3,1,0.25,0.75,0.5,0.5
SF-K23,SF-L30-1,5,3,3,1,2,2,0.6,0.4,0.3333333333333333,0.6666666666666666
SF-K23,SF-L29,4,1,3,0,1,1,0.75,0.25,0.0,1.0
SF-K23,SF-H28,1,2,1,1,0,1,1.0,0.0,0.5,0.5
SF-K23,SF-O25-2,3,3,0,1,3,2,0.0,1.0,0.3333333333333333,0.6666666666666666
SF-K23,SF-N22-1B,5,4,5,2,0,2,1.0,0.0,0.5,0.5
SF-K23,SF-Q23-3,2,3,0,0,2,3,0.0,1.0,0.0,1.0
SF-K23,SF-Q22-1,4,6,0,6,4,0,0.0,1.0,1.0,0.0
SF-K23,SF-Q22-2,12,8,9,5,3,3,0.75,0.25,0.625,0.375
SF-K23,SF-P22,7,4,3,1,4,3,0.42857142857142855,0.5714285714285714,0.25,0.75
SF-K23,SF-T20,3,53,2,46,1,7,0.6666666666666666,0.3333333333333333,0.8679245283018868,0.1320754716981132
SF-H26,SF-M26,6,10,4,10,2,0,0.6666666666666666,0.3333333333333333,1.0,0.0
SF-H26,SF-M25,21,14,12,5,9,9,0.5714285714285714,0.42857142857142855,0.35714285714285715,0.6428571428571429
SF-H26,SF-M26-2,17,18,3,9,14,9,0.17647058823529413,0.8235294117647058,0.5,0.5
SF-H26,SF-L27,10,8,4,4,6,4,0.4,0.6,0.5,0.5
SF-H26,SF-K26,16,23,6,13,10,10,0.375,0.625,0.5652173913043478,0.43478260869565216
SF-H26,SF-J27,16,10,11,8,5,2,0.6875,0.3125,0.8,0.2
SF-H26,SF-M30,36,22,17,5,19,17,0.4722222222222222,0.5277777777777778,0.22727272727272727,0.7727272727272727
SF-H26,SF-L27-2,11,17,7,14,4,3,0.6363636363636364,0.36363636363636365,0.8235294117647058,0.17647058823529413
SF-H26,SF-J29-3,17,15,13,8,4,7,0.7647058823529411,0.23529411764705882,0.5333333333333333,0.4666666666666667
SF-H26,SF-J29,53,42,35,19,18,23,0.660377358490566,0.33962264150943394,0.4523809523809524,0.5476190476190477
SF-H26,SF-L26,24,21,5,10,19,11,0.20833333333333334,0.7916666666666666,0.47619047619047616,0.5238095238095238
SF-H26,SF-M28,9,11,4,6,5,5,0.4444444444444444,0.5555555555555556,0.5454545454545454,0.45454545454545453
SF-H26,SF-M27,2,2,1,1,1,1,0.5,0.5,0.5,0.5
SF-H26,SF-L25,24,29,16,24,8,5,0.6666666666666666,0.3333333333333333,0.8275862068965517,0.1724137931034483
SF-H26,SF-M24,26,16,13,9,13,7,0.5,0.5,0.5625,0.4375
SF-H26,SF-L24,40,44,30,28,10,16,0.75,0.25,0.6363636363636364,0.36363636363636365
SF-H26,SF-N23,9,11,4,4,5,7,0.4444444444444444,0.5555555555555556,0.36363636363636365,0.6363636363636364
SF-H26,SF-N24-2,4,12,0,3,4,9,0.0,1.0,0.25,0.75
SF-H26,SF-K27-2,24,20,16,11,8,9,0.6666666666666666,0.3333333333333333,0.55,0.45
SF-H26,SF-J26-2,37,18,21,11,16,7,0.5675675675675675,0.43243243243243246,0.6111111111111112,0.3888888888888889
SF-H26,SF-K28-3,3,2,2,2,1,0,0.6666666666666666,0.3333333333333333,1.0,0.0
SF-H26,SF-L28,4,5,3,3,1,2,0.75,0.25,0.6,0.4
SF-H26,SF-K28,18,25,8,16,10,9,0.4444444444444444,0.5555555555555556,0.64,0.36
SF-H26,SF-K29-1,37,24,16,11,21,13,0.43243243243243246,0.5675675675675675,0.4583333333333333,0.5416666666666666
SF-H26,SF-J28-2,21,8,6,4,15,4,0.2857142857142857,0.7142857142857143,0.5,0.5
SF-H26,SF-K27,18,7,10,2,8,5,0.5555555555555556,0.4444444444444444,0.2857142857142857,0.7142857142857143
SF-H26,SF-K25,70,54,57,42,13,12,0.8142857142857143,0.18571428571428572,0.7777777777777778,0.2222222222222222
SF-H26,SF-J25,44,52,22,27,22,25,0.5,0.5,0.5192307692307693,0.4807692307692308
SF-H26,SF-H26-2,31,19,22,10,9,9,0.7096774193548387,0.2903225806451613,0.5263157894736842,0.47368421052631576
SF-H26,SF-P24,13,16,5,11,8,5,0.38461538461538464,0.6153846153846154,0.6875,0.3125
SF-H26,SF-N22-1A,6,5,5,5,1,0,0.8333333333333334,0.16666666666666666,1.0,0.0
SF-H26,SF-J24,34,32,18,15,16,17,0.5294117647058824,0.47058823529411764,0.46875,0.53125
SF-H26,SF-O24,11,13,9,10,2,3,0.8181818181818182,0.18181818181818182,0.7692307692307693,0.23076923076923078
SF-H26,SF-J26,27,24,21,22,6,2,0.7777777777777778,0.2222222222222222,0.9166666666666666,0.08333333333333333
SF-H26,SF-I26-,22,24,19,18,3,6,0.8636363636363636,0.13636363636363635,0.75,0.25
SF-H26,SF-I25,124,97,97,69,27,28,0.782258064516129,0.21774193548387097,0.711340206185567,0.28865979381443296
SF-H26,SF-K23,2,3,2,3,0,0,1.0,0.0,1.0,0.0
SF-H26,SF-O23,8,10,5,3,3,7,0.625,0.375,0.3,0.7
SF-H26,SF-H27-1,23,25,17,23,6,2,0.7391304347826086,0.2608695652173913,0.92,0.08
SF-H26,SF-F28-2,88,88,54,59,34,29,0.6136363636363636,0.38636363636363635,0.6704545454545454,0.32954545454545453
SF-H26,SF-G27,115,165,86,139,29,26,0.7478260869565218,0.25217391304347825,0.8424242424242424,0.15757575757575756
SF-H26,SF-M22-2,30,41,16,20,14,21,0.5333333333333333,0.4666666666666667,0.4878048780487805,0.5121951219512195
SF-H26,SF-L22,42,44,14,25,28,19,0.3333333333333333,0.6666666666666666,0.5681818181818182,0.4318181818181818
SF-H26,SF-F27,78,81,65,62,13,19,0.8333333333333334,0.16666666666666666,0.7654320987654321,0.2345679012345679
SF-H26,SF-N22-2,41,52,17,22,24,30,0.4146341463414634,0.5853658536585366,0.4230769230769231,0.5769230769230769
SF-H26,SF-G28-2,10,3,4,1,6,2,0.4,0.6,0.3333333333333333,0.6666666666666666
SF-H26,SF-G28-1,9,3,5,3,4,0,0.5555555555555556,0.4444444444444444,1.0,0.0
SF-H26,SF-M22-1,15,24,6,10,9,14,0.4,0.6,0.4166666666666667,0.5833333333333334
SF-H26,SF-O25-1,4,7,3,1,1,6,0.75,0.25,0.14285714285714285,0.8571428571428571
SF-H26,SF-K22-2,41,38,22,25,19,13,0.5365853658536586,0.4634146341463415,0.6578947368421053,0.34210526315789475
SF-H26,SF-K24,35,19,24,15,11,4,0.6857142857142857,0.3142857142857143,0.7894736842105263,0.21052631578947367
SF-H26,SF-J23-2,43,36,29,24,14,12,0.6744186046511628,0.32558139534883723,0.6666666666666666,0.3333333333333333
SF-H26,SF-G23,30,42,19,18,11,24,0.6333333333333333,0.36666666666666664,0.42857142857142855,0.5714285714285714
SF-H26,SF-G24,141,42,29,3,112,39,0.20567375886524822,0.7943262411347518,0.07142857142857142,0.9285714285714286
SF-H26,SF-G25,56,30,35,10,21,20,0.625,0.375,0.3333333333333333,0.6666666666666666
SF-H26,SF-F23,37,23,17,8,20,15,0.4594594594594595,0.5405405405405406,0.34782608695652173,0.6521739130434783
SF-H26,SF-E23,48,38,19,17,29,21,0.3958333333333333,0.6041666666666666,0.4473684210526316,0.5526315789473685
SF-H26,SF-D24,12,8,4,1,8,7,0.3333333333333333,0.6666666666666666,0.125,0.875
SF-H26,SF-C22,6,6,2,4,4,2,0.3333333333333333,0.6666666666666666,0.6666666666666666,0.3333333333333333
SF-H26,SF-B22,5,29,2,20,3,9,0.4,0.6,0.6896551724137931,0.3103448275862069
SF-H26,SF-J17,46,40,7,3,39,37,0.15217391304347827,0.8478260869565217,0.075,0.925
SF-H26,SF-I19,30,8,21,2,9,6,0.7,0.3,0.25,0.75
SF-H26,SF-I20,34,29,22,20,12,9,0.6470588235294118,0.35294117647058826,0.6896551724137931,0.3103448275862069
SF-H26,SF-H16,1,1,0,0,1,1,0.0,1.0,0.0,1.0
SF-H26,SF-H19,6,1,3,0,3,1,0.5,0.5,0.0,1.0
SF-H26,SF-H20,24,18,17,10,7,8,0.7083333333333334,0.2916666666666667,0.5555555555555556,0.4444444444444444
SF-H26,SF-H18,7,6,0,1,7,5,0.0,1.0,0.16666666666666666,0.8333333333333334
SF-H26,SF-H17,7,2,0,0,7,2,0.0,1.0,0.0,1.0
SF-H26,SF-G19,10,9,4,3,6,6,0.4,0.6,0.3333333333333333,0.6666666666666666
SF-H26,SF-G17,4,10,0,2,4,8,0.0,1.0,0.2,0.8
SF-H26,SF-G18,11,8,6,4,5,4,0.5454545454545454,0.45454545454545453,0.5,0.5
SF-H26,SF-G20,28,8,16,0,12,8,0.5714285714285714,0.42857142857142855,0.0,1.0
SF-H26,SF-F19,33,20,1,0,32,20,0.030303030303030304,0.9696969696969697,0.0,1.0
SF-H26,SF-E18,7,7,0,0,7,7,0.0,1.0,0.0,1.0
SF-H26,SF-E20,6,5,1,1,5,4,0.16666666666666666,0.8333333333333334,0.2,0.8
SF-H26,SF-H30,12,20,6,10,6,10,0.5,0.5,0.5,0.5
SF-H26,SF-G30-2,24,10,10,6,14,4,0.4166666666666667,0.5833333333333334,0.6,0.4
SF-H26,SF-F30-1,15,7,12,6,3,1,0.8,0.2,0.8571428571428571,0.14285714285714285
SF-H26,SF-E29-2,106,117,64,98,42,19,0.6037735849056604,0.39622641509433965,0.8376068376068376,0.1623931623931624
SF-H26,SF-E29-1,42,61,27,51,15,10,0.6428571428571429,0.35714285714285715,0.8360655737704918,0.16393442622950818
SF-H26,SF-D29,40,29,29,23,11,6,0.725,0.275,0.7931034482758621,0.20689655172413793
SF-H26,SF-D28,62,54,54,45,8,9,0.8709677419354839,0.12903225806451613,0.8333333333333334,0.16666666666666666
SF-H26,SF-A27,47,17,33,11,14,6,0.7021276595744681,0.2978723404255319,0.6470588235294118,0.35294117647058826
SF-H26,SF-G29-2,30,10,14,1,16,9,0.4666666666666667,0.5333333333333333,0.1,0.9
SF-H26,SF-G29-1,41,61,30,49,11,12,0.7317073170731707,0.2682926829268293,0.8032786885245902,0.19672131147540983
SF-H26,SF-G30-1,33,10,21,3,12,7,0.6363636363636364,0.36363636363636365,0.3,0.7
SF-H26,SF-G29-3,26,16,22,9,4,7,0.8461538461538461,0.15384615384615385,0.5625,0.4375
SF-H26,SF-F30-2,9,7,6,4,3,3,0.6666666666666666,0.3333333333333333,0.5714285714285714,0.42857142857142855
SF-H26,SF-F29,10,7,6,5,4,2,0.6,0.4,0.7142857142857143,0.2857142857142857
SF-H26,SF-E29-3,24,16,14,10,10,6,0.5833333333333334,0.4166666666666667,0.625,0.375
SF-H26,SF-F28-1,80,59,48,32,32,27,0.6,0.4,0.5423728813559322,0.4576271186440678
SF-H26,SF-E28-2,32,63,26,58,6,5,0.8125,0.1875,0.9206349206349206,0.07936507936507936
SF-H26,SF-E28,33,17,14,10,19,7,0.42424242424242425,0.5757575757575758,0.5882352941176471,0.4117647058823529
SF-H26,SF-J10,5,6,3,6,2,0,0.6,0.4,1.0,0.0
SF-H26,SF-J12,7,5,3,0,4,5,0.42857142857142855,0.5714285714285714,0.0,1.0
SF-H26,SF-J13,10,9,0,2,10,7,0.0,1.0,0.2222222222222222,0.7777777777777778
SF-H26,SF-J15,3,1,0,0,3,1,0.0,1.0,0.0,1.0
SF-H26,SF-I16,3,1,0,0,3,1,0.0,1.0,0.0,1.0
SF-H26,SF-H12,6,11,0,0,6,11,0.0,1.0,0.0,1.0
SF-H26,SF-H14,2,1,0,0,2,1,0.0,1.0,0.0,1.0
SF-H26,SF-G13,1,2,0,0,1,2,0.0,1.0,0.0,1.0
SF-H26,SF-G11,2,1,0,0,2,1,0.0,1.0,0.0,1.0
SF-H26,SF-G12,8,1,0,0,8,1,0.0,1.0,0.0,1.0
SF-H26,SF-F15,2,4,1,3,1,1,0.5,0.5,0.75,0.25
SF-H26,SF-F16,2,7,1,5,1,2,0.5,0.5,0.7142857142857143,0.2857142857142857
SF-H26,SF-C21,3,1,2,0,1,1,0.6666666666666666,0.3333333333333333,0.0,1.0
SF-H26,SF-C20,9,6,0,1,9,5,0.0,1.0,0.16666666666666666,0.8333333333333334
SF-H26,SF-B21,4,7,2,5,2,2,0.5,0.5,0.7142857142857143,0.2857142857142857
SF-H26,SF-B19,9,17,6,11,3,6,0.6666666666666666,0.3333333333333333,0.6470588235294118,0.35294117647058826
SF-H26,SF-A20,18,36,10,31,8,5,0.5555555555555556,0.4444444444444444,0.8611111111111112,0.1388888888888889
SF-H26,SF-A19,4,4,1,3,3,1,0.25,0.75,0.75,0.25
SF-H26,SF-C26,27,34,12,11,15,23,0.4444444444444444,0.5555555555555556,0.3235294117647059,0.6764705882352942
SF-H26,SF-C25,44,31,19,12,25,19,0.4318181818181818,0.5681818181818182,0.3870967741935484,0.6129032258064516
SF-H26,SF-B25,13,29,5,16,8,13,0.38461538461538464,0.6153846153846154,0.5517241379310345,0.4482758620689655
SF-H26,SF-E27,50,77,41,71,9,6,0.82,0.18,0.922077922077922,0.07792207792207792
SF-H26,SF-B28-2,10,8,6,6,4,2,0.6,0.4,0.75,0.25
SF-H26,SF-D27,55,141,36,83,19,58,0.6545454545454545,0.34545454545454546,0.5886524822695035,0.41134751773049644
SF-H26,SF-C28-2,10,3,4,2,6,1,0.4,0.6,0.6666666666666666,0.3333333333333333
SF-H26,SF-C28-1,9,6,8,6,1,0,0.8888888888888888,0.1111111111111111,1.0,0.0
SF-H26,SF-B28,46,60,41,51,5,9,0.8913043478260869,0.10869565217391304,0.85,0.15
SF-H26,SF-J1,2,7,0,2,2,5,0.0,1.0,0.2857142857142857,0.7142857142857143
SF-H26,SF-G8,1,4,1,1,0,3,1.0,0.0,0.25,0.75
SF-H26,SF-G7,1,2,0,0,1,2,0.0,1.0,0.0,1.0
SF-H26,SF-H25,18,34,13,21,5,13,0.7222222222222222,0.2777777777777778,0.6176470588235294,0.38235294117647056
SF-H26,SF-G26,57,44,37,33,20,11,0.6491228070175439,0.3508771929824561,0.75,0.25
SF-H26,SF-K21,49,32,28,2,21,30,0.5714285714285714,0.42857142857142855,0.0625,0.9375
SF-H26,SF-K22-1,71,134,45,84,26,50,0.6338028169014085,0.36619718309859156,0.6268656716417911,0.373134328358209
SF-H26,SF-J23-1,369,335,231,224,138,111,0.6260162601626016,0.37398373983739835,0.6686567164179105,0.33134328358208953
SF-H26,SF-J22-1,56,82,31,41,25,41,0.5535714285714286,0.44642857142857145,0.5,0.5
SF-H26,SF-J22-2,38,61,15,24,23,37,0.39473684210526316,0.6052631578947368,0.39344262295081966,0.6065573770491803
SF-H26,SF-J21,58,71,31,39,27,32,0.5344827586206896,0.46551724137931033,0.5492957746478874,0.4507042253521127
SF-H26,SF-I21,26,19,17,12,9,7,0.6538461538461539,0.34615384615384615,0.631578947368421,0.3684210526315789
SF-H26,SF-I22,40,30,12,11,28,19,0.3,0.7,0.36666666666666664,0.6333333333333333
SF-H26,SF-I23-2,34,36,28,30,6,6,0.8235294117647058,0.17647058823529413,0.8333333333333334,0.16666666666666666
SF-H26,SF-I24,20,63,11,50,9,13,0.55,0.45,0.7936507936507936,0.20634920634920634
SF-H26,SF-I23-1,41,55,26,36,15,19,0.6341463414634146,0.36585365853658536,0.6545454545454545,0.34545454545454546
SF-H26,SF-F26,125,61,95,19,30,42,0.76,0.24,0.3114754098360656,0.6885245901639344
SF-H26,SF-M13,16,5,11,1,5,4,0.6875,0.3125,0.2,0.8
SF-H26,SF-M15,34,16,20,1,14,15,0.5882352941176471,0.4117647058823529,0.0625,0.9375
SF-H26,SF-L19,44,24,19,10,25,14,0.4318181818181818,0.5681818181818182,0.4166666666666667,0.5833333333333334
SF-H26,SF-L20,38,24,18,9,20,15,0.47368421052631576,0.5263157894736842,0.375,0.625
SF-H26,SF-N20-1,36,23,20,2,16,21,0.5555555555555556,0.4444444444444444,0.08695652173913043,0.9130434782608695
SF-H26,SF-M20,122,105,59,39,63,66,0.48360655737704916,0.5163934426229508,0.37142857142857144,0.6285714285714286
SF-H26,SF-K17-2,20,10,10,2,10,8,0.5,0.5,0.2,0.8
SF-H26,SF-K20,35,35,18,11,17,24,0.5142857142857142,0.4857142857142857,0.3142857142857143,0.6857142857142857
SF-H26,SF-K15-,41,38,21,14,20,24,0.5121951219512195,0.4878048780487805,0.3684210526315789,0.631578947368421
SF-H26,SF-K19,39,55,16,13,23,42,0.41025641025641024,0.5897435897435898,0.23636363636363636,0.7636363636363637
SF-H26,SF-K18,38,15,17,5,21,10,0.4473684210526316,0.5526315789473685,0.3333333333333333,0.6666666666666666
SF-H26,SF-K17,17,25,7,15,10,10,0.4117647058823529,0.5882352941176471,0.6,0.4
SF-H26,SF-J16,10,9,1,1,9,8,0.1,0.9,0.1111111111111111,0.8888888888888888
SF-H26,SF-J18,20,16,6,0,14,16,0.3,0.7,0.0,1.0
SF-H26,SF-J20,24,27,17,13,7,14,0.7083333333333334,0.2916666666666667,0.48148148148148145,0.5185185185185185
SF-H26,SF-J19,53,44,36,25,17,19,0.6792452830188679,0.32075471698113206,0.5681818181818182,0.4318181818181818
SF-H26,SF-O12,6,2,5,0,1,2,0.8333333333333334,0.16666666666666666,0.0,1.0
SF-H26,SF-M12,4,1,1,0,3,1,0.25,0.75,0.0,1.0
SF-H26,SF-M10,3,4,1,2,2,2,0.3333333333333333,0.6666666666666666,0.5,0.5
SF-H26,SF-M11,7,11,2,0,5,11,0.2857142857142857,0.7142857142857143,0.0,1.0
SF-H26,SF-R19,27,7,22,2,5,5,0.8148148148148148,0.18518518518518517,0.2857142857142857,0.7142857142857143
SF-H26,SF-R20,10,1,4,0,6,1,0.4,0.6,0.0,1.0
SF-H26,SF-Q21-2,12,6,7,1,5,5,0.5833333333333334,0.4166666666666667,0.16666666666666666,0.8333333333333334
SF-H26,SF-Q21-1,13,17,6,13,7,4,0.46153846153846156,0.5384615384615384,0.7647058823529411,0.23529411764705882
SF-H26,SF-P21,30,10,6,1,24,9,0.2,0.8,0.1,0.9
SF-H26,SF-O18,38,47,18,27,20,20,0.47368421052631576,0.5263157894736842,0.574468085106383,0.425531914893617
SF-H26,SF-O19,45,39,9,13,36,26,0.2,0.8,0.3333333333333333,0.6666666666666666
SF-H26,SF-O21,49,57,22,37,27,20,0.4489795918367347,0.5510204081632653,0.6491228070175439,0.3508771929824561
SF-H26,SF-O22,31,66,12,35,19,31,0.3870967741935484,0.6129032258064516,0.5303030303030303,0.4696969696969697
SF-H26,SF-N21,15,16,8,7,7,9,0.5333333333333333,0.4666666666666667,0.4375,0.5625
SF-H26,SF-N20-2,17,8,8,0,9,8,0.47058823529411764,0.5294117647058824,0.0,1.0
SF-H26,SF-M21,19,22,4,5,15,17,0.21052631578947367,0.7894736842105263,0.22727272727272727,0.7727272727272727
SF-H26,SF-L21,139,176,61,58,78,118,0.43884892086330934,0.5611510791366906,0.32954545454545453,0.6704545454545454
SF-H26,SF-Q30,8,56,1,46,7,10,0.125,0.875,0.8214285714285714,0.17857142857142858
SF-H26,SF-P30,20,11,5,5,15,6,0.25,0.75,0.45454545454545453,0.5454545454545454
SF-H26,SF-O30-2,10,8,8,4,2,4,0.8,0.2,0.5,0.5
SF-H26,SF-O30,27,22,18,13,9,9,0.6666666666666666,0.3333333333333333,0.5909090909090909,0.4090909090909091
SF-H26,SF-N27,38,50,23,34,15,16,0.6052631578947368,0.39473684210526316,0.68,0.32
SF-H26,SF-N29,7,6,4,2,3,4,0.5714285714285714,0.42857142857142855,0.3333333333333333,0.6666666666666666
SF-H26,SF-N28,8,32,5,19,3,13,0.625,0.375,0.59375,0.40625
SF-H26,SF-L30-1,32,31,18,23,14,8,0.5625,0.4375,0.7419354838709677,0.25806451612903225
SF-H26,SF-L31-1,6,6,4,4,2,2,0.6666666666666666,0.3333333333333333,0.6666666666666666,0.3333333333333333
SF-H26,SF-K30-2,7,6,0,4,7,2,0.0,1.0,0.6666666666666666,0.3333333333333333
SF-H26,SF-L29,38,37,20,18,18,19,0.5263157894736842,0.47368421052631576,0.4864864864864865,0.5135135135135135
SF-H26,SF-J29-1,14,17,7,10,7,7,0.5,0.5,0.5882352941176471,0.4117647058823529
SF-H26,SF-I30,14,11,11,9,3,2,0.7857142857142857,0.21428571428571427,0.8181818181818182,0.18181818181818182
SF-H26,SF-I29-2,9,4,5,3,4,1,0.5555555555555556,0.4444444444444444,0.75,0.25
SF-H26,SF-I27,31,22,20,13,11,9,0.6451612903225806,0.3548387096774194,0.5909090909090909,0.4090909090909091
SF-H26,SF-I28,22,23,14,16,8,7,0.6363636363636364,0.36363636363636365,0.6956521739130435,0.30434782608695654
SF-H26,SF-I30-2,9,3,6,3,3,0,0.6666666666666666,0.3333333333333333,1.0,0.0
SF-H26,SF I29-1,19,6,7,2,12,4,0.3684210526315789,0.631578947368421,0.3333333333333333,0.6666666666666666
SF-H26,SF-H28,127,104,115,96,12,8,0.905511811023622,0.09448818897637795,0.9230769230769231,0.07692307692307693
SF-H26,SF-H29,15,9,9,6,6,3,0.6,0.4,0.6666666666666666,0.3333333333333333
SF-H26,SF-S24,15,10,6,4,9,6,0.4,0.6,0.4,0.6
SF-H26,SF-R24,15,27,5,17,10,10,0.3333333333333333,0.6666666666666666,0.6296296296296297,0.37037037037037035
SF-H26,SF-R26,1,2,1,2,0,0,1.0,0.0,1.0,0.0
SF-H26,SF-Q26,2,8,0,0,2,8,0.0,1.0,0.0,1.0
SF-H26,SF-P26,2,7,0,3,2,4,0.0,1.0,0.42857142857142855,0.5714285714285714
SF-H26,SF-O25-2,7,8,1,2,6,6,0.14285714285714285,0.8571428571428571,0.25,0.75
SF-H26,SF-N22-1B,7,11,2,8,5,3,0.2857142857142857,0.7142857142857143,0.7272727272727273,0.2727272727272727
SF-H26,SF-N26,9,5,5,3,4,2,0.5555555555555556,0.4444444444444444,0.6,0.4
SF-H26,SF-N25,5,4,3,2,2,2,0.6,0.4,0.5,0.5
SF-H26,SF-T22,17,12,2,2,15,10,0.11764705882352941,0.8823529411764706,0.16666666666666666,0.8333333333333334
SF-H26,SF-S22-2,3,3,1,0,2,3,0.3333333333333333,0.6666666666666666,0.0,1.0
SF-H26,SF-S22-1,15,12,6,3,9,9,0.4,0.6,0.25,0.75
SF-H26,SF-Q23-3,13,14,7,8,6,6,0.5384615384615384,0.46153846153846156,0.5714285714285714,0.42857142857142855
SF-H26,SF-Q22-1,13,20,4,11,9,9,0.3076923076923077,0.6923076923076923,0.55,0.45
SF-H26,SF-Q22-2,29,18,22,10,7,8,0.7586206896551724,0.2413793103448276,0.5555555555555556,0.4444444444444444
SF-H26,SF-P22,18,28,9,10,9,18,0.5,0.5,0.35714285714285715,0.6428571428571429
SF-H26,SF-W19,1,1,1,1,0,0,1.0,0.0,1.0,0.0
SF-H26,SF-U21,3,5,1,2,2,3,0.3333333333333333,0.6666666666666666,0.4,0.6
SF-H26,SF-T20,9,5,2,3,7,2,0.2222222222222222,0.7777777777777778,0.6,0.4
SF-H26,SF-S21,1,2,1,2,0,0,1.0,0.0,1.0,0.0
SF-H26,SF-U30,24,29,0,0,24,29,0.0,1.0,0.0,1.0
SF-H26,SF-W14,1,2,0,0,1,2,0.0,1.0,0.0,1.0
SF-H26,SF-AA15,1,2,1,2,0,0,1.0,0.0,1.0,0.0
SF-O23,SF-M26,1,1,1,0,0,1,1.0,0.0,0.0,1.0
SF-O23,SF-M25,9,9,3,6,6,3,0.3333333333333333,0.6666666666666666,0.6666666666666666,0.3333333333333333
SF-O23,SF-M26-2,5,3,0,2,5,1,0.0,1.0,0.6666666666666666,0.3333333333333333
SF-O23,SF-L27,3,1,1,0,2,1,0.3333333333333333,0.6666666666666666,0.0,1.0
SF-O23,SF-K26,12,10,7,6,5,4,0.5833333333333334,0.4166666666666667,0.6,0.4
SF-O23,SF-J27,2,1,0,0,2,1,0.0,1.0,0.0,1.0
SF-O23,SF-M30,20,43,7,25,13,18,0.35,0.65,0.5813953488372093,0.4186046511627907
SF-O23,SF-J29-3,6,3,1,0,5,3,0.16666666666666666,0.8333333333333334,0.0,1.0
SF-O23,SF-J29,14,6,7,2,7,4,0.5,0.5,0.3333333333333333,0.6666666666666666
SF-O23,SF-L26,27,22,11,5,16,17,0.4074074074074074,0.5925925925925926,0.22727272727272727,0.7727272727272727
SF-O23,SF-M28,8,8,1,1,7,7,0.125,0.875,0.125,0.875
SF-O23,SF-M27,2,2,0,0,2,2,0.0,1.0,0.0,1.0
SF-O23,SF-L25,9,11,5,6,4,5,0.5555555555555556,0.4444444444444444,0.5454545454545454,0.45454545454545453
SF-O23,SF-M24,14,46,11,39,3,7,0.7857142857142857,0.21428571428571427,0.8478260869565217,0.15217391304347827
SF-O23,SF-L24,21,11,12,4,9,7,0.5714285714285714,0.42857142857142855,0.36363636363636365,0.6363636363636364
SF-O23,SF-N23,2,15,1,12,1,3,0.5,0.5,0.8,0.2
SF-O23,SF-N24-2,20,28,9,18,11,10,0.45,0.55,0.6428571428571429,0.35714285714285715
SF-O23,SF-K27-2,14,12,2,4,12,8,0.14285714285714285,0.8571428571428571,0.3333333333333333,0.6666666666666666
SF-O23,SF-J26-2,4,15,1,3,3,12,0.25,0.75,0.2,0.8
SF-O23,SF-L28,4,5,2,1,2,4,0.5,0.5,0.2,0.8
SF-O23,SF-K28,4,3,2,1,2,2,0.5,0.5,0.3333333333333333,0.6666666666666666
SF-O23,SF-K29-1,6,8,0,1,6,7,0.0,1.0,0.125,0.875
SF-O23,SF-J28-2,10,5,7,1,3,4,0.7,0.3,0.2,0.8
SF-O23,SF-K27,11,2,1,2,10,0,0.09090909090909091,0.9090909090909091,1.0,0.0
SF-O23,SF-K25,29,35,17,19,12,16,0.5862068965517241,0.41379310344827586,0.5428571428571428,0.45714285714285713
SF-O23,SF-J25,36,20,8,5,28,15,0.2222222222222222,0.7777777777777778,0.25,0.75
SF-O23,SF-H26-2,9,3,3,0,6,3,0.3333333333333333,0.6666666666666666,0.0,1.0
SF-O23,SF-P24,36,12,17,11,19,1,0.4722222222222222,0.5277777777777778,0.9166666666666666,0.08333333333333333
SF-O23,SF-N22-1A,8,51,7,49,1,2,0.875,0.125,0.9607843137254902,0.0392156862745098
SF-O23,SF-J24,12,12,2,5,10,7,0.16666666666666666,0.8333333333333334,0.4166666666666667,0.5833333333333334
SF-O23,SF-O24,15,28,11,19,4,9,0.7333333333333333,0.26666666666666666,0.6785714285714286,0.32142857142857145
SF-O23,SF-J26,10,6,8,3,2,3,0.8,0.2,0.5,0.5
SF-O23,SF-I26-,3,6,0,2,3,4,0.0,1.0,0.3333333333333333,0.6666666666666666
SF-O23,SF-I25,3,8,1,4,2,4,0.3333333333333333,0.6666666666666666,0.5,0.5
SF-O23,SF-K23,5,3,3,1,2,2,0.6,0.4,0.3333333333333333,0.6666666666666666
SF-O23,SF-H26,10,8,3,5,7,3,0.3,0.7,0.625,0.375
SF-O23,SF-H27-1,18,7,5,0,13,7,0.2777777777777778,0.7222222222222222,0.0,1.0
SF-O23,SF-F28-2,7,4,2,3,5,1,0.2857142857142857,0.7142857142857143,0.75,0.25
SF-O23,SF-G27,18,15,8,8,10,7,0.4444444444444444,0.5555555555555556,0.5333333333333333,0.4666666666666667
SF-O23,SF-M22-2,7,13,5,8,2,5,0.7142857142857143,0.2857142857142857,0.6153846153846154,0.38461538461538464
SF-O23,SF-L22,16,12,10,5,6,7,0.625,0.375,0.4166666666666667,0.5833333333333334
SF-O23,SF-F27,4,46,0,3,4,43,0.0,1.0,0.06521739130434782,0.9347826086956522
SF-O23,SF-N22-2,12,21,8,16,4,5,0.6666666666666666,0.3333333333333333,0.7619047619047619,0.23809523809523808
SF-O23,SF-G28-2,4,2,1,1,3,1,0.25,0.75,0.5,0.5
SF-O23,SF-G28-1,8,3,0,2,8,1,0.0,1.0,0.6666666666666666,0.3333333333333333
SF-O23,SF-M22-1,9,15,7,4,2,11,0.7777777777777778,0.2222222222222222,0.26666666666666666,0.7333333333333333
SF-O23,SF-O25-1,12,6,12,4,0,2,1.0,0.0,0.6666666666666666,0.3333333333333333
SF-O23,SF-K22-2,14,9,10,5,4,4,0.7142857142857143,0.2857142857142857,0.5555555555555556,0.4444444444444444
SF-O23,SF-K24,23,11,9,3,14,8,0.391304347826087,0.6086956521739131,0.2727272727272727,0.7272727272727273
SF-O23,SF-J23-2,5,9,2,5,3,4,0.4,0.6,0.5555555555555556,0.4444444444444444
SF-O23,SF-G23,5,4,2,1,3,3,0.4,0.6,0.25,0.75
SF-O23,SF-G24,11,9,1,1,10,8,0.09090909090909091,0.9090909090909091,0.1111111111111111,0.8888888888888888
SF-O23,SF-G25,12,8,7,4,5,4,0.5833333333333334,0.4166666666666667,0.5,0.5
SF-O23,SF-F23,9,9,3,3,6,6,0.3333333333333333,0.6666666666666666,0.3333333333333333,0.6666666666666666
SF-O23,SF-E23,13,18,3,2,10,16,0.23076923076923078,0.7692307692307693,0.1111111111111111,0.8888888888888888
SF-O23,SF-D24,3,2,2,0,1,2,0.6666666666666666,0.3333333333333333,0.0,1.0
SF-O23,SF-C22,3,7,0,0,3,7,0.0,1.0,0.0,1.0
SF-O23,SF-J17,10,10,4,1,6,9,0.4,0.6,0.1,0.9
SF-O23,SF-I19,11,1,3,0,8,1,0.2727272727272727,0.7272727272727273,0.0,1.0
SF-O23,SF-I20,5,5,3,0,2,5,0.6,0.4,0.0,1.0
SF-O23,SF-H20,3,1,2,0,1,1,0.6666666666666666,0.3333333333333333,0.0,1.0
SF-O23,SF-H18,1,1,0,0,1,1,0.0,1.0,0.0,1.0
SF-O23,SF-G19,2,3,1,1,1,2,0.5,0.5,0.3333333333333333,0.6666666666666666
SF-O23,SF-G17,2,1,1,0,1,1,0.5,0.5,0.0,1.0
SF-O23,SF-G18,3,2,1,0,2,2,0.3333333333333333,0.6666666666666666,0.0,1.0
SF-O23,SF-G20,9,9,3,4,6,5,0.3333333333333333,0.6666666666666666,0.4444444444444444,0.5555555555555556
SF-O23,SF-F19,3,7,0,2,3,5,0.0,1.0,0.2857142857142857,0.7142857142857143
SF-O23,SF-E20,3,13,1,0,2,13,0.3333333333333333,0.6666666666666666,0.0,1.0
SF-O23,SF-H30,4,3,0,1,4,2,0.0,1.0,0.3333333333333333,0.6666666666666666
SF-O23,SF-G30-2,31,21,9,2,22,19,0.2903225806451613,0.7096774193548387,0.09523809523809523,0.9047619047619048
SF-O23,SF-F30-1,5,2,2,0,3,2,0.4,0.6,0.0,1.0
SF-O23,SF-E29-2,11,7,4,4,7,3,0.36363636363636365,0.6363636363636364,0.5714285714285714,0.42857142857142855
SF-O23,SF-E29-1,3,6,1,4,2,2,0.3333333333333333,0.6666666666666666,0.6666666666666666,0.3333333333333333
SF-O23,SF-D29,1,1,0,1,1,0,0.0,1.0,1.0,0.0
SF-O23,SF-D28,2,2,1,0,1,2,0.5,0.5,0.0,1.0
SF-O23,SF-G29-2,85,103,1,4,84,99,0.011764705882352941,0.9882352941176471,0.038834951456310676,0.9611650485436893
SF-O23,SF-G30-1,4,4,1,1,3,3,0.25,0.75,0.25,0.75
SF-O23,SF-G29-3,23,2,1,1,22,1,0.043478260869565216,0.9565217391304348,0.5,0.5
SF-O23,SF-F30-2,5,12,0,0,5,12,0.0,1.0,0.0,1.0
SF-O23,SF-F29,2,3,0,0,2,3,0.0,1.0,0.0,1.0
SF-O23,SF-E29-3,3,16,0,0,3,16,0.0,1.0,0.0,1.0
SF-O23,SF-F28-1,3,13,1,0,2,13,0.3333333333333333,0.6666666666666666,0.0,1.0
SF-O23,SF-E28-2,1,2,0,1,1,1,0.0,1.0,0.5,0.5
SF-O23,SF-E28,2,1,0,1,2,0,0.0,1.0,1.0,0.0
SF-O23,SF-J13,3,1,0,0,3,1,0.0,1.0,0.0,1.0
SF-O23,SF-I16,1,3,0,0,1,3,0.0,1.0,0.0,1.0
SF-O23,SF-H12,2,1,0,0,2,1,0.0,1.0,0.0,1.0
SF-O23,SF-G10-2,1,2,0,0,1,2,0.0,1.0,0.0,1.0
SF-O23,SF-G13,18,1,18,1,0,0,1.0,0.0,1.0,0.0
SF-O23,SF-G10-1,2,1,0,1,2,0,0.0,1.0,1.0,0.0
SF-O23,SF-F15,5,1,0,0,5,1,0.0,1.0,0.0,1.0
SF-O23,SF-F16,2,2,0,0,2,2,0.0,1.0,0.0,1.0
SF-O23,SF-C21,2,6,0,0,2,6,0.0,1.0,0.0,1.0
SF-O23,SF-C20,1,1,0,0,1,1,0.0,1.0,0.0,1.0
SF-O23,SF-B19,3,2,1,1,2,1,0.3333333333333333,0.6666666666666666,0.5,0.5
SF-O23,SF-C26,2,4,1,0,1,4,0.5,0.5,0.0,1.0
SF-O23,SF-C25,15,7,4,1,11,6,0.26666666666666666,0.7333333333333333,0.14285714285714285,0.8571428571428571
SF-O23,SF-E27,3,9,1,1,2,8,0.3333333333333333,0.6666666666666666,0.1111111111111111,0.8888888888888888
SF-O23,SF-J1,7,6,6,4,1,2,0.8571428571428571,0.14285714285714285,0.6666666666666666,0.3333333333333333
SF-O23,SF-G5,1,2,0,0,1,2,0.0,1.0,0.0,1.0
SF-O23,SF-H25,4,4,3,3,1,1,0.75,0.25,0.75,0.25
SF-O23,SF-G26,7,6,3,2,4,4,0.42857142857142855,0.5714285714285714,0.3333333333333333,0.6666666666666666
SF-O23,SF-K21,6,4,2,0,4,4,0.3333333333333333,0.6666666666666666,0.0,1.0
SF-O23,SF-K22-1,12,10,8,8,4,2,0.6666666666666666,0.3333333333333333,0.8,0.2
SF-O23,SF-J23-1,31,31,15,6,16,25,0.4838709677419355,0.5161290322580645,0.1935483870967742,0.8064516129032258
SF-O23,SF-J22-1,9,12,3,6,6,6,0.3333333333333333,0.6666666666666666,0.5,0.5
SF-O23,SF-J22-2,2,5,1,0,1,5,0.5,0.5,0.0,1.0
SF-O23,SF-J21,5,6,1,2,4,4,0.2,0.8,0.3333333333333333,0.6666666666666666
SF-O23,SF-I21,1,3,1,3,0,0,1.0,0.0,1.0,0.0
SF-O23,SF-I22,9,3,4,0,5,3,0.4444444444444444,0.5555555555555556,0.0,1.0
SF-O23,SF-I23-2,4,4,1,3,3,1,0.25,0.75,0.75,0.25
SF-O23,SF-I23-1,4,7,2,5,2,2,0.5,0.5,0.7142857142857143,0.2857142857142857
SF-O23,SF-F26,9,12,2,3,7,9,0.2222222222222222,0.7777777777777778,0.25,0.75
SF-O23,SF-M13,16,12,4,0,12,12,0.25,0.75,0.0,1.0
SF-O23,SF-M15,11,9,5,1,6,8,0.45454545454545453,0.5454545454545454,0.1111111111111111,0.8888888888888888
SF-O23,SF-L19,16,27,4,5,12,22,0.25,0.75,0.18518518518518517,0.8148148148148148
SF-O23,SF-L20,25,10,12,4,13,6,0.48,0.52,0.4,0.6
SF-O23,SF-N20-1,48,37,11,15,37,22,0.22916666666666666,0.7708333333333334,0.40540540540540543,0.5945945945945946
SF-O23,SF-M20,29,22,16,5,13,17,0.5517241379310345,0.4482758620689655,0.22727272727272727,0.7727272727272727
SF-O23,SF-K17-2,7,4,2,1,5,3,0.2857142857142857,0.7142857142857143,0.25,0.75
SF-O23,SF-K20,26,8,10,1,16,7,0.38461538461538464,0.6153846153846154,0.125,0.875
SF-O23,SF-K15-,8,12,5,4,3,8,0.625,0.375,0.3333333333333333,0.6666666666666666
SF-O23,SF-K19,14,3,8,1,6,2,0.5714285714285714,0.42857142857142855,0.3333333333333333,0.6666666666666666
SF-O23,SF-K18,16,8,7,0,9,8,0.4375,0.5625,0.0,1.0
SF-O23,SF-K17,8,7,2,2,6,5,0.25,0.75,0.2857142857142857,0.7142857142857143
SF-O23,SF-J18,14,20,6,2,8,18,0.42857142857142855,0.5714285714285714,0.1,0.9
SF-O23,SF-J20,8,8,6,3,2,5,0.75,0.25,0.375,0.625
SF-O23,SF-J19,5,3,0,0,5,3,0.0,1.0,0.0,1.0
SF-O23,SF-M12,5,1,0,0,5,1,0.0,1.0,0.0,1.0
SF-O23,SF-M11,2,4,0,0,2,4,0.0,1.0,0.0,1.0
SF-O23,SF-R19,12,2,6,0,6,2,0.5,0.5,0.0,1.0
SF-O23,SF-R20,21,9,7,0,14,9,0.3333333333333333,0.6666666666666666,0.0,1.0
SF-O23,SF-Q21-2,13,7,3,0,10,7,0.23076923076923078,0.7692307692307693,0.0,1.0
SF-O23,SF-Q21-1,2,11,2,3,0,8,1.0,0.0,0.2727272727272727,0.7272727272727273
SF-O23,SF-P21,18,22,10,5,8,17,0.5555555555555556,0.4444444444444444,0.22727272727272727,0.7727272727272727
SF-O23,SF-O18,22,8,13,0,9,8,0.5909090909090909,0.4090909090909091,0.0,1.0
SF-O23,SF-O19,45,42,23,16,22,26,0.5111111111111111,0.4888888888888889,0.38095238095238093,0.6190476190476191
SF-O23,SF-O21,17,26,8,16,9,10,0.47058823529411764,0.5294117647058824,0.6153846153846154,0.38461538461538464
SF-O23,SF-O22,26,29,14,15,12,14,0.5384615384615384,0.46153846153846156,0.5172413793103449,0.4827586206896552
SF-O23,SF-N21,8,5,5,2,3,3,0.625,0.375,0.4,0.6
SF-O23,SF-N20-2,18,20,14,11,4,9,0.7777777777777778,0.2222222222222222,0.55,0.45
SF-O23,SF-M21,22,12,7,3,15,9,0.3181818181818182,0.6818181818181818,0.25,0.75
SF-O23,SF-L21,48,10,28,2,20,8,0.5833333333333334,0.4166666666666667,0.2,0.8
SF-O23,SF-Q30,4,8,1,1,3,7,0.25,0.75,0.125,0.875
SF-O23,SF-P30,12,8,2,5,10,3,0.16666666666666666,0.8333333333333334,0.625,0.375
SF-O23,SF-O30-2,12,13,2,1,10,12,0.16666666666666666,0.8333333333333334,0.07692307692307693,0.9230769230769231
SF-O23,SF-O30,128,85,108,72,20,13,0.84375,0.15625,0.8470588235294118,0.15294117647058825
SF-O23,SF-N27,18,19,5,10,13,9,0.2777777777777778,0.7222222222222222,0.5263157894736842,0.47368421052631576
SF-O23,SF-N29,9,5,4,3,5,2,0.4444444444444444,0.5555555555555556,0.6,0.4
SF-O23,SF-N28,32,22,11,8,21,14,0.34375,0.65625,0.36363636363636365,0.6363636363636364
SF-O23,SF-L30-1,52,56,47,48,5,8,0.9038461538461539,0.09615384615384616,0.8571428571428571,0.14285714285714285
SF-O23,SF-L31-1,4,2,1,0,3,2,0.25,0.75,0.0,1.0
SF-O23,SF-K30-2,9,15,3,3,6,12,0.3333333333333333,0.6666666666666666,0.2,0.8
SF-O23,SF-I30,8,12,6,9,2,3,0.75,0.25,0.75,0.25
SF-O23,SF-I29-2,12,16,0,0,12,16,0.0,1.0,0.0,1.0
SF-O23,SF-I27,7,16,2,14,5,2,0.2857142857142857,0.7142857142857143,0.875,0.125
SF-O23,SF-I28,2,2,0,1,2,1,0.0,1.0,0.5,0.5
SF-O23,SF-I30-2,1,4,0,1,1,3,0.0,1.0,0.25,0.75
SF-O23,SF-H28,8,12,3,6,5,6,0.375,0.625,0.5,0.5
SF-O23,SF-H29,3,4,0,0,3,4,0.0,1.0,0.0,1.0
SF-O23,SF-S24,54,44,15,21,39,23,0.2777777777777778,0.7222222222222222,0.4772727272727273,0.5227272727272727
SF-O23,SF-R24,30,36,22,24,8,12,0.7333333333333333,0.26666666666666666,0.6666666666666666,0.3333333333333333
SF-O23,SF-R26,4,10,0,5,4,5,0.0,1.0,0.5,0.5
SF-O23,SF-Q26,11,12,3,4,8,8,0.2727272727272727,0.7272727272727273,0.3333333333333333,0.6666666666666666
SF-O23,SF-P26,23,26,10,13,13,13,0.43478260869565216,0.5652173913043478,0.5,0.5
SF-O23,SF-O25-2,14,14,9,9,5,5,0.6428571428571429,0.35714285714285715,0.6428571428571429,0.35714285714285715
SF-O23,SF-N22-1B,14,16,8,13,6,3,0.5714285714285714,0.42857142857142855,0.8125,0.1875
SF-O23,SF-N26,10,9,6,1,4,8,0.6,0.4,0.1111111111111111,0.8888888888888888
SF-O23,SF-N25,10,5,8,4,2,1,0.8,0.2,0.8,0.2
SF-O23,SF-T21,1,9,1,1,0,8,1.0,0.0,0.1111111111111111,0.8888888888888888
SF-O23,SF-T22,34,32,13,12,21,20,0.38235294117647056,0.6176470588235294,0.375,0.625
SF-O23,SF-S22-2,7,3,4,0,3,3,0.5714285714285714,0.42857142857142855,0.0,1.0
SF-O23,SF-S22-1,18,26,10,17,8,9,0.5555555555555556,0.4444444444444444,0.6538461538461539,0.34615384615384615
SF-O23,SF-Q23-3,22,14,16,6,6,8,0.7272727272727273,0.2727272727272727,0.42857142857142855,0.5714285714285714
SF-O23,SF-Q22-1,9,8,6,4,3,4,0.6666666666666666,0.3333333333333333,0.5,0.5
SF-O23,SF-Q22-2,24,17,16,11,8,6,0.6666666666666666,0.3333333333333333,0.6470588235294118,0.35294117647058826
SF-O23,SF-P22,12,12,6,8,6,4,0.5,0.5,0.6666666666666666,0.3333333333333333
SF-O23,SF-U21,3,5,0,0,3,5,0.0,1.0,0.0,1.0
SF-O23,SF-T20,14,8,5,2,9,6,0.35714285714285715,0.6428571428571429,0.25,0.75
SF-O23,SF-S21,2,4,1,0,1,4,0.5,0.5,0.0,1.0
SF-O23,SF-V28,1,3,0,2,1,1,0.0,1.0,0.6666666666666666,0.3333333333333333
SF-H27-1,SF-M26,5,5,5,4,0,1,1.0,0.0,0.8,0.2
SF-H27-1,SF-M25,2,2,0,0,2,2,0.0,1.0,0.0,1.0
SF-H27-1,SF-M26-2,15,21,15,19,0,2,1.0,0.0,0.9047619047619048,0.09523809523809523
SF-H27-1,SF-L27,6,5,4,3,2,2,0.6666666666666666,0.3333333333333333,0.6,0.4
SF-H27-1,SF-K26,4,4,3,3,1,1,0.75,0.25,0.75,0.25
SF-H27-1,SF-J27,6,12,1,5,5,7,0.16666666666666666,0.8333333333333334,0.4166666666666667,0.5833333333333334
SF-H27-1,SF-M30,16,9,10,8,6,1,0.625,0.375,0.8888888888888888,0.1111111111111111
SF-H27-1,SF-L27-2,3,5,2,1,1,4,0.6666666666666666,0.3333333333333333,0.2,0.8
SF-H27-1,SF-J29-3,10,19,7,15,3,4,0.7,0.3,0.7894736842105263,0.21052631578947367
SF-H27-1,SF-J29,28,38,19,27,9,11,0.6785714285714286,0.32142857142857145,0.7105263157894737,0.2894736842105263
SF-H27-1,SF-L26,3,1,2,0,1,1,0.6666666666666666,0.3333333333333333,0.0,1.0
SF-H27-1,SF-M28,15,10,5,4,10,6,0.3333333333333333,0.6666666666666666,0.4,0.6
SF-H27-1,SF-M27,3,2,2,2,1,0,0.6666666666666666,0.3333333333333333,1.0,0.0
SF-H27-1,SF-L25,4,12,4,10,0,2,1.0,0.0,0.8333333333333334,0.16666666666666666
SF-H27-1,SF-M24,8,8,3,7,5,1,0.375,0.625,0.875,0.125
SF-H27-1,SF-L24,21,13,14,9,7,4,0.6666666666666666,0.3333333333333333,0.6923076923076923,0.3076923076923077
SF-H27-1,SF-N23,9,21,5,15,4,6,0.5555555555555556,0.4444444444444444,0.7142857142857143,0.2857142857142857
SF-H27-1,SF-N24-2,10,6,0,1,10,5,0.0,1.0,0.16666666666666666,0.8333333333333334
SF-H27-1,SF-K27-2,17,10,8,6,9,4,0.47058823529411764,0.5294117647058824,0.6,0.4
SF-H27-1,SF-J26-2,18,14,11,9,7,5,0.6111111111111112,0.3888888888888889,0.6428571428571429,0.35714285714285715
SF-H27-1,SF-K28-3,1,1,1,0,0,1,1.0,0.0,0.0,1.0
SF-H27-1,SF-L28,11,20,7,14,4,6,0.6363636363636364,0.36363636363636365,0.7,0.3
SF-H27-1,SF-K29-1,40,25,20,12,20,13,0.5,0.5,0.48,0.52
SF-H27-1,SF-J28-2,8,8,4,6,4,2,0.5,0.5,0.75,0.25
SF-H27-1,SF-K25,30,19,15,14,15,5,0.5,0.5,0.7368421052631579,0.2631578947368421
SF-H27-1,SF-J25,23,79,15,63,8,16,0.6521739130434783,0.34782608695652173,0.7974683544303798,0.20253164556962025
SF-H27-1,SF-H26-2,8,7,8,6,0,1,1.0,0.0,0.8571428571428571,0.14285714285714285
SF-H27-1,SF-P24,3,11,1,11,2,0,0.3333333333333333,0.6666666666666666,1.0,0.0
SF-H27-1,SF-J24,12,16,2,11,10,5,0.16666666666666666,0.8333333333333334,0.6875,0.3125
SF-H27-1,SF-O24,9,11,1,6,8,5,0.1111111111111111,0.8888888888888888,0.5454545454545454,0.45454545454545453
SF-H27-1,SF-J26,11,7,9,6,2,1,0.8181818181818182,0.18181818181818182,0.8571428571428571,0.14285714285714285
SF-H27-1,SF-I26-,14,33,9,24,5,9,0.6428571428571429,0.35714285714285715,0.7272727272727273,0.2727272727272727
SF-H27-1,SF-I25,13,6,7,2,6,4,0.5384615384615384,0.46153846153846156,0.3333333333333333,0.6666666666666666
SF-H27-1,SF-H26,25,23,23,17,2,6,0.92,0.08,0.7391304347826086,0.2608695652173913
SF-H27-1,SF-O23,7,18,0,5,7,13,0.0,1.0,0.2777777777777778,0.7222222222222222
SF-H27-1,SF-F28-2,39,17,26,10,13,7,0.6666666666666666,0.3333333333333333,0.5882352941176471,0.4117647058823529
SF-H27-1,SF-G27,33,29,14,17,19,12,0.42424242424242425,0.5757575757575758,0.5862068965517241,0.41379310344827586
SF-H27-1,SF-M22-2,2,10,0,4,2,6,0.0,1.0,0.4,0.6
SF-H27-1,SF-L22,7,4,3,2,4,2,0.42857142857142855,0.5714285714285714,0.5,0.5
SF-H27-1,SF-F27,11,19,6,15,5,4,0.5454545454545454,0.45454545454545453,0.7894736842105263,0.21052631578947367
SF-H27-1,SF-N22-2,3,15,1,12,2,3,0.3333333333333333,0.6666666666666666,0.8,0.2
SF-H27-1,SF-G28-2,14,6,8,4,6,2,0.5714285714285714,0.42857142857142855,0.6666666666666666,0.3333333333333333
SF-H27-1,SF-G28-1,18,9,14,8,4,1,0.7777777777777778,0.2222222222222222,0.8888888888888888,0.1111111111111111
SF-H27-1,SF-M22-1,6,5,3,3,3,2,0.5,0.5,0.6,0.4
SF-H27-1,SF-K22-2,4,5,1,2,3,3,0.25,0.75,0.4,0.6
SF-H27-1,SF-K24,10,25,8,14,2,11,0.8,0.2,0.56,0.44
SF-H27-1,SF-J23-2,3,6,1,1,2,5,0.3333333333333333,0.6666666666666666,0.16666666666666666,0.8333333333333334
SF-H27-1,SF-G23,3,4,1,4,2,0,0.3333333333333333,0.6666666666666666,1.0,0.0
SF-H27-1,SF-G24,14,2,8,1,6,1,0.5714285714285714,0.42857142857142855,0.5,0.5
SF-H27-1,SF-G25,9,6,6,2,3,4,0.6666666666666666,0.3333333333333333,0.3333333333333333,0.6666666666666666
SF-H27-1,SF-F23,3,8,0,2,3,6,0.0,1.0,0.25,0.75
SF-H27-1,SF-E23,6,4,1,1,5,3,0.16666666666666666,0.8333333333333334,0.25,0.75
SF-H27-1,SF-C22,3,1,1,0,2,1,0.3333333333333333,0.6666666666666666,0.0,1.0
SF-H27-1,SF-B22,6,7,1,5,5,2,0.16666666666666666,0.8333333333333334,0.7142857142857143,0.2857142857142857
SF-H27-1,SF-J17,1,2,0,0,1,2,0.0,1.0,0.0,1.0
SF-H27-1,SF-I20,5,1,4,1,1,0,0.8,0.2,1.0,0.0
SF-H27-1,SF-H20,3,4,1,3,2,1,0.3333333333333333,0.6666666666666666,0.75,0.25
SF-H27-1,SF-G18,3,3,0,0,3,3,0.0,1.0,0.0,1.0
SF-H27-1,SF-G20,1,4,0,2,1,2,0.0,1.0,0.5,0.5
SF-H27-1,SF-E18,3,1,1,0,2,1,0.3333333333333333,0.6666666666666666,0.0,1.0
SF-H27-1,SF-H30,10,4,6,4,4,0,0.6,0.4,1.0,0.0
SF-H27-1,SF-G30-2,16,14,10,10,6,4,0.625,0.375,0.7142857142857143,0.2857142857142857
SF-H27-1,SF-F30-1,14,14,4,5,10,9,0.2857142857142857,0.7142857142857143,0.35714285714285715,0.6428571428571429
SF-H27-1,SF-E29-2,9,13,5,8,4,5,0.5555555555555556,0.4444444444444444,0.6153846153846154,0.38461538461538464
SF-H27-1,SF-E29-1,10,20,6,15,4,5,0.6,0.4,0.75,0.25
SF-H27-1,SF-D29,4,8,3,6,1,2,0.75,0.25,0.75,0.25
SF-H27-1,SF-D28,5,6,3,4,2,2,0.6,0.4,0.6666666666666666,0.3333333333333333
SF-H27-1,SF-A27,18,14,14,12,4,2,0.7777777777777778,0.2222222222222222,0.8571428571428571,0.14285714285714285
SF-H27-1,SF-G29-2,39,42,32,28,7,14,0.8205128205128205,0.1794871794871795,0.6666666666666666,0.3333333333333333
SF-H27-1,SF-G29-1,15,10,12,7,3,3,0.8,0.2,0.7,0.3
SF-H27-1,SF-G30-1,50,27,38,18,12,9,0.76,0.24,0.6666666666666666,0.3333333333333333
SF-H27-1,SF-G29-3,12,6,9,4,3,2,0.75,0.25,0.6666666666666666,0.3333333333333333
SF-H27-1,SF-F30-2,5,5,3,3,2,2,0.6,0.4,0.6,0.4
SF-H27-1,SF-F29,38,20,30,12,8,8,0.7894736842105263,0.21052631578947367,0.6,0.4
SF-H27-1,SF-E29-3,5,7,3,7,2,0,0.6,0.4,1.0,0.0
SF-H27-1,SF-F28-1,8,3,5,1,3,2,0.625,0.375,0.3333333333333333,0.6666666666666666
SF-H27-1,SF-E28-2,3,1,3,1,0,0,1.0,0.0,1.0,0.0
SF-H27-1,SF-E28,6,2,2,2,4,0,0.3333333333333333,0.6666666666666666,1.0,0.0
SF-H27-1,SF-B21,1,1,0,0,1,1,0.0,1.0,0.0,1.0
SF-H27-1,SF-B19,1,1,1,0,0,1,1.0,0.0,0.0,1.0
SF-H27-1,SF-A20,1,2,1,0,0,2,1.0,0.0,0.0,1.0
SF-H27-1,SF-C26,11,7,3,3,8,4,0.2727272727272727,0.7272727272727273,0.42857142857142855,0.5714285714285714
SF-H27-1,SF-C25,19,12,3,3,16,9,0.15789473684210525,0.8421052631578947,0.25,0.75
SF-H27-1,SF-B25,3,16,0,12,3,4,0.0,1.0,0.75,0.25
SF-H27-1,SF-E27,2,5,2,3,0,2,1.0,0.0,0.6,0.4
SF-H27-1,SF-D27,13,17,7,7,6,10,0.5384615384615384,0.46153846153846156,0.4117647058823529,0.5882352941176471
SF-H27-1,SF-B28,5,14,2,11,3,3,0.4,0.6,0.7857142857142857,0.21428571428571427
SF-H27-1,SF-J1,2,1,0,0,2,1,0.0,1.0,0.0,1.0
SF-H27-1,SF-J5,4,1,0,0,4,1,0.0,1.0,0.0,1.0
SF-H27-1,SF-H25,7,37,1,15,6,22,0.14285714285714285,0.8571428571428571,0.40540540540540543,0.5945945945945946
SF-H27-1,SF-G26,9,7,1,4,8,3,0.1111111111111111,0.8888888888888888,0.5714285714285714,0.42857142857142855
SF-H27-1,SF-K21,6,2,1,0,5,2,0.16666666666666666,0.8333333333333334,0.0,1.0
SF-H27-1,SF-K22-1,2,8,1,7,1,1,0.5,0.5,0.875,0.125
SF-H27-1,SF-J23-1,35,18,19,6,16,12,0.5428571428571428,0.45714285714285713,0.3333333333333333,0.6666666666666666
SF-H27-1,SF-J22-1,4,5,2,3,2,2,0.5,0.5,0.6,0.4
SF-H27-1,SF-J22-2,5,9,4,2,1,7,0.8,0.2,0.2222222222222222,0.7777777777777778
SF-H27-1,SF-J21,8,9,6,3,2,6,0.75,0.25,0.3333333333333333,0.6666666666666666
SF-H27-1,SF-I21,2,1,0,1,2,0,0.0,1.0,1.0,0.0
SF-H27-1,SF-I23-2,2,6,1,4,1,2,0.5,0.5,0.6666666666666666,0.3333333333333333
SF-H27-1,SF-I23-1,11,11,7,3,4,8,0.6363636363636364,0.36363636363636365,0.2727272727272727,0.7272727272727273
SF-H27-1,SF-F26,20,15,14,10,6,5,0.7,0.3,0.6666666666666666,0.3333333333333333
SF-H27-1,SF-M15,1,3,0,1,1,2,0.0,1.0,0.3333333333333333,0.6666666666666666
SF-H27-1,SF-L19,4,6,0,0,4,6,0.0,1.0,0.0,1.0
SF-H27-1,SF-L20,2,5,1,1,1,4,0.5,0.5,0.2,0.8
SF-H27-1,SF-N20-1,6,2,0,0,6,2,0.0,1.0,0.0,1.0
SF-H27-1,SF-M20,4,10,2,0,2,10,0.5,0.5,0.0,1.0
SF-H27-1,SF-K17-2,3,5,1,1,2,4,0.3333333333333333,0.6666666666666666,0.2,0.8
SF-H27-1,SF-K20,4,4,3,3,1,1,0.75,0.25,0.75,0.25
SF-H27-1,SF-K15-,4,1,1,1,3,0,0.25,0.75,1.0,0.0
SF-H27-1,SF-K19,3,2,2,0,1,2,0.6666666666666666,0.3333333333333333,0.0,1.0
SF-H27-1,SF-K18,4,3,0,1,4,2,0.0,1.0,0.3333333333333333,0.6666666666666666
SF-H27-1,SF-K17,2,3,0,0,2,3,0.0,1.0,0.0,1.0
SF-H27-1,SF-J20,4,3,3,2,1,1,0.75,0.25,0.6666666666666666,0.3333333333333333
SF-H27-1,SF-J19,3,5,1,1,2,4,0.3333333333333333,0.6666666666666666,0.2,0.8
SF-H27-1,SF-M11,1,1,0,0,1,1,0.0,1.0,0.0,1.0
SF-H27-1,SF-Q21-1,1,4,0,3,1,1,0.0,1.0,0.75,0.25
SF-H27-1,SF-O18,4,3,0,1,4,2,0.0,1.0,0.3333333333333333,0.6666666666666666
SF-H27-1,SF-O19,2,4,1,1,1,3,0.5,0.5,0.25,0.75
SF-H27-1,SF-O21,6,10,4,3,2,7,0.6666666666666666,0.3333333333333333,0.3,0.7
SF-H27-1,SF-O22,8,27,4,16,4,11,0.5,0.5,0.5925925925925926,0.4074074074074074
SF-H27-1,SF-N21,6,3,3,1,3,2,0.5,0.5,0.3333333333333333,0.6666666666666666
SF-H27-1,SF-N20-2,2,4,1,1,1,3,0.5,0.5,0.25,0.75
SF-H27-1,SF-M21,2,3,2,2,0,1,1.0,0.0,0.6666666666666666,0.3333333333333333
SF-H27-1,SF-L21,12,7,5,0,7,7,0.4166666666666667,0.5833333333333334,0.0,1.0
SF-H27-1,SF-S29,1,1,0,0,1,1,0.0,1.0,0.0,1.0
SF-H27-1,SF-Q30,16,11,5,6,11,5,0.3125,0.6875,0.5454545454545454,0.45454545454545453
SF-H27-1,SF-P30,11,8,3,4,8,4,0.2727272727272727,0.7272727272727273,0.5,0.5
SF-H27-1,SF-O30-2,8,5,3,3,5,2,0.375,0.625,0.6,0.4
SF-H27-1,SF-O30,16,15,7,8,9,7,0.4375,0.5625,0.5333333333333333,0.4666666666666667
SF-H27-1,SF-N27,9,8,8,5,1,3,0.8888888888888888,0.1111111111111111,0.625,0.375
SF-H27-1,SF-N29,6,25,1,6,5,19,0.16666666666666666,0.8333333333333334,0.24,0.76
SF-H27-1,SF-N28,19,13,18,12,1,1,0.9473684210526315,0.05263157894736842,0.9230769230769231,0.07692307692307693
SF-H27-1,SF-L30-1,37,32,25,22,12,10,0.6756756756756757,0.32432432432432434,0.6875,0.3125
SF-H27-1,SF-L31-1,7,6,4,5,3,1,0.5714285714285714,0.42857142857142855,0.8333333333333334,0.16666666666666666
SF-H27-1,SF-K30-2,9,6,7,1,2,5,0.7777777777777778,0.2222222222222222,0.16666666666666666,0.8333333333333334
SF-H27-1,SF-L29,29,34,18,18,11,16,0.6206896551724138,0.3793103448275862,0.5294117647058824,0.47058823529411764
SF-H27-1,SF-J29-1,33,21,18,15,15,6,0.5454545454545454,0.45454545454545453,0.7142857142857143,0.2857142857142857
SF-H27-1,SF-I30,35,38,10,13,25,25,0.2857142857142857,0.7142857142857143,0.34210526315789475,0.6578947368421053
SF-H27-1,SF-I29-2,9,10,6,8,3,2,0.6666666666666666,0.3333333333333333,0.8,0.2
SF-H27-1,SF-I27,18,12,13,6,5,6,0.7222222222222222,0.2777777777777778,0.5,0.5
SF-H27-1,SF-I28,6,10,5,9,1,1,0.8333333333333334,0.16666666666666666,0.9,0.1
SF-H27-1,SF-I30-2,75,52,58,46,17,6,0.7733333333333333,0.22666666666666666,0.8846153846153846,0.11538461538461539
SF-H27-1,SF I29-1,20,6,11,4,9,2,0.55,0.45,0.6666666666666666,0.3333333333333333
SF-H27-1,SF-H28,43,37,39,29,4,8,0.9069767441860465,0.09302325581395349,0.7837837837837838,0.21621621621621623
SF-H27-1,SF-H29,3,2,2,1,1,1,0.6666666666666666,0.3333333333333333,0.5,0.5
SF-H27-1,SF-S24,5,5,1,2,4,3,0.2,0.8,0.4,0.6
SF-H27-1,SF-R24,2,10,1,3,1,7,0.5,0.5,0.3,0.7
SF-H27-1,SF-R26,3,1,1,1,2,0,0.3333333333333333,0.6666666666666666,1.0,0.0
SF-H27-1,SF-Q26,10,3,5,3,5,0,0.5,0.5,1.0,0.0
SF-H27-1,SF-N22-1B,2,1,2,0,0,1,1.0,0.0,0.0,1.0
SF-H27-1,SF-N26,2,1,0,0,2,1,0.0,1.0,0.0,1.0
SF-H27-1,SF-T21,1,2,0,0,1,2,0.0,1.0,0.0,1.0
SF-H27-1,SF-T22,5,2,0,1,5,1,0.0,1.0,0.5,0.5
SF-H27-1,SF-S22-1,2,1,2,0,0,1,1.0,0.0,0.0,1.0
SF-H27-1,SF-Q22-1,4,9,0,2,4,7,0.0,1.0,0.2222222222222222,0.7777777777777778
SF-H27-1,SF-Q22-2,3,6,1,0,2,6,0.3333333333333333,0.6666666666666666,0.0,1.0
SF-H27-1,SF-P22,6,4,1,1,5,3,0.16666666666666666,0.8333333333333334,0.25,0.75
SF-H27-1,SF-W19,10,2,0,0,10,2,0.0,1.0,0.0,1.0
SF-H27-1,SF-Y29,1,1,1,1,0,0,1.0,0.0,1.0,0.0
SF-H27-1,SF-X30,1,1,1,1,0,0,1.0,0.0,1.0,0.0
SF-H27-1,SF-V30,1,3,1,0,0,3,1.0,0.0,0.0,1.0
SF-F28-2,SF-M26,2,3,0,1,2,2,0.0,1.0,0.3333333333333333,0.6666666666666666
SF-F28-2,SF-M25,3,1,1,0,2,1,0.3333333333333333,0.6666666666666666,0.0,1.0
SF-F28-2,SF-M26-2,3,3,0,2,3,1,0.0,1.0,0.6666666666666666,0.3333333333333333
SF-F28-2,SF-L27,13,5,2,2,11,3,0.15384615384615385,0.8461538461538461,0.4,0.6
SF-F28-2,SF-K26,10,5,1,1,9,4,0.1,0.9,0.2,0.8
SF-F28-2,SF-J27,12,6,5,4,7,2,0.4166666666666667,0.5833333333333334,0.6666666666666666,0.3333333333333333
SF-F28-2,SF-M30,41,13,4,5,37,8,0.0975609756097561,0.9024390243902439,0.38461538461538464,0.6153846153846154
SF-F28-2,SF-L27-2,9,2,2,1,7,1,0.2222222222222222,0.7777777777777778,0.5,0.5
SF-F28-2,SF-J29-3,5,8,4,6,1,2,0.8,0.2,0.75,0.25
SF-F28-2,SF-J29,20,29,3,15,17,14,0.15,0.85,0.5172413793103449,0.4827586206896552
SF-F28-2,SF-L26,1,2,0,0,1,2,0.0,1.0,0.0,1.0
SF-F28-2,SF-M28,9,11,1,2,8,9,0.1111111111111111,0.8888888888888888,0.18181818181818182,0.8181818181818182
SF-F28-2,SF-L25,4,4,2,3,2,1,0.5,0.5,0.75,0.25
SF-F28-2,SF-M24,6,7,3,3,3,4,0.5,0.5,0.42857142857142855,0.5714285714285714
SF-F28-2,SF-L24,3,6,0,3,3,3,0.0,1.0,0.5,0.5
SF-F28-2,SF-N23,9,10,2,2,7,8,0.2222222222222222,0.7777777777777778,0.2,0.8
SF-F28-2,SF-N24-2,2,1,0,0,2,1,0.0,1.0,0.0,1.0
SF-F28-2,SF-K27-2,15,12,4,4,11,8,0.26666666666666666,0.7333333333333333,0.3333333333333333,0.6666666666666666
SF-F28-2,SF-J26-2,24,9,6,4,18,5,0.25,0.75,0.4444444444444444,0.5555555555555556
SF-F28-2,SF-L28,9,3,4,3,5,0,0.4444444444444444,0.5555555555555556,1.0,0.0
SF-F28-2,SF-K28,6,7,3,0,3,7,0.5,0.5,0.0,1.0
SF-F28-2,SF-K29-1,39,35,13,16,26,19,0.3333333333333333,0.6666666666666666,0.45714285714285713,0.5428571428571428
SF-F28-2,SF-J28-2,11,13,8,3,3,10,0.7272727272727273,0.2727272727272727,0.23076923076923078,0.7692307692307693
SF-F28-2,SF-K27,1,3,0,2,1,1,0.0,1.0,0.6666666666666666,0.3333333333333333
SF-F28-2,SF-K25,9,12,2,4,7,8,0.2222222222222222,0.7777777777777778,0.3333333333333333,0.6666666666666666
SF-F28-2,SF-J25,24,49,9,11,15,38,0.375,0.625,0.22448979591836735,0.7755102040816326
SF-F28-2,SF-H26-2,68,16,26,5,42,11,0.38235294117647056,0.6176470588235294,0.3125,0.6875
SF-F28-2,SF-P24,21,25,10,12,11,13,0.47619047619047616,0.5238095238095238,0.48,0.52
SF-F28-2,SF-J24,15,15,13,13,2,2,0.8666666666666667,0.13333333333333333,0.8666666666666667,0.13333333333333333
SF-F28-2,SF-O24,5,6,3,4,2,2,0.6,0.4,0.6666666666666666,0.3333333333333333
SF-F28-2,SF-J26,12,5,5,2,7,3,0.4166666666666667,0.5833333333333334,0.4,0.6
SF-F28-2,SF-I26-,8,19,5,4,3,15,0.625,0.375,0.21052631578947367,0.7894736842105263
SF-F28-2,SF-I25,76,48,51,27,25,21,0.6710526315789473,0.32894736842105265,0.5625,0.4375
SF-F28-2,SF-K23,6,1,1,0,5,1,0.16666666666666666,0.8333333333333334,0.0,1.0
SF-F28-2,SF-H26,88,88,59,54,29,34,0.6704545454545454,0.32954545454545453,0.6136363636363636,0.38636363636363635
SF-F28-2,SF-O23,4,7,3,2,1,5,0.75,0.25,0.2857142857142857,0.7142857142857143
SF-F28-2,SF-H27-1,17,39,10,26,7,13,0.5882352941176471,0.4117647058823529,0.6666666666666666,0.3333333333333333
SF-F28-2,SF-G27,141,134,86,83,55,51,0.6099290780141844,0.3900709219858156,0.6194029850746269,0.3805970149253731
SF-F28-2,SF-M22-2,14,13,6,3,8,10,0.42857142857142855,0.5714285714285714,0.23076923076923078,0.7692307692307693
SF-F28-2,SF-L22,27,14,16,6,11,8,0.5925925925925926,0.4074074074074074,0.42857142857142855,0.5714285714285714
SF-F28-2,SF-F27,65,61,38,46,27,15,0.5846153846153846,0.4153846153846154,0.7540983606557377,0.2459016393442623
SF-F28-2,SF-N22-2,33,27,10,7,23,20,0.30303030303030304,0.696969696969697,0.25925925925925924,0.7407407407407407
SF-F28-2,SF-G28-2,5,5,3,4,2,1,0.6,0.4,0.8,0.2
SF-F28-2,SF-G28-1,18,11,12,7,6,4,0.6666666666666666,0.3333333333333333,0.6363636363636364,0.36363636363636365
SF-F28-2,SF-M22-1,6,7,2,5,4,2,0.3333333333333333,0.6666666666666666,0.7142857142857143,0.2857142857142857
SF-F28-2,SF-O25-1,1,1,0,0,1,1,0.0,1.0,0.0,1.0
SF-F28-2,SF-K22-2,37,9,10,3,27,6,0.2702702702702703,0.7297297297297297,0.3333333333333333,0.6666666666666666
SF-F28-2,SF-K24,27,22,4,4,23,18,0.14814814814814814,0.8518518518518519,0.18181818181818182,0.8181818181818182
SF-F28-2,SF-J23-2,12,8,5,5,7,3,0.4166666666666667,0.5833333333333334,0.625,0.375
SF-F28-2,SF-G23,16,5,11,1,5,4,0.6875,0.3125,0.2,0.8
SF-F28-2,SF-G24,68,34,27,5,41,29,0.39705882352941174,0.6029411764705882,0.14705882352941177,0.8529411764705882
SF-F28-2,SF-G25,51,24,47,4,4,20,0.9215686274509803,0.0784313725490196,0.16666666666666666,0.8333333333333334
SF-F28-2,SF-F23,84,19,66,3,18,16,0.7857142857142857,0.21428571428571427,0.15789473684210525,0.8421052631578947
SF-F28-2,SF-E23,15,26,5,2,10,24,0.3333333333333333,0.6666666666666666,0.07692307692307693,0.9230769230769231
SF-F28-2,SF-D24,16,4,4,1,12,3,0.25,0.75,0.25,0.75
SF-F28-2,SF-C22,1,6,1,0,0,6,1.0,0.0,0.0,1.0
SF-F28-2,SF-B22,76,40,8,13,68,27,0.10526315789473684,0.8947368421052632,0.325,0.675
SF-F28-2,SF-J17,20,20,4,1,16,19,0.2,0.8,0.05,0.95
SF-F28-2,SF-I19,8,3,4,1,4,2,0.5,0.5,0.3333333333333333,0.6666666666666666
SF-F28-2,SF-H16,7,2,0,0,7,2,0.0,1.0,0.0,1.0
SF-F28-2,SF-H19,5,1,4,1,1,0,0.8,0.2,1.0,0.0
SF-F28-2,SF-H20,8,8,5,5,3,3,0.625,0.375,0.625,0.375
SF-F28-2,SF-G19,3,2,0,1,3,1,0.0,1.0,0.5,0.5
SF-F28-2,SF-G17,2,1,0,0,2,1,0.0,1.0,0.0,1.0
SF-F28-2,SF-G18,10,6,9,0,1,6,0.9,0.1,0.0,1.0
SF-F28-2,SF-G20,12,16,11,7,1,9,0.9166666666666666,0.08333333333333333,0.4375,0.5625
SF-F28-2,SF-F19,8,10,2,0,6,10,0.25,0.75,0.0,1.0
SF-F28-2,SF-E18,11,4,2,0,9,4,0.18181818181818182,0.8181818181818182,0.0,1.0
SF-F28-2,SF-E20,3,3,1,0,2,3,0.3333333333333333,0.6666666666666666,0.0,1.0
SF-F28-2,SF-H30,17,9,13,7,4,2,0.7647058823529411,0.23529411764705882,0.7777777777777778,0.2222222222222222
SF-F28-2,SF-G30-2,40,31,24,16,16,15,0.6,0.4,0.5161290322580645,0.4838709677419355
SF-F28-2,SF-F30-1,10,11,7,9,3,2,0.7,0.3,0.8181818181818182,0.18181818181818182
SF-F28-2,SF-E29-2,64,97,49,79,15,18,0.765625,0.234375,0.8144329896907216,0.18556701030927836
SF-F28-2,SF-E29-1,50,41,27,29,23,12,0.54,0.46,0.7073170731707317,0.2926829268292683
SF-F28-2,SF-D29,44,28,37,16,7,12,0.8409090909090909,0.1590909090909091,0.5714285714285714,0.42857142857142855
SF-F28-2,SF-D28,33,30,25,16,8,14,0.7575757575757576,0.24242424242424243,0.5333333333333333,0.4666666666666667
SF-F28-2,SF-A27,48,31,35,22,13,9,0.7291666666666666,0.2708333333333333,0.7096774193548387,0.2903225806451613
SF-F28-2,SF-G29-2,72,41,42,29,30,12,0.5833333333333334,0.4166666666666667,0.7073170731707317,0.2926829268292683
SF-F28-2,SF-G29-1,40,38,30,32,10,6,0.75,0.25,0.8421052631578947,0.15789473684210525
SF-F28-2,SF-G30-1,50,40,29,25,21,15,0.58,0.42,0.625,0.375
SF-F28-2,SF-G29-3,47,38,24,27,23,11,0.5106382978723404,0.48936170212765956,0.7105263157894737,0.2894736842105263
SF-F28-2,SF-F30-2,26,14,20,11,6,3,0.7692307692307693,0.23076923076923078,0.7857142857142857,0.21428571428571427
SF-F28-2,SF-F29,40,19,15,9,25,10,0.375,0.625,0.47368421052631576,0.5263157894736842
SF-F28-2,SF-E29-3,40,29,23,18,17,11,0.575,0.425,0.6206896551724138,0.3793103448275862
SF-F28-2,SF-F28-1,83,54,61,29,22,25,0.7349397590361446,0.26506024096385544,0.5370370370370371,0.46296296296296297
SF-F28-2,SF-E28-2,18,14,16,9,2,5,0.8888888888888888,0.1111111111111111,0.6428571428571429,0.35714285714285715
SF-F28-2,SF-E28,33,15,25,8,8,7,0.7575757575757576,0.24242424242424243,0.5333333333333333,0.4666666666666667
SF-F28-2,SF-J12,2,7,1,0,1,7,0.5,0.5,0.0,1.0
SF-F28-2,SF-J13,2,2,0,1,2,1,0.0,1.0,0.5,0.5
SF-F28-2,SF-H12,1,1,0,0,1,1,0.0,1.0,0.0,1.0
SF-F28-2,SF-H15,4,1,0,0,4,1,0.0,1.0,0.0,1.0
SF-F28-2,SF-G13,11,10,0,0,11,10,0.0,1.0,0.0,1.0
SF-F28-2,SF-G11,1,1,0,0,1,1,0.0,1.0,0.0,1.0
SF-F28-2,SF-G12,6,3,1,0,5,3,0.16666666666666666,0.8333333333333334,0.0,1.0
SF-F28-2,SF-F15,2,2,0,0,2,2,0.0,1.0,0.0,1.0
SF-F28-2,SF-F16,3,1,2,0,1,1,0.6666666666666666,0.3333333333333333,0.0,1.0
SF-F28-2,SF-C20,13,25,1,2,12,23,0.07692307692307693,0.9230769230769231,0.08,0.92
SF-F28-2,SF-B21,4,20,0,1,4,19,0.0,1.0,0.05,0.95
SF-F28-2,SF-B19,8,10,1,4,7,6,0.125,0.875,0.4,0.6
SF-F28-2,SF-A20,5,11,4,4,1,7,0.8,0.2,0.36363636363636365,0.6363636363636364
SF-F28-2,SF-A19,2,8,1,0,1,8,0.5,0.5,0.0,1.0
SF-F28-2,SF-C26,64,68,24,17,40,51,0.375,0.625,0.25,0.75
SF-F28-2,SF-C25,42,29,19,16,23,13,0.4523809523809524,0.5476190476190477,0.5517241379310345,0.4482758620689655
SF-F28-2,SF-B25,26,46,7,24,19,22,0.2692307692307692,0.7307692307692307,0.5217391304347826,0.4782608695652174
SF-F28-2,SF-E27,28,7,21,4,7,3,0.75,0.25,0.5714285714285714,0.42857142857142855
SF-F28-2,SF-B28-2,17,12,12,7,5,5,0.7058823529411765,0.29411764705882354,0.5833333333333334,0.4166666666666667
SF-F28-2,SF-D27,33,36,19,28,14,8,0.5757575757575758,0.42424242424242425,0.7777777777777778,0.2222222222222222
SF-F28-2,SF-C28-2,21,33,14,3,7,30,0.6666666666666666,0.3333333333333333,0.09090909090909091,0.9090909090909091
SF-F28-2,SF-C28-1,11,10,7,8,4,2,0.6363636363636364,0.36363636363636365,0.8,0.2
SF-F28-2,SF-B28,32,30,16,24,16,6,0.5,0.5,0.8,0.2
SF-F28-2,SF-J3,1,2,1,0,0,2,1.0,0.0,0.0,1.0
SF-F28-2,SF-G8,1,1,1,0,0,1,1.0,0.0,0.0,1.0
SF-F28-2,SF-G5,5,2,0,0,5,2,0.0,1.0,0.0,1.0
SF-F28-2,SF-F9,1,1,1,0,0,1,1.0,0.0,0.0,1.0
SF-F28-2,SF-H25,8,16,1,7,7,9,0.125,0.875,0.4375,0.5625
SF-F28-2,SF-G26,30,21,25,13,5,8,0.8333333333333334,0.16666666666666666,0.6190476190476191,0.38095238095238093
SF-F28-2,SF-K21,26,12,5,0,21,12,0.19230769230769232,0.8076923076923077,0.0,1.0
SF-F28-2,SF-K22-1,28,40,24,31,4,9,0.8571428571428571,0.14285714285714285,0.775,0.225
SF-F28-2,SF-J23-1,139,97,70,47,69,50,0.5035971223021583,0.49640287769784175,0.4845360824742268,0.5154639175257731
SF-F28-2,SF-J22-1,31,41,14,6,17,35,0.45161290322580644,0.5483870967741935,0.14634146341463414,0.8536585365853658
SF-F28-2,SF-J22-2,16,51,8,5,8,46,0.5,0.5,0.09803921568627451,0.9019607843137255
SF-F28-2,SF-J21,23,19,6,8,17,11,0.2608695652173913,0.7391304347826086,0.42105263157894735,0.5789473684210527
SF-F28-2,SF-I21,16,6,4,2,12,4,0.25,0.75,0.3333333333333333,0.6666666666666666
SF-F28-2,SF-I22,14,27,7,5,7,22,0.5,0.5,0.18518518518518517,0.8148148148148148
SF-F28-2,SF-I23-2,10,7,8,3,2,4,0.8,0.2,0.42857142857142855,0.5714285714285714
SF-F28-2,SF-I24,14,7,9,4,5,3,0.6428571428571429,0.35714285714285715,0.5714285714285714,0.42857142857142855
SF-F28-2,SF-I23-1,27,19,15,13,12,6,0.5555555555555556,0.4444444444444444,0.6842105263157895,0.3157894736842105
SF-F28-2,SF-F26,45,52,27,30,18,22,0.6,0.4,0.5769230769230769,0.4230769230769231
SF-F28-2,SF-M13,7,23,1,0,6,23,0.14285714285714285,0.8571428571428571,0.0,1.0
SF-F28-2,SF-M15,28,22,7,1,21,21,0.25,0.75,0.045454545454545456,0.9545454545454546
SF-F28-2,SF-L19,48,39,4,1,44,38,0.08333333333333333,0.9166666666666666,0.02564102564102564,0.9743589743589743
SF-F28-2,SF-L20,44,75,26,25,18,50,0.5909090909090909,0.4090909090909091,0.3333333333333333,0.6666666666666666
SF-F28-2,SF-N20-1,17,17,5,0,12,17,0.29411764705882354,0.7058823529411765,0.0,1.0
SF-F28-2,SF-M20,38,39,15,4,23,35,0.39473684210526316,0.6052631578947368,0.10256410256410256,0.8974358974358975
SF-F28-2,SF-K17-2,5,2,0,1,5,1,0.0,1.0,0.5,0.5
SF-F28-2,SF-K20,85,57,43,24,42,33,0.5058823529411764,0.49411764705882355,0.42105263157894735,0.5789473684210527
SF-F28-2,SF-K15-,7,8,3,1,4,7,0.42857142857142855,0.5714285714285714,0.125,0.875
SF-F28-2,SF-K19,19,21,5,10,14,11,0.2631578947368421,0.7368421052631579,0.47619047619047616,0.5238095238095238
SF-F28-2,SF-K18,31,5,21,1,10,4,0.6774193548387096,0.3225806451612903,0.2,0.8
SF-F28-2,SF-K17,10,12,5,3,5,9,0.5,0.5,0.25,0.75
SF-F28-2,SF-J16,3,12,0,1,3,11,0.0,1.0,0.08333333333333333,0.9166666666666666
SF-F28-2,SF-J18,27,15,0,0,27,15,0.0,1.0,0.0,1.0
SF-F28-2,SF-J20,15,13,8,4,7,9,0.5333333333333333,0.4666666666666667,0.3076923076923077,0.6923076923076923
SF-F28-2,SF-J19,38,22,12,8,26,14,0.3157894736842105,0.6842105263157895,0.36363636363636365,0.6363636363636364
SF-F28-2,SF-O12,1,1,1,0,0,1,1.0,0.0,0.0,1.0
SF-F28-2,SF-M11,3,6,0,1,3,5,0.0,1.0,0.16666666666666666,0.8333333333333334
SF-F28-2,SF-R19,23,32,0,1,23,31,0.0,1.0,0.03125,0.96875
SF-F28-2,SF-R20,7,2,1,0,6,2,0.14285714285714285,0.8571428571428571,0.0,1.0
SF-F28-2,SF-Q21-2,18,12,1,1,17,11,0.05555555555555555,0.9444444444444444,0.08333333333333333,0.9166666666666666
SF-F28-2,SF-Q21-1,9,10,1,1,8,9,0.1111111111111111,0.8888888888888888,0.1,0.9
SF-F28-2,SF-P21,2,2,1,1,1,1,0.5,0.5,0.5,0.5
SF-F28-2,SF-O18,51,30,9,1,42,29,0.17647058823529413,0.8235294117647058,0.03333333333333333,0.9666666666666667
SF-F28-2,SF-O19,12,25,5,9,7,16,0.4166666666666667,0.5833333333333334,0.36,0.64
SF-F28-2,SF-O21,30,38,13,20,17,18,0.43333333333333335,0.5666666666666667,0.5263157894736842,0.47368421052631576
SF-F28-2,SF-O22,22,30,7,17,15,13,0.3181818181818182,0.6818181818181818,0.5666666666666667,0.43333333333333335
SF-F28-2,SF-N21,12,10,0,4,12,6,0.0,1.0,0.4,0.6
SF-F28-2,SF-N20-2,7,9,4,1,3,8,0.5714285714285714,0.42857142857142855,0.1111111111111111,0.8888888888888888
SF-F28-2,SF-M21,56,23,50,9,6,14,0.8928571428571429,0.10714285714285714,0.391304347826087,0.6086956521739131
SF-F28-2,SF-L21,51,73,18,13,33,60,0.35294117647058826,0.6470588235294118,0.1780821917808219,0.821917808219178
SF-F28-2,SF-Q30,5,9,1,2,4,7,0.2,0.8,0.2222222222222222,0.7777777777777778
SF-F28-2,SF-P30,14,7,2,3,12,4,0.14285714285714285,0.8571428571428571,0.42857142857142855,0.5714285714285714
SF-F28-2,SF-O30-2,12,20,5,16,7,4,0.4166666666666667,0.5833333333333334,0.8,0.2
SF-F28-2,SF-O30,23,13,10,7,13,6,0.43478260869565216,0.5652173913043478,0.5384615384615384,0.46153846153846156
SF-F28-2,SF-N27,18,18,9,3,9,15,0.5,0.5,0.16666666666666666,0.8333333333333334
SF-F28-2,SF-N29,2,7,1,3,1,4,0.5,0.5,0.42857142857142855,0.5714285714285714
SF-F28-2,SF-N28,6,5,3,2,3,3,0.5,0.5,0.4,0.6
SF-F28-2,SF-L30-1,28,41,6,4,22,37,0.21428571428571427,0.7857142857142857,0.0975609756097561,0.9024390243902439
SF-F28-2,SF-L31-1,17,6,14,5,3,1,0.8235294117647058,0.17647058823529413,0.8333333333333334,0.16666666666666666
SF-F28-2,SF-K30-2,11,22,4,10,7,12,0.36363636363636365,0.6363636363636364,0.45454545454545453,0.5454545454545454
SF-F28-2,SF-L29,67,87,5,17,62,70,0.07462686567164178,0.9253731343283582,0.19540229885057472,0.8045977011494253
SF-F28-2,SF-J29-1,29,32,16,19,13,13,0.5517241379310345,0.4482758620689655,0.59375,0.40625
SF-F28-2,SF-I30,175,170,150,151,25,19,0.8571428571428571,0.14285714285714285,0.888235294117647,0.11176470588235295
SF-F28-2,SF-I29-2,7,31,3,2,4,29,0.42857142857142855,0.5714285714285714,0.06451612903225806,0.9354838709677419
SF-F28-2,SF-I27,28,27,16,15,12,12,0.5714285714285714,0.42857142857142855,0.5555555555555556,0.4444444444444444
SF-F28-2,SF-I28,12,17,8,9,4,8,0.6666666666666666,0.3333333333333333,0.5294117647058824,0.47058823529411764
SF-F28-2,SF-I30-2,85,51,56,38,29,13,0.6588235294117647,0.3411764705882353,0.7450980392156863,0.2549019607843137
SF-F28-2,SF I29-1,90,68,56,22,34,46,0.6222222222222222,0.37777777777777777,0.3235294117647059,0.6764705882352942
SF-F28-2,SF-H28,83,42,67,25,16,17,0.8072289156626506,0.1927710843373494,0.5952380952380952,0.40476190476190477
SF-F28-2,SF-H29,26,11,21,9,5,2,0.8076923076923077,0.19230769230769232,0.8181818181818182,0.18181818181818182
SF-F28-2,SF-S24,24,18,19,12,5,6,0.7916666666666666,0.20833333333333334,0.6666666666666666,0.3333333333333333
SF-F28-2,SF-R24,6,9,4,4,2,5,0.6666666666666666,0.3333333333333333,0.4444444444444444,0.5555555555555556
SF-F28-2,SF-R26,1,1,0,0,1,1,0.0,1.0,0.0,1.0
SF-F28-2,SF-Q26,2,2,0,0,2,2,0.0,1.0,0.0,1.0
SF-F28-2,SF-O25-2,2,4,2,3,0,1,1.0,0.0,0.75,0.25
SF-F28-2,SF-N22-1B,2,1,0,0,2,1,0.0,1.0,0.0,1.0
SF-F28-2,SF-N26,5,4,2,1,3,3,0.4,0.6,0.25,0.75
SF-F28-2,SF-N25,1,4,0,0,1,4,0.0,1.0,0.0,1.0
SF-F28-2,SF-T22,28,12,25,6,3,6,0.8928571428571429,0.10714285714285714,0.5,0.5
SF-F28-2,SF-S22-2,2,2,0,2,2,0,0.0,1.0,1.0,0.0
SF-F28-2,SF-S22-1,2,11,2,7,0,4,1.0,0.0,0.6363636363636364,0.36363636363636365
SF-F28-2,SF-Q23-3,13,5,6,5,7,0,0.46153846153846156,0.5384615384615384,1.0,0.0
SF-F28-2,SF-Q22-1,13,18,8,5,5,13,0.6153846153846154,0.38461538461538464,0.2777777777777778,0.7222222222222222
SF-F28-2,SF-Q22-2,36,14,25,10,11,4,0.6944444444444444,0.3055555555555556,0.7142857142857143,0.2857142857142857
SF-F28-2,SF-P22,11,14,6,5,5,9,0.5454545454545454,0.45454545454545453,0.35714285714285715,0.6428571428571429
SF-F28-2,SF-W19,68,64,61,39,7,25,0.8970588235294118,0.10294117647058823,0.609375,0.390625
SF-F28-2,SF-T20,13,9,2,3,11,6,0.15384615384615385,0.8461538461538461,0.3333333333333333,0.6666666666666666
SF-G27,SF-M26,6,5,1,2,5,3,0.16666666666666666,0.8333333333333334,0.4,0.6
SF-G27,SF-M25,6,13,5,9,1,4,0.8333333333333334,0.16666666666666666,0.6923076923076923,0.3076923076923077
SF-G27,SF-M26-2,7,12,1,4,6,8,0.14285714285714285,0.8571428571428571,0.3333333333333333,0.6666666666666666
SF-G27,SF-L27,8,9,4,0,4,9,0.5,0.5,0.0,1.0
SF-G27,SF-K26,28,32,7,19,21,13,0.25,0.75,0.59375,0.40625
SF-G27,SF-J27,8,18,4,11,4,7,0.5,0.5,0.6111111111111112,0.3888888888888889
SF-G27,SF-M30,54,33,26,19,28,14,0.48148148148148145,0.5185185185185185,0.5757575757575758,0.42424242424242425
SF-G27,SF-L27-2,13,7,9,3,4,4,0.6923076923076923,0.3076923076923077,0.42857142857142855,0.5714285714285714
SF-G27,SF-J29-3,24,32,16,21,8,11,0.6666666666666666,0.3333333333333333,0.65625,0.34375
SF-G27,SF-J29,45,60,18,32,27,28,0.4,0.6,0.5333333333333333,0.4666666666666667
SF-G27,SF-L26,10,5,4,1,6,4,0.4,0.6,0.2,0.8
SF-G27,SF-M28,14,19,5,3,9,16,0.35714285714285715,0.6428571428571429,0.15789473684210525,0.8421052631578947
SF-G27,SF-L25,38,22,27,17,11,5,0.7105263157894737,0.2894736842105263,0.7727272727272727,0.22727272727272727
SF-G27,SF-M24,20,10,7,7,13,3,0.35,0.65,0.7,0.3
SF-G27,SF-L24,5,12,2,8,3,4,0.4,0.6,0.6666666666666666,0.3333333333333333
SF-G27,SF-N23,19,8,7,5,12,3,0.3684210526315789,0.631578947368421,0.625,0.375
SF-G27,SF-N24-2,9,9,2,2,7,7,0.2222222222222222,0.7777777777777778,0.2222222222222222,0.7777777777777778
SF-G27,SF-K27-2,41,22,22,12,19,10,0.5365853658536586,0.4634146341463415,0.5454545454545454,0.45454545454545453
SF-G27,SF-J26-2,70,45,28,20,42,25,0.4,0.6,0.4444444444444444,0.5555555555555556
SF-G27,SF-K28-3,1,5,0,3,1,2,0.0,1.0,0.6,0.4
SF-G27,SF-L28,8,9,5,5,3,4,0.625,0.375,0.5555555555555556,0.4444444444444444
SF-G27,SF-K28,8,13,5,10,3,3,0.625,0.375,0.7692307692307693,0.23076923076923078
SF-G27,SF-K29-1,56,53,29,31,27,22,0.5178571428571429,0.48214285714285715,0.5849056603773585,0.41509433962264153
SF-G27,SF-J28-2,25,22,12,8,13,14,0.48,0.52,0.36363636363636365,0.6363636363636364
SF-G27,SF-K27,18,9,8,3,10,6,0.4444444444444444,0.5555555555555556,0.3333333333333333,0.6666666666666666
SF-G27,SF-K25,33,22,17,5,16,17,0.5151515151515151,0.48484848484848486,0.22727272727272727,0.7727272727272727
SF-G27,SF-J25,85,78,35,37,50,41,0.4117647058823529,0.5882352941176471,0.47435897435897434,0.5256410256410257
SF-G27,SF-H26-2,41,25,20,12,21,13,0.4878048780487805,0.5121951219512195,0.48,0.52
SF-G27,SF-P24,40,14,7,6,33,8,0.175,0.825,0.42857142857142855,0.5714285714285714
SF-G27,SF-N22-1A,1,1,0,1,1,0,0.0,1.0,1.0,0.0
SF-G27,SF-J24,28,37,12,16,16,21,0.42857142857142855,0.5714285714285714,0.43243243243243246,0.5675675675675675
SF-G27,SF-O24,15,5,8,3,7,2,0.5333333333333333,0.4666666666666667,0.6,0.4
SF-G27,SF-J26,34,22,20,13,14,9,0.5882352941176471,0.4117647058823529,0.5909090909090909,0.4090909090909091
SF-G27,SF-I26-,34,24,21,9,13,15,0.6176470588235294,0.38235294117647056,0.375,0.625
SF-G27,SF-I25,209,179,160,121,49,58,0.7655502392344498,0.23444976076555024,0.6759776536312849,0.3240223463687151
SF-G27,SF-K23,3,6,3,3,0,3,1.0,0.0,0.5,0.5
SF-G27,SF-H26,165,115,139,86,26,29,0.8424242424242424,0.15757575757575756,0.7478260869565218,0.25217391304347825
SF-G27,SF-O23,15,18,8,8,7,10,0.5333333333333333,0.4666666666666667,0.4444444444444444,0.5555555555555556
SF-G27,SF-H27-1,29,33,17,14,12,19,0.5862068965517241,0.41379310344827586,0.42424242424242425,0.5757575757575758
SF-G27,SF-F28-2,134,141,83,86,51,55,0.6194029850746269,0.3805970149253731,0.6099290780141844,0.3900709219858156
SF-G27,SF-M22-2,51,41,26,17,25,24,0.5098039215686274,0.49019607843137253,0.4146341463414634,0.5853658536585366
SF-G27,SF-L22,36,28,19,14,17,14,0.5277777777777778,0.4722222222222222,0.5,0.5
SF-G27,SF-F27,92,67,58,44,34,23,0.6304347826086957,0.3695652173913043,0.6567164179104478,0.34328358208955223
SF-G27,SF-N22-2,40,46,18,13,22,33,0.45,0.55,0.2826086956521739,0.717391304347826
SF-G27,SF-G28-2,8,10,4,5,4,5,0.5,0.5,0.5,0.5
SF-G27,SF-G28-1,26,22,17,11,9,11,0.6538461538461539,0.34615384615384615,0.5,0.5
SF-G27,SF-M22-1,16,9,8,6,8,3,0.5,0.5,0.6666666666666666,0.3333333333333333
SF-G27,SF-O25-1,4,14,3,2,1,12,0.75,0.25,0.14285714285714285,0.8571428571428571
SF-G27,SF-K22-2,52,38,31,13,21,25,0.5961538461538461,0.40384615384615385,0.34210526315789475,0.6578947368421053
SF-G27,SF-K24,35,42,25,33,10,9,0.7142857142857143,0.2857142857142857,0.7857142857142857,0.21428571428571427
SF-G27,SF-J23-2,82,49,56,38,26,11,0.6829268292682927,0.3170731707317073,0.7755102040816326,0.22448979591836735
SF-G27,SF-G23,26,6,16,0,10,6,0.6153846153846154,0.38461538461538464,0.0,1.0
SF-G27,SF-G24,69,62,26,15,43,47,0.37681159420289856,0.6231884057971014,0.24193548387096775,0.7580645161290323
SF-G27,SF-G25,98,51,84,18,14,33,0.8571428571428571,0.14285714285714285,0.35294117647058826,0.6470588235294118
SF-G27,SF-F23,69,26,20,7,49,19,0.2898550724637681,0.7101449275362319,0.2692307692307692,0.7307692307692307
SF-G27,SF-E23,39,23,21,6,18,17,0.5384615384615384,0.46153846153846156,0.2608695652173913,0.7391304347826086
SF-G27,SF-D24,11,5,6,0,5,5,0.5454545454545454,0.45454545454545453,0.0,1.0
SF-G27,SF-C22,15,7,1,1,14,6,0.06666666666666667,0.9333333333333333,0.14285714285714285,0.8571428571428571
SF-G27,SF-B22,11,42,2,23,9,19,0.18181818181818182,0.8181818181818182,0.5476190476190477,0.4523809523809524
SF-G27,SF-J17,89,28,34,0,55,28,0.38202247191011235,0.6179775280898876,0.0,1.0
SF-G27,SF-I19,19,8,12,0,7,8,0.631578947368421,0.3684210526315789,0.0,1.0
SF-G27,SF-I20,18,19,10,16,8,3,0.5555555555555556,0.4444444444444444,0.8421052631578947,0.15789473684210525
SF-G27,SF-H16,3,1,0,0,3,1,0.0,1.0,0.0,1.0
SF-G27,SF-H19,6,4,2,0,4,4,0.3333333333333333,0.6666666666666666,0.0,1.0
SF-G27,SF-H20,20,13,10,3,10,10,0.5,0.5,0.23076923076923078,0.7692307692307693
SF-G27,SF-H18,6,5,1,1,5,4,0.16666666666666666,0.8333333333333334,0.2,0.8
SF-G27,SF-H17,7,3,2,0,5,3,0.2857142857142857,0.7142857142857143,0.0,1.0
SF-G27,SF-G19,22,7,5,1,17,6,0.22727272727272727,0.7727272727272727,0.14285714285714285,0.8571428571428571
SF-G27,SF-G17,16,2,1,0,15,2,0.0625,0.9375,0.0,1.0
SF-G27,SF-G18,12,13,4,4,8,9,0.3333333333333333,0.6666666666666666,0.3076923076923077,0.6923076923076923
SF-G27,SF-G20,27,24,19,8,8,16,0.7037037037037037,0.2962962962962963,0.3333333333333333,0.6666666666666666
SF-G27,SF-F19,8,7,2,1,6,6,0.25,0.75,0.14285714285714285,0.8571428571428571
SF-G27,SF-E18,11,11,3,0,8,11,0.2727272727272727,0.7272727272727273,0.0,1.0
SF-G27,SF-E20,4,5,2,1,2,4,0.5,0.5,0.2,0.8
SF-G27,SF-H30,37,38,23,22,14,16,0.6216216216216216,0.3783783783783784,0.5789473684210527,0.42105263157894735
SF-G27,SF-G30-2,81,77,33,31,48,46,0.4074074074074074,0.5925925925925926,0.4025974025974026,0.5974025974025974
SF-G27,SF-F30-1,68,32,52,28,16,4,0.7647058823529411,0.23529411764705882,0.875,0.125
SF-G27,SF-E29-2,165,134,89,96,76,38,0.5393939393939394,0.46060606060606063,0.7164179104477612,0.2835820895522388
SF-G27,SF-E29-1,98,80,57,53,41,27,0.5816326530612245,0.41836734693877553,0.6625,0.3375
SF-G27,SF-D29,40,49,28,33,12,16,0.7,0.3,0.673469387755102,0.32653061224489793
SF-G27,SF-D28,71,92,57,56,14,36,0.8028169014084507,0.19718309859154928,0.6086956521739131,0.391304347826087
SF-G27,SF-A27,64,69,54,50,10,19,0.84375,0.15625,0.7246376811594203,0.2753623188405797
SF-G27,SF-G29-2,119,119,71,57,48,62,0.5966386554621849,0.40336134453781514,0.4789915966386555,0.5210084033613446
SF-G27,SF-G29-1,77,43,64,30,13,13,0.8311688311688312,0.16883116883116883,0.6976744186046512,0.3023255813953488
SF-G27,SF-G30-1,99,149,59,88,40,61,0.5959595959595959,0.40404040404040403,0.5906040268456376,0.40939597315436244
SF-G27,SF-G29-3,92,102,66,64,26,38,0.717391304347826,0.2826086956521739,0.6274509803921569,0.37254901960784315
SF-G27,SF-F30-2,40,43,19,19,21,24,0.475,0.525,0.4418604651162791,0.5581395348837209
SF-G27,SF-F29,28,48,23,26,5,22,0.8214285714285714,0.17857142857142858,0.5416666666666666,0.4583333333333333
SF-G27,SF-E29-3,35,63,19,28,16,35,0.5428571428571428,0.45714285714285713,0.4444444444444444,0.5555555555555556
SF-G27,SF-F28-1,98,62,73,41,25,21,0.7448979591836735,0.25510204081632654,0.6612903225806451,0.3387096774193548
SF-G27,SF-E28-2,30,24,10,11,20,13,0.3333333333333333,0.6666666666666666,0.4583333333333333,0.5416666666666666
SF-G27,SF-E28,57,52,36,35,21,17,0.631578947368421,0.3684210526315789,0.6730769230769231,0.3269230769230769
SF-G27,SF-J10,2,4,2,0,0,4,1.0,0.0,0.0,1.0
SF-G27,SF-J12,15,5,1,0,14,5,0.06666666666666667,0.9333333333333333,0.0,1.0
SF-G27,SF-J13,4,5,0,0,4,5,0.0,1.0,0.0,1.0
SF-G27,SF-J15,2,1,2,0,0,1,1.0,0.0,0.0,1.0
SF-G27,SF-J14,1,2,1,0,0,2,1.0,0.0,0.0,1.0
SF-G27,SF-H12,12,6,1,0,11,6,0.08333333333333333,0.9166666666666666,0.0,1.0
SF-G27,SF-G10-2,3,2,3,0,0,2,1.0,0.0,0.0,1.0
SF-G27,SF-G9,1,1,0,0,1,1,0.0,1.0,0.0,1.0
SF-G27,SF-G13,5,4,0,0,5,4,0.0,1.0,0.0,1.0
SF-G27,SF-G12,7,1,4,0,3,1,0.5714285714285714,0.42857142857142855,0.0,1.0
SF-G27,SF-G10-1,2,2,0,2,2,0,0.0,1.0,1.0,0.0
SF-G27,SF-F15,4,1,1,0,3,1,0.25,0.75,0.0,1.0
SF-G27,SF-F16,3,1,2,1,1,0,0.6666666666666666,0.3333333333333333,1.0,0.0
SF-G27,SF-C21,2,3,0,1,2,2,0.0,1.0,0.3333333333333333,0.6666666666666666
SF-G27,SF-C20,13,4,2,1,11,3,0.15384615384615385,0.8461538461538461,0.25,0.75
SF-G27,SF-B21,5,1,0,0,5,1,0.0,1.0,0.0,1.0
SF-G27,SF-B19,16,13,2,3,14,10,0.125,0.875,0.23076923076923078,0.7692307692307693
SF-G27,SF-A20,15,22,8,12,7,10,0.5333333333333333,0.4666666666666667,0.5454545454545454,0.45454545454545453
SF-G27,SF-C26,68,104,28,42,40,62,0.4117647058823529,0.5882352941176471,0.40384615384615385,0.5961538461538461
SF-G27,SF-C25,58,89,13,23,45,66,0.22413793103448276,0.7758620689655172,0.25842696629213485,0.7415730337078652
SF-G27,SF-B25,31,73,9,30,22,43,0.2903225806451613,0.7096774193548387,0.410958904109589,0.589041095890411
SF-G27,SF-E27,53,48,26,28,27,20,0.49056603773584906,0.5094339622641509,0.5833333333333334,0.4166666666666667
SF-G27,SF-B28-2,23,26,8,10,15,16,0.34782608695652173,0.6521739130434783,0.38461538461538464,0.6153846153846154
SF-G27,SF-D27,66,127,37,75,29,52,0.5606060606060606,0.4393939393939394,0.5905511811023622,0.4094488188976378
SF-G27,SF-C28-2,17,10,8,3,9,7,0.47058823529411764,0.5294117647058824,0.3,0.7
SF-G27,SF-C28-1,12,4,11,4,1,0,0.9166666666666666,0.08333333333333333,1.0,0.0
SF-G27,SF-B28,32,56,21,41,11,15,0.65625,0.34375,0.7321428571428571,0.26785714285714285
SF-G27,SF-J1,6,6,2,1,4,5,0.3333333333333333,0.6666666666666666,0.16666666666666666,0.8333333333333334
SF-G27,SF-H0,2,1,0,0,2,1,0.0,1.0,0.0,1.0
SF-G27,SF-J3,2,3,0,0,2,3,0.0,1.0,0.0,1.0
SF-G27,SF-G7,2,1,0,0,2,1,0.0,1.0,0.0,1.0
SF-G27,SF-H25,60,51,45,30,15,21,0.75,0.25,0.5882352941176471,0.4117647058823529
SF-G27,SF-G26,44,69,27,49,17,20,0.6136363636363636,0.38636363636363635,0.7101449275362319,0.2898550724637681
SF-G27,SF-K21,70,31,43,11,27,20,0.6142857142857143,0.38571428571428573,0.3548387096774194,0.6451612903225806
SF-G27,SF-K22-1,108,129,89,75,19,54,0.8240740740740741,0.17592592592592593,0.5813953488372093,0.4186046511627907
SF-G27,SF-J23-1,478,360,316,203,162,157,0.6610878661087866,0.3389121338912134,0.5638888888888889,0.4361111111111111
SF-G27,SF-J22-1,67,66,24,28,43,38,0.3582089552238806,0.6417910447761194,0.42424242424242425,0.5757575757575758
SF-G27,SF-J22-2,81,97,46,50,35,47,0.5679012345679012,0.43209876543209874,0.5154639175257731,0.4845360824742268
SF-G27,SF-J21,144,142,60,60,84,82,0.4166666666666667,0.5833333333333334,0.4225352112676056,0.5774647887323944
SF-G27,SF-I21,12,18,6,7,6,11,0.5,0.5,0.3888888888888889,0.6111111111111112
SF-G27,SF-I22,72,17,30,6,42,11,0.4166666666666667,0.5833333333333334,0.35294117647058826,0.6470588235294118
SF-G27,SF-I23-2,46,46,32,26,14,20,0.6956521739130435,0.30434782608695654,0.5652173913043478,0.43478260869565216
SF-G27,SF-I24,38,53,19,34,19,19,0.5,0.5,0.6415094339622641,0.3584905660377358
SF-G27,SF-I23-1,124,58,106,31,18,27,0.8548387096774194,0.14516129032258066,0.5344827586206896,0.46551724137931033
SF-G27,SF-F26,117,108,65,37,52,71,0.5555555555555556,0.4444444444444444,0.3425925925925926,0.6574074074074074
SF-G27,SF-M13,23,7,15,0,8,7,0.6521739130434783,0.34782608695652173,0.0,1.0
SF-G27,SF-M15,20,8,7,0,13,8,0.35,0.65,0.0,1.0
SF-G27,SF-L19,54,46,30,4,24,42,0.5555555555555556,0.4444444444444444,0.08695652173913043,0.9130434782608695
SF-G27,SF-L20,49,47,30,13,19,34,0.6122448979591837,0.3877551020408163,0.2765957446808511,0.723404255319149
SF-G27,SF-N20-1,29,10,7,1,22,9,0.2413793103448276,0.7586206896551724,0.1,0.9
SF-G27,SF-M20,67,91,20,15,47,76,0.29850746268656714,0.7014925373134329,0.16483516483516483,0.8351648351648352
SF-G27,SF-K17-2,13,7,5,2,8,5,0.38461538461538464,0.6153846153846154,0.2857142857142857,0.7142857142857143
SF-G27,SF-K20,50,25,26,6,24,19,0.52,0.48,0.24,0.76
SF-G27,SF-K15-,25,19,8,6,17,13,0.32,0.68,0.3157894736842105,0.6842105263157895
SF-G27,SF-K19,29,32,14,5,15,27,0.4827586206896552,0.5172413793103449,0.15625,0.84375
SF-G27,SF-K18,35,13,8,2,27,11,0.22857142857142856,0.7714285714285715,0.15384615384615385,0.8461538461538461
SF-G27,SF-K17,19,14,14,2,5,12,0.7368421052631579,0.2631578947368421,0.14285714285714285,0.8571428571428571
SF-G27,SF-J16,17,3,9,0,8,3,0.5294117647058824,0.47058823529411764,0.0,1.0
SF-G27,SF-J18,40,23,14,1,26,22,0.35,0.65,0.043478260869565216,0.9565217391304348
SF-G27,SF-J20,28,40,19,26,9,14,0.6785714285714286,0.32142857142857145,0.65,0.35
SF-G27,SF-J19,49,52,27,18,22,34,0.5510204081632653,0.4489795918367347,0.34615384615384615,0.6538461538461539
SF-G27,SF-M12,9,12,2,5,7,7,0.2222222222222222,0.7777777777777778,0.4166666666666667,0.5833333333333334
SF-G27,SF-M10,6,1,4,0,2,1,0.6666666666666666,0.3333333333333333,0.0,1.0
SF-G27,SF-M11,4,5,1,0,3,5,0.25,0.75,0.0,1.0
SF-G27,SF-R19,9,11,1,3,8,8,0.1111111111111111,0.8888888888888888,0.2727272727272727,0.7272727272727273
SF-G27,SF-R20,6,7,1,2,5,5,0.16666666666666666,0.8333333333333334,0.2857142857142857,0.7142857142857143
SF-G27,SF-Q21-2,6,9,1,0,5,9,0.16666666666666666,0.8333333333333334,0.0,1.0
SF-G27,SF-Q21-1,11,8,4,2,7,6,0.36363636363636365,0.6363636363636364,0.25,0.75
SF-G27,SF-P21,10,12,2,0,8,12,0.2,0.8,0.0,1.0
SF-G27,SF-O18,24,19,4,5,20,14,0.16666666666666666,0.8333333333333334,0.2631578947368421,0.7368421052631579
SF-G27,SF-O19,53,34,13,11,40,23,0.24528301886792453,0.7547169811320755,0.3235294117647059,0.6764705882352942
SF-G27,SF-O21,42,30,11,8,31,22,0.2619047619047619,0.7380952380952381,0.26666666666666666,0.7333333333333333
SF-G27,SF-O22,38,50,7,14,31,36,0.18421052631578946,0.8157894736842105,0.28,0.72
SF-G27,SF-N21,16,14,9,7,7,7,0.5625,0.4375,0.5,0.5
SF-G27,SF-N20-2,12,6,7,3,5,3,0.5833333333333334,0.4166666666666667,0.5,0.5
SF-G27,SF-M21,29,53,13,11,16,42,0.4482758620689655,0.5517241379310345,0.20754716981132076,0.7924528301886793
SF-G27,SF-L21,91,128,44,31,47,97,0.4835164835164835,0.5164835164835165,0.2421875,0.7578125
SF-G27,SF-S29,4,1,4,0,0,1,1.0,0.0,0.0,1.0
SF-G27,SF-Q30,7,17,1,2,6,15,0.14285714285714285,0.8571428571428571,0.11764705882352941,0.8823529411764706
SF-G27,SF-P30,4,17,0,1,4,16,0.0,1.0,0.058823529411764705,0.9411764705882353
SF-G27,SF-O30-2,55,31,23,18,32,13,0.41818181818181815,0.5818181818181818,0.5806451612903226,0.41935483870967744
SF-G27,SF-O30,27,33,12,11,15,22,0.4444444444444444,0.5555555555555556,0.3333333333333333,0.6666666666666666
SF-G27,SF-N27,41,31,5,11,36,20,0.12195121951219512,0.8780487804878049,0.3548387096774194,0.6451612903225806
SF-G27,SF-N29,8,5,6,1,2,4,0.75,0.25,0.2,0.8
SF-G27,SF-N28,26,19,8,5,18,14,0.3076923076923077,0.6923076923076923,0.2631578947368421,0.7368421052631579
SF-G27,SF-L30-1,81,70,34,51,47,19,0.41975308641975306,0.5802469135802469,0.7285714285714285,0.2714285714285714
SF-G27,SF-L31-1,8,10,5,9,3,1,0.625,0.375,0.9,0.1
SF-G27,SF-K30-2,12,29,4,12,8,17,0.3333333333333333,0.6666666666666666,0.41379310344827586,0.5862068965517241
SF-G27,SF-L29,48,73,22,25,26,48,0.4583333333333333,0.5416666666666666,0.3424657534246575,0.6575342465753424
SF-G27,SF-J29-1,37,46,22,28,15,18,0.5945945945945946,0.40540540540540543,0.6086956521739131,0.391304347826087
SF-G27,SF-I30,26,23,15,12,11,11,0.5769230769230769,0.4230769230769231,0.5217391304347826,0.4782608695652174
SF-G27,SF-I29-2,14,35,2,8,12,27,0.14285714285714285,0.8571428571428571,0.22857142857142856,0.7714285714285715
SF-G27,SF-I27,48,51,32,36,16,15,0.6666666666666666,0.3333333333333333,0.7058823529411765,0.29411764705882354
SF-G27,SF-I28,26,23,13,13,13,10,0.5,0.5,0.5652173913043478,0.43478260869565216
SF-G27,SF-I30-2,27,40,14,24,13,16,0.5185185185185185,0.48148148148148145,0.6,0.4
SF-G27,SF I29-1,60,30,25,7,35,23,0.4166666666666667,0.5833333333333334,0.23333333333333334,0.7666666666666667
SF-G27,SF-H28,53,43,42,34,11,9,0.7924528301886793,0.20754716981132076,0.7906976744186046,0.20930232558139536
SF-G27,SF-H29,9,10,5,5,4,5,0.5555555555555556,0.4444444444444444,0.5,0.5
SF-G27,SF-S24,12,13,4,5,8,8,0.3333333333333333,0.6666666666666666,0.38461538461538464,0.6153846153846154
SF-G27,SF-R24,12,22,4,7,8,15,0.3333333333333333,0.6666666666666666,0.3181818181818182,0.6818181818181818
SF-G27,SF-R26,4,3,2,2,2,1,0.5,0.5,0.6666666666666666,0.3333333333333333
SF-G27,SF-Q26,4,5,2,3,2,2,0.5,0.5,0.6,0.4
SF-G27,SF-P26,8,8,3,2,5,6,0.375,0.625,0.25,0.75
SF-G27,SF-O25-2,7,5,0,1,7,4,0.0,1.0,0.2,0.8
SF-G27,SF-N22-1B,9,8,5,4,4,4,0.5555555555555556,0.4444444444444444,0.5,0.5
SF-G27,SF-N26,1,4,1,0,0,4,1.0,0.0,0.0,1.0
SF-G27,SF-N25,4,2,1,0,3,2,0.25,0.75,0.0,1.0
SF-G27,SF-T21,10,8,5,1,5,7,0.5,0.5,0.125,0.875
SF-G27,SF-T22,16,16,10,6,6,10,0.625,0.375,0.375,0.625
SF-G27,SF-S22-2,6,5,0,0,6,5,0.0,1.0,0.0,1.0
SF-G27,SF-S22-1,13,10,6,5,7,5,0.46153846153846156,0.5384615384615384,0.5,0.5
SF-G27,SF-Q23-3,14,7,7,1,7,6,0.5,0.5,0.14285714285714285,0.8571428571428571
SF-G27,SF-Q22-1,13,26,5,8,8,18,0.38461538461538464,0.6153846153846154,0.3076923076923077,0.6923076923076923
SF-G27,SF-Q22-2,29,32,19,15,10,17,0.6551724137931034,0.3448275862068966,0.46875,0.53125
SF-G27,SF-P22,21,18,9,9,12,9,0.42857142857142855,0.5714285714285714,0.5,0.5
SF-G27,SF-W19,4,2,1,1,3,1,0.25,0.75,0.5,0.5
SF-G27,SF-U21,1,5,0,0,1,5,0.0,1.0,0.0,1.0
SF-G27,SF-T20,13,20,2,3,11,17,0.15384615384615385,0.8461538461538461,0.15,0.85
SF-G27,SF-S21,4,5,3,0,1,5,0.75,0.25,0.0,1.0
SF-G27,SF-Z28,9,4,1,1,8,3,0.1111111111111111,0.8888888888888888,0.25,0.75
SF-G27,SF-Y30,1,2,1,1,0,1,1.0,0.0,0.5,0.5
SF-G27,SF-Y27,2,2,0,0,2,2,0.0,1.0,0.0,1.0
SF-G27,SF-V28,2,1,0,0,2,1,0.0,1.0,0.0,1.0
SF-G27,SF-V29,7,1,0,0,7,1,0.0,1.0,0.0,1.0
SF-G27,SF-W14,5,1,1,0,4,1,0.2,0.8,0.0,1.0
SF-G27,SF-Y14,8,1,0,0,8,1,0.0,1.0,0.0,1.0
SF-M22-2,SF-M26,3,1,0,0,3,1,0.0,1.0,0.0,1.0
SF-M22-2,SF-M25,23,13,5,3,18,10,0.21739130434782608,0.782608695652174,0.23076923076923078,0.7692307692307693
SF-M22-2,SF-M26-2,9,14,3,4,6,10,0.3333333333333333,0.6666666666666666,0.2857142857142857,0.7142857142857143
SF-M22-2,SF-L27,1,5,0,4,1,1,0.0,1.0,0.8,0.2
SF-M22-2,SF-K26,10,11,3,4,7,7,0.3,0.7,0.36363636363636365,0.6363636363636364
SF-M22-2,SF-J27,8,9,0,3,8,6,0.0,1.0,0.3333333333333333,0.6666666666666666
SF-M22-2,SF-M30,31,22,15,4,16,18,0.4838709677419355,0.5161290322580645,0.18181818181818182,0.8181818181818182
SF-M22-2,SF-L27-2,1,3,0,2,1,1,0.0,1.0,0.6666666666666666,0.3333333333333333
SF-M22-2,SF-J29-3,4,3,1,2,3,1,0.25,0.75,0.6666666666666666,0.3333333333333333
SF-M22-2,SF-J29,16,26,8,7,8,19,0.5,0.5,0.2692307692307692,0.7307692307692307
SF-M22-2,SF-L26,73,80,31,40,42,40,0.4246575342465753,0.5753424657534246,0.5,0.5
SF-M22-2,SF-M28,11,6,1,1,10,5,0.09090909090909091,0.9090909090909091,0.16666666666666666,0.8333333333333334
SF-M22-2,SF-M27,2,1,1,1,1,0,0.5,0.5,1.0,0.0
SF-M22-2,SF-L25,9,10,3,7,6,3,0.3333333333333333,0.6666666666666666,0.7,0.3
SF-M22-2,SF-M24,59,86,16,28,43,58,0.2711864406779661,0.7288135593220338,0.32558139534883723,0.6744186046511628
SF-M22-2,SF-L24,18,15,9,5,9,10,0.5,0.5,0.3333333333333333,0.6666666666666666
SF-M22-2,SF-N23,10,9,6,6,4,3,0.6,0.4,0.6666666666666666,0.3333333333333333
SF-M22-2,SF-N24-2,9,8,6,6,3,2,0.6666666666666666,0.3333333333333333,0.75,0.25
SF-M22-2,SF-K27-2,16,12,7,5,9,7,0.4375,0.5625,0.4166666666666667,0.5833333333333334
SF-M22-2,SF-J26-2,34,23,11,9,23,14,0.3235294117647059,0.6764705882352942,0.391304347826087,0.6086956521739131
SF-M22-2,SF-L28,18,19,2,9,16,10,0.1111111111111111,0.8888888888888888,0.47368421052631576,0.5263157894736842
SF-M22-2,SF-K28,5,3,4,2,1,1,0.8,0.2,0.6666666666666666,0.3333333333333333
SF-M22-2,SF-K29-1,13,8,1,2,12,6,0.07692307692307693,0.9230769230769231,0.25,0.75
SF-M22-2,SF-J28-2,3,6,1,2,2,4,0.3333333333333333,0.6666666666666666,0.3333333333333333,0.6666666666666666
SF-M22-2,SF-K27,3,5,2,1,1,4,0.6666666666666666,0.3333333333333333,0.2,0.8
SF-M22-2,SF-K25,12,39,6,21,6,18,0.5,0.5,0.5384615384615384,0.46153846153846156
SF-M22-2,SF-J25,95,79,18,2,77,77,0.18947368421052632,0.8105263157894737,0.02531645569620253,0.9746835443037974
SF-M22-2,SF-H26-2,9,3,8,2,1,1,0.8888888888888888,0.1111111111111111,0.6666666666666666,0.3333333333333333
SF-M22-2,SF-P24,40,23,27,13,13,10,0.675,0.325,0.5652173913043478,0.43478260869565216
SF-M22-2,SF-N22-1A,2,2,2,1,0,1,1.0,0.0,0.5,0.5
SF-M22-2,SF-J24,18,15,1,3,17,12,0.05555555555555555,0.9444444444444444,0.2,0.8
SF-M22-2,SF-O24,11,8,8,6,3,2,0.7272727272727273,0.2727272727272727,0.75,0.25
SF-M22-2,SF-J26,3,11,0,4,3,7,0.0,1.0,0.36363636363636365,0.6363636363636364
SF-M22-2,SF-I26-,10,4,4,3,6,1,0.4,0.6,0.75,0.25
SF-M22-2,SF-I25,107,133,72,99,35,34,0.6728971962616822,0.32710280373831774,0.7443609022556391,0.2556390977443609
SF-M22-2,SF-K23,3,8,2,2,1,6,0.6666666666666666,0.3333333333333333,0.25,0.75
SF-M22-2,SF-H26,41,30,20,16,21,14,0.4878048780487805,0.5121951219512195,0.5333333333333333,0.4666666666666667
SF-M22-2,SF-O23,13,7,8,5,5,2,0.6153846153846154,0.38461538461538464,0.7142857142857143,0.2857142857142857
SF-M22-2,SF-H27-1,10,2,4,0,6,2,0.4,0.6,0.0,1.0
SF-M22-2,SF-F28-2,13,14,3,6,10,8,0.23076923076923078,0.7692307692307693,0.42857142857142855,0.5714285714285714
SF-M22-2,SF-G27,41,51,17,26,24,25,0.4146341463414634,0.5853658536585366,0.5098039215686274,0.49019607843137253
SF-M22-2,SF-L22,84,114,58,74,26,40,0.6904761904761905,0.30952380952380953,0.6491228070175439,0.3508771929824561
SF-M22-2,SF-F27,16,10,6,1,10,9,0.375,0.625,0.1,0.9
SF-M22-2,SF-N22-2,56,32,34,12,22,20,0.6071428571428571,0.39285714285714285,0.375,0.625
SF-M22-2,SF-G28-2,15,18,1,0,14,18,0.06666666666666667,0.9333333333333333,0.0,1.0
SF-M22-2,SF-G28-1,4,1,1,0,3,1,0.25,0.75,0.0,1.0
SF-M22-2,SF-M22-1,40,51,23,22,17,29,0.575,0.425,0.43137254901960786,0.5686274509803921
SF-M22-2,SF-O25-1,16,12,8,5,8,7,0.5,0.5,0.4166666666666667,0.5833333333333334
SF-M22-2,SF-K22-2,31,59,16,43,15,16,0.5161290322580645,0.4838709677419355,0.7288135593220338,0.2711864406779661
SF-M22-2,SF-K24,15,23,8,15,7,8,0.5333333333333333,0.4666666666666667,0.6521739130434783,0.34782608695652173
SF-M22-2,SF-J23-2,24,25,17,17,7,8,0.7083333333333334,0.2916666666666667,0.68,0.32
SF-M22-2,SF-G23,6,10,4,1,2,9,0.6666666666666666,0.3333333333333333,0.1,0.9
SF-M22-2,SF-G24,47,47,16,5,31,42,0.3404255319148936,0.6595744680851063,0.10638297872340426,0.8936170212765957
SF-M22-2,SF-G25,30,17,12,6,18,11,0.4,0.6,0.35294117647058826,0.6470588235294118
SF-M22-2,SF-F23,25,29,6,8,19,21,0.24,0.76,0.27586206896551724,0.7241379310344828
SF-M22-2,SF-E23,28,23,10,7,18,16,0.35714285714285715,0.6428571428571429,0.30434782608695654,0.6956521739130435
SF-M22-2,SF-D24,6,6,1,1,5,5,0.16666666666666666,0.8333333333333334,0.16666666666666666,0.8333333333333334
SF-M22-2,SF-C22,4,11,0,1,4,10,0.0,1.0,0.09090909090909091,0.9090909090909091
SF-M22-2,SF-B22,12,6,3,1,9,5,0.25,0.75,0.16666666666666666,0.8333333333333334
SF-M22-2,SF-J17,17,16,6,0,11,16,0.35294117647058826,0.6470588235294118,0.0,1.0
SF-M22-2,SF-I19,5,6,1,0,4,6,0.2,0.8,0.0,1.0
SF-M22-2,SF-I20,3,2,1,0,2,2,0.3333333333333333,0.6666666666666666,0.0,1.0
SF-M22-2,SF-H16,9,2,4,0,5,2,0.4444444444444444,0.5555555555555556,0.0,1.0
SF-M22-2,SF-H20,11,11,5,4,6,7,0.45454545454545453,0.5454545454545454,0.36363636363636365,0.6363636363636364
SF-M22-2,SF-H18,3,1,0,0,3,1,0.0,1.0,0.0,1.0
SF-M22-2,SF-H17,5,1,1,0,4,1,0.2,0.8,0.0,1.0
SF-M22-2,SF-G19,1,1,0,0,1,1,0.0,1.0,0.0,1.0
SF-M22-2,SF-G17,5,2,0,0,5,2,0.0,1.0,0.0,1.0
SF-M22-2,SF-G18,7,6,2,0,5,6,0.2857142857142857,0.7142857142857143,0.0,1.0
SF-M22-2,SF-G20,9,10,5,1,4,9,0.5555555555555556,0.4444444444444444,0.1,0.9
SF-M22-2,SF-F19,4,10,0,3,4,7,0.0,1.0,0.3,0.7
SF-M22-2,SF-E18,6,4,4,1,2,3,0.6666666666666666,0.3333333333333333,0.25,0.75
SF-M22-2,SF-E20,2,5,0,0,2,5,0.0,1.0,0.0,1.0
SF-M22-2,SF-H30,5,4,0,3,5,1,0.0,1.0,0.75,0.25
SF-M22-2,SF-G30-2,11,11,3,3,8,8,0.2727272727272727,0.7272727272727273,0.2727272727272727,0.7272727272727273
SF-M22-2,SF-F30-1,5,2,0,0,5,2,0.0,1.0,0.0,1.0
SF-M22-2,SF-E29-2,20,23,5,8,15,15,0.25,0.75,0.34782608695652173,0.6521739130434783
SF-M22-2,SF-E29-1,15,11,6,3,9,8,0.4,0.6,0.2727272727272727,0.7272727272727273
SF-M22-2,SF-D29,7,3,4,3,3,0,0.5714285714285714,0.42857142857142855,1.0,0.0
SF-M22-2,SF-D28,8,9,3,0,5,9,0.375,0.625,0.0,1.0
SF-M22-2,SF-A27,5,6,3,4,2,2,0.6,0.4,0.6666666666666666,0.3333333333333333
SF-M22-2,SF-G29-2,74,37,10,5,64,32,0.13513513513513514,0.8648648648648649,0.13513513513513514,0.8648648648648649
SF-M22-2,SF-G29-1,32,49,13,2,19,47,0.40625,0.59375,0.04081632653061224,0.9591836734693877
SF-M22-2,SF-G30-1,6,5,1,0,5,5,0.16666666666666666,0.8333333333333334,0.0,1.0
SF-M22-2,SF-G29-3,24,25,1,14,23,11,0.041666666666666664,0.9583333333333334,0.56,0.44
SF-M22-2,SF-F30-2,5,3,1,1,4,2,0.2,0.8,0.3333333333333333,0.6666666666666666
SF-M22-2,SF-F29,5,2,1,1,4,1,0.2,0.8,0.5,0.5
SF-M22-2,SF-E29-3,4,4,0,4,4,0,0.0,1.0,1.0,0.0
SF-M22-2,SF-F28-1,9,5,7,3,2,2,0.7777777777777778,0.2222222222222222,0.6,0.4
SF-M22-2,SF-E28,4,2,1,0,3,2,0.25,0.75,0.0,1.0
SF-M22-2,SF-J12,7,6,5,2,2,4,0.7142857142857143,0.2857142857142857,0.3333333333333333,0.6666666666666666
SF-M22-2,SF-J13,4,3,0,0,4,3,0.0,1.0,0.0,1.0
SF-M22-2,SF-H13,6,2,3,0,3,2,0.5,0.5,0.0,1.0
SF-M22-2,SF-I16,1,2,0,1,1,1,0.0,1.0,0.5,0.5
SF-M22-2,SF-H12,4,1,1,0,3,1,0.25,0.75,0.0,1.0
SF-M22-2,SF-G10-2,8,3,1,0,7,3,0.125,0.875,0.0,1.0
SF-M22-2,SF-H15,4,6,2,1,2,5,0.5,0.5,0.16666666666666666,0.8333333333333334
SF-M22-2,SF-H14,1,1,1,0,0,1,1.0,0.0,0.0,1.0
SF-M22-2,SF-G13,3,1,2,0,1,1,0.6666666666666666,0.3333333333333333,0.0,1.0
SF-M22-2,SF-G12,14,9,1,0,13,9,0.07142857142857142,0.9285714285714286,0.0,1.0
SF-M22-2,SF-G10-1,1,6,0,0,1,6,0.0,1.0,0.0,1.0
SF-M22-2,SF-C20,1,2,0,1,1,1,0.0,1.0,0.5,0.5
SF-M22-2,SF-B21,2,2,1,1,1,1,0.5,0.5,0.5,0.5
SF-M22-2,SF-B19,1,3,0,0,1,3,0.0,1.0,0.0,1.0
SF-M22-2,SF-A20,4,7,0,0,4,7,0.0,1.0,0.0,1.0
SF-M22-2,SF-C26,9,9,0,0,9,9,0.0,1.0,0.0,1.0
SF-M22-2,SF-C25,33,28,6,2,27,26,0.18181818181818182,0.8181818181818182,0.07142857142857142,0.9285714285714286
SF-M22-2,SF-B25,3,7,0,2,3,5,0.0,1.0,0.2857142857142857,0.7142857142857143
SF-M22-2,SF-E27,5,7,1,2,4,5,0.2,0.8,0.2857142857142857,0.7142857142857143
SF-M22-2,SF-B28-2,3,2,0,0,3,2,0.0,1.0,0.0,1.0
SF-M22-2,SF-D27,6,16,3,4,3,12,0.5,0.5,0.25,0.75
SF-M22-2,SF-C28-2,2,3,0,2,2,1,0.0,1.0,0.6666666666666666,0.3333333333333333
SF-M22-2,SF-C28-1,4,2,3,1,1,1,0.75,0.25,0.5,0.5
SF-M22-2,SF-B28,3,3,1,0,2,3,0.3333333333333333,0.6666666666666666,0.0,1.0
SF-M22-2,SF-J1,5,5,0,2,5,3,0.0,1.0,0.4,0.6
SF-M22-2,SF-H0,5,4,0,3,5,1,0.0,1.0,0.75,0.25
SF-M22-2,SF-J3,5,3,4,2,1,1,0.8,0.2,0.6666666666666666,0.3333333333333333
SF-M22-2,SF-G8,3,2,0,0,3,2,0.0,1.0,0.0,1.0
SF-M22-2,SF-G7,2,9,0,1,2,8,0.0,1.0,0.1111111111111111,0.8888888888888888
SF-M22-2,SF-F9,1,2,0,0,1,2,0.0,1.0,0.0,1.0
SF-M22-2,SF-H25,244,188,222,171,22,17,0.9098360655737705,0.09016393442622951,0.9095744680851063,0.09042553191489362
SF-M22-2,SF-G26,20,12,7,6,13,6,0.35,0.65,0.5,0.5
SF-M22-2,SF-K21,21,18,6,3,15,15,0.2857142857142857,0.7142857142857143,0.16666666666666666,0.8333333333333334
SF-M22-2,SF-K22-1,65,42,49,33,16,9,0.7538461538461538,0.24615384615384617,0.7857142857142857,0.21428571428571427
SF-M22-2,SF-J23-1,114,143,50,76,64,67,0.43859649122807015,0.5614035087719298,0.5314685314685315,0.46853146853146854
SF-M22-2,SF-J22-1,46,41,20,16,26,25,0.43478260869565216,0.5652173913043478,0.3902439024390244,0.6097560975609756
SF-M22-2,SF-J22-2,20,22,11,7,9,15,0.55,0.45,0.3181818181818182,0.6818181818181818
SF-M22-2,SF-J21,36,37,16,12,20,25,0.4444444444444444,0.5555555555555556,0.32432432432432434,0.6756756756756757
SF-M22-2,SF-I21,11,9,5,4,6,5,0.45454545454545453,0.5454545454545454,0.4444444444444444,0.5555555555555556
SF-M22-2,SF-I22,5,5,3,2,2,3,0.6,0.4,0.4,0.6
SF-M22-2,SF-I23-2,24,15,17,11,7,4,0.7083333333333334,0.2916666666666667,0.7333333333333333,0.26666666666666666
SF-M22-2,SF-I24,4,4,2,2,2,2,0.5,0.5,0.5,0.5
SF-M22-2,SF-I23-1,25,40,17,25,8,15,0.68,0.32,0.625,0.375
SF-M22-2,SF-F26,37,19,12,3,25,16,0.32432432432432434,0.6756756756756757,0.15789473684210525,0.8421052631578947
SF-M22-2,SF-M13,13,7,3,0,10,7,0.23076923076923078,0.7692307692307693,0.0,1.0
SF-M22-2,SF-M15,12,15,5,1,7,14,0.4166666666666667,0.5833333333333334,0.06666666666666667,0.9333333333333333
SF-M22-2,SF-L19,24,29,10,1,14,28,0.4166666666666667,0.5833333333333334,0.034482758620689655,0.9655172413793104
SF-M22-2,SF-L20,15,31,7,13,8,18,0.4666666666666667,0.5333333333333333,0.41935483870967744,0.5806451612903226
SF-M22-2,SF-N20-1,11,21,8,6,3,15,0.7272727272727273,0.2727272727272727,0.2857142857142857,0.7142857142857143
SF-M22-2,SF-M20,14,31,6,10,8,21,0.42857142857142855,0.5714285714285714,0.3225806451612903,0.6774193548387096
SF-M22-2,SF-K17-2,13,9,5,0,8,9,0.38461538461538464,0.6153846153846154,0.0,1.0
SF-M22-2,SF-K20,34,35,24,10,10,25,0.7058823529411765,0.29411764705882354,0.2857142857142857,0.7142857142857143
SF-M22-2,SF-K15-,30,31,8,6,22,25,0.26666666666666666,0.7333333333333333,0.1935483870967742,0.8064516129032258
SF-M22-2,SF-K19,70,39,43,9,27,30,0.6142857142857143,0.38571428571428573,0.23076923076923078,0.7692307692307693
SF-M22-2,SF-K18,40,22,14,3,26,19,0.35,0.65,0.13636363636363635,0.8636363636363636
SF-M22-2,SF-K17,33,16,21,2,12,14,0.6363636363636364,0.36363636363636365,0.125,0.875
SF-M22-2,SF-J16,10,8,5,0,5,8,0.5,0.5,0.0,1.0
SF-M22-2,SF-J18,36,17,19,1,17,16,0.5277777777777778,0.4722222222222222,0.058823529411764705,0.9411764705882353
SF-M22-2,SF-J20,11,5,4,1,7,4,0.36363636363636365,0.6363636363636364,0.2,0.8
SF-M22-2,SF-J19,13,8,5,0,8,8,0.38461538461538464,0.6153846153846154,0.0,1.0
SF-M22-2,SF-M12,7,4,3,0,4,4,0.42857142857142855,0.5714285714285714,0.0,1.0
SF-M22-2,SF-M10,3,4,0,3,3,1,0.0,1.0,0.75,0.25
SF-M22-2,SF-M11,8,10,4,4,4,6,0.5,0.5,0.4,0.6
SF-M22-2,SF-R19,15,12,4,2,11,10,0.26666666666666666,0.7333333333333333,0.16666666666666666,0.8333333333333334
SF-M22-2,SF-R20,15,6,7,2,8,4,0.4666666666666667,0.5333333333333333,0.3333333333333333,0.6666666666666666
SF-M22-2,SF-Q21-2,26,19,10,1,16,18,0.38461538461538464,0.6153846153846154,0.05263157894736842,0.9473684210526315
SF-M22-2,SF-Q21-1,16,16,5,8,11,8,0.3125,0.6875,0.5,0.5
SF-M22-2,SF-P21,17,23,7,2,10,21,0.4117647058823529,0.5882352941176471,0.08695652173913043,0.9130434782608695
SF-M22-2,SF-O18,37,28,6,5,31,23,0.16216216216216217,0.8378378378378378,0.17857142857142858,0.8214285714285714
SF-M22-2,SF-O19,26,38,14,19,12,19,0.5384615384615384,0.46153846153846156,0.5,0.5
SF-M22-2,SF-O21,39,35,27,21,12,14,0.6923076923076923,0.3076923076923077,0.6,0.4
SF-M22-2,SF-O22,67,72,39,51,28,21,0.582089552238806,0.417910447761194,0.7083333333333334,0.2916666666666667
SF-M22-2,SF-N21,25,9,18,7,7,2,0.72,0.28,0.7777777777777778,0.2222222222222222
SF-M22-2,SF-N20-2,7,9,6,2,1,7,0.8571428571428571,0.14285714285714285,0.2222222222222222,0.7777777777777778
SF-M22-2,SF-M21,19,18,14,6,5,12,0.7368421052631579,0.2631578947368421,0.3333333333333333,0.6666666666666666
SF-M22-2,SF-L21,26,58,10,19,16,39,0.38461538461538464,0.6153846153846154,0.3275862068965517,0.6724137931034483
SF-M22-2,SF-S30,3,2,1,2,2,0,0.3333333333333333,0.6666666666666666,1.0,0.0
SF-M22-2,SF-Q30,7,5,1,2,6,3,0.14285714285714285,0.8571428571428571,0.4,0.6
SF-M22-2,SF-P30,7,7,3,2,4,5,0.42857142857142855,0.5714285714285714,0.2857142857142857,0.7142857142857143
SF-M22-2,SF-O30-2,8,8,2,2,6,6,0.25,0.75,0.25,0.75
SF-M22-2,SF-O30,8,9,1,3,7,6,0.125,0.875,0.3333333333333333,0.6666666666666666
SF-M22-2,SF-N27,21,18,5,6,16,12,0.23809523809523808,0.7619047619047619,0.3333333333333333,0.6666666666666666
SF-M22-2,SF-N29,7,3,2,1,5,2,0.2857142857142857,0.7142857142857143,0.3333333333333333,0.6666666666666666
SF-M22-2,SF-N28,23,22,12,9,11,13,0.5217391304347826,0.4782608695652174,0.4090909090909091,0.5909090909090909
SF-M22-2,SF-L30-1,14,20,9,7,5,13,0.6428571428571429,0.35714285714285715,0.35,0.65
SF-M22-2,SF-L31-1,3,5,0,1,3,4,0.0,1.0,0.2,0.8
SF-M22-2,SF-K30-2,3,2,2,1,1,1,0.6666666666666666,0.3333333333333333,0.5,0.5
SF-M22-2,SF-L29,8,10,5,2,3,8,0.625,0.375,0.2,0.8
SF-M22-2,SF-J29-1,4,3,0,1,4,2,0.0,1.0,0.3333333333333333,0.6666666666666666
SF-M22-2,SF-I30,6,2,0,0,6,2,0.0,1.0,0.0,1.0
SF-M22-2,SF-I29-2,6,2,4,1,2,1,0.6666666666666666,0.3333333333333333,0.5,0.5
SF-M22-2,SF-I27,17,22,8,6,9,16,0.47058823529411764,0.5294117647058824,0.2727272727272727,0.7272727272727273
SF-M22-2,SF-I28,4,3,2,2,2,1,0.5,0.5,0.6666666666666666,0.3333333333333333
SF-M22-2,SF-I30-2,3,9,0,1,3,8,0.0,1.0,0.1111111111111111,0.8888888888888888
SF-M22-2,SF I29-1,5,3,0,1,5,2,0.0,1.0,0.3333333333333333,0.6666666666666666
SF-M22-2,SF-H28,9,21,3,13,6,8,0.3333333333333333,0.6666666666666666,0.6190476190476191,0.38095238095238093
SF-M22-2,SF-H29,6,1,0,0,6,1,0.0,1.0,0.0,1.0
SF-M22-2,SF-S24,15,16,9,9,6,7,0.6,0.4,0.5625,0.4375
SF-M22-2,SF-R24,26,21,14,13,12,8,0.5384615384615384,0.46153846153846156,0.6190476190476191,0.38095238095238093
SF-M22-2,SF-R26,6,9,6,4,0,5,1.0,0.0,0.4444444444444444,0.5555555555555556
SF-M22-2,SF-Q26,8,11,4,1,4,10,0.5,0.5,0.09090909090909091,0.9090909090909091
SF-M22-2,SF-P26,6,8,1,5,5,3,0.16666666666666666,0.8333333333333334,0.625,0.375
SF-M22-2,SF-O25-2,12,24,6,13,6,11,0.5,0.5,0.5416666666666666,0.4583333333333333
SF-M22-2,SF-N22-1B,17,12,11,6,6,6,0.6470588235294118,0.35294117647058826,0.5,0.5
SF-M22-2,SF-N26,10,5,8,2,2,3,0.8,0.2,0.4,0.6
SF-M22-2,SF-N25,9,13,4,2,5,11,0.4444444444444444,0.5555555555555556,0.15384615384615385,0.8461538461538461
SF-M22-2,SF-T21,18,12,8,3,10,9,0.4444444444444444,0.5555555555555556,0.25,0.75
SF-M22-2,SF-T22,91,96,19,12,72,84,0.2087912087912088,0.7912087912087912,0.125,0.875
SF-M22-2,SF-S22-2,63,29,14,8,49,21,0.2222222222222222,0.7777777777777778,0.27586206896551724,0.7241379310344828
SF-M22-2,SF-S22-1,78,41,39,21,39,20,0.5,0.5,0.5121951219512195,0.4878048780487805
SF-M22-2,SF-Q23-3,43,26,20,11,23,15,0.46511627906976744,0.5348837209302325,0.4230769230769231,0.5769230769230769
SF-M22-2,SF-Q22-1,65,52,41,24,24,28,0.6307692307692307,0.36923076923076925,0.46153846153846156,0.5384615384615384
SF-M22-2,SF-Q22-2,76,42,52,19,24,23,0.6842105263157895,0.3157894736842105,0.4523809523809524,0.5476190476190477
SF-M22-2,SF-P22,79,48,52,28,27,20,0.6582278481012658,0.34177215189873417,0.5833333333333334,0.4166666666666667
SF-M22-2,SF-W19,6,6,2,4,4,2,0.3333333333333333,0.6666666666666666,0.6666666666666666,0.3333333333333333
SF-M22-2,SF-W19-2,4,3,2,0,2,3,0.5,0.5,0.0,1.0
SF-M22-2,SF-U21,27,5,6,0,21,5,0.2222222222222222,0.7777777777777778,0.0,1.0
SF-M22-2,SF-T20,22,15,9,4,13,11,0.4090909090909091,0.5909090909090909,0.26666666666666666,0.7333333333333333
SF-M22-2,SF-S21,1,9,0,5,1,4,0.0,1.0,0.5555555555555556,0.4444444444444444
SF-M22-2,SF-Y30,5,2,0,0,5,2,0.0,1.0,0.0,1.0
SF-M22-2,SF-Y27,1,1,0,0,1,1,0.0,1.0,0.0,1.0
SF-M22-2,SF-W29,2,2,0,0,2,2,0.0,1.0,0.0,1.0
SF-M22-2,SF-W14,1,2,0,0,1,2,0.0,1.0,0.0,1.0
SF-M22-2,SF-BB17,1,2,0,0,1,2,0.0,1.0,0.0,1.0
SF-M22-2,SF-AA15,2,2,2,1,0,1,1.0,0.0,0.5,0.5
SF-M22-2,SF-X19,3,4,3,2,0,2,1.0,0.0,0.5,0.5
SF-M22-2,SF-Y25,3,1,0,0,3,1,0.0,1.0,0.0,1.0
SF-L22,SF-M26,3,9,2,4,1,5,0.6666666666666666,0.3333333333333333,0.4444444444444444,0.5555555555555556
SF-L22,SF-M25,14,14,1,6,13,8,0.07142857142857142,0.9285714285714286,0.42857142857142855,0.5714285714285714
SF-L22,SF-M26-2,6,8,1,6,5,2,0.16666666666666666,0.8333333333333334,0.75,0.25
SF-L22,SF-L27,3,2,2,2,1,0,0.6666666666666666,0.3333333333333333,1.0,0.0
SF-L22,SF-K26,4,8,2,5,2,3,0.5,0.5,0.625,0.375
SF-L22,SF-J27,4,6,0,2,4,4,0.0,1.0,0.3333333333333333,0.6666666666666666
SF-L22,SF-M30,56,73,2,9,54,64,0.03571428571428571,0.9642857142857143,0.1232876712328767,0.8767123287671232
SF-L22,SF-L27-2,4,2,2,0,2,2,0.5,0.5,0.0,1.0
SF-L22,SF-J29,51,43,20,14,31,29,0.39215686274509803,0.6078431372549019,0.32558139534883723,0.6744186046511628
SF-L22,SF-L26,50,46,35,36,15,10,0.7,0.3,0.782608695652174,0.21739130434782608
SF-L22,SF-M28,3,9,0,2,3,7,0.0,1.0,0.2222222222222222,0.7777777777777778
SF-L22,SF-L25,13,20,3,6,10,14,0.23076923076923078,0.7692307692307693,0.3,0.7
SF-L22,SF-M24,20,14,7,6,13,8,0.35,0.65,0.42857142857142855,0.5714285714285714
SF-L22,SF-L24,51,48,20,21,31,27,0.39215686274509803,0.6078431372549019,0.4375,0.5625
SF-L22,SF-N23,12,7,9,4,3,3,0.75,0.25,0.5714285714285714,0.42857142857142855
SF-L22,SF-N24-2,9,14,4,10,5,4,0.4444444444444444,0.5555555555555556,0.7142857142857143,0.2857142857142857
SF-L22,SF-K27-2,13,21,4,8,9,13,0.3076923076923077,0.6923076923076923,0.38095238095238093,0.6190476190476191
SF-L22,SF-J26-2,8,10,5,1,3,9,0.625,0.375,0.1,0.9
SF-L22,SF-K28-3,1,1,1,0,0,1,1.0,0.0,0.0,1.0
SF-L22,SF-L28,1,2,0,2,1,0,0.0,1.0,1.0,0.0
SF-L22,SF-K28,1,4,0,1,1,3,0.0,1.0,0.25,0.75
SF-L22,SF-K29-1,7,1,2,1,5,0,0.2857142857142857,0.7142857142857143,1.0,0.0
SF-L22,SF-J28-2,8,2,1,0,7,2,0.125,0.875,0.0,1.0
SF-L22,SF-K27,11,2,10,2,1,0,0.9090909090909091,0.09090909090909091,1.0,0.0
SF-L22,SF-K25,11,14,5,2,6,12,0.45454545454545453,0.5454545454545454,0.14285714285714285,0.8571428571428571
SF-L22,SF-J25,15,19,6,8,9,11,0.4,0.6,0.42105263157894735,0.5789473684210527
SF-L22,SF-H26-2,5,4,0,3,5,1,0.0,1.0,0.75,0.25
SF-L22,SF-P24,10,21,4,11,6,10,0.4,0.6,0.5238095238095238,0.47619047619047616
SF-L22,SF-N22-1A,2,6,0,4,2,2,0.0,1.0,0.6666666666666666,0.3333333333333333
SF-L22,SF-J24,3,13,0,4,3,9,0.0,1.0,0.3076923076923077,0.6923076923076923
SF-L22,SF-O24,10,7,3,1,7,6,0.3,0.7,0.14285714285714285,0.8571428571428571
SF-L22,SF-J26,6,6,3,3,3,3,0.5,0.5,0.5,0.5
SF-L22,SF-I26-,2,1,0,0,2,1,0.0,1.0,0.0,1.0
SF-L22,SF-I25,15,31,11,21,4,10,0.7333333333333333,0.26666666666666666,0.6774193548387096,0.3225806451612903
SF-L22,SF-K23,2,2,2,2,0,0,1.0,0.0,1.0,0.0
SF-L22,SF-H26,44,42,25,14,19,28,0.5681818181818182,0.4318181818181818,0.3333333333333333,0.6666666666666666
SF-L22,SF-O23,12,16,5,10,7,6,0.4166666666666667,0.5833333333333334,0.625,0.375
SF-L22,SF-H27-1,4,7,2,3,2,4,0.5,0.5,0.42857142857142855,0.5714285714285714
SF-L22,SF-F28-2,14,27,6,16,8,11,0.42857142857142855,0.5714285714285714,0.5925925925925926,0.4074074074074074
SF-L22,SF-G27,28,36,14,19,14,17,0.5,0.5,0.5277777777777778,0.4722222222222222
SF-L22,SF-M22-2,114,84,74,58,40,26,0.6491228070175439,0.3508771929824561,0.6904761904761905,0.30952380952380953
SF-L22,SF-F27,12,11,6,7,6,4,0.5,0.5,0.6363636363636364,0.36363636363636365
SF-L22,SF-N22-2,61,43,27,29,34,14,0.4426229508196721,0.5573770491803278,0.6744186046511628,0.32558139534883723
SF-L22,SF-G28-2,7,8,2,6,5,2,0.2857142857142857,0.7142857142857143,0.75,0.25
SF-L22,SF-G28-1,1,2,0,1,1,1,0.0,1.0,0.5,0.5
SF-L22,SF-M22-1,49,51,36,32,13,19,0.7346938775510204,0.2653061224489796,0.6274509803921569,0.37254901960784315
SF-L22,SF-O25-1,6,3,1,2,5,1,0.16666666666666666,0.8333333333333334,0.6666666666666666,0.3333333333333333
SF-L22,SF-K22-2,15,57,9,44,6,13,0.6,0.4,0.7719298245614035,0.22807017543859648
SF-L22,SF-K24,6,2,3,2,3,0,0.5,0.5,1.0,0.0
SF-L22,SF-J23-2,9,12,4,5,5,7,0.4444444444444444,0.5555555555555556,0.4166666666666667,0.5833333333333334
SF-L22,SF-G23,17,23,9,6,8,17,0.5294117647058824,0.47058823529411764,0.2608695652173913,0.7391304347826086
SF-L22,SF-G24,28,21,12,3,16,18,0.42857142857142855,0.5714285714285714,0.14285714285714285,0.8571428571428571
SF-L22,SF-G25,16,23,6,6,10,17,0.375,0.625,0.2608695652173913,0.7391304347826086
SF-L22,SF-F23,27,35,17,24,10,11,0.6296296296296297,0.37037037037037035,0.6857142857142857,0.3142857142857143
SF-L22,SF-E23,20,14,6,5,14,9,0.3,0.7,0.35714285714285715,0.6428571428571429
SF-L22,SF-D24,18,11,5,0,13,11,0.2777777777777778,0.7222222222222222,0.0,1.0
SF-L22,SF-C22,10,13,1,3,9,10,0.1,0.9,0.23076923076923078,0.7692307692307693
SF-L22,SF-B22,6,10,1,4,5,6,0.16666666666666666,0.8333333333333334,0.4,0.6
SF-L22,SF-J17,18,4,7,0,11,4,0.3888888888888889,0.6111111111111112,0.0,1.0
SF-L22,SF-I20,2,1,1,1,1,0,0.5,0.5,1.0,0.0
SF-L22,SF-H19,2,1,1,1,1,0,0.5,0.5,1.0,0.0
SF-L22,SF-H20,5,6,1,1,4,5,0.2,0.8,0.16666666666666666,0.8333333333333334
SF-L22,SF-G19,8,9,3,3,5,6,0.375,0.625,0.3333333333333333,0.6666666666666666
SF-L22,SF-G17,8,4,3,0,5,4,0.375,0.625,0.0,1.0
SF-L22,SF-G18,5,3,0,1,5,2,0.0,1.0,0.3333333333333333,0.6666666666666666
SF-L22,SF-G20,13,38,0,0,13,38,0.0,1.0,0.0,1.0
SF-L22,SF-F19,10,6,4,2,6,4,0.4,0.6,0.3333333333333333,0.6666666666666666
SF-L22,SF-E18,7,5,3,1,4,4,0.42857142857142855,0.5714285714285714,0.2,0.8
SF-L22,SF-E20,3,3,1,0,2,3,0.3333333333333333,0.6666666666666666,0.0,1.0
SF-L22,SF-H30,6,1,2,0,4,1,0.3333333333333333,0.6666666666666666,0.0,1.0
SF-L22,SF-G30-2,20,12,3,1,17,11,0.15,0.85,0.08333333333333333,0.9166666666666666
SF-L22,SF-F30-1,2,3,1,2,1,1,0.5,0.5,0.6666666666666666,0.3333333333333333
SF-L22,SF-E29-2,14,18,6,8,8,10,0.42857142857142855,0.5714285714285714,0.4444444444444444,0.5555555555555556
SF-L22,SF-E29-1,14,18,3,10,11,8,0.21428571428571427,0.7857142857142857,0.5555555555555556,0.4444444444444444
SF-L22,SF-D29,5,6,1,4,4,2,0.2,0.8,0.6666666666666666,0.3333333333333333
SF-L22,SF-D28,4,2,2,1,2,1,0.5,0.5,0.5,0.5
SF-L22,SF-A27,4,5,1,4,3,1,0.25,0.75,0.8,0.2
SF-L22,SF-G29-2,10,17,2,2,8,15,0.2,0.8,0.11764705882352941,0.8823529411764706
SF-L22,SF-G29-1,5,9,0,3,5,6,0.0,1.0,0.3333333333333333,0.6666666666666666
SF-L22,SF-G30-1,8,5,3,0,5,5,0.375,0.625,0.0,1.0
SF-L22,SF-G29-3,9,11,5,1,4,10,0.5555555555555556,0.4444444444444444,0.09090909090909091,0.9090909090909091
SF-L22,SF-F30-2,4,2,0,0,4,2,0.0,1.0,0.0,1.0
SF-L22,SF-F29,3,2,1,0,2,2,0.3333333333333333,0.6666666666666666,0.0,1.0
SF-L22,SF-E29-3,4,10,0,4,4,6,0.0,1.0,0.4,0.6
SF-L22,SF-F28-1,8,17,2,11,6,6,0.25,0.75,0.6470588235294118,0.35294117647058826
SF-L22,SF-E28-2,5,1,4,1,1,0,0.8,0.2,1.0,0.0
SF-L22,SF-E28,6,2,4,0,2,2,0.6666666666666666,0.3333333333333333,0.0,1.0
SF-L22,SF-J10,2,3,1,1,1,2,0.5,0.5,0.3333333333333333,0.6666666666666666
SF-L22,SF-J12,5,6,4,1,1,5,0.8,0.2,0.16666666666666666,0.8333333333333334
SF-L22,SF-J15,1,1,1,1,0,0,1.0,0.0,1.0,0.0
SF-L22,SF-H12,1,2,1,0,0,2,1.0,0.0,0.0,1.0
SF-L22,SF-H15,1,1,0,0,1,1,0.0,1.0,0.0,1.0
SF-L22,SF-G13,1,3,1,1,0,2,1.0,0.0,0.3333333333333333,0.6666666666666666
SF-L22,SF-G11,2,2,0,0,2,2,0.0,1.0,0.0,1.0
SF-L22,SF-G12,11,13,0,0,11,13,0.0,1.0,0.0,1.0
SF-L22,SF-G10-1,10,1,0,0,10,1,0.0,1.0,0.0,1.0
SF-L22,SF-F16,2,1,1,0,1,1,0.5,0.5,0.0,1.0
SF-L22,SF-A20,8,8,0,3,8,5,0.0,1.0,0.375,0.625
SF-L22,SF-A19,7,1,0,0,7,1,0.0,1.0,0.0,1.0
SF-L22,SF-C26,5,12,0,4,5,8,0.0,1.0,0.3333333333333333,0.6666666666666666
SF-L22,SF-C25,6,22,3,3,3,19,0.5,0.5,0.13636363636363635,0.8636363636363636
SF-L22,SF-B25,3,7,0,3,3,4,0.0,1.0,0.42857142857142855,0.5714285714285714
SF-L22,SF-E27,3,4,0,0,3,4,0.0,1.0,0.0,1.0
SF-L22,SF-D27,5,9,1,2,4,7,0.2,0.8,0.2222222222222222,0.7777777777777778
SF-L22,SF-C28-2,3,1,1,1,2,0,0.3333333333333333,0.6666666666666666,1.0,0.0
SF-L22,SF-J5,2,1,0,1,2,0,0.0,1.0,1.0,0.0
SF-L22,SF-G7,2,3,1,1,1,2,0.5,0.5,0.3333333333333333,0.6666666666666666
SF-L22,SF-F9,1,1,0,0,1,1,0.0,1.0,0.0,1.0
SF-L22,SF-H25,4,12,1,9,3,3,0.25,0.75,0.75,0.25
SF-L22,SF-G26,13,18,3,5,10,13,0.23076923076923078,0.7692307692307693,0.2777777777777778,0.7222222222222222
SF-L22,SF-K21,10,11,1,0,9,11,0.1,0.9,0.0,1.0
SF-L22,SF-K22-1,6,15,6,12,0,3,1.0,0.0,0.8,0.2
SF-L22,SF-J23-1,46,66,17,33,29,33,0.3695652173913043,0.6304347826086957,0.5,0.5
SF-L22,SF-J22-1,17,13,6,5,11,8,0.35294117647058826,0.6470588235294118,0.38461538461538464,0.6153846153846154
SF-L22,SF-J22-2,10,15,5,4,5,11,0.5,0.5,0.26666666666666666,0.7333333333333333
SF-L22,SF-J21,18,23,6,7,12,16,0.3333333333333333,0.6666666666666666,0.30434782608695654,0.6956521739130435
SF-L22,SF-I21,1,4,1,4,0,0,1.0,0.0,1.0,0.0
SF-L22,SF-I22,24,20,6,1,18,19,0.25,0.75,0.05,0.95
SF-L22,SF-I23-2,9,14,8,11,1,3,0.8888888888888888,0.1111111111111111,0.7857142857142857,0.21428571428571427
SF-L22,SF-I24,4,5,3,4,1,1,0.75,0.25,0.8,0.2
SF-L22,SF-I23-1,60,40,50,28,10,12,0.8333333333333334,0.16666666666666666,0.7,0.3
SF-L22,SF-F26,26,21,12,4,14,17,0.46153846153846156,0.5384615384615384,0.19047619047619047,0.8095238095238095
SF-L22,SF-M13,1,3,0,0,1,3,0.0,1.0,0.0,1.0
SF-L22,SF-M15,15,9,7,0,8,9,0.4666666666666667,0.5333333333333333,0.0,1.0
SF-L22,SF-L19,20,12,12,0,8,12,0.6,0.4,0.0,1.0
SF-L22,SF-L20,17,13,2,6,15,7,0.11764705882352941,0.8823529411764706,0.46153846153846156,0.5384615384615384
SF-L22,SF-N20-1,18,15,4,4,14,11,0.2222222222222222,0.7777777777777778,0.26666666666666666,0.7333333333333333
SF-L22,SF-M20,26,15,14,4,12,11,0.5384615384615384,0.46153846153846156,0.26666666666666666,0.7333333333333333
SF-L22,SF-K17-2,8,10,2,0,6,10,0.25,0.75,0.0,1.0
SF-L22,SF-K20,16,31,5,5,11,26,0.3125,0.6875,0.16129032258064516,0.8387096774193549
SF-L22,SF-K15-,8,28,4,4,4,24,0.5,0.5,0.14285714285714285,0.8571428571428571
SF-L22,SF-K19,24,15,8,0,16,15,0.3333333333333333,0.6666666666666666,0.0,1.0
SF-L22,SF-K18,17,18,4,5,13,13,0.23529411764705882,0.7647058823529411,0.2777777777777778,0.7222222222222222
SF-L22,SF-K17,17,13,3,4,14,9,0.17647058823529413,0.8235294117647058,0.3076923076923077,0.6923076923076923
SF-L22,SF-J16,13,10,3,1,10,9,0.23076923076923078,0.7692307692307693,0.1,0.9
SF-L22,SF-J18,33,22,7,6,26,16,0.21212121212121213,0.7878787878787878,0.2727272727272727,0.7272727272727273
SF-L22,SF-J20,10,13,4,1,6,12,0.4,0.6,0.07692307692307693,0.9230769230769231
SF-L22,SF-J19,7,7,3,0,4,7,0.42857142857142855,0.5714285714285714,0.0,1.0
SF-L22,SF-M12,9,11,2,0,7,11,0.2222222222222222,0.7777777777777778,0.0,1.0
SF-L22,SF-M10,2,1,0,0,2,1,0.0,1.0,0.0,1.0
SF-L22,SF-M11,9,6,1,0,8,6,0.1111111111111111,0.8888888888888888,0.0,1.0
SF-L22,SF-R19,23,23,4,4,19,19,0.17391304347826086,0.8260869565217391,0.17391304347826086,0.8260869565217391
SF-L22,SF-R20,17,13,7,4,10,9,0.4117647058823529,0.5882352941176471,0.3076923076923077,0.6923076923076923
SF-L22,SF-Q21-2,24,13,12,0,12,13,0.5,0.5,0.0,1.0
SF-L22,SF-Q21-1,22,15,10,10,12,5,0.45454545454545453,0.5454545454545454,0.6666666666666666,0.3333333333333333
SF-L22,SF-P21,9,16,3,4,6,12,0.3333333333333333,0.6666666666666666,0.25,0.75
SF-L22,SF-O18,20,17,5,0,15,17,0.25,0.75,0.0,1.0
SF-L22,SF-O19,27,34,12,4,15,30,0.4444444444444444,0.5555555555555556,0.11764705882352941,0.8823529411764706
SF-L22,SF-O21,54,42,21,19,33,23,0.3888888888888889,0.6111111111111112,0.4523809523809524,0.5476190476190477
SF-L22,SF-O22,79,98,33,53,46,45,0.4177215189873418,0.5822784810126582,0.5408163265306123,0.45918367346938777
SF-L22,SF-N21,8,12,4,7,4,5,0.5,0.5,0.5833333333333334,0.4166666666666667
SF-L22,SF-N20-2,12,6,5,2,7,4,0.4166666666666667,0.5833333333333334,0.3333333333333333,0.6666666666666666
SF-L22,SF-M21,18,10,11,4,7,6,0.6111111111111112,0.3888888888888889,0.4,0.6
SF-L22,SF-L21,75,45,11,9,64,36,0.14666666666666667,0.8533333333333334,0.2,0.8
SF-L22,SF-S29,5,1,1,0,4,1,0.2,0.8,0.0,1.0
SF-L22,SF-Q30,3,5,1,0,2,5,0.3333333333333333,0.6666666666666666,0.0,1.0
SF-L22,SF-P30,16,8,1,0,15,8,0.0625,0.9375,0.0,1.0
SF-L22,SF-O30-2,5,3,3,1,2,2,0.6,0.4,0.3333333333333333,0.6666666666666666
SF-L22,SF-O30,11,5,4,3,7,2,0.36363636363636365,0.6363636363636364,0.6,0.4
SF-L22,SF-N27,8,10,3,4,5,6,0.375,0.625,0.4,0.6
SF-L22,SF-N29,3,5,2,2,1,3,0.6666666666666666,0.3333333333333333,0.4,0.6
SF-L22,SF-N28,9,16,1,5,8,11,0.1111111111111111,0.8888888888888888,0.3125,0.6875
SF-L22,SF-L30-1,14,50,8,32,6,18,0.5714285714285714,0.42857142857142855,0.64,0.36
SF-L22,SF-L29,11,5,4,3,7,2,0.36363636363636365,0.6363636363636364,0.6,0.4
SF-L22,SF-J29-1,7,5,0,0,7,5,0.0,1.0,0.0,1.0
SF-L22,SF-I30,2,1,1,1,1,0,0.5,0.5,1.0,0.0
SF-L22,SF-I29-2,2,2,0,0,2,2,0.0,1.0,0.0,1.0
SF-L22,SF-I27,3,4,1,2,2,2,0.3333333333333333,0.6666666666666666,0.5,0.5
SF-L22,SF-I28,3,1,1,1,2,0,0.3333333333333333,0.6666666666666666,1.0,0.0
SF-L22,SF-I30-2,3,7,2,1,1,6,0.6666666666666666,0.3333333333333333,0.14285714285714285,0.8571428571428571
SF-L22,SF I29-1,2,1,2,1,0,0,1.0,0.0,1.0,0.0
SF-L22,SF-H28,5,5,2,2,3,3,0.4,0.6,0.4,0.6
SF-L22,SF-H29,2,1,1,1,1,0,0.5,0.5,1.0,0.0
SF-L22,SF-S24,16,17,8,4,8,13,0.5,0.5,0.23529411764705882,0.7647058823529411
SF-L22,SF-R24,25,30,13,16,12,14,0.52,0.48,0.5333333333333333,0.4666666666666667
SF-L22,SF-R26,11,13,3,3,8,10,0.2727272727272727,0.7272727272727273,0.23076923076923078,0.7692307692307693
SF-L22,SF-Q26,12,12,1,9,11,3,0.08333333333333333,0.9166666666666666,0.75,0.25
SF-L22,SF-P26,13,5,3,1,10,4,0.23076923076923078,0.7692307692307693,0.2,0.8
SF-L22,SF-O25-2,7,14,2,5,5,9,0.2857142857142857,0.7142857142857143,0.35714285714285715,0.6428571428571429
SF-L22,SF-N22-1B,25,37,12,20,13,17,0.48,0.52,0.5405405405405406,0.4594594594594595
SF-L22,SF-N26,5,2,2,0,3,2,0.4,0.6,0.0,1.0
SF-L22,SF-N25,17,6,12,2,5,4,0.7058823529411765,0.29411764705882354,0.3333333333333333,0.6666666666666666
SF-L22,SF-T21,4,6,2,3,2,3,0.5,0.5,0.5,0.5
SF-L22,SF-T22,17,20,6,14,11,6,0.35294117647058826,0.6470588235294118,0.7,0.3
SF-L22,SF-S22-2,11,3,3,2,8,1,0.2727272727272727,0.7272727272727273,0.6666666666666666,0.3333333333333333
SF-L22,SF-S22-1,42,30,17,16,25,14,0.40476190476190477,0.5952380952380952,0.5333333333333333,0.4666666666666667
SF-L22,SF-Q23-3,35,19,20,11,15,8,0.5714285714285714,0.42857142857142855,0.5789473684210527,0.42105263157894735
SF-L22,SF-Q22-1,114,80,68,51,46,29,0.5964912280701754,0.40350877192982454,0.6375,0.3625
SF-L22,SF-Q22-2,100,70,38,29,62,41,0.38,0.62,0.4142857142857143,0.5857142857142857
SF-L22,SF-P22,57,75,28,35,29,40,0.49122807017543857,0.5087719298245614,0.4666666666666667,0.5333333333333333
SF-L22,SF-W19,4,2,0,0,4,2,0.0,1.0,0.0,1.0
SF-L22,SF-U21,4,2,1,1,3,1,0.25,0.75,0.5,0.5
SF-L22,SF-T20,22,44,17,11,5,33,0.7727272727272727,0.22727272727272727,0.25,0.75
SF-L22,SF-S21,4,4,1,0,3,4,0.25,0.75,0.0,1.0
SF-L22,SF-Y30,9,12,0,2,9,10,0.0,1.0,0.16666666666666666,0.8333333333333334
SF-L22,SF-Y14,1,3,0,0,1,3,0.0,1.0,0.0,1.0
SF-L22,SF-X19,1,2,1,0,0,2,1.0,0.0,0.0,1.0
SF-F27,SF-M26,5,3,3,0,2,3,0.6,0.4,0.0,1.0
SF-F27,SF-M25,6,6,1,3,5,3,0.16666666666666666,0.8333333333333334,0.5,0.5
SF-F27,SF-M26-2,15,11,3,3,12,8,0.2,0.8,0.2727272727272727,0.7272727272727273
SF-F27,SF-L27,5,19,2,1,3,18,0.4,0.6,0.05263157894736842,0.9473684210526315
SF-F27,SF-K26,8,16,2,7,6,9,0.25,0.75,0.4375,0.5625
SF-F27,SF-J27,8,11,4,1,4,10,0.5,0.5,0.09090909090909091,0.9090909090909091
SF-F27,SF-M30,23,10,8,3,15,7,0.34782608695652173,0.6521739130434783,0.3,0.7
SF-F27,SF-J29-3,9,13,3,8,6,5,0.3333333333333333,0.6666666666666666,0.6153846153846154,0.38461538461538464
SF-F27,SF-J29,27,39,7,13,20,26,0.25925925925925924,0.7407407407407407,0.3333333333333333,0.6666666666666666
SF-F27,SF-L26,3,19,1,3,2,16,0.3333333333333333,0.6666666666666666,0.15789473684210525,0.8421052631578947
SF-F27,SF-M28,5,2,0,0,5,2,0.0,1.0,0.0,1.0
SF-F27,SF-L25,5,8,2,7,3,1,0.4,0.6,0.875,0.125
SF-F27,SF-M24,6,3,2,3,4,0,0.3333333333333333,0.6666666666666666,1.0,0.0
SF-F27,SF-L24,5,3,2,2,3,1,0.4,0.6,0.6666666666666666,0.3333333333333333
SF-F27,SF-N23,9,8,4,5,5,3,0.4444444444444444,0.5555555555555556,0.625,0.375
SF-F27,SF-N24-2,2,14,0,2,2,12,0.0,1.0,0.14285714285714285,0.8571428571428571
SF-F27,SF-K27-2,17,14,4,8,13,6,0.23529411764705882,0.7647058823529411,0.5714285714285714,0.42857142857142855
SF-F27,SF-J26-2,31,26,11,10,20,16,0.3548387096774194,0.6451612903225806,0.38461538461538464,0.6153846153846154
SF-F27,SF-K28-3,1,1,1,0,0,1,1.0,0.0,0.0,1.0
SF-F27,SF-L28,6,5,5,4,1,1,0.8333333333333334,0.16666666666666666,0.8,0.2
SF-F27,SF-K28,6,5,4,2,2,3,0.6666666666666666,0.3333333333333333,0.4,0.6
SF-F27,SF-K29-1,35,26,21,11,14,15,0.6,0.4,0.4230769230769231,0.5769230769230769
SF-F27,SF-J28-2,12,13,2,3,10,10,0.16666666666666666,0.8333333333333334,0.23076923076923078,0.7692307692307693
SF-F27,SF-K27,5,4,5,0,0,4,1.0,0.0,0.0,1.0
SF-F27,SF-K25,19,10,1,4,18,6,0.05263157894736842,0.9473684210526315,0.4,0.6
SF-F27,SF-J25,24,22,17,8,7,14,0.7083333333333334,0.2916666666666667,0.36363636363636365,0.6363636363636364
SF-F27,SF-H26-2,9,10,6,2,3,8,0.6666666666666666,0.3333333333333333,0.2,0.8
SF-F27,SF-P24,1,8,0,1,1,7,0.0,1.0,0.125,0.875
SF-F27,SF-N22-1A,3,1,2,1,1,0,0.6666666666666666,0.3333333333333333,1.0,0.0
SF-F27,SF-J24,11,12,7,4,4,8,0.6363636363636364,0.36363636363636365,0.3333333333333333,0.6666666666666666
SF-F27,SF-O24,7,6,1,5,6,1,0.14285714285714285,0.8571428571428571,0.8333333333333334,0.16666666666666666
SF-F27,SF-J26,11,5,2,2,9,3,0.18181818181818182,0.8181818181818182,0.4,0.6
SF-F27,SF-I26-,10,12,6,6,4,6,0.6,0.4,0.5,0.5
SF-F27,SF-I25,46,34,25,23,21,11,0.5434782608695652,0.45652173913043476,0.6764705882352942,0.3235294117647059
SF-F27,SF-K23,3,2,3,1,0,1,1.0,0.0,0.5,0.5
SF-F27,SF-H26,81,78,62,65,19,13,0.7654320987654321,0.2345679012345679,0.8333333333333334,0.16666666666666666
SF-F27,SF-O23,46,4,3,0,43,4,0.06521739130434782,0.9347826086956522,0.0,1.0
SF-F27,SF-H27-1,19,11,15,6,4,5,0.7894736842105263,0.21052631578947367,0.5454545454545454,0.45454545454545453
SF-F27,SF-F28-2,61,65,46,38,15,27,0.7540983606557377,0.2459016393442623,0.5846153846153846,0.4153846153846154
SF-F27,SF-G27,67,92,44,58,23,34,0.6567164179104478,0.34328358208955223,0.6304347826086957,0.3695652173913043
SF-F27,SF-M22-2,10,16,1,6,9,10,0.1,0.9,0.375,0.625
SF-F27,SF-L22,11,12,7,6,4,6,0.6363636363636364,0.36363636363636365,0.5,0.5
SF-F27,SF-N22-2,18,20,6,5,12,15,0.3333333333333333,0.6666666666666666,0.25,0.75
SF-F27,SF-G28-2,4,4,4,2,0,2,1.0,0.0,0.5,0.5
SF-F27,SF-G28-1,12,8,9,6,3,2,0.75,0.25,0.75,0.25
SF-F27,SF-M22-1,8,5,2,2,6,3,0.25,0.75,0.4,0.6
SF-F27,SF-O25-1,3,1,2,0,1,1,0.6666666666666666,0.3333333333333333,0.0,1.0
SF-F27,SF-K22-2,34,19,27,17,7,2,0.7941176470588235,0.20588235294117646,0.8947368421052632,0.10526315789473684
SF-F27,SF-K24,14,11,2,5,12,6,0.14285714285714285,0.8571428571428571,0.45454545454545453,0.5454545454545454
SF-F27,SF-J23-2,8,8,5,3,3,5,0.625,0.375,0.375,0.625
SF-F27,SF-G23,12,12,1,3,11,9,0.08333333333333333,0.9166666666666666,0.25,0.75
SF-F27,SF-G24,123,42,53,9,70,33,0.43089430894308944,0.5691056910569106,0.21428571428571427,0.7857142857142857
SF-F27,SF-G25,91,55,65,12,26,43,0.7142857142857143,0.2857142857142857,0.21818181818181817,0.7818181818181819
SF-F27,SF-F23,31,40,9,6,22,34,0.2903225806451613,0.7096774193548387,0.15,0.85
SF-F27,SF-E23,26,29,5,3,21,26,0.19230769230769232,0.8076923076923077,0.10344827586206896,0.896551724137931
SF-F27,SF-D24,26,8,7,0,19,8,0.2692307692307692,0.7307692307692307,0.0,1.0
SF-F27,SF-C22,6,11,2,2,4,9,0.3333333333333333,0.6666666666666666,0.18181818181818182,0.8181818181818182
SF-F27,SF-B22,12,33,2,9,10,24,0.16666666666666666,0.8333333333333334,0.2727272727272727,0.7272727272727273
SF-F27,SF-J17,7,4,2,0,5,4,0.2857142857142857,0.7142857142857143,0.0,1.0
SF-F27,SF-I19,8,2,5,0,3,2,0.625,0.375,0.0,1.0
SF-F27,SF-I20,9,5,3,2,6,3,0.3333333333333333,0.6666666666666666,0.4,0.6
SF-F27,SF-H16,4,2,2,1,2,1,0.5,0.5,0.5,0.5
SF-F27,SF-H19,2,1,0,0,2,1,0.0,1.0,0.0,1.0
SF-F27,SF-H20,5,5,0,0,5,5,0.0,1.0,0.0,1.0
SF-F27,SF-H17,1,2,0,0,1,2,0.0,1.0,0.0,1.0
SF-F27,SF-G19,3,2,0,0,3,2,0.0,1.0,0.0,1.0
SF-F27,SF-G17,6,4,1,0,5,4,0.16666666666666666,0.8333333333333334,0.0,1.0
SF-F27,SF-G18,13,14,2,0,11,14,0.15384615384615385,0.8461538461538461,0.0,1.0
SF-F27,SF-G20,53,46,8,6,45,40,0.1509433962264151,0.8490566037735849,0.13043478260869565,0.8695652173913043
SF-F27,SF-F19,5,14,1,0,4,14,0.2,0.8,0.0,1.0
SF-F27,SF-E18,11,14,4,1,7,13,0.36363636363636365,0.6363636363636364,0.07142857142857142,0.9285714285714286
SF-F27,SF-E20,138,131,0,1,138,130,0.0,1.0,0.007633587786259542,0.9923664122137404
SF-F27,SF-H30,13,9,9,7,4,2,0.6923076923076923,0.3076923076923077,0.7777777777777778,0.2222222222222222
SF-F27,SF-G30-2,38,43,23,8,15,35,0.6052631578947368,0.39473684210526316,0.18604651162790697,0.813953488372093
SF-F27,SF-F30-1,6,22,5,18,1,4,0.8333333333333334,0.16666666666666666,0.8181818181818182,0.18181818181818182
SF-F27,SF-E29-2,30,56,19,35,11,21,0.6333333333333333,0.36666666666666664,0.625,0.375
SF-F27,SF-E29-1,46,38,32,28,14,10,0.6956521739130435,0.30434782608695654,0.7368421052631579,0.2631578947368421
SF-F27,SF-D29,18,23,12,14,6,9,0.6666666666666666,0.3333333333333333,0.6086956521739131,0.391304347826087
SF-F27,SF-D28,65,82,59,70,6,12,0.9076923076923077,0.09230769230769231,0.8536585365853658,0.14634146341463414
SF-F27,SF-A27,16,31,11,22,5,9,0.6875,0.3125,0.7096774193548387,0.2903225806451613
SF-F27,SF-G29-2,53,43,40,18,13,25,0.7547169811320755,0.24528301886792453,0.4186046511627907,0.5813953488372093
SF-F27,SF-G29-1,27,34,23,22,4,12,0.8518518518518519,0.14814814814814814,0.6470588235294118,0.35294117647058826
SF-F27,SF-G30-1,39,36,32,23,7,13,0.8205128205128205,0.1794871794871795,0.6388888888888888,0.3611111111111111
SF-F27,SF-G29-3,46,27,39,14,7,13,0.8478260869565217,0.15217391304347827,0.5185185185185185,0.48148148148148145
SF-F27,SF-F30-2,17,8,11,8,6,0,0.6470588235294118,0.35294117647058826,1.0,0.0
SF-F27,SF-F29,24,22,18,9,6,13,0.75,0.25,0.4090909090909091,0.5909090909090909
SF-F27,SF-E29-3,16,18,2,5,14,13,0.125,0.875,0.2777777777777778,0.7222222222222222
SF-F27,SF-F28-1,35,23,26,17,9,6,0.7428571428571429,0.2571428571428571,0.7391304347826086,0.2608695652173913
SF-F27,SF-E28-2,11,11,5,5,6,6,0.45454545454545453,0.5454545454545454,0.45454545454545453,0.5454545454545454
SF-F27,SF-E28,8,10,6,6,2,4,0.75,0.25,0.6,0.4
SF-F27,SF-J10,1,3,1,0,0,3,1.0,0.0,0.0,1.0
SF-F27,SF-J12,7,6,3,1,4,5,0.42857142857142855,0.5714285714285714,0.16666666666666666,0.8333333333333334
SF-F27,SF-J13,10,2,6,0,4,2,0.6,0.4,0.0,1.0
SF-F27,SF-H12,1,2,0,0,1,2,0.0,1.0,0.0,1.0
SF-F27,SF-G10-2,2,2,0,0,2,2,0.0,1.0,0.0,1.0
SF-F27,SF-G9,1,1,0,0,1,1,0.0,1.0,0.0,1.0
SF-F27,SF-G13,6,5,0,0,6,5,0.0,1.0,0.0,1.0
SF-F27,SF-G12,1,1,0,0,1,1,0.0,1.0,0.0,1.0
SF-F27,SF-F15,4,4,0,0,4,4,0.0,1.0,0.0,1.0
SF-F27,SF-C21,9,4,0,0,9,4,0.0,1.0,0.0,1.0
SF-F27,SF-C20,18,52,0,6,18,46,0.0,1.0,0.11538461538461539,0.8846153846153846
SF-F27,SF-B21,5,3,1,0,4,3,0.2,0.8,0.0,1.0
SF-F27,SF-B19,17,14,0,4,17,10,0.0,1.0,0.2857142857142857,0.7142857142857143
SF-F27,SF-A20,15,9,3,4,12,5,0.2,0.8,0.4444444444444444,0.5555555555555556
SF-F27,SF-A19,1,4,0,3,1,1,0.0,1.0,0.75,0.25
SF-F27,SF-C26,35,58,16,19,19,39,0.45714285714285713,0.5428571428571428,0.3275862068965517,0.6724137931034483
SF-F27,SF-C25,44,44,14,18,30,26,0.3181818181818182,0.6818181818181818,0.4090909090909091,0.5909090909090909
SF-F27,SF-B25,27,26,6,9,21,17,0.2222222222222222,0.7777777777777778,0.34615384615384615,0.6538461538461539
SF-F27,SF-E27,12,16,6,6,6,10,0.5,0.5,0.375,0.625
SF-F27,SF-B28-2,3,15,2,9,1,6,0.6666666666666666,0.3333333333333333,0.6,0.4
SF-F27,SF-D27,49,68,37,50,12,18,0.7551020408163265,0.24489795918367346,0.7352941176470589,0.2647058823529412
SF-F27,SF-C28-2,3,4,1,1,2,3,0.3333333333333333,0.6666666666666666,0.25,0.75
SF-F27,SF-C28-1,2,5,2,1,0,4,1.0,0.0,0.2,0.8
SF-F27,SF-B28,20,37,14,29,6,8,0.7,0.3,0.7837837837837838,0.21621621621621623
SF-F27,SF-J1,1,3,1,1,0,2,1.0,0.0,0.3333333333333333,0.6666666666666666
SF-F27,SF-J5,2,3,0,0,2,3,0.0,1.0,0.0,1.0
SF-F27,SF-G6,1,1,1,0,0,1,1.0,0.0,0.0,1.0
SF-F27,SF-G5,4,3,0,0,4,3,0.0,1.0,0.0,1.0
SF-F27,SF-G7,3,3,0,0,3,3,0.0,1.0,0.0,1.0
SF-F27,SF-H25,11,31,6,23,5,8,0.5454545454545454,0.45454545454545453,0.7419354838709677,0.25806451612903225
SF-F27,SF-G26,27,47,19,27,8,20,0.7037037037037037,0.2962962962962963,0.574468085106383,0.425531914893617
SF-F27,SF-K21,15,5,6,0,9,5,0.4,0.6,0.0,1.0
SF-F27,SF-K22-1,38,50,18,28,20,22,0.47368421052631576,0.5263157894736842,0.56,0.44
SF-F27,SF-J23-1,125,91,61,34,64,57,0.488,0.512,0.37362637362637363,0.6263736263736264
SF-F27,SF-J22-1,11,16,4,5,7,11,0.36363636363636365,0.6363636363636364,0.3125,0.6875
SF-F27,SF-J22-2,43,33,11,14,32,19,0.2558139534883721,0.7441860465116279,0.42424242424242425,0.5757575757575758
SF-F27,SF-J21,58,74,18,15,40,59,0.3103448275862069,0.6896551724137931,0.20270270270270271,0.7972972972972973
SF-F27,SF-I21,44,25,7,0,37,25,0.1590909090909091,0.8409090909090909,0.0,1.0
SF-F27,SF-I22,5,9,4,1,1,8,0.8,0.2,0.1111111111111111,0.8888888888888888
SF-F27,SF-I23-2,7,9,3,2,4,7,0.42857142857142855,0.5714285714285714,0.2222222222222222,0.7777777777777778
SF-F27,SF-I24,9,5,6,4,3,1,0.6666666666666666,0.3333333333333333,0.8,0.2
SF-F27,SF-I23-1,11,57,4,31,7,26,0.36363636363636365,0.6363636363636364,0.543859649122807,0.45614035087719296
SF-F27,SF-F26,52,74,35,25,17,49,0.6730769230769231,0.3269230769230769,0.33783783783783783,0.6621621621621622
SF-F27,SF-M13,50,13,4,0,46,13,0.08,0.92,0.0,1.0
SF-F27,SF-M15,11,10,2,2,9,8,0.18181818181818182,0.8181818181818182,0.2,0.8
SF-F27,SF-L19,22,29,9,4,13,25,0.4090909090909091,0.5909090909090909,0.13793103448275862,0.8620689655172413
SF-F27,SF-L20,58,28,41,1,17,27,0.7068965517241379,0.29310344827586204,0.03571428571428571,0.9642857142857143
SF-F27,SF-N20-1,14,8,7,2,7,6,0.5,0.5,0.25,0.75
SF-F27,SF-M20,45,19,25,5,20,14,0.5555555555555556,0.4444444444444444,0.2631578947368421,0.7368421052631579
SF-F27,SF-K17-2,5,3,1,0,4,3,0.2,0.8,0.0,1.0
SF-F27,SF-K20,20,15,8,1,12,14,0.4,0.6,0.06666666666666667,0.9333333333333333
SF-F27,SF-K15-,5,10,0,3,5,7,0.0,1.0,0.3,0.7
SF-F27,SF-K19,19,13,9,0,10,13,0.47368421052631576,0.5263157894736842,0.0,1.0
SF-F27,SF-K18,5,8,2,2,3,6,0.4,0.6,0.25,0.75
SF-F27,SF-K17,6,5,3,2,3,3,0.5,0.5,0.4,0.6
SF-F27,SF-J16,4,2,0,1,4,1,0.0,1.0,0.5,0.5
SF-F27,SF-J18,5,10,2,2,3,8,0.4,0.6,0.2,0.8
SF-F27,SF-J20,3,9,1,3,2,6,0.3333333333333333,0.6666666666666666,0.3333333333333333,0.6666666666666666
SF-F27,SF-J19,72,40,19,2,53,38,0.2638888888888889,0.7361111111111112,0.05,0.95
SF-F27,SF-M12,51,11,20,0,31,11,0.39215686274509803,0.6078431372549019,0.0,1.0
SF-F27,SF-M10,1,4,0,0,1,4,0.0,1.0,0.0,1.0
SF-F27,SF-M11,2,1,0,0,2,1,0.0,1.0,0.0,1.0
SF-F27,SF-R19,2,3,1,0,1,3,0.5,0.5,0.0,1.0
SF-F27,SF-R20,2,1,0,0,2,1,0.0,1.0,0.0,1.0
SF-F27,SF-Q21-2,9,5,3,0,6,5,0.3333333333333333,0.6666666666666666,0.0,1.0
SF-F27,SF-Q21-1,12,14,9,4,3,10,0.75,0.25,0.2857142857142857,0.7142857142857143
SF-F27,SF-P21,4,6,0,1,4,5,0.0,1.0,0.16666666666666666,0.8333333333333334
SF-F27,SF-O18,16,29,3,7,13,22,0.1875,0.8125,0.2413793103448276,0.7586206896551724
SF-F27,SF-O19,7,28,1,17,6,11,0.14285714285714285,0.8571428571428571,0.6071428571428571,0.39285714285714285
SF-F27,SF-O21,9,8,6,1,3,7,0.6666666666666666,0.3333333333333333,0.125,0.875
SF-F27,SF-O22,39,51,7,8,32,43,0.1794871794871795,0.8205128205128205,0.1568627450980392,0.8431372549019608
SF-F27,SF-N21,17,5,14,3,3,2,0.8235294117647058,0.17647058823529413,0.6,0.4
SF-F27,SF-N20-2,6,4,5,3,1,1,0.8333333333333334,0.16666666666666666,0.75,0.25
SF-F27,SF-M21,9,2,3,1,6,1,0.3333333333333333,0.6666666666666666,0.5,0.5
SF-F27,SF-L21,137,78,11,16,126,62,0.08029197080291971,0.9197080291970803,0.20512820512820512,0.7948717948717948
SF-F27,SF-Q30,12,11,5,2,7,9,0.4166666666666667,0.5833333333333334,0.18181818181818182,0.8181818181818182
SF-F27,SF-P30,8,4,3,3,5,1,0.375,0.625,0.75,0.25
SF-F27,SF-O30-2,5,10,3,6,2,4,0.6,0.4,0.6,0.4
SF-F27,SF-O30,13,10,6,4,7,6,0.46153846153846156,0.5384615384615384,0.4,0.6
SF-F27,SF-N27,46,48,36,32,10,16,0.782608695652174,0.21739130434782608,0.6666666666666666,0.3333333333333333
SF-F27,SF-N29,17,18,15,15,2,3,0.8823529411764706,0.11764705882352941,0.8333333333333334,0.16666666666666666
SF-F27,SF-N28,14,23,7,8,7,15,0.5,0.5,0.34782608695652173,0.6521739130434783
SF-F27,SF-L30-1,34,14,13,10,21,4,0.38235294117647056,0.6176470588235294,0.7142857142857143,0.2857142857142857
SF-F27,SF-L31-1,36,11,6,7,30,4,0.16666666666666666,0.8333333333333334,0.6363636363636364,0.36363636363636365
SF-F27,SF-K30-2,74,57,15,9,59,48,0.20270270270270271,0.7972972972972973,0.15789473684210525,0.8421052631578947
SF-F27,SF-L29,27,20,12,10,15,10,0.4444444444444444,0.5555555555555556,0.5,0.5
SF-F27,SF-J29-1,49,8,19,5,30,3,0.3877551020408163,0.6122448979591837,0.625,0.375
SF-F27,SF-I30,51,144,29,110,22,34,0.5686274509803921,0.43137254901960786,0.7638888888888888,0.2361111111111111
SF-F27,SF-I29-2,10,11,5,6,5,5,0.5,0.5,0.5454545454545454,0.45454545454545453
SF-F27,SF-I27,30,15,16,8,14,7,0.5333333333333333,0.4666666666666667,0.5333333333333333,0.4666666666666667
SF-F27,SF-I28,5,16,1,8,4,8,0.2,0.8,0.5,0.5
SF-F27,SF-I30-2,46,32,28,11,18,21,0.6086956521739131,0.391304347826087,0.34375,0.65625
SF-F27,SF I29-1,33,21,10,5,23,16,0.30303030303030304,0.696969696969697,0.23809523809523808,0.7619047619047619
SF-F27,SF-H28,102,65,84,51,18,14,0.8235294117647058,0.17647058823529413,0.7846153846153846,0.2153846153846154
SF-F27,SF-H29,10,7,6,2,4,5,0.6,0.4,0.2857142857142857,0.7142857142857143
SF-F27,SF-S24,17,19,4,2,13,17,0.23529411764705882,0.7647058823529411,0.10526315789473684,0.8947368421052632
SF-F27,SF-R24,9,7,3,0,6,7,0.3333333333333333,0.6666666666666666,0.0,1.0
SF-F27,SF-R26,4,1,1,0,3,1,0.25,0.75,0.0,1.0
SF-F27,SF-Q26,2,1,0,0,2,1,0.0,1.0,0.0,1.0
SF-F27,SF-P26,32,24,11,10,21,14,0.34375,0.65625,0.4166666666666667,0.5833333333333334
SF-F27,SF-O25-2,8,10,2,3,6,7,0.25,0.75,0.3,0.7
SF-F27,SF-N22-1B,5,5,2,4,3,1,0.4,0.6,0.8,0.2
SF-F27,SF-N26,14,9,12,9,2,0,0.8571428571428571,0.14285714285714285,1.0,0.0
SF-F27,SF-T21,10,1,7,0,3,1,0.7,0.3,0.0,1.0
SF-F27,SF-S22-1,6,6,1,2,5,4,0.16666666666666666,0.8333333333333334,0.3333333333333333,0.6666666666666666
SF-F27,SF-Q23-3,16,6,7,0,9,6,0.4375,0.5625,0.0,1.0
SF-F27,SF-Q22-1,7,5,2,5,5,0,0.2857142857142857,0.7142857142857143,1.0,0.0
SF-F27,SF-Q22-2,13,12,3,6,10,6,0.23076923076923078,0.7692307692307693,0.5,0.5
SF-F27,SF-P22,11,9,3,4,8,5,0.2727272727272727,0.7272727272727273,0.4444444444444444,0.5555555555555556
SF-F27,SF-W19,3,14,0,2,3,12,0.0,1.0,0.14285714285714285,0.8571428571428571
SF-F27,SF-T20,11,3,2,0,9,3,0.18181818181818182,0.8181818181818182,0.0,1.0
SF-F27,SF-S21,3,3,0,0,3,3,0.0,1.0,0.0,1.0
SF-F27,SF-V28,3,3,0,0,3,3,0.0,1.0,0.0,1.0
SF-F27,SF-V30,2,5,1,2,1,3,0.5,0.5,0.4,0.6
SF-F27,SF-V31,2,7,1,5,1,2,0.5,0.5,0.7142857142857143,0.2857142857142857
SF-F27,SF-V32,2,2,2,2,0,0,1.0,0.0,1.0,0.0
SF-F27,SF-Y14,4,2,0,0,4,2,0.0,1.0,0.0,1.0
SF-N22-2,SF-M26,12,2,4,1,8,1,0.3333333333333333,0.6666666666666666,0.5,0.5
SF-N22-2,SF-M25,30,25,12,13,18,12,0.4,0.6,0.52,0.48
SF-N22-2,SF-M26-2,16,8,10,2,6,6,0.625,0.375,0.25,0.75
SF-N22-2,SF-L27,8,4,4,0,4,4,0.5,0.5,0.0,1.0
SF-N22-2,SF-K26,40,33,23,15,17,18,0.575,0.425,0.45454545454545453,0.5454545454545454
SF-N22-2,SF-J27,6,7,2,4,4,3,0.3333333333333333,0.6666666666666666,0.5714285714285714,0.42857142857142855
SF-N22-2,SF-M30,87,73,25,22,62,51,0.28735632183908044,0.7126436781609196,0.3013698630136986,0.6986301369863014
SF-N22-2,SF-L27-2,27,2,26,0,1,2,0.9629629629629629,0.037037037037037035,0.0,1.0
SF-N22-2,SF-J29-3,4,3,0,0,4,3,0.0,1.0,0.0,1.0
SF-N22-2,SF-J29,31,25,11,5,20,20,0.3548387096774194,0.6451612903225806,0.2,0.8
SF-N22-2,SF-L26,233,201,23,33,210,168,0.09871244635193133,0.9012875536480687,0.16417910447761194,0.835820895522388
SF-N22-2,SF-M28,20,18,8,7,12,11,0.4,0.6,0.3888888888888889,0.6111111111111112
SF-N22-2,SF-M27,3,1,1,1,2,0,0.3333333333333333,0.6666666666666666,1.0,0.0
SF-N22-2,SF-L25,48,19,38,13,10,6,0.7916666666666666,0.20833333333333334,0.6842105263157895,0.3157894736842105
SF-N22-2,SF-M24,28,47,18,23,10,24,0.6428571428571429,0.35714285714285715,0.48936170212765956,0.5106382978723404
SF-N22-2,SF-L24,49,28,14,19,35,9,0.2857142857142857,0.7142857142857143,0.6785714285714286,0.32142857142857145
SF-N22-2,SF-N23,43,41,33,31,10,10,0.7674418604651163,0.23255813953488372,0.7560975609756098,0.24390243902439024
SF-N22-2,SF-N24-2,36,46,25,30,11,16,0.6944444444444444,0.3055555555555556,0.6521739130434783,0.34782608695652173
SF-N22-2,SF-K27-2,38,24,17,6,21,18,0.4473684210526316,0.5526315789473685,0.25,0.75
SF-N22-2,SF-J26-2,12,27,2,9,10,18,0.16666666666666666,0.8333333333333334,0.3333333333333333,0.6666666666666666
SF-N22-2,SF-K28-3,2,3,0,1,2,2,0.0,1.0,0.3333333333333333,0.6666666666666666
SF-N22-2,SF-L28,8,9,3,5,5,4,0.375,0.625,0.5555555555555556,0.4444444444444444
SF-N22-2,SF-K28,8,5,2,0,6,5,0.25,0.75,0.0,1.0
SF-N22-2,SF-K29-1,33,22,16,12,17,10,0.48484848484848486,0.5151515151515151,0.5454545454545454,0.45454545454545453
SF-N22-2,SF-J28-2,11,9,0,1,11,8,0.0,1.0,0.1111111111111111,0.8888888888888888
SF-N22-2,SF-K25,63,55,37,26,26,29,0.5873015873015873,0.4126984126984127,0.4727272727272727,0.5272727272727272
SF-N22-2,SF-J25,109,19,46,6,63,13,0.42201834862385323,0.5779816513761468,0.3157894736842105,0.6842105263157895
SF-N22-2,SF-H26-2,7,5,3,2,4,3,0.42857142857142855,0.5714285714285714,0.4,0.6
SF-N22-2,SF-P24,28,28,11,18,17,10,0.39285714285714285,0.6071428571428571,0.6428571428571429,0.35714285714285715
SF-N22-2,SF-N22-1A,8,2,5,2,3,0,0.625,0.375,1.0,0.0
SF-N22-2,SF-J24,26,21,14,9,12,12,0.5384615384615384,0.46153846153846156,0.42857142857142855,0.5714285714285714
SF-N22-2,SF-O24,17,6,7,4,10,2,0.4117647058823529,0.5882352941176471,0.6666666666666666,0.3333333333333333
SF-N22-2,SF-J26,2,12,1,2,1,10,0.5,0.5,0.16666666666666666,0.8333333333333334
SF-N22-2,SF-I26-,13,11,11,7,2,4,0.8461538461538461,0.15384615384615385,0.6363636363636364,0.36363636363636365
SF-N22-2,SF-I25,32,29,11,13,21,16,0.34375,0.65625,0.4482758620689655,0.5517241379310345
SF-N22-2,SF-K23,5,6,3,5,2,1,0.6,0.4,0.8333333333333334,0.16666666666666666
SF-N22-2,SF-H26,52,41,22,17,30,24,0.4230769230769231,0.5769230769230769,0.4146341463414634,0.5853658536585366
SF-N22-2,SF-O23,21,12,16,8,5,4,0.7619047619047619,0.23809523809523808,0.6666666666666666,0.3333333333333333
SF-N22-2,SF-H27-1,15,3,12,1,3,2,0.8,0.2,0.3333333333333333,0.6666666666666666
SF-N22-2,SF-F28-2,27,33,7,10,20,23,0.25925925925925924,0.7407407407407407,0.30303030303030304,0.696969696969697
SF-N22-2,SF-G27,46,40,13,18,33,22,0.2826086956521739,0.717391304347826,0.45,0.55
SF-N22-2,SF-M22-2,32,56,12,34,20,22,0.375,0.625,0.6071428571428571,0.39285714285714285
SF-N22-2,SF-L22,43,61,29,27,14,34,0.6744186046511628,0.32558139534883723,0.4426229508196721,0.5573770491803278
SF-N22-2,SF-F27,20,18,5,6,15,12,0.25,0.75,0.3333333333333333,0.6666666666666666
SF-N22-2,SF-G28-2,11,18,1,4,10,14,0.09090909090909091,0.9090909090909091,0.2222222222222222,0.7777777777777778
SF-N22-2,SF-M22-1,40,31,23,4,17,27,0.575,0.425,0.12903225806451613,0.8709677419354839
SF-N22-2,SF-O25-1,26,22,16,14,10,8,0.6153846153846154,0.38461538461538464,0.6363636363636364,0.36363636363636365
SF-N22-2,SF-K22-2,27,33,17,22,10,11,0.6296296296296297,0.37037037037037035,0.6666666666666666,0.3333333333333333
SF-N22-2,SF-K24,56,33,31,18,25,15,0.5535714285714286,0.44642857142857145,0.5454545454545454,0.45454545454545453
SF-N22-2,SF-J23-2,19,15,9,7,10,8,0.47368421052631576,0.5263157894736842,0.4666666666666667,0.5333333333333333
SF-N22-2,SF-G23,9,11,3,4,6,7,0.3333333333333333,0.6666666666666666,0.36363636363636365,0.6363636363636364
SF-N22-2,SF-G24,36,66,17,1,19,65,0.4722222222222222,0.5277777777777778,0.015151515151515152,0.9848484848484849
SF-N22-2,SF-G25,20,12,8,6,12,6,0.4,0.6,0.5,0.5
SF-N22-2,SF-F23,48,25,12,2,36,23,0.25,0.75,0.08,0.92
SF-N22-2,SF-E23,20,22,3,7,17,15,0.15,0.85,0.3181818181818182,0.6818181818181818
SF-N22-2,SF-D24,4,9,2,3,2,6,0.5,0.5,0.3333333333333333,0.6666666666666666
SF-N22-2,SF-C22,10,6,2,1,8,5,0.2,0.8,0.16666666666666666,0.8333333333333334
SF-N22-2,SF-B22,14,8,2,1,12,7,0.14285714285714285,0.8571428571428571,0.125,0.875
SF-N22-2,SF-J17,28,28,7,0,21,28,0.25,0.75,0.0,1.0
SF-N22-2,SF-I19,8,13,3,3,5,10,0.375,0.625,0.23076923076923078,0.7692307692307693
SF-N22-2,SF-I20,8,5,1,0,7,5,0.125,0.875,0.0,1.0
SF-N22-2,SF-H16,1,2,0,0,1,2,0.0,1.0,0.0,1.0
SF-N22-2,SF-H19,3,2,0,1,3,1,0.0,1.0,0.5,0.5
SF-N22-2,SF-H20,23,20,10,7,13,13,0.43478260869565216,0.5652173913043478,0.35,0.65
SF-N22-2,SF-H18,5,3,3,0,2,3,0.6,0.4,0.0,1.0
SF-N22-2,SF-H17,6,1,1,0,5,1,0.16666666666666666,0.8333333333333334,0.0,1.0
SF-N22-2,SF-G19,11,9,4,4,7,5,0.36363636363636365,0.6363636363636364,0.4444444444444444,0.5555555555555556
SF-N22-2,SF-G17,3,2,0,0,3,2,0.0,1.0,0.0,1.0
SF-N22-2,SF-G18,17,7,0,1,17,6,0.0,1.0,0.14285714285714285,0.8571428571428571
SF-N22-2,SF-G20,12,12,3,2,9,10,0.25,0.75,0.16666666666666666,0.8333333333333334
SF-N22-2,SF-F19,5,7,0,0,5,7,0.0,1.0,0.0,1.0
SF-N22-2,SF-E18,7,2,2,1,5,1,0.2857142857142857,0.7142857142857143,0.5,0.5
SF-N22-2,SF-E20,8,11,0,1,8,10,0.0,1.0,0.09090909090909091,0.9090909090909091
SF-N22-2,SF-H30,9,3,9,2,0,1,1.0,0.0,0.6666666666666666,0.3333333333333333
SF-N22-2,SF-G30-2,13,9,8,5,5,4,0.6153846153846154,0.38461538461538464,0.5555555555555556,0.4444444444444444
SF-N22-2,SF-F30-1,3,7,2,1,1,6,0.6666666666666666,0.3333333333333333,0.14285714285714285,0.8571428571428571
SF-N22-2,SF-E29-2,23,25,13,14,10,11,0.5652173913043478,0.43478260869565216,0.56,0.44
SF-N22-2,SF-E29-1,13,13,4,7,9,6,0.3076923076923077,0.6923076923076923,0.5384615384615384,0.46153846153846156
SF-N22-2,SF-D29,6,13,1,10,5,3,0.16666666666666666,0.8333333333333334,0.7692307692307693,0.23076923076923078
SF-N22-2,SF-D28,3,4,0,0,3,4,0.0,1.0,0.0,1.0
SF-N22-2,SF-G29-2,8,46,3,2,5,44,0.375,0.625,0.043478260869565216,0.9565217391304348
SF-N22-2,SF-G29-1,11,8,5,3,6,5,0.45454545454545453,0.5454545454545454,0.375,0.625
SF-N22-2,SF-G30-1,16,3,12,0,4,3,0.75,0.25,0.0,1.0
SF-N22-2,SF-G29-3,7,10,2,0,5,10,0.2857142857142857,0.7142857142857143,0.0,1.0
SF-N22-2,SF-F30-2,4,4,0,0,4,4,0.0,1.0,0.0,1.0
SF-N22-2,SF-E29-3,3,3,0,1,3,2,0.0,1.0,0.3333333333333333,0.6666666666666666
SF-N22-2,SF-F28-1,8,6,2,2,6,4,0.25,0.75,0.3333333333333333,0.6666666666666666
SF-N22-2,SF-E28,6,7,2,2,4,5,0.3333333333333333,0.6666666666666666,0.2857142857142857,0.7142857142857143
SF-N22-2,SF-J10,9,9,2,1,7,8,0.2222222222222222,0.7777777777777778,0.1111111111111111,0.8888888888888888
SF-N22-2,SF-J12,6,12,1,5,5,7,0.16666666666666666,0.8333333333333334,0.4166666666666667,0.5833333333333334
SF-N22-2,SF-J13,6,2,3,0,3,2,0.5,0.5,0.0,1.0
SF-N22-2,SF-H13,2,3,0,0,2,3,0.0,1.0,0.0,1.0
SF-N22-2,SF-H12,2,5,0,0,2,5,0.0,1.0,0.0,1.0
SF-N22-2,SF-G10-2,2,3,0,2,2,1,0.0,1.0,0.6666666666666666,0.3333333333333333
SF-N22-2,SF-G13,4,3,2,1,2,2,0.5,0.5,0.3333333333333333,0.6666666666666666
SF-N22-2,SF-G11,3,4,0,0,3,4,0.0,1.0,0.0,1.0
SF-N22-2,SF-G12,5,10,0,0,5,10,0.0,1.0,0.0,1.0
SF-N22-2,SF-F15,11,2,2,0,9,2,0.18181818181818182,0.8181818181818182,0.0,1.0
SF-N22-2,SF-F16,9,4,2,1,7,3,0.2222222222222222,0.7777777777777778,0.25,0.75
SF-N22-2,SF-C20,3,4,0,2,3,2,0.0,1.0,0.5,0.5
SF-N22-2,SF-B21,5,3,1,1,4,2,0.2,0.8,0.3333333333333333,0.6666666666666666
SF-N22-2,SF-B19,1,6,0,0,1,6,0.0,1.0,0.0,1.0
SF-N22-2,SF-A20,5,4,0,2,5,2,0.0,1.0,0.5,0.5
SF-N22-2,SF-A19,2,2,0,0,2,2,0.0,1.0,0.0,1.0
SF-N22-2,SF-C26,12,10,3,2,9,8,0.25,0.75,0.2,0.8
SF-N22-2,SF-C25,11,19,1,0,10,19,0.09090909090909091,0.9090909090909091,0.0,1.0
SF-N22-2,SF-B25,6,4,0,0,6,4,0.0,1.0,0.0,1.0
SF-N22-2,SF-E27,7,1,3,1,4,0,0.42857142857142855,0.5714285714285714,1.0,0.0
SF-N22-2,SF-B28-2,8,2,1,1,7,1,0.125,0.875,0.5,0.5
SF-N22-2,SF-D27,9,14,4,4,5,10,0.4444444444444444,0.5555555555555556,0.2857142857142857,0.7142857142857143
SF-N22-2,SF-C28-2,7,10,6,9,1,1,0.8571428571428571,0.14285714285714285,0.9,0.1
SF-N22-2,SF-B28,9,11,1,1,8,10,0.1111111111111111,0.8888888888888888,0.09090909090909091,0.9090909090909091
SF-N22-2,SF-J1,9,10,0,2,9,8,0.0,1.0,0.2,0.8
SF-N22-2,SF-H0,4,1,0,0,4,1,0.0,1.0,0.0,1.0
SF-N22-2,SF-J3,4,3,0,1,4,2,0.0,1.0,0.3333333333333333,0.6666666666666666
SF-N22-2,SF-G7,8,3,1,0,7,3,0.125,0.875,0.0,1.0
SF-N22-2,SF-F9,3,1,0,0,3,1,0.0,1.0,0.0,1.0
SF-N22-2,SF-H25,10,14,5,4,5,10,0.5,0.5,0.2857142857142857,0.7142857142857143
SF-N22-2,SF-G26,19,6,5,4,14,2,0.2631578947368421,0.7368421052631579,0.6666666666666666,0.3333333333333333
SF-N22-2,SF-K21,24,27,8,6,16,21,0.3333333333333333,0.6666666666666666,0.2222222222222222,0.7777777777777778
SF-N22-2,SF-K22-1,41,31,32,25,9,6,0.7804878048780488,0.21951219512195122,0.8064516129032258,0.1935483870967742
SF-N22-2,SF-J23-1,150,129,88,63,62,66,0.5866666666666667,0.41333333333333333,0.4883720930232558,0.5116279069767442
SF-N22-2,SF-J22-1,36,50,15,22,21,28,0.4166666666666667,0.5833333333333334,0.44,0.56
SF-N22-2,SF-J22-2,19,23,12,11,7,12,0.631578947368421,0.3684210526315789,0.4782608695652174,0.5217391304347826
SF-N22-2,SF-J21,37,32,13,6,24,26,0.35135135135135137,0.6486486486486487,0.1875,0.8125
SF-N22-2,SF-I21,5,6,3,2,2,4,0.6,0.4,0.3333333333333333,0.6666666666666666
SF-N22-2,SF-I22,10,14,7,5,3,9,0.7,0.3,0.35714285714285715,0.6428571428571429
SF-N22-2,SF-I23-2,11,17,5,9,6,8,0.45454545454545453,0.5454545454545454,0.5294117647058824,0.47058823529411764
SF-N22-2,SF-I24,8,6,3,5,5,1,0.375,0.625,0.8333333333333334,0.16666666666666666
SF-N22-2,SF-I23-1,26,18,13,13,13,5,0.5,0.5,0.7222222222222222,0.2777777777777778
SF-N22-2,SF-F26,37,33,11,8,26,25,0.2972972972972973,0.7027027027027027,0.24242424242424243,0.7575757575757576
SF-N22-2,SF-M13,24,23,4,3,20,20,0.16666666666666666,0.8333333333333334,0.13043478260869565,0.8695652173913043
SF-N22-2,SF-M15,40,25,14,4,26,21,0.35,0.65,0.16,0.84
SF-N22-2,SF-L19,35,35,22,8,13,27,0.6285714285714286,0.37142857142857144,0.22857142857142856,0.7714285714285715
SF-N22-2,SF-L20,59,25,52,8,7,17,0.8813559322033898,0.11864406779661017,0.32,0.68
SF-N22-2,SF-N20-1,27,39,19,12,8,27,0.7037037037037037,0.2962962962962963,0.3076923076923077,0.6923076923076923
SF-N22-2,SF-M20,53,52,25,23,28,29,0.4716981132075472,0.5283018867924528,0.4423076923076923,0.5576923076923077
SF-N22-2,SF-K17-2,11,12,5,1,6,11,0.45454545454545453,0.5454545454545454,0.08333333333333333,0.9166666666666666
SF-N22-2,SF-K20,89,64,35,16,54,48,0.39325842696629215,0.6067415730337079,0.25,0.75
SF-N22-2,SF-K15-,53,54,15,13,38,41,0.2830188679245283,0.7169811320754716,0.24074074074074073,0.7592592592592593
SF-N22-2,SF-K19,70,43,27,9,43,34,0.38571428571428573,0.6142857142857143,0.20930232558139536,0.7906976744186046
SF-N22-2,SF-K18,54,48,21,5,33,43,0.3888888888888889,0.6111111111111112,0.10416666666666667,0.8958333333333334
SF-N22-2,SF-K17,43,41,20,8,23,33,0.46511627906976744,0.5348837209302325,0.1951219512195122,0.8048780487804879
SF-N22-2,SF-J16,24,12,5,1,19,11,0.20833333333333334,0.7916666666666666,0.08333333333333333,0.9166666666666666
SF-N22-2,SF-J18,29,31,7,2,22,29,0.2413793103448276,0.7586206896551724,0.06451612903225806,0.9354838709677419
SF-N22-2,SF-J20,10,4,5,2,5,2,0.5,0.5,0.5,0.5
SF-N22-2,SF-J19,12,13,3,2,9,11,0.25,0.75,0.15384615384615385,0.8461538461538461
SF-N22-2,SF-M12,9,6,2,2,7,4,0.2222222222222222,0.7777777777777778,0.3333333333333333,0.6666666666666666
SF-N22-2,SF-M10,8,8,1,1,7,7,0.125,0.875,0.125,0.875
SF-N22-2,SF-M11,32,16,13,2,19,14,0.40625,0.59375,0.125,0.875
SF-N22-2,SF-R19,26,15,12,0,14,15,0.46153846153846156,0.5384615384615384,0.0,1.0
SF-N22-2,SF-R20,18,14,7,1,11,13,0.3888888888888889,0.6111111111111112,0.07142857142857142,0.9285714285714286
SF-N22-2,SF-Q21-2,48,34,16,4,32,30,0.3333333333333333,0.6666666666666666,0.11764705882352941,0.8823529411764706
SF-N22-2,SF-Q21-1,51,61,13,22,38,39,0.2549019607843137,0.7450980392156863,0.36065573770491804,0.639344262295082
SF-N22-2,SF-P21,19,14,17,2,2,12,0.8947368421052632,0.10526315789473684,0.14285714285714285,0.8571428571428571
SF-N22-2,SF-O18,76,116,43,89,33,27,0.5657894736842105,0.4342105263157895,0.7672413793103449,0.23275862068965517
SF-N22-2,SF-O19,55,70,24,22,31,48,0.43636363636363634,0.5636363636363636,0.3142857142857143,0.6857142857142857
SF-N22-2,SF-O21,52,45,33,30,19,15,0.6346153846153846,0.36538461538461536,0.6666666666666666,0.3333333333333333
SF-N22-2,SF-O22,58,63,35,40,23,23,0.603448275862069,0.39655172413793105,0.6349206349206349,0.36507936507936506
SF-N22-2,SF-N21,51,68,41,53,10,15,0.803921568627451,0.19607843137254902,0.7794117647058824,0.22058823529411764
SF-N22-2,SF-N20-2,73,63,64,29,9,34,0.8767123287671232,0.1232876712328767,0.4603174603174603,0.5396825396825397
SF-N22-2,SF-M21,44,28,30,13,14,15,0.6818181818181818,0.3181818181818182,0.4642857142857143,0.5357142857142857
SF-N22-2,SF-L21,60,56,32,17,28,39,0.5333333333333333,0.4666666666666667,0.30357142857142855,0.6964285714285714
SF-N22-2,SF-S29,2,2,0,1,2,1,0.0,1.0,0.5,0.5
SF-N22-2,SF-Q30,24,13,8,6,16,7,0.3333333333333333,0.6666666666666666,0.46153846153846156,0.5384615384615384
SF-N22-2,SF-P30,27,20,5,8,22,12,0.18518518518518517,0.8148148148148148,0.4,0.6
SF-N22-2,SF-O30-2,34,14,1,3,33,11,0.029411764705882353,0.9705882352941176,0.21428571428571427,0.7857142857142857
SF-N22-2,SF-O30,46,30,14,11,32,19,0.30434782608695654,0.6956521739130435,0.36666666666666664,0.6333333333333333
SF-N22-2,SF-N27,51,37,15,12,36,25,0.29411764705882354,0.7058823529411765,0.32432432432432434,0.6756756756756757
SF-N22-2,SF-N29,28,19,6,11,22,8,0.21428571428571427,0.7857142857142857,0.5789473684210527,0.42105263157894735
SF-N22-2,SF-N28,55,28,23,6,32,22,0.41818181818181815,0.5818181818181818,0.21428571428571427,0.7857142857142857
SF-N22-2,SF-L30-1,57,21,27,2,30,19,0.47368421052631576,0.5263157894736842,0.09523809523809523,0.9047619047619048
SF-N22-2,SF-L31-1,18,17,8,13,10,4,0.4444444444444444,0.5555555555555556,0.7647058823529411,0.23529411764705882
SF-N22-2,SF-K30-2,5,6,2,1,3,5,0.4,0.6,0.16666666666666666,0.8333333333333334
SF-N22-2,SF-L29,36,24,22,11,14,13,0.6111111111111112,0.3888888888888889,0.4583333333333333,0.5416666666666666
SF-N22-2,SF-J29-1,17,7,8,4,9,3,0.47058823529411764,0.5294117647058824,0.5714285714285714,0.42857142857142855
SF-N22-2,SF-I30,14,8,3,4,11,4,0.21428571428571427,0.7857142857142857,0.5,0.5
SF-N22-2,SF-I27,13,14,7,3,6,11,0.5384615384615384,0.46153846153846156,0.21428571428571427,0.7857142857142857
SF-N22-2,SF-I28,4,3,1,2,3,1,0.25,0.75,0.6666666666666666,0.3333333333333333
SF-N22-2,SF-I30-2,9,5,2,1,7,4,0.2222222222222222,0.7777777777777778,0.2,0.8
SF-N22-2,SF I29-1,11,7,2,1,9,6,0.18181818181818182,0.8181818181818182,0.14285714285714285,0.8571428571428571
SF-N22-2,SF-H28,11,14,2,6,9,8,0.18181818181818182,0.8181818181818182,0.42857142857142855,0.5714285714285714
SF-N22-2,SF-H29,1,3,0,1,1,2,0.0,1.0,0.3333333333333333,0.6666666666666666
SF-N22-2,SF-S24,24,37,10,15,14,22,0.4166666666666667,0.5833333333333334,0.40540540540540543,0.5945945945945946
SF-N22-2,SF-R24,63,64,33,22,30,42,0.5238095238095238,0.47619047619047616,0.34375,0.65625
SF-N22-2,SF-R26,6,4,1,0,5,4,0.16666666666666666,0.8333333333333334,0.0,1.0
SF-N22-2,SF-Q26,18,16,6,5,12,11,0.3333333333333333,0.6666666666666666,0.3125,0.6875
SF-N22-2,SF-P26,27,22,7,4,20,18,0.25925925925925924,0.7407407407407407,0.18181818181818182,0.8181818181818182
SF-N22-2,SF-O25-2,30,40,14,14,16,26,0.4666666666666667,0.5333333333333333,0.35,0.65
SF-N22-2,SF-N22-1B,11,7,7,3,4,4,0.6363636363636364,0.36363636363636365,0.42857142857142855,0.5714285714285714
SF-N22-2,SF-N26,13,16,4,6,9,10,0.3076923076923077,0.6923076923076923,0.375,0.625
SF-N22-2,SF-N25,57,70,41,52,16,18,0.7192982456140351,0.2807017543859649,0.7428571428571429,0.2571428571428571
SF-N22-2,SF-T21,28,22,10,3,18,19,0.35714285714285715,0.6428571428571429,0.13636363636363635,0.8636363636363636
SF-N22-2,SF-T22,66,68,29,25,37,43,0.4393939393939394,0.5606060606060606,0.36764705882352944,0.6323529411764706
SF-N22-2,SF-S22-2,21,27,8,6,13,21,0.38095238095238093,0.6190476190476191,0.2222222222222222,0.7777777777777778
SF-N22-2,SF-S22-1,48,37,25,22,23,15,0.5208333333333334,0.4791666666666667,0.5945945945945946,0.40540540540540543
SF-N22-2,SF-Q23-3,36,29,27,13,9,16,0.75,0.25,0.4482758620689655,0.5517241379310345
SF-N22-2,SF-Q22-1,57,61,34,33,23,28,0.5964912280701754,0.40350877192982454,0.5409836065573771,0.45901639344262296
SF-N22-2,SF-Q22-2,97,69,67,41,30,28,0.6907216494845361,0.30927835051546393,0.5942028985507246,0.4057971014492754
SF-N22-2,SF-P22,86,79,63,40,23,39,0.7325581395348837,0.26744186046511625,0.5063291139240507,0.4936708860759494
SF-N22-2,SF-W19,11,5,4,2,7,3,0.36363636363636365,0.6363636363636364,0.4,0.6
SF-N22-2,SF-W19-2,1,1,1,0,0,1,1.0,0.0,0.0,1.0
SF-N22-2,SF-U21,15,16,6,2,9,14,0.4,0.6,0.125,0.875
SF-N22-2,SF-T20,36,36,12,11,24,25,0.3333333333333333,0.6666666666666666,0.3055555555555556,0.6944444444444444
SF-N22-2,SF-S21,13,10,6,1,7,9,0.46153846153846156,0.5384615384615384,0.1,0.9
SF-N22-2,SF-AA28,1,1,0,1,1,0,0.0,1.0,1.0,0.0
SF-N22-2,SF-V29,2,2,0,0,2,2,0.0,1.0,0.0,1.0
SF-N22-2,SF-V30,1,2,0,0,1,2,0.0,1.0,0.0,1.0
SF-N22-2,SF-W14,2,9,0,0,2,9,0.0,1.0,0.0,1.0
SF-N22-2,SF-AA15,6,1,6,0,0,1,1.0,0.0,0.0,1.0
SF-N22-2,SF-Z16,2,3,0,0,2,3,0.0,1.0,0.0,1.0
SF-N22-2,SF-X19,6,1,0,0,6,1,0.0,1.0,0.0,1.0
SF-G28-2,SF-M26-2,2,2,2,2,0,0,1.0,0.0,1.0,0.0
SF-G28-2,SF-L27,8,3,0,1,8,2,0.0,1.0,0.3333333333333333,0.6666666666666666
SF-G28-2,SF-K26,2,3,2,2,0,1,1.0,0.0,0.6666666666666666,0.3333333333333333
SF-G28-2,SF-J27,3,3,0,0,3,3,0.0,1.0,0.0,1.0
SF-G28-2,SF-L27-2,2,1,0,1,2,0,0.0,1.0,1.0,0.0
SF-G28-2,SF-J29-3,8,10,0,6,8,4,0.0,1.0,0.6,0.4
SF-G28-2,SF-J29,17,14,2,3,15,11,0.11764705882352941,0.8823529411764706,0.21428571428571427,0.7857142857142857
SF-G28-2,SF-M28,4,10,2,6,2,4,0.5,0.5,0.6,0.4
SF-G28-2,SF-M27,1,1,1,0,0,1,1.0,0.0,0.0,1.0
SF-G28-2,SF-L24,3,3,2,1,1,2,0.6666666666666666,0.3333333333333333,0.3333333333333333,0.6666666666666666
SF-G28-2,SF-N23,2,1,0,0,2,1,0.0,1.0,0.0,1.0
SF-G28-2,SF-J26-2,4,4,2,1,2,3,0.5,0.5,0.25,0.75
SF-G28-2,SF-L28,2,7,0,3,2,4,0.0,1.0,0.42857142857142855,0.5714285714285714
SF-G28-2,SF-K28,1,4,0,2,1,2,0.0,1.0,0.5,0.5
SF-G28-2,SF-K29-1,21,21,2,4,19,17,0.09523809523809523,0.9047619047619048,0.19047619047619047,0.8095238095238095
SF-G28-2,SF-J28-2,1,6,0,1,1,5,0.0,1.0,0.16666666666666666,0.8333333333333334
SF-G28-2,SF-K25,6,2,3,0,3,2,0.5,0.5,0.0,1.0
SF-G28-2,SF-J25,2,18,1,7,1,11,0.5,0.5,0.3888888888888889,0.6111111111111112
SF-G28-2,SF-H26-2,1,3,1,3,0,0,1.0,0.0,1.0,0.0
SF-G28-2,SF-P24,1,2,0,0,1,2,0.0,1.0,0.0,1.0
SF-G28-2,SF-J24,12,19,10,9,2,10,0.8333333333333334,0.16666666666666666,0.47368421052631576,0.5263157894736842
SF-G28-2,SF-J26,2,3,2,1,0,2,1.0,0.0,0.3333333333333333,0.6666666666666666
SF-G28-2,SF-I25,15,7,13,2,2,5,0.8666666666666667,0.13333333333333333,0.2857142857142857,0.7142857142857143
SF-G28-2,SF-K23,1,1,1,1,0,0,1.0,0.0,1.0,0.0
SF-G28-2,SF-H26,3,10,1,4,2,6,0.3333333333333333,0.6666666666666666,0.4,0.6
SF-G28-2,SF-O23,2,4,1,1,1,3,0.5,0.5,0.25,0.75
SF-G28-2,SF-H27-1,6,14,4,8,2,6,0.6666666666666666,0.3333333333333333,0.5714285714285714,0.42857142857142855
SF-G28-2,SF-F28-2,5,5,4,3,1,2,0.8,0.2,0.6,0.4
SF-G28-2,SF-G27,10,8,5,4,5,4,0.5,0.5,0.5,0.5
SF-G28-2,SF-M22-2,18,15,0,1,18,14,0.0,1.0,0.06666666666666667,0.9333333333333333
SF-G28-2,SF-L22,8,7,6,2,2,5,0.75,0.25,0.2857142857142857,0.7142857142857143
SF-G28-2,SF-F27,4,4,2,4,2,0,0.5,0.5,1.0,0.0
SF-G28-2,SF-N22-2,18,11,4,1,14,10,0.2222222222222222,0.7777777777777778,0.09090909090909091,0.9090909090909091
SF-G28-2,SF-G28-1,4,5,2,2,2,3,0.5,0.5,0.4,0.6
SF-G28-2,SF-M22-1,2,1,0,0,2,1,0.0,1.0,0.0,1.0
SF-G28-2,SF-O25-1,1,1,0,0,1,1,0.0,1.0,0.0,1.0
SF-G28-2,SF-K22-2,5,1,2,0,3,1,0.4,0.6,0.0,1.0
SF-G28-2,SF-K24,2,3,1,1,1,2,0.5,0.5,0.3333333333333333,0.6666666666666666
SF-G28-2,SF-G23,2,3,0,1,2,2,0.0,1.0,0.3333333333333333,0.6666666666666666
SF-G28-2,SF-G24,11,9,2,1,9,8,0.18181818181818182,0.8181818181818182,0.1111111111111111,0.8888888888888888
SF-G28-2,SF-G25,25,3,22,0,3,3,0.88,0.12,0.0,1.0
SF-G28-2,SF-F23,78,39,26,14,52,25,0.3333333333333333,0.6666666666666666,0.358974358974359,0.6410256410256411
SF-G28-2,SF-E23,10,7,3,2,7,5,0.3,0.7,0.2857142857142857,0.7142857142857143
SF-G28-2,SF-D24,3,1,2,1,1,0,0.6666666666666666,0.3333333333333333,1.0,0.0
SF-G28-2,SF-C22,36,19,1,0,35,19,0.027777777777777776,0.9722222222222222,0.0,1.0
SF-G28-2,SF-B22,2,5,0,1,2,4,0.0,1.0,0.2,0.8
SF-G28-2,SF-J17,3,2,0,0,3,2,0.0,1.0,0.0,1.0
SF-G28-2,SF-I20,47,1,27,0,20,1,0.574468085106383,0.425531914893617,0.0,1.0
SF-G28-2,SF-H20,3,5,2,5,1,0,0.6666666666666666,0.3333333333333333,1.0,0.0
SF-G28-2,SF-G17,4,2,1,0,3,2,0.25,0.75,0.0,1.0
SF-G28-2,SF-G18,3,1,1,0,2,1,0.3333333333333333,0.6666666666666666,0.0,1.0
SF-G28-2,SF-G20,10,2,0,0,10,2,0.0,1.0,0.0,1.0
SF-G28-2,SF-F19,4,2,0,0,4,2,0.0,1.0,0.0,1.0
SF-G28-2,SF-E20,1,2,0,0,1,2,0.0,1.0,0.0,1.0
SF-G28-2,SF-G30-2,3,3,2,1,1,2,0.6666666666666666,0.3333333333333333,0.3333333333333333,0.6666666666666666
SF-G28-2,SF-F30-1,8,5,4,3,4,2,0.5,0.5,0.6,0.4
SF-G28-2,SF-E29-2,1,8,0,5,1,3,0.0,1.0,0.625,0.375
SF-G28-2,SF-E29-1,7,12,6,4,1,8,0.8571428571428571,0.14285714285714285,0.3333333333333333,0.6666666666666666
SF-G28-2,SF-D29,1,11,0,8,1,3,0.0,1.0,0.7272727272727273,0.2727272727272727
SF-G28-2,SF-D28,32,39,32,31,0,8,1.0,0.0,0.7948717948717948,0.20512820512820512
SF-G28-2,SF-A27,2,10,2,7,0,3,1.0,0.0,0.7,0.3
SF-G28-2,SF-G29-2,13,5,5,4,8,1,0.38461538461538464,0.6153846153846154,0.8,0.2
SF-G28-2,SF-G29-1,12,7,5,4,7,3,0.4166666666666667,0.5833333333333334,0.5714285714285714,0.42857142857142855
SF-G28-2,SF-G30-1,22,19,18,15,4,4,0.8181818181818182,0.18181818181818182,0.7894736842105263,0.21052631578947367
SF-G28-2,SF-G29-3,5,4,4,2,1,2,0.8,0.2,0.5,0.5
SF-G28-2,SF-F30-2,1,1,0,0,1,1,0.0,1.0,0.0,1.0
SF-G28-2,SF-F29,2,16,1,7,1,9,0.5,0.5,0.4375,0.5625
SF-G28-2,SF-F28-1,3,12,3,2,0,10,1.0,0.0,0.16666666666666666,0.8333333333333334
SF-G28-2,SF-E28,5,1,2,0,3,1,0.4,0.6,0.0,1.0
SF-G28-2,SF-G12,2,1,0,0,2,1,0.0,1.0,0.0,1.0
SF-G28-2,SF-C20,3,1,1,0,2,1,0.3333333333333333,0.6666666666666666,0.0,1.0
SF-G28-2,SF-A20,19,11,0,0,19,11,0.0,1.0,0.0,1.0
SF-G28-2,SF-C26,5,11,1,10,4,1,0.2,0.8,0.9090909090909091,0.09090909090909091
SF-G28-2,SF-C25,8,5,2,1,6,4,0.25,0.75,0.2,0.8
SF-G28-2,SF-B25,2,6,0,3,2,3,0.0,1.0,0.5,0.5
SF-G28-2,SF-E27,2,1,0,0,2,1,0.0,1.0,0.0,1.0
SF-G28-2,SF-B28-2,2,2,0,1,2,1,0.0,1.0,0.5,0.5
SF-G28-2,SF-D27,13,7,4,7,9,0,0.3076923076923077,0.6923076923076923,1.0,0.0
SF-G28-2,SF-C28-1,4,1,3,1,1,0,0.75,0.25,1.0,0.0
SF-G28-2,SF-B28,4,9,0,6,4,3,0.0,1.0,0.6666666666666666,0.3333333333333333
SF-G28-2,SF-H25,1,1,1,1,0,0,1.0,0.0,1.0,0.0
SF-G28-2,SF-G26,3,2,0,2,3,0,0.0,1.0,1.0,0.0
SF-G28-2,SF-K21,5,1,1,0,4,1,0.2,0.8,0.0,1.0
SF-G28-2,SF-K22-1,1,3,0,2,1,1,0.0,1.0,0.6666666666666666,0.3333333333333333
SF-G28-2,SF-J23-1,14,17,10,14,4,3,0.7142857142857143,0.2857142857142857,0.8235294117647058,0.17647058823529413
SF-G28-2,SF-J22-1,1,1,0,0,1,1,0.0,1.0,0.0,1.0
SF-G28-2,SF-J22-2,1,4,0,1,1,3,0.0,1.0,0.25,0.75
SF-G28-2,SF-J21,5,7,2,2,3,5,0.4,0.6,0.2857142857142857,0.7142857142857143
SF-G28-2,SF-I22,1,4,1,0,0,4,1.0,0.0,0.0,1.0
SF-G28-2,SF-I23-2,3,1,1,1,2,0,0.3333333333333333,0.6666666666666666,1.0,0.0
SF-G28-2,SF-I24,1,2,0,0,1,2,0.0,1.0,0.0,1.0
SF-G28-2,SF-I23-1,3,3,2,1,1,2,0.6666666666666666,0.3333333333333333,0.3333333333333333,0.6666666666666666
SF-G28-2,SF-F26,19,10,5,4,14,6,0.2631578947368421,0.7368421052631579,0.4,0.6
SF-G28-2,SF-M15,2,2,1,0,1,2,0.5,0.5,0.0,1.0
SF-G28-2,SF-L20,27,23,4,1,23,22,0.14814814814814814,0.8518518518518519,0.043478260869565216,0.9565217391304348
SF-G28-2,SF-N20-1,2,4,1,2,1,2,0.5,0.5,0.5,0.5
SF-G28-2,SF-M20,4,7,0,1,4,6,0.0,1.0,0.14285714285714285,0.8571428571428571
SF-G28-2,SF-K20,2,1,0,0,2,1,0.0,1.0,0.0,1.0
SF-G28-2,SF-K19,1,2,0,0,1,2,0.0,1.0,0.0,1.0
SF-G28-2,SF-K17,3,2,0,1,3,1,0.0,1.0,0.5,0.5
SF-G28-2,SF-J16,1,2,1,0,0,2,1.0,0.0,0.0,1.0
SF-G28-2,SF-J18,2,2,0,0,2,2,0.0,1.0,0.0,1.0
SF-G28-2,SF-J20,6,1,3,1,3,0,0.5,0.5,1.0,0.0
SF-G28-2,SF-J19,24,4,5,0,19,4,0.20833333333333334,0.7916666666666666,0.0,1.0
SF-G28-2,SF-P21,1,1,0,0,1,1,0.0,1.0,0.0,1.0
SF-G28-2,SF-O18,2,1,0,0,2,1,0.0,1.0,0.0,1.0
SF-G28-2,SF-O19,2,2,0,2,2,0,0.0,1.0,1.0,0.0
SF-G28-2,SF-O21,3,7,0,3,3,4,0.0,1.0,0.42857142857142855,0.5714285714285714
SF-G28-2,SF-O22,15,9,5,3,10,6,0.3333333333333333,0.6666666666666666,0.3333333333333333,0.6666666666666666
SF-G28-2,SF-N21,3,4,2,0,1,4,0.6666666666666666,0.3333333333333333,0.0,1.0
SF-G28-2,SF-L21,19,10,1,0,18,10,0.05263157894736842,0.9473684210526315,0.0,1.0
SF-G28-2,SF-S30,2,1,0,0,2,1,0.0,1.0,0.0,1.0
SF-G28-2,SF-P30,1,2,1,1,0,1,1.0,0.0,0.5,0.5
SF-G28-2,SF-N27,2,2,0,1,2,1,0.0,1.0,0.5,0.5
SF-G28-2,SF-N28,2,9,0,5,2,4,0.0,1.0,0.5555555555555556,0.4444444444444444
SF-G28-2,SF-L30-1,2,2,2,2,0,0,1.0,0.0,1.0,0.0
SF-G28-2,SF-L31-1,5,5,3,0,2,5,0.6,0.4,0.0,1.0
SF-G28-2,SF-K30-2,4,2,1,2,3,0,0.25,0.75,1.0,0.0
SF-G28-2,SF-L29,13,13,2,4,11,9,0.15384615384615385,0.8461538461538461,0.3076923076923077,0.6923076923076923
SF-G28-2,SF-J29-1,17,19,11,6,6,13,0.6470588235294118,0.35294117647058826,0.3157894736842105,0.6842105263157895
SF-G28-2,SF-I30,4,1,1,0,3,1,0.25,0.75,0.0,1.0
SF-G28-2,SF-I29-2,3,2,2,1,1,1,0.6666666666666666,0.3333333333333333,0.5,0.5
SF-G28-2,SF-I27,34,28,29,21,5,7,0.8529411764705882,0.14705882352941177,0.75,0.25
SF-G28-2,SF-I28,3,3,2,3,1,0,0.6666666666666666,0.3333333333333333,1.0,0.0
SF-G28-2,SF-I30-2,1,7,0,4,1,3,0.0,1.0,0.5714285714285714,0.42857142857142855
SF-G28-2,SF I29-1,11,9,8,0,3,9,0.7272727272727273,0.2727272727272727,0.0,1.0
SF-G28-2,SF-H28,3,3,1,1,2,2,0.3333333333333333,0.6666666666666666,0.3333333333333333,0.6666666666666666
SF-G28-2,SF-H29,2,3,1,1,1,2,0.5,0.5,0.3333333333333333,0.6666666666666666
SF-G28-2,SF-S24,39,27,35,22,4,5,0.8974358974358975,0.10256410256410256,0.8148148148148148,0.18518518518518517
SF-G28-2,SF-R24,2,2,1,0,1,2,0.5,0.5,0.0,1.0
SF-G28-2,SF-N22-1B,6,6,3,2,3,4,0.5,0.5,0.3333333333333333,0.6666666666666666
SF-G28-2,SF-N26,1,1,0,1,1,0,0.0,1.0,1.0,0.0
SF-G28-2,SF-T22,1,1,1,1,0,0,1.0,0.0,1.0,0.0
SF-G28-2,SF-Q23-3,2,3,0,3,2,0,0.0,1.0,1.0,0.0
SF-G28-2,SF-Q22-1,1,9,0,3,1,6,0.0,1.0,0.3333333333333333,0.6666666666666666
SF-G28-2,SF-P22,2,1,0,0,2,1,0.0,1.0,0.0,1.0
SF-G28-2,SF-U21,1,1,1,0,0,1,1.0,0.0,0.0,1.0
SF-G28-2,SF-T20,4,4,2,2,2,2,0.5,0.5,0.5,0.5
SF-G28-1,SF-M26-2,6,1,1,1,5,0,0.16666666666666666,0.8333333333333334,1.0,0.0
SF-G28-1,SF-L27,3,2,0,0,3,2,0.0,1.0,0.0,1.0
SF-G28-1,SF-K26,2,2,1,2,1,0,0.5,0.5,1.0,0.0
SF-G28-1,SF-J27,7,7,2,5,5,2,0.2857142857142857,0.7142857142857143,0.7142857142857143,0.2857142857142857
SF-G28-1,SF-M30,2,7,2,7,0,0,1.0,0.0,1.0,0.0
SF-G28-1,SF-J29-3,4,3,1,2,3,1,0.25,0.75,0.6666666666666666,0.3333333333333333
SF-G28-1,SF-J29,11,13,4,7,7,6,0.36363636363636365,0.6363636363636364,0.5384615384615384,0.46153846153846156
SF-G28-1,SF-M28,2,4,1,1,1,3,0.5,0.5,0.25,0.75
SF-G28-1,SF-K27-2,8,4,4,2,4,2,0.5,0.5,0.5,0.5
SF-G28-1,SF-J26-2,12,11,8,8,4,3,0.6666666666666666,0.3333333333333333,0.7272727272727273,0.2727272727272727
SF-G28-1,SF-L28,1,2,0,0,1,2,0.0,1.0,0.0,1.0
SF-G28-1,SF-K29-1,35,7,8,4,27,3,0.22857142857142856,0.7714285714285715,0.5714285714285714,0.42857142857142855
SF-G28-1,SF-J28-2,2,2,0,0,2,2,0.0,1.0,0.0,1.0
SF-G28-1,SF-K27,1,1,0,0,1,1,0.0,1.0,0.0,1.0
SF-G28-1,SF-K25,2,10,1,1,1,9,0.5,0.5,0.1,0.9
SF-G28-1,SF-J25,10,44,5,20,5,24,0.5,0.5,0.45454545454545453,0.5454545454545454
SF-G28-1,SF-H26-2,2,5,0,3,2,2,0.0,1.0,0.6,0.4
SF-G28-1,SF-P24,1,3,1,1,0,2,1.0,0.0,0.3333333333333333,0.6666666666666666
SF-G28-1,SF-J24,2,7,0,3,2,4,0.0,1.0,0.42857142857142855,0.5714285714285714
SF-G28-1,SF-I26-,2,12,2,12,0,0,1.0,0.0,1.0,0.0
SF-G28-1,SF-I25,5,5,3,5,2,0,0.6,0.4,1.0,0.0
SF-G28-1,SF-H26,3,9,3,5,0,4,1.0,0.0,0.5555555555555556,0.4444444444444444
SF-G28-1,SF-O23,3,8,2,0,1,8,0.6666666666666666,0.3333333333333333,0.0,1.0
SF-G28-1,SF-H27-1,9,18,8,14,1,4,0.8888888888888888,0.1111111111111111,0.7777777777777778,0.2222222222222222
SF-G28-1,SF-F28-2,11,18,7,12,4,6,0.6363636363636364,0.36363636363636365,0.6666666666666666,0.3333333333333333
SF-G28-1,SF-G27,22,26,11,17,11,9,0.5,0.5,0.6538461538461539,0.34615384615384615
SF-G28-1,SF-M22-2,1,4,0,1,1,3,0.0,1.0,0.25,0.75
SF-G28-1,SF-L22,2,1,1,0,1,1,0.5,0.5,0.0,1.0
SF-G28-1,SF-F27,8,12,6,9,2,3,0.75,0.25,0.75,0.25
SF-G28-1,SF-G28-2,5,4,2,2,3,2,0.4,0.6,0.5,0.5
SF-G28-1,SF-M22-1,8,3,7,2,1,1,0.875,0.125,0.6666666666666666,0.3333333333333333
SF-G28-1,SF-K24,1,6,0,3,1,3,0.0,1.0,0.5,0.5
SF-G28-1,SF-G24,6,1,1,0,5,1,0.16666666666666666,0.8333333333333334,0.0,1.0
SF-G28-1,SF-G25,3,2,2,0,1,2,0.6666666666666666,0.3333333333333333,0.0,1.0
SF-G28-1,SF-F23,24,5,3,1,21,4,0.125,0.875,0.2,0.8
SF-G28-1,SF-E23,28,6,18,0,10,6,0.6428571428571429,0.35714285714285715,0.0,1.0
SF-G28-1,SF-C22,1,1,0,0,1,1,0.0,1.0,0.0,1.0
SF-G28-1,SF-B22,1,6,0,5,1,1,0.0,1.0,0.8333333333333334,0.16666666666666666
SF-G28-1,SF-I19,3,2,1,0,2,2,0.3333333333333333,0.6666666666666666,0.0,1.0
SF-G28-1,SF-G18,6,6,1,0,5,6,0.16666666666666666,0.8333333333333334,0.0,1.0
SF-G28-1,SF-H30,3,3,2,1,1,2,0.6666666666666666,0.3333333333333333,0.3333333333333333,0.6666666666666666
SF-G28-1,SF-G30-2,14,17,9,4,5,13,0.6428571428571429,0.35714285714285715,0.23529411764705882,0.7647058823529411
SF-G28-1,SF-F30-1,5,2,3,2,2,0,0.6,0.4,1.0,0.0
SF-G28-1,SF-E29-2,8,9,4,6,4,3,0.5,0.5,0.6666666666666666,0.3333333333333333
SF-G28-1,SF-E29-1,8,8,7,6,1,2,0.875,0.125,0.75,0.25
SF-G28-1,SF-D29,1,1,1,0,0,1,1.0,0.0,0.0,1.0
SF-G28-1,SF-D28,5,1,3,1,2,0,0.6,0.4,1.0,0.0
SF-G28-1,SF-A27,7,8,6,7,1,1,0.8571428571428571,0.14285714285714285,0.875,0.125
SF-G28-1,SF-G29-2,21,9,16,6,5,3,0.7619047619047619,0.23809523809523808,0.6666666666666666,0.3333333333333333
SF-G28-1,SF-G29-1,10,7,8,5,2,2,0.8,0.2,0.7142857142857143,0.2857142857142857
SF-G28-1,SF-G30-1,19,8,16,6,3,2,0.8421052631578947,0.15789473684210525,0.75,0.25
SF-G28-1,SF-G29-3,11,1,10,1,1,0,0.9090909090909091,0.09090909090909091,1.0,0.0
SF-G28-1,SF-F30-2,3,1,2,1,1,0,0.6666666666666666,0.3333333333333333,1.0,0.0
SF-G28-1,SF-F29,37,12,31,7,6,5,0.8378378378378378,0.16216216216216217,0.5833333333333334,0.4166666666666667
SF-G28-1,SF-F28-1,5,1,4,0,1,1,0.8,0.2,0.0,1.0
SF-G28-1,SF-J12,1,2,0,1,1,1,0.0,1.0,0.5,0.5
SF-G28-1,SF-J13,1,1,1,0,0,1,1.0,0.0,0.0,1.0
SF-G28-1,SF-G10-1,1,1,0,0,1,1,0.0,1.0,0.0,1.0
SF-G28-1,SF-C20,2,1,1,0,1,1,0.5,0.5,0.0,1.0
SF-G28-1,SF-B19,1,3,1,0,0,3,1.0,0.0,0.0,1.0
SF-G28-1,SF-A20,2,6,2,3,0,3,1.0,0.0,0.5,0.5
SF-G28-1,SF-C26,7,8,4,6,3,2,0.5714285714285714,0.42857142857142855,0.75,0.25
SF-G28-1,SF-C25,3,6,0,1,3,5,0.0,1.0,0.16666666666666666,0.8333333333333334
SF-G28-1,SF-B25,4,6,2,4,2,2,0.5,0.5,0.6666666666666666,0.3333333333333333
SF-G28-1,SF-E27,4,1,3,1,1,0,0.75,0.25,1.0,0.0
SF-G28-1,SF-B28-2,2,4,1,3,1,1,0.5,0.5,0.75,0.25
SF-G28-1,SF-D27,2,8,0,7,2,1,0.0,1.0,0.875,0.125
SF-G28-1,SF-C28-1,4,4,4,4,0,0,1.0,0.0,1.0,0.0
SF-G28-1,SF-B28,3,6,2,6,1,0,0.6666666666666666,0.3333333333333333,1.0,0.0
SF-G28-1,SF-G26,3,6,2,5,1,1,0.6666666666666666,0.3333333333333333,0.8333333333333334,0.16666666666666666
SF-G28-1,SF-K21,1,1,0,0,1,1,0.0,1.0,0.0,1.0
SF-G28-1,SF-K22-1,3,7,3,5,0,2,1.0,0.0,0.7142857142857143,0.2857142857142857
SF-G28-1,SF-J23-1,18,6,10,1,8,5,0.5555555555555556,0.4444444444444444,0.16666666666666666,0.8333333333333334
SF-G28-1,SF-J22-1,3,4,1,3,2,1,0.3333333333333333,0.6666666666666666,0.75,0.25
SF-G28-1,SF-J22-2,14,13,8,9,6,4,0.5714285714285714,0.42857142857142855,0.6923076923076923,0.3076923076923077
SF-G28-1,SF-J21,4,7,1,5,3,2,0.25,0.75,0.7142857142857143,0.2857142857142857
SF-G28-1,SF-I21,1,2,1,1,0,1,1.0,0.0,0.5,0.5
SF-G28-1,SF-I23-2,2,1,2,1,0,0,1.0,0.0,1.0,0.0
SF-G28-1,SF-I24,1,2,0,2,1,0,0.0,1.0,1.0,0.0
SF-G28-1,SF-I23-1,2,5,1,3,1,2,0.5,0.5,0.6,0.4
SF-G28-1,SF-F26,4,12,2,8,2,4,0.5,0.5,0.6666666666666666,0.3333333333333333
SF-G28-1,SF-L19,19,3,2,1,17,2,0.10526315789473684,0.8947368421052632,0.3333333333333333,0.6666666666666666
SF-G28-1,SF-L20,2,10,0,6,2,4,0.0,1.0,0.6,0.4
SF-G28-1,SF-M20,7,3,1,0,6,3,0.14285714285714285,0.8571428571428571,0.0,1.0
SF-G28-1,SF-K15-,29,23,26,19,3,4,0.896551724137931,0.10344827586206896,0.8260869565217391,0.17391304347826086
SF-G28-1,SF-K19,3,5,0,4,3,1,0.0,1.0,0.8,0.2
SF-G28-1,SF-K18,1,2,0,0,1,2,0.0,1.0,0.0,1.0
SF-G28-1,SF-K17,1,1,1,1,0,0,1.0,0.0,1.0,0.0
SF-G28-1,SF-J16,2,1,0,1,2,0,0.0,1.0,1.0,0.0
SF-G28-1,SF-J18,1,1,0,0,1,1,0.0,1.0,0.0,1.0
SF-G28-1,SF-J20,2,1,0,1,2,0,0.0,1.0,1.0,0.0
SF-G28-1,SF-J19,4,3,1,2,3,1,0.25,0.75,0.6666666666666666,0.3333333333333333
SF-G28-1,SF-Q21-2,1,1,0,0,1,1,0.0,1.0,0.0,1.0
SF-G28-1,SF-O21,5,6,2,3,3,3,0.4,0.6,0.5,0.5
SF-G28-1,SF-N20-2,2,2,2,2,0,0,1.0,0.0,1.0,0.0
SF-G28-1,SF-L21,3,9,1,8,2,1,0.3333333333333333,0.6666666666666666,0.8888888888888888,0.1111111111111111
SF-G28-1,SF-Q30,2,6,0,2,2,4,0.0,1.0,0.3333333333333333,0.6666666666666666
SF-G28-1,SF-O30-2,3,3,3,3,0,0,1.0,0.0,1.0,0.0
SF-G28-1,SF-N27,2,2,2,2,0,0,1.0,0.0,1.0,0.0
SF-G28-1,SF-N28,3,1,0,0,3,1,0.0,1.0,0.0,1.0
SF-G28-1,SF-L30-1,5,11,3,7,2,4,0.6,0.4,0.6363636363636364,0.36363636363636365
SF-G28-1,SF-L31-1,3,3,3,3,0,0,1.0,0.0,1.0,0.0
SF-G28-1,SF-K30-2,3,4,1,2,2,2,0.3333333333333333,0.6666666666666666,0.5,0.5
SF-G28-1,SF-L29,12,6,5,3,7,3,0.4166666666666667,0.5833333333333334,0.5,0.5
SF-G28-1,SF-J29-1,16,12,7,6,9,6,0.4375,0.5625,0.5,0.5
SF-G28-1,SF-I30,8,8,5,4,3,4,0.625,0.375,0.5,0.5
SF-G28-1,SF-I27,9,7,7,2,2,5,0.7777777777777778,0.2222222222222222,0.2857142857142857,0.7142857142857143
SF-G28-1,SF-I30-2,4,2,2,0,2,2,0.5,0.5,0.0,1.0
SF-G28-1,SF I29-1,27,16,24,3,3,13,0.8888888888888888,0.1111111111111111,0.1875,0.8125
SF-G28-1,SF-H28,11,24,10,11,1,13,0.9090909090909091,0.09090909090909091,0.4583333333333333,0.5416666666666666
SF-G28-1,SF-H29,2,5,2,3,0,2,1.0,0.0,0.6,0.4
SF-G28-1,SF-R24,2,5,2,0,0,5,1.0,0.0,0.0,1.0
SF-G28-1,SF-Q22-1,3,3,0,0,3,3,0.0,1.0,0.0,1.0
SF-G28-1,SF-P22,1,1,0,0,1,1,0.0,1.0,0.0,1.0
SF-G28-1,SF-BB17,1,1,1,1,0,0,1.0,0.0,1.0,0.0
SF-G28-1,SF-AA15,1,1,0,1,1,0,0.0,1.0,1.0,0.0
SF-M22-1,SF-M26,16,15,5,5,11,10,0.3125,0.6875,0.3333333333333333,0.6666666666666666
SF-M22-1,SF-M25,8,7,3,1,5,6,0.375,0.625,0.14285714285714285,0.8571428571428571
SF-M22-1,SF-M26-2,4,4,0,1,4,3,0.0,1.0,0.25,0.75
SF-M22-1,SF-L27,3,6,1,4,2,2,0.3333333333333333,0.6666666666666666,0.6666666666666666,0.3333333333333333
SF-M22-1,SF-K26,16,5,8,2,8,3,0.5,0.5,0.4,0.6
SF-M22-1,SF-J27,6,4,3,2,3,2,0.5,0.5,0.5,0.5
SF-M22-1,SF-M30,5,15,0,4,5,11,0.0,1.0,0.26666666666666666,0.7333333333333333
SF-M22-1,SF-J29-3,3,3,3,2,0,1,1.0,0.0,0.6666666666666666,0.3333333333333333
SF-M22-1,SF-J29,14,22,9,8,5,14,0.6428571428571429,0.35714285714285715,0.36363636363636365,0.6363636363636364
SF-M22-1,SF-L26,71,69,17,36,54,33,0.23943661971830985,0.7605633802816901,0.5217391304347826,0.4782608695652174
SF-M22-1,SF-M28,2,6,1,1,1,5,0.5,0.5,0.16666666666666666,0.8333333333333334
SF-M22-1,SF-M27,1,7,1,7,0,0,1.0,0.0,1.0,0.0
SF-M22-1,SF-L25,9,9,5,7,4,2,0.5555555555555556,0.4444444444444444,0.7777777777777778,0.2222222222222222
SF-M22-1,SF-M24,5,7,2,5,3,2,0.4,0.6,0.7142857142857143,0.2857142857142857
SF-M22-1,SF-L24,26,29,15,21,11,8,0.5769230769230769,0.4230769230769231,0.7241379310344828,0.27586206896551724
SF-M22-1,SF-N23,4,7,4,7,0,0,1.0,0.0,1.0,0.0
SF-M22-1,SF-N24-2,3,6,2,6,1,0,0.6666666666666666,0.3333333333333333,1.0,0.0
SF-M22-1,SF-K27-2,20,19,5,7,15,12,0.25,0.75,0.3684210526315789,0.631578947368421
SF-M22-1,SF-J26-2,7,16,5,8,2,8,0.7142857142857143,0.2857142857142857,0.5,0.5
SF-M22-1,SF-K28-3,1,3,1,2,0,1,1.0,0.0,0.6666666666666666,0.3333333333333333
SF-M22-1,SF-L28,1,3,1,1,0,2,1.0,0.0,0.3333333333333333,0.6666666666666666
SF-M22-1,SF-K28,4,1,2,0,2,1,0.5,0.5,0.0,1.0
SF-M22-1,SF-K29-1,2,5,1,1,1,4,0.5,0.5,0.2,0.8
SF-M22-1,SF-J28-2,2,6,0,0,2,6,0.0,1.0,0.0,1.0
SF-M22-1,SF-K27,4,4,3,1,1,3,0.75,0.25,0.25,0.75
SF-M22-1,SF-K25,17,39,12,26,5,13,0.7058823529411765,0.29411764705882354,0.6666666666666666,0.3333333333333333
SF-M22-1,SF-J25,18,36,10,10,8,26,0.5555555555555556,0.4444444444444444,0.2777777777777778,0.7222222222222222
SF-M22-1,SF-H26-2,8,5,3,0,5,5,0.375,0.625,0.0,1.0
SF-M22-1,SF-P24,4,7,3,3,1,4,0.75,0.25,0.42857142857142855,0.5714285714285714
SF-M22-1,SF-N22-1A,1,3,1,2,0,1,1.0,0.0,0.6666666666666666,0.3333333333333333
SF-M22-1,SF-J24,7,10,2,1,5,9,0.2857142857142857,0.7142857142857143,0.1,0.9
SF-M22-1,SF-O24,8,9,6,8,2,1,0.75,0.25,0.8888888888888888,0.1111111111111111
SF-M22-1,SF-J26,1,6,1,5,0,1,1.0,0.0,0.8333333333333334,0.16666666666666666
SF-M22-1,SF-I26-,3,1,2,0,1,1,0.6666666666666666,0.3333333333333333,0.0,1.0
SF-M22-1,SF-I25,7,7,3,6,4,1,0.42857142857142855,0.5714285714285714,0.8571428571428571,0.14285714285714285
SF-M22-1,SF-K23,1,1,1,1,0,0,1.0,0.0,1.0,0.0
SF-M22-1,SF-H26,24,15,10,6,14,9,0.4166666666666667,0.5833333333333334,0.4,0.6
SF-M22-1,SF-O23,15,9,4,7,11,2,0.26666666666666666,0.7333333333333333,0.7777777777777778,0.2222222222222222
SF-M22-1,SF-H27-1,5,6,3,3,2,3,0.6,0.4,0.5,0.5
SF-M22-1,SF-F28-2,7,6,5,2,2,4,0.7142857142857143,0.2857142857142857,0.3333333333333333,0.6666666666666666
SF-M22-1,SF-G27,9,16,6,8,3,8,0.6666666666666666,0.3333333333333333,0.5,0.5
SF-M22-1,SF-M22-2,51,40,22,23,29,17,0.43137254901960786,0.5686274509803921,0.575,0.425
SF-M22-1,SF-L22,51,49,32,36,19,13,0.6274509803921569,0.37254901960784315,0.7346938775510204,0.2653061224489796
SF-M22-1,SF-F27,5,8,2,2,3,6,0.4,0.6,0.25,0.75
SF-M22-1,SF-N22-2,31,40,4,23,27,17,0.12903225806451613,0.8709677419354839,0.575,0.425
SF-M22-1,SF-G28-2,1,2,0,0,1,2,0.0,1.0,0.0,1.0
SF-M22-1,SF-G28-1,3,8,2,7,1,1,0.6666666666666666,0.3333333333333333,0.875,0.125
SF-M22-1,SF-O25-1,2,12,0,5,2,7,0.0,1.0,0.4166666666666667,0.5833333333333334
SF-M22-1,SF-K22-2,1,11,1,6,0,5,1.0,0.0,0.5454545454545454,0.45454545454545453
SF-M22-1,SF-K24,7,15,6,8,1,7,0.8571428571428571,0.14285714285714285,0.5333333333333333,0.4666666666666667
SF-M22-1,SF-J23-2,10,7,7,3,3,4,0.7,0.3,0.42857142857142855,0.5714285714285714
SF-M22-1,SF-G23,4,7,1,0,3,7,0.25,0.75,0.0,1.0
SF-M22-1,SF-G24,10,10,8,2,2,8,0.8,0.2,0.2,0.8
SF-M22-1,SF-G25,6,2,5,2,1,0,0.8333333333333334,0.16666666666666666,1.0,0.0
SF-M22-1,SF-F23,36,8,3,1,33,7,0.08333333333333333,0.9166666666666666,0.125,0.875
SF-M22-1,SF-E23,19,5,0,0,19,5,0.0,1.0,0.0,1.0
SF-M22-1,SF-D24,3,5,0,0,3,5,0.0,1.0,0.0,1.0
SF-M22-1,SF-C22,2,2,1,1,1,1,0.5,0.5,0.5,0.5
SF-M22-1,SF-J17,10,4,3,0,7,4,0.3,0.7,0.0,1.0
SF-M22-1,SF-I19,3,2,0,0,3,2,0.0,1.0,0.0,1.0
SF-M22-1,SF-I20,4,4,0,2,4,2,0.0,1.0,0.5,0.5
SF-M22-1,SF-H20,1,4,0,2,1,2,0.0,1.0,0.5,0.5
SF-M22-1,SF-G19,8,1,7,0,1,1,0.875,0.125,0.0,1.0
SF-M22-1,SF-G17,3,1,0,0,3,1,0.0,1.0,0.0,1.0
SF-M22-1,SF-G18,1,2,0,0,1,2,0.0,1.0,0.0,1.0
SF-M22-1,SF-G20,3,4,2,1,1,3,0.6666666666666666,0.3333333333333333,0.25,0.75
SF-M22-1,SF-F19,2,1,1,0,1,1,0.5,0.5,0.0,1.0
SF-M22-1,SF-E18,4,7,1,0,3,7,0.25,0.75,0.0,1.0
SF-M22-1,SF-E20,9,3,1,0,8,3,0.1111111111111111,0.8888888888888888,0.0,1.0
SF-M22-1,SF-H30,1,3,0,1,1,2,0.0,1.0,0.3333333333333333,0.6666666666666666
SF-M22-1,SF-G30-2,16,10,2,1,14,9,0.125,0.875,0.1,0.9
SF-M22-1,SF-E29-2,3,10,1,1,2,9,0.3333333333333333,0.6666666666666666,0.1,0.9
SF-M22-1,SF-E29-1,6,7,1,3,5,4,0.16666666666666666,0.8333333333333334,0.42857142857142855,0.5714285714285714
SF-M22-1,SF-G29-2,8,9,1,0,7,9,0.125,0.875,0.0,1.0
SF-M22-1,SF-G29-1,6,12,1,0,5,12,0.16666666666666666,0.8333333333333334,0.0,1.0
SF-M22-1,SF-G30-1,4,3,1,1,3,2,0.25,0.75,0.3333333333333333,0.6666666666666666
SF-M22-1,SF-G29-3,8,9,3,4,5,5,0.375,0.625,0.4444444444444444,0.5555555555555556
SF-M22-1,SF-F29,1,3,1,2,0,1,1.0,0.0,0.6666666666666666,0.3333333333333333
SF-M22-1,SF-E29-3,2,3,0,0,2,3,0.0,1.0,0.0,1.0
SF-M22-1,SF-J10,1,2,1,0,0,2,1.0,0.0,0.0,1.0
SF-M22-1,SF-J12,8,5,5,0,3,5,0.625,0.375,0.0,1.0
SF-M22-1,SF-J13,2,1,0,0,2,1,0.0,1.0,0.0,1.0
SF-M22-1,SF-H15,2,1,0,0,2,1,0.0,1.0,0.0,1.0
SF-M22-1,SF-G11,3,1,0,0,3,1,0.0,1.0,0.0,1.0
SF-M22-1,SF-G10-1,1,1,0,0,1,1,0.0,1.0,0.0,1.0
SF-M22-1,SF-F15,5,6,0,0,5,6,0.0,1.0,0.0,1.0
SF-M22-1,SF-F16,2,1,0,0,2,1,0.0,1.0,0.0,1.0
SF-M22-1,SF-B19,5,4,0,1,5,3,0.0,1.0,0.25,0.75
SF-M22-1,SF-A20,1,1,0,0,1,1,0.0,1.0,0.0,1.0
SF-M22-1,SF-C25,1,4,0,0,1,4,0.0,1.0,0.0,1.0
SF-M22-1,SF-D27,2,2,0,0,2,2,0.0,1.0,0.0,1.0
SF-M22-1,SF-B28,3,2,1,0,2,2,0.3333333333333333,0.6666666666666666,0.0,1.0
SF-M22-1,SF-J1,2,3,2,0,0,3,1.0,0.0,0.0,1.0
SF-M22-1,SF-J3,1,1,0,0,1,1,0.0,1.0,0.0,1.0
SF-M22-1,SF-J5,3,4,1,1,2,3,0.3333333333333333,0.6666666666666666,0.25,0.75
SF-M22-1,SF-G7,3,2,1,0,2,2,0.3333333333333333,0.6666666666666666,0.0,1.0
SF-M22-1,SF-H25,3,14,0,0,3,14,0.0,1.0,0.0,1.0
SF-M22-1,SF-G26,5,5,2,3,3,2,0.4,0.6,0.6,0.4
SF-M22-1,SF-K21,13,6,3,0,10,6,0.23076923076923078,0.7692307692307693,0.0,1.0
SF-M22-1,SF-K22-1,4,2,3,1,1,1,0.75,0.25,0.5,0.5
SF-M22-1,SF-J23-1,31,35,12,13,19,22,0.3870967741935484,0.6129032258064516,0.37142857142857144,0.6285714285714286
SF-M22-1,SF-J22-1,5,17,2,1,3,16,0.4,0.6,0.058823529411764705,0.9411764705882353
SF-M22-1,SF-J22-2,7,4,1,1,6,3,0.14285714285714285,0.8571428571428571,0.25,0.75
SF-M22-1,SF-J21,14,19,5,5,9,14,0.35714285714285715,0.6428571428571429,0.2631578947368421,0.7368421052631579
SF-M22-1,SF-I21,1,1,0,0,1,1,0.0,1.0,0.0,1.0
SF-M22-1,SF-I22,9,6,0,3,9,3,0.0,1.0,0.5,0.5
SF-M22-1,SF-I23-2,3,4,1,1,2,3,0.3333333333333333,0.6666666666666666,0.25,0.75
SF-M22-1,SF-I24,4,1,3,0,1,1,0.75,0.25,0.0,1.0
SF-M22-1,SF-I23-1,15,8,11,1,4,7,0.7333333333333333,0.26666666666666666,0.125,0.875
SF-M22-1,SF-F26,11,2,2,1,9,1,0.18181818181818182,0.8181818181818182,0.5,0.5
SF-M22-1,SF-M13,6,2,4,1,2,1,0.6666666666666666,0.3333333333333333,0.5,0.5
SF-M22-1,SF-M15,18,6,2,1,16,5,0.1111111111111111,0.8888888888888888,0.16666666666666666,0.8333333333333334
SF-M22-1,SF-L19,17,8,14,1,3,7,0.8235294117647058,0.17647058823529413,0.125,0.875
SF-M22-1,SF-L20,13,12,6,0,7,12,0.46153846153846156,0.5384615384615384,0.0,1.0
SF-M22-1,SF-N20-1,10,7,3,0,7,7,0.3,0.7,0.0,1.0
SF-M22-1,SF-M20,41,9,25,3,16,6,0.6097560975609756,0.3902439024390244,0.3333333333333333,0.6666666666666666
SF-M22-1,SF-K17-2,9,5,4,2,5,3,0.4444444444444444,0.5555555555555556,0.4,0.6
SF-M22-1,SF-K20,19,11,11,2,8,9,0.5789473684210527,0.42105263157894735,0.18181818181818182,0.8181818181818182
SF-M22-1,SF-K15-,11,14,7,6,4,8,0.6363636363636364,0.36363636363636365,0.42857142857142855,0.5714285714285714
SF-M22-1,SF-K19,31,4,17,1,14,3,0.5483870967741935,0.45161290322580644,0.25,0.75
SF-M22-1,SF-K18,13,12,5,2,8,10,0.38461538461538464,0.6153846153846154,0.16666666666666666,0.8333333333333334
SF-M22-1,SF-K17,17,10,15,4,2,6,0.8823529411764706,0.11764705882352941,0.4,0.6
SF-M22-1,SF-J16,8,7,6,1,2,6,0.75,0.25,0.14285714285714285,0.8571428571428571
SF-M22-1,SF-J18,82,14,21,4,61,10,0.25609756097560976,0.7439024390243902,0.2857142857142857,0.7142857142857143
SF-M22-1,SF-J20,10,5,6,0,4,5,0.6,0.4,0.0,1.0
SF-M22-1,SF-J19,6,6,3,1,3,5,0.5,0.5,0.16666666666666666,0.8333333333333334
SF-M22-1,SF-M12,7,17,1,0,6,17,0.14285714285714285,0.8571428571428571,0.0,1.0
SF-M22-1,SF-M10,7,1,4,0,3,1,0.5714285714285714,0.42857142857142855,0.0,1.0
SF-M22-1,SF-M11,6,4,3,0,3,4,0.5,0.5,0.0,1.0
SF-M22-1,SF-R19,3,6,0,1,3,5,0.0,1.0,0.16666666666666666,0.8333333333333334
SF-M22-1,SF-Q21-2,7,2,5,0,2,2,0.7142857142857143,0.2857142857142857,0.0,1.0
SF-M22-1,SF-Q21-1,21,4,8,1,13,3,0.38095238095238093,0.6190476190476191,0.25,0.75
SF-M22-1,SF-P21,31,7,3,1,28,6,0.0967741935483871,0.9032258064516129,0.14285714285714285,0.8571428571428571
SF-M22-1,SF-O18,12,12,3,1,9,11,0.25,0.75,0.08333333333333333,0.9166666666666666
SF-M22-1,SF-O19,67,123,7,7,60,116,0.1044776119402985,0.8955223880597015,0.056910569105691054,0.943089430894309
SF-M22-1,SF-O21,30,27,3,9,27,18,0.1,0.9,0.3333333333333333,0.6666666666666666
SF-M22-1,SF-O22,66,35,13,19,53,16,0.19696969696969696,0.803030303030303,0.5428571428571428,0.45714285714285713
SF-M22-1,SF-N21,5,5,2,4,3,1,0.4,0.6,0.8,0.2
SF-M22-1,SF-N20-2,3,5,2,3,1,2,0.6666666666666666,0.3333333333333333,0.6,0.4
SF-M22-1,SF-M21,10,7,7,6,3,1,0.7,0.3,0.8571428571428571,0.14285714285714285
SF-M22-1,SF-L21,42,29,17,3,25,26,0.40476190476190477,0.5952380952380952,0.10344827586206896,0.896551724137931
SF-M22-1,SF-Q30,6,2,0,1,6,1,0.0,1.0,0.5,0.5
SF-M22-1,SF-O30-2,1,5,1,2,0,3,1.0,0.0,0.4,0.6
SF-M22-1,SF-O30,6,5,0,3,6,2,0.0,1.0,0.6,0.4
SF-M22-1,SF-N27,6,8,2,4,4,4,0.3333333333333333,0.6666666666666666,0.5,0.5
SF-M22-1,SF-N29,5,9,1,2,4,7,0.2,0.8,0.2222222222222222,0.7777777777777778
SF-M22-1,SF-N28,4,7,1,1,3,6,0.25,0.75,0.14285714285714285,0.8571428571428571
SF-M22-1,SF-L30-1,9,27,2,14,7,13,0.2222222222222222,0.7777777777777778,0.5185185185185185,0.48148148148148145
SF-M22-1,SF-L31-1,3,4,0,3,3,1,0.0,1.0,0.75,0.25
SF-M22-1,SF-K30-2,2,5,1,4,1,1,0.5,0.5,0.8,0.2
SF-M22-1,SF-L29,5,16,3,11,2,5,0.6,0.4,0.6875,0.3125
SF-M22-1,SF-J29-1,10,12,7,11,3,1,0.7,0.3,0.9166666666666666,0.08333333333333333
SF-M22-1,SF-I30,3,2,0,1,3,1,0.0,1.0,0.5,0.5
SF-M22-1,SF-I29-2,2,1,1,1,1,0,0.5,0.5,1.0,0.0
SF-M22-1,SF-I27,4,11,3,7,1,4,0.75,0.25,0.6363636363636364,0.36363636363636365
SF-M22-1,SF-I28,2,3,2,2,0,1,1.0,0.0,0.6666666666666666,0.3333333333333333
SF-M22-1,SF-I30-2,6,15,1,1,5,14,0.16666666666666666,0.8333333333333334,0.06666666666666667,0.9333333333333333
SF-M22-1,SF-H28,6,24,1,6,5,18,0.16666666666666666,0.8333333333333334,0.25,0.75
SF-M22-1,SF-S24,6,14,4,7,2,7,0.6666666666666666,0.3333333333333333,0.5,0.5
SF-M22-1,SF-R24,8,15,3,8,5,7,0.375,0.625,0.5333333333333333,0.4666666666666667
SF-M22-1,SF-R26,1,1,1,0,0,1,1.0,0.0,0.0,1.0
SF-M22-1,SF-P26,4,5,1,1,3,4,0.25,0.75,0.2,0.8
SF-M22-1,SF-O25-2,5,11,3,8,2,3,0.6,0.4,0.7272727272727273,0.2727272727272727
SF-M22-1,SF-N22-1B,7,5,7,5,0,0,1.0,0.0,1.0,0.0
SF-M22-1,SF-N26,4,6,2,0,2,6,0.5,0.5,0.0,1.0
SF-M22-1,SF-N25,11,14,5,0,6,14,0.45454545454545453,0.5454545454545454,0.0,1.0
SF-M22-1,SF-T21,6,2,4,0,2,2,0.6666666666666666,0.3333333333333333,0.0,1.0
SF-M22-1,SF-T22,14,15,3,3,11,12,0.21428571428571427,0.7857142857142857,0.2,0.8
SF-M22-1,SF-S22-2,3,2,0,0,3,2,0.0,1.0,0.0,1.0
SF-M22-1,SF-S22-1,10,9,4,4,6,5,0.4,0.6,0.4444444444444444,0.5555555555555556
SF-M22-1,SF-Q23-3,9,8,4,1,5,7,0.4444444444444444,0.5555555555555556,0.125,0.875
SF-M22-1,SF-Q22-1,93,66,13,10,80,56,0.13978494623655913,0.8602150537634409,0.15151515151515152,0.8484848484848485
SF-M22-1,SF-Q22-2,22,27,8,9,14,18,0.36363636363636365,0.6363636363636364,0.3333333333333333,0.6666666666666666
SF-M22-1,SF-P22,54,30,16,7,38,23,0.2962962962962963,0.7037037037037037,0.23333333333333334,0.7666666666666667
SF-M22-1,SF-W19,8,2,6,1,2,1,0.75,0.25,0.5,0.5
SF-M22-1,SF-U21,2,1,0,0,2,1,0.0,1.0,0.0,1.0
SF-M22-1,SF-T20,30,13,2,1,28,12,0.06666666666666667,0.9333333333333333,0.07692307692307693,0.9230769230769231
SF-M22-1,SF-S21,1,2,1,0,0,2,1.0,0.0,0.0,1.0
SF-M22-1,SF-V28,1,2,0,0,1,2,0.0,1.0,0.0,1.0
SF-M22-1,SF-W14,2,1,0,0,2,1,0.0,1.0,0.0,1.0
SF-O25-1,SF-M25,3,6,0,1,3,5,0.0,1.0,0.16666666666666666,0.8333333333333334
SF-O25-1,SF-M26-2,6,9,2,2,4,7,0.3333333333333333,0.6666666666666666,0.2222222222222222,0.7777777777777778
SF-O25-1,SF-L27,2,1,0,0,2,1,0.0,1.0,0.0,1.0
SF-O25-1,SF-K26,9,4,1,1,8,3,0.1111111111111111,0.8888888888888888,0.25,0.75
SF-O25-1,SF-M30,43,26,4,0,39,26,0.09302325581395349,0.9069767441860465,0.0,1.0
SF-O25-1,SF-L27-2,2,3,2,2,0,1,1.0,0.0,0.6666666666666666,0.3333333333333333
SF-O25-1,SF-J29,3,4,1,3,2,1,0.3333333333333333,0.6666666666666666,0.75,0.25
SF-O25-1,SF-L26,10,14,7,11,3,3,0.7,0.3,0.7857142857142857,0.21428571428571427
SF-O25-1,SF-M28,5,5,0,3,5,2,0.0,1.0,0.6,0.4
SF-O25-1,SF-L25,11,3,4,2,7,1,0.36363636363636365,0.6363636363636364,0.6666666666666666,0.3333333333333333
SF-O25-1,SF-M24,10,8,8,4,2,4,0.8,0.2,0.5,0.5
SF-O25-1,SF-L24,8,15,4,7,4,8,0.5,0.5,0.4666666666666667,0.5333333333333333
SF-O25-1,SF-N23,3,7,3,6,0,1,1.0,0.0,0.8571428571428571,0.14285714285714285
SF-O25-1,SF-N24-2,16,20,13,14,3,6,0.8125,0.1875,0.7,0.3
SF-O25-1,SF-K27-2,4,1,3,0,1,1,0.75,0.25,0.0,1.0
SF-O25-1,SF-J26-2,28,52,2,2,26,50,0.07142857142857142,0.9285714285714286,0.038461538461538464,0.9615384615384616
SF-O25-1,SF-L28,1,1,1,1,0,0,1.0,0.0,1.0,0.0
SF-O25-1,SF-K29-1,5,5,2,4,3,1,0.4,0.6,0.8,0.2
SF-O25-1,SF-K25,5,10,0,4,5,6,0.0,1.0,0.4,0.6
SF-O25-1,SF-J25,2,9,0,2,2,7,0.0,1.0,0.2222222222222222,0.7777777777777778
SF-O25-1,SF-P24,5,6,4,2,1,4,0.8,0.2,0.3333333333333333,0.6666666666666666
SF-O25-1,SF-N22-1A,1,9,0,3,1,6,0.0,1.0,0.3333333333333333,0.6666666666666666
SF-O25-1,SF-J24,12,2,3,1,9,1,0.25,0.75,0.5,0.5
SF-O25-1,SF-O24,3,9,1,8,2,1,0.3333333333333333,0.6666666666666666,0.8888888888888888,0.1111111111111111
SF-O25-1,SF-I25,4,1,0,1,4,0,0.0,1.0,1.0,0.0
SF-O25-1,SF-H26,7,4,1,3,6,1,0.14285714285714285,0.8571428571428571,0.75,0.25
SF-O25-1,SF-O23,6,12,4,12,2,0,0.6666666666666666,0.3333333333333333,1.0,0.0
SF-O25-1,SF-F28-2,1,1,0,0,1,1,0.0,1.0,0.0,1.0
SF-O25-1,SF-G27,14,4,2,3,12,1,0.14285714285714285,0.8571428571428571,0.75,0.25
SF-O25-1,SF-M22-2,12,16,5,8,7,8,0.4166666666666667,0.5833333333333334,0.5,0.5
SF-O25-1,SF-L22,3,6,2,1,1,5,0.6666666666666666,0.3333333333333333,0.16666666666666666,0.8333333333333334
SF-O25-1,SF-F27,1,3,0,2,1,1,0.0,1.0,0.6666666666666666,0.3333333333333333
SF-O25-1,SF-N22-2,22,26,14,16,8,10,0.6363636363636364,0.36363636363636365,0.6153846153846154,0.38461538461538464
SF-O25-1,SF-G28-2,1,1,0,0,1,1,0.0,1.0,0.0,1.0
SF-O25-1,SF-M22-1,12,2,5,0,7,2,0.4166666666666667,0.5833333333333334,0.0,1.0
SF-O25-1,SF-K22-2,5,2,2,1,3,1,0.4,0.6,0.5,0.5
SF-O25-1,SF-K24,6,8,1,6,5,2,0.16666666666666666,0.8333333333333334,0.75,0.25
SF-O25-1,SF-J23-2,9,3,3,0,6,3,0.3333333333333333,0.6666666666666666,0.0,1.0
SF-O25-1,SF-G24,3,2,0,0,3,2,0.0,1.0,0.0,1.0
SF-O25-1,SF-G25,1,2,0,0,1,2,0.0,1.0,0.0,1.0
SF-O25-1,SF-F23,1,1,0,0,1,1,0.0,1.0,0.0,1.0
SF-O25-1,SF-D24,3,1,1,0,2,1,0.3333333333333333,0.6666666666666666,0.0,1.0
SF-O25-1,SF-C22,1,1,1,1,0,0,1.0,0.0,1.0,0.0
SF-O25-1,SF-J17,8,1,2,0,6,1,0.25,0.75,0.0,1.0
SF-O25-1,SF-H18,2,1,0,0,2,1,0.0,1.0,0.0,1.0
SF-O25-1,SF-E18,10,1,2,0,8,1,0.2,0.8,0.0,1.0
SF-O25-1,SF-H30,3,5,2,3,1,2,0.6666666666666666,0.3333333333333333,0.6,0.4
SF-O25-1,SF-G30-2,3,3,1,1,2,2,0.3333333333333333,0.6666666666666666,0.3333333333333333,0.6666666666666666
SF-O25-1,SF-F30-1,1,1,0,0,1,1,0.0,1.0,0.0,1.0
SF-O25-1,SF-E29-1,2,3,1,1,1,2,0.5,0.5,0.3333333333333333,0.6666666666666666
SF-O25-1,SF-D29,3,5,0,1,3,4,0.0,1.0,0.2,0.8
SF-O25-1,SF-A27,2,2,1,2,1,0,0.5,0.5,1.0,0.0
SF-O25-1,SF-G29-2,1,3,0,0,1,3,0.0,1.0,0.0,1.0
SF-O25-1,SF-G30-1,6,4,0,0,6,4,0.0,1.0,0.0,1.0
SF-O25-1,SF-G29-3,4,1,4,0,0,1,1.0,0.0,0.0,1.0
SF-O25-1,SF-F30-2,1,1,0,1,1,0,0.0,1.0,1.0,0.0
SF-O25-1,SF-J10,1,1,1,0,0,1,1.0,0.0,0.0,1.0
SF-O25-1,SF-J12,2,1,1,0,1,1,0.5,0.5,0.0,1.0
SF-O25-1,SF-C20,1,3,0,0,1,3,0.0,1.0,0.0,1.0
SF-O25-1,SF-A20,2,1,0,0,2,1,0.0,1.0,0.0,1.0
SF-O25-1,SF-C26,5,2,1,1,4,1,0.2,0.8,0.5,0.5
SF-O25-1,SF-C25,3,3,0,0,3,3,0.0,1.0,0.0,1.0
SF-O25-1,SF-E27,1,1,0,0,1,1,0.0,1.0,0.0,1.0
SF-O25-1,SF-D27,1,1,0,1,1,0,0.0,1.0,1.0,0.0
SF-O25-1,SF-G26,1,1,1,1,0,0,1.0,0.0,1.0,0.0
SF-O25-1,SF-K22-1,3,6,1,1,2,5,0.3333333333333333,0.6666666666666666,0.16666666666666666,0.8333333333333334
SF-O25-1,SF-J23-1,8,13,1,1,7,12,0.125,0.875,0.07692307692307693,0.9230769230769231
SF-O25-1,SF-J22-1,9,4,2,1,7,3,0.2222222222222222,0.7777777777777778,0.25,0.75
SF-O25-1,SF-J21,8,7,6,4,2,3,0.75,0.25,0.5714285714285714,0.42857142857142855
SF-O25-1,SF-I23-1,2,1,2,1,0,0,1.0,0.0,1.0,0.0
SF-O25-1,SF-F26,8,7,0,0,8,7,0.0,1.0,0.0,1.0
SF-O25-1,SF-M15,3,2,3,0,0,2,1.0,0.0,0.0,1.0
SF-O25-1,SF-L19,6,28,6,1,0,27,1.0,0.0,0.03571428571428571,0.9642857142857143
SF-O25-1,SF-L20,4,1,2,0,2,1,0.5,0.5,0.0,1.0
SF-O25-1,SF-N20-1,3,4,1,2,2,2,0.3333333333333333,0.6666666666666666,0.5,0.5
SF-O25-1,SF-M20,7,4,4,1,3,3,0.5714285714285714,0.42857142857142855,0.25,0.75
SF-O25-1,SF-K20,6,1,2,0,4,1,0.3333333333333333,0.6666666666666666,0.0,1.0
SF-O25-1,SF-K15-,3,4,1,1,2,3,0.3333333333333333,0.6666666666666666,0.25,0.75
SF-O25-1,SF-K19,4,7,2,1,2,6,0.5,0.5,0.14285714285714285,0.8571428571428571
SF-O25-1,SF-K18,3,4,1,1,2,3,0.3333333333333333,0.6666666666666666,0.25,0.75
SF-O25-1,SF-J18,2,4,1,1,1,3,0.5,0.5,0.25,0.75
SF-O25-1,SF-J19,1,1,1,0,0,1,1.0,0.0,0.0,1.0
SF-O25-1,SF-M12,10,4,0,0,10,4,0.0,1.0,0.0,1.0
SF-O25-1,SF-M11,2,2,1,0,1,2,0.5,0.5,0.0,1.0
SF-O25-1,SF-Q21-2,7,7,6,4,1,3,0.8571428571428571,0.14285714285714285,0.5714285714285714,0.42857142857142855
SF-O25-1,SF-Q21-1,2,3,0,0,2,3,0.0,1.0,0.0,1.0
SF-O25-1,SF-P21,14,8,2,4,12,4,0.14285714285714285,0.8571428571428571,0.5,0.5
SF-O25-1,SF-O18,12,2,5,1,7,1,0.4166666666666667,0.5833333333333334,0.5,0.5
SF-O25-1,SF-O19,14,6,3,0,11,6,0.21428571428571427,0.7857142857142857,0.0,1.0
SF-O25-1,SF-O21,25,24,5,9,20,15,0.2,0.8,0.375,0.625
SF-O25-1,SF-O22,12,20,4,10,8,10,0.3333333333333333,0.6666666666666666,0.5,0.5
SF-O25-1,SF-N21,2,5,1,4,1,1,0.5,0.5,0.8,0.2
SF-O25-1,SF-N20-2,9,5,9,3,0,2,1.0,0.0,0.6,0.4
SF-O25-1,SF-M21,14,5,5,3,9,2,0.35714285714285715,0.6428571428571429,0.6,0.4
SF-O25-1,SF-L21,4,2,1,1,3,1,0.25,0.75,0.5,0.5
SF-O25-1,SF-S29,1,1,1,0,0,1,1.0,0.0,0.0,1.0
SF-O25-1,SF-Q30,6,6,0,4,6,2,0.0,1.0,0.6666666666666666,0.3333333333333333
SF-O25-1,SF-P30,10,6,3,1,7,5,0.3,0.7,0.16666666666666666,0.8333333333333334
SF-O25-1,SF-O30-2,6,1,1,0,5,1,0.16666666666666666,0.8333333333333334,0.0,1.0
SF-O25-1,SF-O30,6,11,2,4,4,7,0.3333333333333333,0.6666666666666666,0.36363636363636365,0.6363636363636364
SF-O25-1,SF-N27,8,10,2,4,6,6,0.25,0.75,0.4,0.6
SF-O25-1,SF-N29,4,1,2,0,2,1,0.5,0.5,0.0,1.0
SF-O25-1,SF-N28,13,5,3,2,10,3,0.23076923076923078,0.7692307692307693,0.4,0.6
SF-O25-1,SF-L30-1,9,4,3,2,6,2,0.3333333333333333,0.6666666666666666,0.5,0.5
SF-O25-1,SF-K30-2,1,1,0,0,1,1,0.0,1.0,0.0,1.0
SF-O25-1,SF-L29,20,1,10,0,10,1,0.5,0.5,0.0,1.0
SF-O25-1,SF-I30,1,2,0,2,1,0,0.0,1.0,1.0,0.0
SF-O25-1,SF-I27,1,4,1,4,0,0,1.0,0.0,1.0,0.0
SF-O25-1,SF-I28,1,1,0,0,1,1,0.0,1.0,0.0,1.0
SF-O25-1,SF-I30-2,2,2,2,2,0,0,1.0,0.0,1.0,0.0
SF-O25-1,SF-H28,6,3,5,1,1,2,0.8333333333333334,0.16666666666666666,0.3333333333333333,0.6666666666666666
SF-O25-1,SF-S24,8,13,4,2,4,11,0.5,0.5,0.15384615384615385,0.8461538461538461
SF-O25-1,SF-R24,8,8,5,6,3,2,0.625,0.375,0.75,0.25
SF-O25-1,SF-Q26,7,6,6,3,1,3,0.8571428571428571,0.14285714285714285,0.5,0.5
SF-O25-1,SF-O25-2,22,14,12,7,10,7,0.5454545454545454,0.45454545454545453,0.5,0.5
SF-O25-1,SF-N22-1B,6,6,4,6,2,0,0.6666666666666666,0.3333333333333333,1.0,0.0
SF-O25-1,SF-N26,8,7,6,6,2,1,0.75,0.25,0.8571428571428571,0.14285714285714285
SF-O25-1,SF-N25,21,15,10,7,11,8,0.47619047619047616,0.5238095238095238,0.4666666666666667,0.5333333333333333
SF-O25-1,SF-T22,3,5,2,4,1,1,0.6666666666666666,0.3333333333333333,0.8,0.2
SF-O25-1,SF-S22-2,1,1,0,0,1,1,0.0,1.0,0.0,1.0
SF-O25-1,SF-S22-1,2,2,0,2,2,0,0.0,1.0,1.0,0.0
SF-O25-1,SF-Q23-3,10,9,8,7,2,2,0.8,0.2,0.7777777777777778,0.2222222222222222
SF-O25-1,SF-Q22-1,7,10,5,5,2,5,0.7142857142857143,0.2857142857142857,0.5,0.5
SF-O25-1,SF-Q22-2,3,8,2,4,1,4,0.6666666666666666,0.3333333333333333,0.5,0.5
SF-O25-1,SF-P22,9,15,5,7,4,8,0.5555555555555556,0.4444444444444444,0.4666666666666667,0.5333333333333333
SF-O25-1,SF-T20,3,5,1,0,2,5,0.3333333333333333,0.6666666666666666,0.0,1.0
SF-O25-1,SF-W14,1,2,1,0,0,2,1.0,0.0,0.0,1.0
SF-K22-2,SF-M25,12,7,7,4,5,3,0.5833333333333334,0.4166666666666667,0.5714285714285714,0.42857142857142855
SF-K22-2,SF-M26-2,8,7,1,6,7,1,0.125,0.875,0.8571428571428571,0.14285714285714285
SF-K22-2,SF-K26,16,23,10,17,6,6,0.625,0.375,0.7391304347826086,0.2608695652173913
SF-K22-2,SF-J27,4,4,1,4,3,0,0.25,0.75,1.0,0.0
SF-K22-2,SF-M30,5,6,1,4,4,2,0.2,0.8,0.6666666666666666,0.3333333333333333
SF-K22-2,SF-L27-2,2,3,0,0,2,3,0.0,1.0,0.0,1.0
SF-K22-2,SF-J29,6,10,3,4,3,6,0.5,0.5,0.4,0.6
SF-K22-2,SF-L26,100,67,89,65,11,2,0.89,0.11,0.9701492537313433,0.029850746268656716
SF-K22-2,SF-L25,15,26,6,22,9,4,0.4,0.6,0.8461538461538461,0.15384615384615385
SF-K22-2,SF-M24,6,4,6,4,0,0,1.0,0.0,1.0,0.0
SF-K22-2,SF-L24,24,15,18,10,6,5,0.75,0.25,0.6666666666666666,0.3333333333333333
SF-K22-2,SF-N23,5,3,0,3,5,0,0.0,1.0,1.0,0.0
SF-K22-2,SF-N24-2,9,5,7,1,2,4,0.7777777777777778,0.2222222222222222,0.2,0.8
SF-K22-2,SF-K27-2,10,9,7,4,3,5,0.7,0.3,0.4444444444444444,0.5555555555555556
SF-K22-2,SF-J26-2,9,6,6,3,3,3,0.6666666666666666,0.3333333333333333,0.5,0.5
SF-K22-2,SF-K28-3,1,1,1,0,0,1,1.0,0.0,0.0,1.0
SF-K22-2,SF-L28,6,4,5,3,1,1,0.8333333333333334,0.16666666666666666,0.75,0.25
SF-K22-2,SF-K29-1,3,4,1,1,2,3,0.3333333333333333,0.6666666666666666,0.25,0.75
SF-K22-2,SF-J28-2,7,7,2,3,5,4,0.2857142857142857,0.7142857142857143,0.42857142857142855,0.5714285714285714
SF-K22-2,SF-K25,3,8,2,7,1,1,0.6666666666666666,0.3333333333333333,0.875,0.125
SF-K22-2,SF-J25,27,10,9,2,18,8,0.3333333333333333,0.6666666666666666,0.2,0.8
SF-K22-2,SF-H26-2,9,2,4,1,5,1,0.4444444444444444,0.5555555555555556,0.5,0.5
SF-K22-2,SF-P24,9,8,7,7,2,1,0.7777777777777778,0.2222222222222222,0.875,0.125
SF-K22-2,SF-J24,2,10,1,5,1,5,0.5,0.5,0.5,0.5
SF-K22-2,SF-O24,4,2,3,2,1,0,0.75,0.25,1.0,0.0
SF-K22-2,SF-J26,7,7,3,5,4,2,0.42857142857142855,0.5714285714285714,0.7142857142857143,0.2857142857142857
SF-K22-2,SF-I26-,12,3,10,3,2,0,0.8333333333333334,0.16666666666666666,1.0,0.0
SF-K22-2,SF-I25,14,25,8,18,6,7,0.5714285714285714,0.42857142857142855,0.72,0.28
SF-K22-2,SF-K23,13,4,11,2,2,2,0.8461538461538461,0.15384615384615385,0.5,0.5
SF-K22-2,SF-H26,38,41,25,22,13,19,0.6578947368421053,0.34210526315789475,0.5365853658536586,0.4634146341463415
SF-K22-2,SF-O23,9,14,5,10,4,4,0.5555555555555556,0.4444444444444444,0.7142857142857143,0.2857142857142857
SF-K22-2,SF-H27-1,5,4,2,1,3,3,0.4,0.6,0.25,0.75
SF-K22-2,SF-F28-2,9,37,3,10,6,27,0.3333333333333333,0.6666666666666666,0.2702702702702703,0.7297297297297297
SF-K22-2,SF-G27,38,52,13,31,25,21,0.34210526315789475,0.6578947368421053,0.5961538461538461,0.40384615384615385
SF-K22-2,SF-M22-2,59,31,43,16,16,15,0.7288135593220338,0.2711864406779661,0.5161290322580645,0.4838709677419355
SF-K22-2,SF-L22,57,15,44,9,13,6,0.7719298245614035,0.22807017543859648,0.6,0.4
SF-K22-2,SF-F27,19,34,17,27,2,7,0.8947368421052632,0.10526315789473684,0.7941176470588235,0.20588235294117646
SF-K22-2,SF-N22-2,33,27,22,17,11,10,0.6666666666666666,0.3333333333333333,0.6296296296296297,0.37037037037037035
SF-K22-2,SF-G28-2,1,5,0,2,1,3,0.0,1.0,0.4,0.6
SF-K22-2,SF-M22-1,11,1,6,1,5,0,0.5454545454545454,0.45454545454545453,1.0,0.0
SF-K22-2,SF-O25-1,2,5,1,2,1,3,0.5,0.5,0.4,0.6
SF-K22-2,SF-K24,7,5,5,4,2,1,0.7142857142857143,0.2857142857142857,0.8,0.2
SF-K22-2,SF-J23-2,14,22,10,18,4,4,0.7142857142857143,0.2857142857142857,0.8181818181818182,0.18181818181818182
SF-K22-2,SF-G23,11,14,6,5,5,9,0.5454545454545454,0.45454545454545453,0.35714285714285715,0.6428571428571429
SF-K22-2,SF-G24,27,12,16,3,11,9,0.5925925925925926,0.4074074074074074,0.25,0.75
SF-K22-2,SF-G25,15,9,10,4,5,5,0.6666666666666666,0.3333333333333333,0.4444444444444444,0.5555555555555556
SF-K22-2,SF-F23,10,14,6,6,4,8,0.6,0.4,0.42857142857142855,0.5714285714285714
SF-K22-2,SF-E23,13,8,8,2,5,6,0.6153846153846154,0.38461538461538464,0.25,0.75
SF-K22-2,SF-D24,6,3,3,1,3,2,0.5,0.5,0.3333333333333333,0.6666666666666666
SF-K22-2,SF-C22,20,8,4,1,16,7,0.2,0.8,0.125,0.875
SF-K22-2,SF-B22,1,8,0,4,1,4,0.0,1.0,0.5,0.5
SF-K22-2,SF-J17,8,6,1,2,7,4,0.125,0.875,0.3333333333333333,0.6666666666666666
SF-K22-2,SF-I19,4,7,3,2,1,5,0.75,0.25,0.2857142857142857,0.7142857142857143
SF-K22-2,SF-I20,8,4,5,3,3,1,0.625,0.375,0.75,0.25
SF-K22-2,SF-H20,12,8,5,4,7,4,0.4166666666666667,0.5833333333333334,0.5,0.5
SF-K22-2,SF-G19,2,6,2,2,0,4,1.0,0.0,0.3333333333333333,0.6666666666666666
SF-K22-2,SF-G18,5,5,4,2,1,3,0.8,0.2,0.4,0.6
SF-K22-2,SF-G20,1,14,0,0,1,14,0.0,1.0,0.0,1.0
SF-K22-2,SF-F19,2,4,1,1,1,3,0.5,0.5,0.25,0.75
SF-K22-2,SF-E18,1,1,1,1,0,0,1.0,0.0,1.0,0.0
SF-K22-2,SF-E20,4,2,1,0,3,2,0.25,0.75,0.0,1.0
SF-K22-2,SF-H30,1,3,0,2,1,1,0.0,1.0,0.6666666666666666,0.3333333333333333
SF-K22-2,SF-G30-2,5,16,1,10,4,6,0.2,0.8,0.625,0.375
SF-K22-2,SF-F30-1,3,7,3,4,0,3,1.0,0.0,0.5714285714285714,0.42857142857142855
SF-K22-2,SF-E29-2,28,41,9,22,19,19,0.32142857142857145,0.6785714285714286,0.5365853658536586,0.4634146341463415
SF-K22-2,SF-E29-1,23,27,5,15,18,12,0.21739130434782608,0.782608695652174,0.5555555555555556,0.4444444444444444
SF-K22-2,SF-D28,3,4,2,1,1,3,0.6666666666666666,0.3333333333333333,0.25,0.75
SF-K22-2,SF-A27,2,3,1,2,1,1,0.5,0.5,0.6666666666666666,0.3333333333333333
SF-K22-2,SF-G29-2,22,16,6,6,16,10,0.2727272727272727,0.7272727272727273,0.375,0.625
SF-K22-2,SF-G29-1,2,4,1,0,1,4,0.5,0.5,0.0,1.0
SF-K22-2,SF-G30-1,4,1,0,0,4,1,0.0,1.0,0.0,1.0
SF-K22-2,SF-G29-3,2,9,1,3,1,6,0.5,0.5,0.3333333333333333,0.6666666666666666
SF-K22-2,SF-F30-2,3,4,0,3,3,1,0.0,1.0,0.75,0.25
SF-K22-2,SF-F29,8,4,4,3,4,1,0.5,0.5,0.75,0.25
SF-K22-2,SF-E29-3,3,6,2,6,1,0,0.6666666666666666,0.3333333333333333,1.0,0.0
SF-K22-2,SF-F28-1,6,4,2,0,4,4,0.3333333333333333,0.6666666666666666,0.0,1.0
SF-K22-2,SF-E28,3,6,2,6,1,0,0.6666666666666666,0.3333333333333333,1.0,0.0
SF-K22-2,SF-J12,3,5,2,1,1,4,0.6666666666666666,0.3333333333333333,0.2,0.8
SF-K22-2,SF-I16,1,2,0,1,1,1,0.0,1.0,0.5,0.5
SF-K22-2,SF-H12,4,5,2,0,2,5,0.5,0.5,0.0,1.0
SF-K22-2,SF-G13,3,1,0,0,3,1,0.0,1.0,0.0,1.0
SF-K22-2,SF-F16,2,2,1,1,1,1,0.5,0.5,0.5,0.5
SF-K22-2,SF-C21,2,1,0,0,2,1,0.0,1.0,0.0,1.0
SF-K22-2,SF-C20,4,3,0,0,4,3,0.0,1.0,0.0,1.0
SF-K22-2,SF-B21,2,4,0,0,2,4,0.0,1.0,0.0,1.0
SF-K22-2,SF-B19,3,6,0,0,3,6,0.0,1.0,0.0,1.0
SF-K22-2,SF-A20,4,5,0,1,4,4,0.0,1.0,0.2,0.8
SF-K22-2,SF-A19,1,1,0,1,1,0,0.0,1.0,1.0,0.0
SF-K22-2,SF-C26,4,2,0,0,4,2,0.0,1.0,0.0,1.0
SF-K22-2,SF-C25,8,15,4,5,4,10,0.5,0.5,0.3333333333333333,0.6666666666666666
SF-K22-2,SF-E27,2,3,1,0,1,3,0.5,0.5,0.0,1.0
SF-K22-2,SF-B28-2,2,2,2,1,0,1,1.0,0.0,0.5,0.5
SF-K22-2,SF-D27,4,6,0,5,4,1,0.0,1.0,0.8333333333333334,0.16666666666666666
SF-K22-2,SF-C28-2,2,2,0,1,2,1,0.0,1.0,0.5,0.5
SF-K22-2,SF-C28-1,2,26,0,23,2,3,0.0,1.0,0.8846153846153846,0.11538461538461539
SF-K22-2,SF-J1,2,10,1,6,1,4,0.5,0.5,0.6,0.4
SF-K22-2,SF-H0,1,4,1,2,0,2,1.0,0.0,0.5,0.5
SF-K22-2,SF-J3,2,1,2,1,0,0,1.0,0.0,1.0,0.0
SF-K22-2,SF-F9,2,2,1,2,1,0,0.5,0.5,1.0,0.0
SF-K22-2,SF-H25,3,11,0,9,3,2,0.0,1.0,0.8181818181818182,0.18181818181818182
SF-K22-2,SF-G26,5,10,0,3,5,7,0.0,1.0,0.3,0.7
SF-K22-2,SF-K21,14,12,11,1,3,11,0.7857142857142857,0.21428571428571427,0.08333333333333333,0.9166666666666666
SF-K22-2,SF-K22-1,13,12,11,9,2,3,0.8461538461538461,0.15384615384615385,0.75,0.25
SF-K22-2,SF-J23-1,53,68,37,45,16,23,0.6981132075471698,0.3018867924528302,0.6617647058823529,0.3382352941176471
SF-K22-2,SF-J22-1,12,10,6,4,6,6,0.5,0.5,0.4,0.6
SF-K22-2,SF-J22-2,5,1,2,1,3,0,0.4,0.6,1.0,0.0
SF-K22-2,SF-J21,5,19,3,13,2,6,0.6,0.4,0.6842105263157895,0.3157894736842105
SF-K22-2,SF-I21,3,1,2,1,1,0,0.6666666666666666,0.3333333333333333,1.0,0.0
SF-K22-2,SF-I22,3,7,3,1,0,6,1.0,0.0,0.14285714285714285,0.8571428571428571
SF-K22-2,SF-I23-2,9,8,9,6,0,2,1.0,0.0,0.75,0.25
SF-K22-2,SF-I24,24,2,22,1,2,1,0.9166666666666666,0.08333333333333333,0.5,0.5
SF-K22-2,SF-I23-1,36,22,17,10,19,12,0.4722222222222222,0.5277777777777778,0.45454545454545453,0.5454545454545454
SF-K22-2,SF-F26,19,19,7,6,12,13,0.3684210526315789,0.631578947368421,0.3157894736842105,0.6842105263157895
SF-K22-2,SF-M13,5,3,2,0,3,3,0.4,0.6,0.0,1.0
SF-K22-2,SF-M15,6,10,4,0,2,10,0.6666666666666666,0.3333333333333333,0.0,1.0
SF-K22-2,SF-L19,9,2,7,0,2,2,0.7777777777777778,0.2222222222222222,0.0,1.0
SF-K22-2,SF-L20,3,8,1,4,2,4,0.3333333333333333,0.6666666666666666,0.5,0.5
SF-K22-2,SF-N20-1,10,9,4,4,6,5,0.4,0.6,0.4444444444444444,0.5555555555555556
SF-K22-2,SF-M20,23,21,18,9,5,12,0.782608695652174,0.21739130434782608,0.42857142857142855,0.5714285714285714
SF-K22-2,SF-K17-2,9,2,5,0,4,2,0.5555555555555556,0.4444444444444444,0.0,1.0
SF-K22-2,SF-K20,14,12,5,7,9,5,0.35714285714285715,0.6428571428571429,0.5833333333333334,0.4166666666666667
SF-K22-2,SF-K15-,26,26,14,9,12,17,0.5384615384615384,0.46153846153846156,0.34615384615384615,0.6538461538461539
SF-K22-2,SF-K19,15,13,6,8,9,5,0.4,0.6,0.6153846153846154,0.38461538461538464
SF-K22-2,SF-K18,17,7,6,1,11,6,0.35294117647058826,0.6470588235294118,0.14285714285714285,0.8571428571428571
SF-K22-2,SF-K17,14,8,3,3,11,5,0.21428571428571427,0.7857142857142857,0.375,0.625
SF-K22-2,SF-J16,5,3,2,1,3,2,0.4,0.6,0.3333333333333333,0.6666666666666666
SF-K22-2,SF-J18,15,5,4,2,11,3,0.26666666666666666,0.7333333333333333,0.4,0.6
SF-K22-2,SF-J20,7,6,6,2,1,4,0.8571428571428571,0.14285714285714285,0.3333333333333333,0.6666666666666666
SF-K22-2,SF-J19,7,6,3,5,4,1,0.42857142857142855,0.5714285714285714,0.8333333333333334,0.16666666666666666
SF-K22-2,SF-M12,2,7,0,3,2,4,0.0,1.0,0.42857142857142855,0.5714285714285714
SF-K22-2,SF-M11,1,2,0,2,1,0,0.0,1.0,1.0,0.0
SF-K22-2,SF-R19,13,16,3,3,10,13,0.23076923076923078,0.7692307692307693,0.1875,0.8125
SF-K22-2,SF-R20,11,8,2,1,9,7,0.18181818181818182,0.8181818181818182,0.125,0.875
SF-K22-2,SF-Q21-2,27,26,9,1,18,25,0.3333333333333333,0.6666666666666666,0.038461538461538464,0.9615384615384616
SF-K22-2,SF-Q21-1,30,11,3,1,27,10,0.1,0.9,0.09090909090909091,0.9090909090909091
SF-K22-2,SF-P21,21,12,9,2,12,10,0.42857142857142855,0.5714285714285714,0.16666666666666666,0.8333333333333334
SF-K22-2,SF-O18,12,12,5,4,7,8,0.4166666666666667,0.5833333333333334,0.3333333333333333,0.6666666666666666
SF-K22-2,SF-O19,7,12,3,5,4,7,0.42857142857142855,0.5714285714285714,0.4166666666666667,0.5833333333333334
SF-K22-2,SF-O21,38,49,14,20,24,29,0.3684210526315789,0.631578947368421,0.40816326530612246,0.5918367346938775
SF-K22-2,SF-O22,37,54,14,34,23,20,0.3783783783783784,0.6216216216216216,0.6296296296296297,0.37037037037037035
SF-K22-2,SF-N21,11,6,8,4,3,2,0.7272727272727273,0.2727272727272727,0.6666666666666666,0.3333333333333333
SF-K22-2,SF-N20-2,6,3,1,1,5,2,0.16666666666666666,0.8333333333333334,0.3333333333333333,0.6666666666666666
SF-K22-2,SF-M21,7,7,4,0,3,7,0.5714285714285714,0.42857142857142855,0.0,1.0
SF-K22-2,SF-L21,29,34,11,12,18,22,0.3793103448275862,0.6206896551724138,0.35294117647058826,0.6470588235294118
SF-K22-2,SF-Q30,1,24,0,2,1,22,0.0,1.0,0.08333333333333333,0.9166666666666666
SF-K22-2,SF-P30,2,3,0,0,2,3,0.0,1.0,0.0,1.0
SF-K22-2,SF-O30-2,2,1,2,1,0,0,1.0,0.0,1.0,0.0
SF-K22-2,SF-O30,1,1,0,0,1,1,0.0,1.0,0.0,1.0
SF-K22-2,SF-N27,8,4,4,1,4,3,0.5,0.5,0.25,0.75
SF-K22-2,SF-N29,5,5,3,1,2,4,0.6,0.4,0.2,0.8
SF-K22-2,SF-N28,5,3,0,2,5,1,0.0,1.0,0.6666666666666666,0.3333333333333333
SF-K22-2,SF-L30-1,58,62,2,29,56,33,0.034482758620689655,0.9655172413793104,0.46774193548387094,0.532258064516129
SF-K22-2,SF-K30-2,4,2,2,2,2,0,0.5,0.5,1.0,0.0
SF-K22-2,SF-L29,2,6,0,4,2,2,0.0,1.0,0.6666666666666666,0.3333333333333333
SF-K22-2,SF-J29-1,3,20,1,3,2,17,0.3333333333333333,0.6666666666666666,0.15,0.85
SF-K22-2,SF-I30,2,5,1,5,1,0,0.5,0.5,1.0,0.0
SF-K22-2,SF-I29-2,4,3,1,1,3,2,0.25,0.75,0.3333333333333333,0.6666666666666666
SF-K22-2,SF-I27,6,4,1,1,5,3,0.16666666666666666,0.8333333333333334,0.25,0.75
SF-K22-2,SF I29-1,2,3,0,1,2,2,0.0,1.0,0.3333333333333333,0.6666666666666666
SF-K22-2,SF-H28,9,1,4,0,5,1,0.4444444444444444,0.5555555555555556,0.0,1.0
SF-K22-2,SF-H29,1,1,0,1,1,0,0.0,1.0,1.0,0.0
SF-K22-2,SF-S24,8,6,4,6,4,0,0.5,0.5,1.0,0.0
SF-K22-2,SF-R24,13,14,8,9,5,5,0.6153846153846154,0.38461538461538464,0.6428571428571429,0.35714285714285715
SF-K22-2,SF-R26,3,4,2,0,1,4,0.6666666666666666,0.3333333333333333,0.0,1.0
SF-K22-2,SF-Q26,3,6,0,3,3,3,0.0,1.0,0.5,0.5
SF-K22-2,SF-P26,5,2,1,1,4,1,0.2,0.8,0.5,0.5
SF-K22-2,SF-O25-2,12,17,6,10,6,7,0.5,0.5,0.5882352941176471,0.4117647058823529
SF-K22-2,SF-N22-1B,14,12,9,5,5,7,0.6428571428571429,0.35714285714285715,0.4166666666666667,0.5833333333333334
SF-K22-2,SF-N26,5,1,4,1,1,0,0.8,0.2,1.0,0.0
SF-K22-2,SF-N25,2,1,0,0,2,1,0.0,1.0,0.0,1.0
SF-K22-2,SF-T21,2,1,1,0,1,1,0.5,0.5,0.0,1.0
SF-K22-2,SF-T22,12,12,8,7,4,5,0.6666666666666666,0.3333333333333333,0.5833333333333334,0.4166666666666667
SF-K22-2,SF-S22-2,5,1,0,1,5,0,0.0,1.0,1.0,0.0
SF-K22-2,SF-S22-1,35,21,22,16,13,5,0.6285714285714286,0.37142857142857144,0.7619047619047619,0.23809523809523808
SF-K22-2,SF-Q23-3,18,15,11,7,7,8,0.6111111111111112,0.3888888888888889,0.4666666666666667,0.5333333333333333
SF-K22-2,SF-Q22-1,30,28,20,17,10,11,0.6666666666666666,0.3333333333333333,0.6071428571428571,0.39285714285714285
SF-K22-2,SF-Q22-2,51,35,36,15,15,20,0.7058823529411765,0.29411764705882354,0.42857142857142855,0.5714285714285714
SF-K22-2,SF-P22,51,44,23,21,28,23,0.45098039215686275,0.5490196078431373,0.4772727272727273,0.5227272727272727
SF-K22-2,SF-W19,1,2,1,1,0,1,1.0,0.0,0.5,0.5
SF-K22-2,SF-U21,10,3,4,0,6,3,0.4,0.6,0.0,1.0
SF-K22-2,SF-T20,9,35,4,22,5,13,0.4444444444444444,0.5555555555555556,0.6285714285714286,0.37142857142857144
SF-K22-2,SF-S21,11,4,5,3,6,1,0.45454545454545453,0.5454545454545454,0.75,0.25
SF-K22-2,SF-V32,1,2,0,0,1,2,0.0,1.0,0.0,1.0
SF-K22-2,SF-U30,3,1,0,0,3,1,0.0,1.0,0.0,1.0
SF-K24,SF-M26,1,4,0,3,1,1,0.0,1.0,0.75,0.25
SF-K24,SF-M25,30,23,21,16,9,7,0.7,0.3,0.6956521739130435,0.30434782608695654
SF-K24,SF-M26-2,12,11,7,8,5,3,0.5833333333333334,0.4166666666666667,0.7272727272727273,0.2727272727272727
SF-K24,SF-L27,10,4,7,3,3,1,0.7,0.3,0.75,0.25
SF-K24,SF-K26,14,18,9,13,5,5,0.6428571428571429,0.35714285714285715,0.7222222222222222,0.2777777777777778
SF-K24,SF-J27,9,8,3,7,6,1,0.3333333333333333,0.6666666666666666,0.875,0.125
SF-K24,SF-M30,12,9,1,4,11,5,0.08333333333333333,0.9166666666666666,0.4444444444444444,0.5555555555555556
SF-K24,SF-J29-3,5,4,2,3,3,1,0.4,0.6,0.75,0.25
SF-K24,SF-J29,15,19,4,12,11,7,0.26666666666666666,0.7333333333333333,0.631578947368421,0.3684210526315789
SF-K24,SF-L26,64,43,28,17,36,26,0.4375,0.5625,0.3953488372093023,0.6046511627906976
SF-K24,SF-M28,3,9,2,6,1,3,0.6666666666666666,0.3333333333333333,0.6666666666666666,0.3333333333333333
SF-K24,SF-M27,2,2,1,1,1,1,0.5,0.5,0.5,0.5
SF-K24,SF-L25,60,42,51,42,9,0,0.85,0.15,1.0,0.0
SF-K24,SF-M24,17,23,15,19,2,4,0.8823529411764706,0.11764705882352941,0.8260869565217391,0.17391304347826086
SF-K24,SF-L24,50,50,44,42,6,8,0.88,0.12,0.84,0.16
SF-K24,SF-N23,6,12,6,9,0,3,1.0,0.0,0.75,0.25
SF-K24,SF-N24-2,7,8,6,6,1,2,0.8571428571428571,0.14285714285714285,0.75,0.25
SF-K24,SF-K27-2,11,15,7,5,4,10,0.6363636363636364,0.36363636363636365,0.3333333333333333,0.6666666666666666
SF-K24,SF-J26-2,10,8,6,7,4,1,0.6,0.4,0.875,0.125
SF-K24,SF-L28,2,3,1,2,1,1,0.5,0.5,0.6666666666666666,0.3333333333333333
SF-K24,SF-K29-1,13,13,7,5,6,8,0.5384615384615384,0.46153846153846156,0.38461538461538464,0.6153846153846154
SF-K24,SF-J28-2,8,8,5,5,3,3,0.625,0.375,0.625,0.375
SF-K24,SF-K27,10,2,10,1,0,1,1.0,0.0,0.5,0.5
SF-K24,SF-K25,32,20,28,17,4,3,0.875,0.125,0.85,0.15
SF-K24,SF-J25,43,20,34,13,9,7,0.7906976744186046,0.20930232558139536,0.65,0.35
SF-K24,SF-H26-2,5,9,4,6,1,3,0.8,0.2,0.6666666666666666,0.3333333333333333
SF-K24,SF-P24,52,42,51,37,1,5,0.9807692307692307,0.019230769230769232,0.8809523809523809,0.11904761904761904
SF-K24,SF-J24,93,98,88,94,5,4,0.946236559139785,0.053763440860215055,0.9591836734693877,0.04081632653061224
SF-K24,SF-O24,13,13,9,5,4,8,0.6923076923076923,0.3076923076923077,0.38461538461538464,0.6153846153846154
SF-K24,SF-J26,11,4,9,1,2,3,0.8181818181818182,0.18181818181818182,0.25,0.75
SF-K24,SF-I26-,9,2,8,1,1,1,0.8888888888888888,0.1111111111111111,0.5,0.5
SF-K24,SF-I25,34,38,33,32,1,6,0.9705882352941176,0.029411764705882353,0.8421052631578947,0.15789473684210525
SF-K24,SF-K23,5,5,3,4,2,1,0.6,0.4,0.8,0.2
SF-K24,SF-H26,19,35,15,24,4,11,0.7894736842105263,0.21052631578947367,0.6857142857142857,0.3142857142857143
SF-K24,SF-O23,11,23,3,9,8,14,0.2727272727272727,0.7272727272727273,0.391304347826087,0.6086956521739131
SF-K24,SF-H27-1,25,10,14,8,11,2,0.56,0.44,0.8,0.2
SF-K24,SF-F28-2,22,27,4,4,18,23,0.18181818181818182,0.8181818181818182,0.14814814814814814,0.8518518518518519
SF-K24,SF-G27,42,35,33,25,9,10,0.7857142857142857,0.21428571428571427,0.7142857142857143,0.2857142857142857
SF-K24,SF-M22-2,23,15,15,8,8,7,0.6521739130434783,0.34782608695652173,0.5333333333333333,0.4666666666666667
SF-K24,SF-L22,2,6,2,3,0,3,1.0,0.0,0.5,0.5
SF-K24,SF-F27,11,14,5,2,6,12,0.45454545454545453,0.5454545454545454,0.14285714285714285,0.8571428571428571
SF-K24,SF-N22-2,33,56,18,31,15,25,0.5454545454545454,0.45454545454545453,0.5535714285714286,0.44642857142857145
SF-K24,SF-G28-2,3,2,1,1,2,1,0.3333333333333333,0.6666666666666666,0.5,0.5
SF-K24,SF-G28-1,6,1,3,0,3,1,0.5,0.5,0.0,1.0
SF-K24,SF-M22-1,15,7,8,6,7,1,0.5333333333333333,0.4666666666666667,0.8571428571428571,0.14285714285714285
SF-K24,SF-O25-1,8,6,6,1,2,5,0.75,0.25,0.16666666666666666,0.8333333333333334
SF-K24,SF-K22-2,5,7,4,5,1,2,0.8,0.2,0.7142857142857143,0.2857142857142857
SF-K24,SF-J23-2,12,15,11,14,1,1,0.9166666666666666,0.08333333333333333,0.9333333333333333,0.06666666666666667
SF-K24,SF-G23,25,24,9,4,16,20,0.36,0.64,0.16666666666666666,0.8333333333333334
SF-K24,SF-G24,55,37,15,14,40,23,0.2727272727272727,0.7272727272727273,0.3783783783783784,0.6216216216216216
SF-K24,SF-G25,10,9,6,2,4,7,0.6,0.4,0.2222222222222222,0.7777777777777778
SF-K24,SF-F23,43,27,15,7,28,20,0.3488372093023256,0.6511627906976745,0.25925925925925924,0.7407407407407407
SF-K24,SF-E23,11,11,4,1,7,10,0.36363636363636365,0.6363636363636364,0.09090909090909091,0.9090909090909091
SF-K24,SF-C22,6,6,1,0,5,6,0.16666666666666666,0.8333333333333334,0.0,1.0
SF-K24,SF-B22,11,21,3,3,8,18,0.2727272727272727,0.7272727272727273,0.14285714285714285,0.8571428571428571
SF-K24,SF-J17,7,4,0,1,7,3,0.0,1.0,0.25,0.75
SF-K24,SF-I19,4,3,2,1,2,2,0.5,0.5,0.3333333333333333,0.6666666666666666
SF-K24,SF-I20,2,13,0,2,2,11,0.0,1.0,0.15384615384615385,0.8461538461538461
SF-K24,SF-H16,4,1,2,0,2,1,0.5,0.5,0.0,1.0
SF-K24,SF-H19,2,3,0,0,2,3,0.0,1.0,0.0,1.0
SF-K24,SF-H20,3,6,1,3,2,3,0.3333333333333333,0.6666666666666666,0.5,0.5
SF-K24,SF-H18,1,1,0,0,1,1,0.0,1.0,0.0,1.0
SF-K24,SF-H17,1,1,0,0,1,1,0.0,1.0,0.0,1.0
SF-K24,SF-G19,2,6,0,0,2,6,0.0,1.0,0.0,1.0
SF-K24,SF-G18,4,2,1,0,3,2,0.25,0.75,0.0,1.0
SF-K24,SF-G20,4,6,1,2,3,4,0.25,0.75,0.3333333333333333,0.6666666666666666
SF-K24,SF-F19,7,12,3,2,4,10,0.42857142857142855,0.5714285714285714,0.16666666666666666,0.8333333333333334
SF-K24,SF-H30,2,2,0,1,2,1,0.0,1.0,0.5,0.5
SF-K24,SF-G30-2,12,10,2,5,10,5,0.16666666666666666,0.8333333333333334,0.5,0.5
SF-K24,SF-F30-1,3,5,2,5,1,0,0.6666666666666666,0.3333333333333333,1.0,0.0
SF-K24,SF-E29-2,13,13,5,8,8,5,0.38461538461538464,0.6153846153846154,0.6153846153846154,0.38461538461538464
SF-K24,SF-E29-1,23,31,18,25,5,6,0.782608695652174,0.21739130434782608,0.8064516129032258,0.1935483870967742
SF-K24,SF-D29,4,2,1,1,3,1,0.25,0.75,0.5,0.5
SF-K24,SF-D28,1,4,1,2,0,2,1.0,0.0,0.5,0.5
SF-K24,SF-A27,43,3,42,1,1,2,0.9767441860465116,0.023255813953488372,0.3333333333333333,0.6666666666666666
SF-K24,SF-G29-2,15,15,9,10,6,5,0.6,0.4,0.6666666666666666,0.3333333333333333
SF-K24,SF-G29-1,13,4,5,3,8,1,0.38461538461538464,0.6153846153846154,0.75,0.25
SF-K24,SF-G30-1,5,5,2,2,3,3,0.4,0.6,0.4,0.6
SF-K24,SF-F30-2,4,3,2,3,2,0,0.5,0.5,1.0,0.0
SF-K24,SF-F29,9,4,7,2,2,2,0.7777777777777778,0.2222222222222222,0.5,0.5
SF-K24,SF-F28-1,11,2,5,1,6,1,0.45454545454545453,0.5454545454545454,0.5,0.5
SF-K24,SF-E28-2,2,2,0,0,2,2,0.0,1.0,0.0,1.0
SF-K24,SF-E28,9,11,8,8,1,3,0.8888888888888888,0.1111111111111111,0.7272727272727273,0.2727272727272727
SF-K24,SF-J12,5,1,1,1,4,0,0.2,0.8,1.0,0.0
SF-K24,SF-J13,7,5,4,1,3,4,0.5714285714285714,0.42857142857142855,0.2,0.8
SF-K24,SF-H12,1,3,0,1,1,2,0.0,1.0,0.3333333333333333,0.6666666666666666
SF-K24,SF-G10-2,1,1,0,0,1,1,0.0,1.0,0.0,1.0
SF-K24,SF-H15,3,3,0,0,3,3,0.0,1.0,0.0,1.0
SF-K24,SF-G11,1,1,0,0,1,1,0.0,1.0,0.0,1.0
SF-K24,SF-G12,2,2,1,0,1,2,0.5,0.5,0.0,1.0
SF-K24,SF-G10-1,5,1,0,0,5,1,0.0,1.0,0.0,1.0
SF-K24,SF-F15,1,2,0,0,1,2,0.0,1.0,0.0,1.0
SF-K24,SF-C20,3,3,0,0,3,3,0.0,1.0,0.0,1.0
SF-K24,SF-B21,9,1,1,0,8,1,0.1111111111111111,0.8888888888888888,0.0,1.0
SF-K24,SF-B19,5,10,0,6,5,4,0.0,1.0,0.6,0.4
SF-K24,SF-A20,9,3,1,1,8,2,0.1111111111111111,0.8888888888888888,0.3333333333333333,0.6666666666666666
SF-K24,SF-C26,1,2,0,0,1,2,0.0,1.0,0.0,1.0
SF-K24,SF-C25,10,13,2,3,8,10,0.2,0.8,0.23076923076923078,0.7692307692307693
SF-K24,SF-B25,3,4,2,1,1,3,0.6666666666666666,0.3333333333333333,0.25,0.75
SF-K24,SF-B28-2,6,11,2,2,4,9,0.3333333333333333,0.6666666666666666,0.18181818181818182,0.8181818181818182
SF-K24,SF-D27,10,7,2,3,8,4,0.2,0.8,0.42857142857142855,0.5714285714285714
SF-K24,SF-C28-2,3,3,0,0,3,3,0.0,1.0,0.0,1.0
SF-K24,SF-C28-1,2,1,1,1,1,0,0.5,0.5,1.0,0.0
SF-K24,SF-B28,1,4,1,4,0,0,1.0,0.0,1.0,0.0
SF-K24,SF-G5,3,1,2,0,1,1,0.6666666666666666,0.3333333333333333,0.0,1.0
SF-K24,SF-G7,1,4,1,0,0,4,1.0,0.0,0.0,1.0
SF-K24,SF-H25,5,3,5,2,0,1,1.0,0.0,0.6666666666666666,0.3333333333333333
SF-K24,SF-G26,6,7,3,5,3,2,0.5,0.5,0.7142857142857143,0.2857142857142857
SF-K24,SF-K21,5,10,4,2,1,8,0.8,0.2,0.2,0.8
SF-K24,SF-K22-1,12,19,11,17,1,2,0.9166666666666666,0.08333333333333333,0.8947368421052632,0.10526315789473684
SF-K24,SF-J23-1,34,67,13,41,21,26,0.38235294117647056,0.6176470588235294,0.6119402985074627,0.3880597014925373
SF-K24,SF-J22-1,4,12,1,9,3,3,0.25,0.75,0.75,0.25
SF-K24,SF-J22-2,4,5,2,4,2,1,0.5,0.5,0.8,0.2
SF-K24,SF-J21,7,11,6,5,1,6,0.8571428571428571,0.14285714285714285,0.45454545454545453,0.5454545454545454
SF-K24,SF-I21,1,1,1,1,0,0,1.0,0.0,1.0,0.0
SF-K24,SF-I22,3,6,3,3,0,3,1.0,0.0,0.5,0.5
SF-K24,SF-I23-2,8,12,5,7,3,5,0.625,0.375,0.5833333333333334,0.4166666666666667
SF-K24,SF-I24,2,4,2,2,0,2,1.0,0.0,0.5,0.5
SF-K24,SF-I23-1,18,19,14,15,4,4,0.7777777777777778,0.2222222222222222,0.7894736842105263,0.21052631578947367
SF-K24,SF-F26,32,36,7,8,25,28,0.21875,0.78125,0.2222222222222222,0.7777777777777778
SF-K24,SF-M13,7,5,5,1,2,4,0.7142857142857143,0.2857142857142857,0.2,0.8
SF-K24,SF-M15,6,7,4,3,2,4,0.6666666666666666,0.3333333333333333,0.42857142857142855,0.5714285714285714
SF-K24,SF-L19,5,10,2,5,3,5,0.4,0.6,0.5,0.5
SF-K24,SF-L20,13,10,3,3,10,7,0.23076923076923078,0.7692307692307693,0.3,0.7
SF-K24,SF-N20-1,6,6,1,5,5,1,0.16666666666666666,0.8333333333333334,0.8333333333333334,0.16666666666666666
SF-K24,SF-M20,31,25,17,11,14,14,0.5483870967741935,0.45161290322580644,0.44,0.56
SF-K24,SF-K17-2,10,6,2,0,8,6,0.2,0.8,0.0,1.0
SF-K24,SF-K20,7,17,1,5,6,12,0.14285714285714285,0.8571428571428571,0.29411764705882354,0.7058823529411765
SF-K24,SF-K15-,16,12,2,3,14,9,0.125,0.875,0.25,0.75
SF-K24,SF-K19,7,5,3,1,4,4,0.42857142857142855,0.5714285714285714,0.2,0.8
SF-K24,SF-K18,13,6,2,0,11,6,0.15384615384615385,0.8461538461538461,0.0,1.0
SF-K24,SF-K17,18,7,6,5,12,2,0.3333333333333333,0.6666666666666666,0.7142857142857143,0.2857142857142857
SF-K24,SF-J16,1,1,0,0,1,1,0.0,1.0,0.0,1.0
SF-K24,SF-J18,2,1,1,0,1,1,0.5,0.5,0.0,1.0
SF-K24,SF-J20,9,9,6,7,3,2,0.6666666666666666,0.3333333333333333,0.7777777777777778,0.2222222222222222
SF-K24,SF-J19,20,10,6,2,14,8,0.3,0.7,0.2,0.8
SF-K24,SF-M12,4,7,1,0,3,7,0.25,0.75,0.0,1.0
SF-K24,SF-M11,1,1,0,0,1,1,0.0,1.0,0.0,1.0
SF-K24,SF-R19,2,3,0,1,2,2,0.0,1.0,0.3333333333333333,0.6666666666666666
SF-K24,SF-R20,2,3,1,1,1,2,0.5,0.5,0.3333333333333333,0.6666666666666666
SF-K24,SF-Q21-2,1,7,0,2,1,5,0.0,1.0,0.2857142857142857,0.7142857142857143
SF-K24,SF-Q21-1,18,4,15,4,3,0,0.8333333333333334,0.16666666666666666,1.0,0.0
SF-K24,SF-P21,9,10,1,3,8,7,0.1111111111111111,0.8888888888888888,0.3,0.7
SF-K24,SF-O18,6,1,1,0,5,1,0.16666666666666666,0.8333333333333334,0.0,1.0
SF-K24,SF-O19,10,11,4,3,6,8,0.4,0.6,0.2727272727272727,0.7272727272727273
SF-K24,SF-O21,15,22,3,6,12,16,0.2,0.8,0.2727272727272727,0.7272727272727273
SF-K24,SF-O22,9,8,2,5,7,3,0.2222222222222222,0.7777777777777778,0.625,0.375
SF-K24,SF-N21,2,7,1,3,1,4,0.5,0.5,0.42857142857142855,0.5714285714285714
SF-K24,SF-M21,3,4,2,1,1,3,0.6666666666666666,0.3333333333333333,0.25,0.75
SF-K24,SF-L21,21,18,8,5,13,13,0.38095238095238093,0.6190476190476191,0.2777777777777778,0.7222222222222222
SF-K24,SF-P30,3,3,2,1,1,2,0.6666666666666666,0.3333333333333333,0.3333333333333333,0.6666666666666666
SF-K24,SF-O30-2,2,3,0,2,2,1,0.0,1.0,0.6666666666666666,0.3333333333333333
SF-K24,SF-O30,10,6,8,4,2,2,0.8,0.2,0.6666666666666666,0.3333333333333333
SF-K24,SF-N27,11,14,7,8,4,6,0.6363636363636364,0.36363636363636365,0.5714285714285714,0.42857142857142855
SF-K24,SF-N29,8,5,4,1,4,4,0.5,0.5,0.2,0.8
SF-K24,SF-N28,9,3,3,1,6,2,0.3333333333333333,0.6666666666666666,0.3333333333333333,0.6666666666666666
SF-K24,SF-L30-1,14,16,5,5,9,11,0.35714285714285715,0.6428571428571429,0.3125,0.6875
SF-K24,SF-L31-1,4,1,1,0,3,1,0.25,0.75,0.0,1.0
SF-K24,SF-K30-2,4,2,0,1,4,1,0.0,1.0,0.5,0.5
SF-K24,SF-L29,16,4,9,3,7,1,0.5625,0.4375,0.75,0.25
SF-K24,SF-J29-1,4,2,2,0,2,2,0.5,0.5,0.0,1.0
SF-K24,SF-I30,3,5,1,4,2,1,0.3333333333333333,0.6666666666666666,0.8,0.2
SF-K24,SF-I29-2,2,14,1,4,1,10,0.5,0.5,0.2857142857142857,0.7142857142857143
SF-K24,SF-I27,8,8,2,6,6,2,0.25,0.75,0.75,0.25
SF-K24,SF-I28,4,12,1,6,3,6,0.25,0.75,0.5,0.5
SF-K24,SF-I30-2,14,12,13,12,1,0,0.9285714285714286,0.07142857142857142,1.0,0.0
SF-K24,SF I29-1,1,2,0,1,1,1,0.0,1.0,0.5,0.5
SF-K24,SF-H28,25,25,20,18,5,7,0.8,0.2,0.72,0.28
SF-K24,SF-H29,3,4,1,2,2,2,0.3333333333333333,0.6666666666666666,0.5,0.5
SF-K24,SF-S24,21,19,12,11,9,8,0.5714285714285714,0.42857142857142855,0.5789473684210527,0.42105263157894735
SF-K24,SF-R24,26,25,19,17,7,8,0.7307692307692307,0.2692307692307692,0.68,0.32
SF-K24,SF-R26,4,4,4,3,0,1,1.0,0.0,0.75,0.25
SF-K24,SF-Q26,3,6,2,5,1,1,0.6666666666666666,0.3333333333333333,0.8333333333333334,0.16666666666666666
SF-K24,SF-P26,11,3,2,2,9,1,0.18181818181818182,0.8181818181818182,0.6666666666666666,0.3333333333333333
SF-K24,SF-O25-2,7,14,3,8,4,6,0.42857142857142855,0.5714285714285714,0.5714285714285714,0.42857142857142855
SF-K24,SF-N22-1B,2,9,1,5,1,4,0.5,0.5,0.5555555555555556,0.4444444444444444
SF-K24,SF-N26,5,1,2,0,3,1,0.4,0.6,0.0,1.0
SF-K24,SF-N25,4,1,2,1,2,0,0.5,0.5,1.0,0.0
SF-K24,SF-T21,4,1,3,1,1,0,0.75,0.25,1.0,0.0
SF-K24,SF-T22,1,4,0,2,1,2,0.0,1.0,0.5,0.5
SF-K24,SF-S22-2,1,5,0,1,1,4,0.0,1.0,0.2,0.8
SF-K24,SF-S22-1,6,2,3,1,3,1,0.5,0.5,0.5,0.5
SF-K24,SF-Q23-3,16,11,13,7,3,4,0.8125,0.1875,0.6363636363636364,0.36363636363636365
SF-K24,SF-Q22-1,10,9,4,3,6,6,0.4,0.6,0.3333333333333333,0.6666666666666666
SF-K24,SF-Q22-2,5,7,4,3,1,4,0.8,0.2,0.42857142857142855,0.5714285714285714
SF-K24,SF-P22,6,6,4,5,2,1,0.6666666666666666,0.3333333333333333,0.8333333333333334,0.16666666666666666
SF-K24,SF-W19-2,1,1,0,1,1,0,0.0,1.0,1.0,0.0
SF-K24,SF-T20,9,7,1,1,8,6,0.1111111111111111,0.8888888888888888,0.14285714285714285,0.8571428571428571
SF-K24,SF-S21,2,1,1,0,1,1,0.5,0.5,0.0,1.0
SF-J23-2,SF-M25,2,8,2,6,0,2,1.0,0.0,0.75,0.25
SF-J23-2,SF-M26-2,22,25,7,5,15,20,0.3181818181818182,0.6818181818181818,0.2,0.8
SF-J23-2,SF-L27,1,2,0,2,1,0,0.0,1.0,1.0,0.0
SF-J23-2,SF-K26,14,15,9,12,5,3,0.6428571428571429,0.35714285714285715,0.8,0.2
SF-J23-2,SF-J27,4,3,3,2,1,1,0.75,0.25,0.6666666666666666,0.3333333333333333
SF-J23-2,SF-J29-3,2,1,2,1,0,0,1.0,0.0,1.0,0.0
SF-J23-2,SF-J29,7,19,4,14,3,5,0.5714285714285714,0.42857142857142855,0.7368421052631579,0.2631578947368421
SF-J23-2,SF-L26,16,32,3,19,13,13,0.1875,0.8125,0.59375,0.40625
SF-J23-2,SF-M28,5,11,0,8,5,3,0.0,1.0,0.7272727272727273,0.2727272727272727
SF-J23-2,SF-L25,19,23,10,18,9,5,0.5263157894736842,0.47368421052631576,0.782608695652174,0.21739130434782608
SF-J23-2,SF-M24,6,10,3,7,3,3,0.5,0.5,0.7,0.3
SF-J23-2,SF-L24,22,28,15,19,7,9,0.6818181818181818,0.3181818181818182,0.6785714285714286,0.32142857142857145
SF-J23-2,SF-N23,3,2,2,2,1,0,0.6666666666666666,0.3333333333333333,1.0,0.0
SF-J23-2,SF-N24-2,9,6,3,4,6,2,0.3333333333333333,0.6666666666666666,0.6666666666666666,0.3333333333333333
SF-J23-2,SF-K27-2,10,9,5,3,5,6,0.5,0.5,0.3333333333333333,0.6666666666666666
SF-J23-2,SF-J26-2,8,5,4,5,4,0,0.5,0.5,1.0,0.0
SF-J23-2,SF-L28,2,2,0,1,2,1,0.0,1.0,0.5,0.5
SF-J23-2,SF-K28,1,1,0,1,1,0,0.0,1.0,1.0,0.0
SF-J23-2,SF-K29-1,3,1,3,1,0,0,1.0,0.0,1.0,0.0
SF-J23-2,SF-K25,22,12,13,6,9,6,0.5909090909090909,0.4090909090909091,0.5,0.5
SF-J23-2,SF-J25,21,9,14,6,7,3,0.6666666666666666,0.3333333333333333,0.6666666666666666,0.3333333333333333
SF-J23-2,SF-H26-2,3,6,2,2,1,4,0.6666666666666666,0.3333333333333333,0.3333333333333333,0.6666666666666666
SF-J23-2,SF-P24,11,6,7,3,4,3,0.6363636363636364,0.36363636363636365,0.5,0.5
SF-J23-2,SF-N22-1A,1,8,1,7,0,1,1.0,0.0,0.875,0.125
SF-J23-2,SF-J24,12,11,10,6,2,5,0.8333333333333334,0.16666666666666666,0.5454545454545454,0.45454545454545453
SF-J23-2,SF-O24,5,5,4,4,1,1,0.8,0.2,0.8,0.2
SF-J23-2,SF-J26,4,11,1,4,3,7,0.25,0.75,0.36363636363636365,0.6363636363636364
SF-J23-2,SF-I26-,4,5,2,2,2,3,0.5,0.5,0.4,0.6
SF-J23-2,SF-I25,24,40,20,31,4,9,0.8333333333333334,0.16666666666666666,0.775,0.225
SF-J23-2,SF-H26,36,43,24,29,12,14,0.6666666666666666,0.3333333333333333,0.6744186046511628,0.32558139534883723
SF-J23-2,SF-O23,9,5,5,2,4,3,0.5555555555555556,0.4444444444444444,0.4,0.6
SF-J23-2,SF-H27-1,6,3,1,1,5,2,0.16666666666666666,0.8333333333333334,0.3333333333333333,0.6666666666666666
SF-J23-2,SF-F28-2,8,12,5,5,3,7,0.625,0.375,0.4166666666666667,0.5833333333333334
SF-J23-2,SF-G27,49,82,38,56,11,26,0.7755102040816326,0.22448979591836735,0.6829268292682927,0.3170731707317073
SF-J23-2,SF-M22-2,25,24,17,17,8,7,0.68,0.32,0.7083333333333334,0.2916666666666667
SF-J23-2,SF-L22,12,9,5,4,7,5,0.4166666666666667,0.5833333333333334,0.4444444444444444,0.5555555555555556
SF-J23-2,SF-F27,8,8,3,5,5,3,0.375,0.625,0.625,0.375
SF-J23-2,SF-N22-2,15,19,7,9,8,10,0.4666666666666667,0.5333333333333333,0.47368421052631576,0.5263157894736842
SF-J23-2,SF-M22-1,7,10,3,7,4,3,0.42857142857142855,0.5714285714285714,0.7,0.3
SF-J23-2,SF-O25-1,3,9,0,3,3,6,0.0,1.0,0.3333333333333333,0.6666666666666666
SF-J23-2,SF-K22-2,22,14,18,10,4,4,0.8181818181818182,0.18181818181818182,0.7142857142857143,0.2857142857142857
SF-J23-2,SF-K24,15,12,14,11,1,1,0.9333333333333333,0.06666666666666667,0.9166666666666666,0.08333333333333333
SF-J23-2,SF-G23,9,13,6,3,3,10,0.6666666666666666,0.3333333333333333,0.23076923076923078,0.7692307692307693
SF-J23-2,SF-G24,30,42,5,21,25,21,0.16666666666666666,0.8333333333333334,0.5,0.5
SF-J23-2,SF-G25,20,7,13,3,7,4,0.65,0.35,0.42857142857142855,0.5714285714285714
SF-J23-2,SF-F23,8,12,2,7,6,5,0.25,0.75,0.5833333333333334,0.4166666666666667
SF-J23-2,SF-E23,67,33,61,4,6,29,0.9104477611940298,0.08955223880597014,0.12121212121212122,0.8787878787878788
SF-J23-2,SF-D24,14,8,6,2,8,6,0.42857142857142855,0.5714285714285714,0.25,0.75
SF-J23-2,SF-C22,3,8,3,2,0,6,1.0,0.0,0.25,0.75
SF-J23-2,SF-B22,8,11,4,6,4,5,0.5,0.5,0.5454545454545454,0.45454545454545453
SF-J23-2,SF-J17,54,26,9,2,45,24,0.16666666666666666,0.8333333333333334,0.07692307692307693,0.9230769230769231
SF-J23-2,SF-I19,6,1,2,0,4,1,0.3333333333333333,0.6666666666666666,0.0,1.0
SF-J23-2,SF-I20,2,5,1,2,1,3,0.5,0.5,0.4,0.6
SF-J23-2,SF-H20,8,7,6,5,2,2,0.75,0.25,0.7142857142857143,0.2857142857142857
SF-J23-2,SF-G19,9,7,2,2,7,5,0.2222222222222222,0.7777777777777778,0.2857142857142857,0.7142857142857143
SF-J23-2,SF-G18,7,2,0,0,7,2,0.0,1.0,0.0,1.0
SF-J23-2,SF-G20,7,7,4,3,3,4,0.5714285714285714,0.42857142857142855,0.42857142857142855,0.5714285714285714
SF-J23-2,SF-F19,2,4,1,1,1,3,0.5,0.5,0.25,0.75
SF-J23-2,SF-E18,30,11,2,1,28,10,0.06666666666666667,0.9333333333333333,0.09090909090909091,0.9090909090909091
SF-J23-2,SF-E20,4,2,0,1,4,1,0.0,1.0,0.5,0.5
SF-J23-2,SF-G30-2,4,6,1,1,3,5,0.25,0.75,0.16666666666666666,0.8333333333333334
SF-J23-2,SF-E29-2,15,35,13,24,2,11,0.8666666666666667,0.13333333333333333,0.6857142857142857,0.3142857142857143
SF-J23-2,SF-E29-1,4,14,2,5,2,9,0.5,0.5,0.35714285714285715,0.6428571428571429
SF-J23-2,SF-D28,1,7,0,6,1,1,0.0,1.0,0.8571428571428571,0.14285714285714285
SF-J23-2,SF-A27,20,73,20,72,0,1,1.0,0.0,0.9863013698630136,0.0136986301369863
SF-J23-2,SF-G29-2,7,7,1,3,6,4,0.14285714285714285,0.8571428571428571,0.42857142857142855,0.5714285714285714
SF-J23-2,SF-G29-1,12,12,0,1,12,11,0.0,1.0,0.08333333333333333,0.9166666666666666
SF-J23-2,SF-G30-1,2,6,0,1,2,5,0.0,1.0,0.16666666666666666,0.8333333333333334
SF-J23-2,SF-G29-3,3,5,1,2,2,3,0.3333333333333333,0.6666666666666666,0.4,0.6
SF-J23-2,SF-F30-2,1,1,0,0,1,1,0.0,1.0,0.0,1.0
SF-J23-2,SF-F29,1,2,1,1,0,1,1.0,0.0,0.5,0.5
SF-J23-2,SF-E29-3,8,14,4,12,4,2,0.5,0.5,0.8571428571428571,0.14285714285714285
SF-J23-2,SF-F28-1,6,11,6,6,0,5,1.0,0.0,0.5454545454545454,0.45454545454545453
SF-J23-2,SF-E28-2,3,2,2,1,1,1,0.6666666666666666,0.3333333333333333,0.5,0.5
SF-J23-2,SF-E28,2,2,1,1,1,1,0.5,0.5,0.5,0.5
SF-J23-2,SF-J10,5,2,1,0,4,2,0.2,0.8,0.0,1.0
SF-J23-2,SF-J12,6,12,0,1,6,11,0.0,1.0,0.08333333333333333,0.9166666666666666
SF-J23-2,SF-J13,2,3,0,0,2,3,0.0,1.0,0.0,1.0
SF-J23-2,SF-J15,1,2,0,0,1,2,0.0,1.0,0.0,1.0
SF-J23-2,SF-J14,1,1,1,0,0,1,1.0,0.0,0.0,1.0
SF-J23-2,SF-H12,15,7,0,0,15,7,0.0,1.0,0.0,1.0
SF-J23-2,SF-G13,4,1,2,0,2,1,0.5,0.5,0.0,1.0
SF-J23-2,SF-G12,1,3,0,0,1,3,0.0,1.0,0.0,1.0
SF-J23-2,SF-C21,3,1,0,0,3,1,0.0,1.0,0.0,1.0
SF-J23-2,SF-C20,2,4,0,1,2,3,0.0,1.0,0.25,0.75
SF-J23-2,SF-B21,1,4,1,2,0,2,1.0,0.0,0.5,0.5
SF-J23-2,SF-B19,1,10,1,8,0,2,1.0,0.0,0.8,0.2
SF-J23-2,SF-A20,41,47,39,44,2,3,0.9512195121951219,0.04878048780487805,0.9361702127659575,0.06382978723404255
SF-J23-2,SF-A19,2,3,1,2,1,1,0.5,0.5,0.6666666666666666,0.3333333333333333
SF-J23-2,SF-C26,2,5,1,0,1,5,0.5,0.5,0.0,1.0
SF-J23-2,SF-C25,3,3,1,2,2,1,0.3333333333333333,0.6666666666666666,0.6666666666666666,0.3333333333333333
SF-J23-2,SF-B28-2,3,2,3,2,0,0,1.0,0.0,1.0,0.0
SF-J23-2,SF-D27,2,9,1,7,1,2,0.5,0.5,0.7777777777777778,0.2222222222222222
SF-J23-2,SF-C28-1,2,1,0,1,2,0,0.0,1.0,1.0,0.0
SF-J23-2,SF-J1,1,3,0,0,1,3,0.0,1.0,0.0,1.0
SF-J23-2,SF-H0,2,1,1,0,1,1,0.5,0.5,0.0,1.0
SF-J23-2,SF-G8,1,1,0,0,1,1,0.0,1.0,0.0,1.0
SF-J23-2,SF-F9,7,3,7,1,0,2,1.0,0.0,0.3333333333333333,0.6666666666666666
SF-J23-2,SF-H25,8,11,7,10,1,1,0.875,0.125,0.9090909090909091,0.09090909090909091
SF-J23-2,SF-G26,12,12,5,4,7,8,0.4166666666666667,0.5833333333333334,0.3333333333333333,0.6666666666666666
SF-J23-2,SF-K21,17,6,13,2,4,4,0.7647058823529411,0.23529411764705882,0.3333333333333333,0.6666666666666666
SF-J23-2,SF-K22-1,18,31,16,29,2,2,0.8888888888888888,0.1111111111111111,0.9354838709677419,0.06451612903225806
SF-J23-2,SF-J23-1,36,67,26,44,10,23,0.7222222222222222,0.2777777777777778,0.6567164179104478,0.34328358208955223
SF-J23-2,SF-J22-1,4,17,1,13,3,4,0.25,0.75,0.7647058823529411,0.23529411764705882
SF-J23-2,SF-J22-2,33,31,23,24,10,7,0.696969696969697,0.30303030303030304,0.7741935483870968,0.22580645161290322
SF-J23-2,SF-J21,12,10,5,5,7,5,0.4166666666666667,0.5833333333333334,0.5,0.5
SF-J23-2,SF-I21,2,3,2,3,0,0,1.0,0.0,1.0,0.0
SF-J23-2,SF-I22,4,7,3,5,1,2,0.75,0.25,0.7142857142857143,0.2857142857142857
SF-J23-2,SF-I23-2,12,17,10,15,2,2,0.8333333333333334,0.16666666666666666,0.8823529411764706,0.11764705882352941
SF-J23-2,SF-I24,13,10,10,7,3,3,0.7692307692307693,0.23076923076923078,0.7,0.3
SF-J23-2,SF-I23-1,16,9,13,6,3,3,0.8125,0.1875,0.6666666666666666,0.3333333333333333
SF-J23-2,SF-F26,30,24,8,10,22,14,0.26666666666666666,0.7333333333333333,0.4166666666666667,0.5833333333333334
SF-J23-2,SF-M13,11,9,7,0,4,9,0.6363636363636364,0.36363636363636365,0.0,1.0
SF-J23-2,SF-M15,10,6,9,2,1,4,0.9,0.1,0.3333333333333333,0.6666666666666666
SF-J23-2,SF-L19,8,23,5,15,3,8,0.625,0.375,0.6521739130434783,0.34782608695652173
SF-J23-2,SF-L20,15,12,12,7,3,5,0.8,0.2,0.5833333333333334,0.4166666666666667
SF-J23-2,SF-N20-1,9,8,1,2,8,6,0.1111111111111111,0.8888888888888888,0.25,0.75
SF-J23-2,SF-M20,41,46,20,15,21,31,0.4878048780487805,0.5121951219512195,0.32608695652173914,0.6739130434782609
SF-J23-2,SF-K17-2,24,3,16,0,8,3,0.6666666666666666,0.3333333333333333,0.0,1.0
SF-J23-2,SF-K20,14,20,7,8,7,12,0.5,0.5,0.4,0.6
SF-J23-2,SF-K15-,7,17,1,7,6,10,0.14285714285714285,0.8571428571428571,0.4117647058823529,0.5882352941176471
SF-J23-2,SF-K19,30,12,13,4,17,8,0.43333333333333335,0.5666666666666667,0.3333333333333333,0.6666666666666666
SF-J23-2,SF-K18,35,20,11,3,24,17,0.3142857142857143,0.6857142857142857,0.15,0.85
SF-J23-2,SF-K17,12,8,10,0,2,8,0.8333333333333334,0.16666666666666666,0.0,1.0
SF-J23-2,SF-J16,3,5,1,1,2,4,0.3333333333333333,0.6666666666666666,0.2,0.8
SF-J23-2,SF-J18,5,10,2,1,3,9,0.4,0.6,0.1,0.9
SF-J23-2,SF-J20,4,5,3,2,1,3,0.75,0.25,0.4,0.6
SF-J23-2,SF-J19,4,9,4,0,0,9,1.0,0.0,0.0,1.0
SF-J23-2,SF-M12,4,3,0,0,4,3,0.0,1.0,0.0,1.0
SF-J23-2,SF-M10,4,1,3,0,1,1,0.75,0.25,0.0,1.0
SF-J23-2,SF-M11,12,8,2,2,10,6,0.16666666666666666,0.8333333333333334,0.25,0.75
SF-J23-2,SF-R19,14,7,4,4,10,3,0.2857142857142857,0.7142857142857143,0.5714285714285714,0.42857142857142855
SF-J23-2,SF-R20,4,3,1,1,3,2,0.25,0.75,0.3333333333333333,0.6666666666666666
SF-J23-2,SF-Q21-2,17,15,6,1,11,14,0.35294117647058826,0.6470588235294118,0.06666666666666667,0.9333333333333333
SF-J23-2,SF-Q21-1,52,45,49,45,3,0,0.9423076923076923,0.057692307692307696,1.0,0.0
SF-J23-2,SF-P21,8,9,5,2,3,7,0.625,0.375,0.2222222222222222,0.7777777777777778
SF-J23-2,SF-O18,9,8,1,3,8,5,0.1111111111111111,0.8888888888888888,0.375,0.625
SF-J23-2,SF-O19,5,11,3,4,2,7,0.6,0.4,0.36363636363636365,0.6363636363636364
SF-J23-2,SF-O21,18,22,6,16,12,6,0.3333333333333333,0.6666666666666666,0.7272727272727273,0.2727272727272727
SF-J23-2,SF-O22,10,16,3,8,7,8,0.3,0.7,0.5,0.5
SF-J23-2,SF-N21,18,10,7,4,11,6,0.3888888888888889,0.6111111111111112,0.4,0.6
SF-J23-2,SF-N20-2,6,4,4,4,2,0,0.6666666666666666,0.3333333333333333,1.0,0.0
SF-J23-2,SF-M21,5,2,3,0,2,2,0.6,0.4,0.0,1.0
SF-J23-2,SF-L21,101,55,66,23,35,32,0.6534653465346535,0.3465346534653465,0.41818181818181815,0.5818181818181818
SF-J23-2,SF-Q30,2,1,0,0,2,1,0.0,1.0,0.0,1.0
SF-J23-2,SF-P30,2,4,1,0,1,4,0.5,0.5,0.0,1.0
SF-J23-2,SF-O30-2,3,1,1,1,2,0,0.3333333333333333,0.6666666666666666,1.0,0.0
SF-J23-2,SF-N27,12,13,3,5,9,8,0.25,0.75,0.38461538461538464,0.6153846153846154
SF-J23-2,SF-N28,4,3,2,0,2,3,0.5,0.5,0.0,1.0
SF-J23-2,SF-L30-1,2,14,0,5,2,9,0.0,1.0,0.35714285714285715,0.6428571428571429
SF-J23-2,SF-K30-2,1,1,1,1,0,0,1.0,0.0,1.0,0.0
SF-J23-2,SF-L29,3,5,2,3,1,2,0.6666666666666666,0.3333333333333333,0.6,0.4
SF-J23-2,SF-I29-2,3,3,0,0,3,3,0.0,1.0,0.0,1.0
SF-J23-2,SF-I28,3,3,0,0,3,3,0.0,1.0,0.0,1.0
SF-J23-2,SF-I30-2,4,2,0,2,4,0,0.0,1.0,1.0,0.0
SF-J23-2,SF I29-1,22,29,0,1,22,28,0.0,1.0,0.034482758620689655,0.9655172413793104
SF-J23-2,SF-H28,6,6,5,6,1,0,0.8333333333333334,0.16666666666666666,1.0,0.0
SF-J23-2,SF-H29,1,3,1,1,0,2,1.0,0.0,0.3333333333333333,0.6666666666666666
SF-J23-2,SF-S24,6,2,3,2,3,0,0.5,0.5,1.0,0.0
SF-J23-2,SF-R24,6,7,1,2,5,5,0.16666666666666666,0.8333333333333334,0.2857142857142857,0.7142857142857143
SF-J23-2,SF-P26,1,6,0,1,1,5,0.0,1.0,0.16666666666666666,0.8333333333333334
SF-J23-2,SF-O25-2,13,14,0,4,13,10,0.0,1.0,0.2857142857142857,0.7142857142857143
SF-J23-2,SF-N22-1B,5,13,4,10,1,3,0.8,0.2,0.7692307692307693,0.23076923076923078
SF-J23-2,SF-N26,3,3,2,1,1,2,0.6666666666666666,0.3333333333333333,0.3333333333333333,0.6666666666666666
SF-J23-2,SF-N25,4,1,1,0,3,1,0.25,0.75,0.0,1.0
SF-J23-2,SF-T22,7,10,0,6,7,4,0.0,1.0,0.6,0.4
SF-J23-2,SF-S22-1,6,13,3,8,3,5,0.5,0.5,0.6153846153846154,0.38461538461538464
SF-J23-2,SF-Q23-3,6,11,2,7,4,4,0.3333333333333333,0.6666666666666666,0.6363636363636364,0.36363636363636365
SF-J23-2,SF-Q22-1,11,9,9,7,2,2,0.8181818181818182,0.18181818181818182,0.7777777777777778,0.2222222222222222
SF-J23-2,SF-Q22-2,18,18,9,8,9,10,0.5,0.5,0.4444444444444444,0.5555555555555556
SF-J23-2,SF-P22,11,18,10,9,1,9,0.9090909090909091,0.09090909090909091,0.5,0.5
SF-J23-2,SF-U21,19,5,14,0,5,5,0.7368421052631579,0.2631578947368421,0.0,1.0
SF-J23-2,SF-T20,46,12,6,0,40,12,0.13043478260869565,0.8695652173913043,0.0,1.0
SF-J23-2,SF-Y27,1,1,0,0,1,1,0.0,1.0,0.0,1.0
SF-J23-2,SF-Y14,1,1,0,0,1,1,0.0,1.0,0.0,1.0
SF-G23,SF-M26,14,6,0,0,14,6,0.0,1.0,0.0,1.0
SF-G23,SF-M25,2,6,0,3,2,3,0.0,1.0,0.5,0.5
SF-G23,SF-M26-2,43,9,3,7,40,2,0.06976744186046512,0.9302325581395349,0.7777777777777778,0.2222222222222222
SF-G23,SF-L27,1,9,0,0,1,9,0.0,1.0,0.0,1.0
SF-G23,SF-K26,15,55,2,13,13,42,0.13333333333333333,0.8666666666666667,0.23636363636363636,0.7636363636363637
SF-G23,SF-J27,10,27,0,4,10,23,0.0,1.0,0.14814814814814814,0.8518518518518519
SF-G23,SF-M30,3,2,1,1,2,1,0.3333333333333333,0.6666666666666666,0.5,0.5
SF-G23,SF-L27-2,5,3,2,0,3,3,0.4,0.6,0.0,1.0
SF-G23,SF-J29-3,3,2,1,1,2,1,0.3333333333333333,0.6666666666666666,0.5,0.5
SF-G23,SF-J29,8,21,2,5,6,16,0.25,0.75,0.23809523809523808,0.7619047619047619
SF-G23,SF-L26,21,3,0,0,21,3,0.0,1.0,0.0,1.0
SF-G23,SF-M28,9,2,0,1,9,1,0.0,1.0,0.5,0.5
SF-G23,SF-L25,3,17,0,10,3,7,0.0,1.0,0.5882352941176471,0.4117647058823529
SF-G23,SF-M24,6,7,1,5,5,2,0.16666666666666666,0.8333333333333334,0.7142857142857143,0.2857142857142857
SF-G23,SF-L24,7,14,3,8,4,6,0.42857142857142855,0.5714285714285714,0.5714285714285714,0.42857142857142855
SF-G23,SF-N23,2,4,0,0,2,4,0.0,1.0,0.0,1.0
SF-G23,SF-N24-2,3,6,0,3,3,3,0.0,1.0,0.5,0.5
SF-G23,SF-K27-2,10,8,1,4,9,4,0.1,0.9,0.5,0.5
SF-G23,SF-J26-2,8,8,0,3,8,5,0.0,1.0,0.375,0.625
SF-G23,SF-L28,3,3,3,1,0,2,1.0,0.0,0.3333333333333333,0.6666666666666666
SF-G23,SF-K29-1,2,4,2,3,0,1,1.0,0.0,0.75,0.25
SF-G23,SF-J28-2,6,3,4,3,2,0,0.6666666666666666,0.3333333333333333,1.0,0.0
SF-G23,SF-K27,9,21,2,6,7,15,0.2222222222222222,0.7777777777777778,0.2857142857142857,0.7142857142857143
SF-G23,SF-K25,12,23,3,13,9,10,0.25,0.75,0.5652173913043478,0.43478260869565216
SF-G23,SF-J25,24,24,3,10,21,14,0.125,0.875,0.4166666666666667,0.5833333333333334
SF-G23,SF-H26-2,3,10,1,3,2,7,0.3333333333333333,0.6666666666666666,0.3,0.7
SF-G23,SF-P24,2,3,0,0,2,3,0.0,1.0,0.0,1.0
SF-G23,SF-J24,10,12,0,7,10,5,0.0,1.0,0.5833333333333334,0.4166666666666667
SF-G23,SF-O24,2,5,2,3,0,2,1.0,0.0,0.6,0.4
SF-G23,SF-J26,1,5,0,3,1,2,0.0,1.0,0.6,0.4
SF-G23,SF-I26-,16,4,14,3,2,1,0.875,0.125,0.75,0.25
SF-G23,SF-I25,13,18,8,14,5,4,0.6153846153846154,0.38461538461538464,0.7777777777777778,0.2222222222222222
SF-G23,SF-K23,1,6,1,5,0,1,1.0,0.0,0.8333333333333334,0.16666666666666666
SF-G23,SF-H26,42,30,18,19,24,11,0.42857142857142855,0.5714285714285714,0.6333333333333333,0.36666666666666664
SF-G23,SF-O23,4,5,1,2,3,3,0.25,0.75,0.4,0.6
SF-G23,SF-H27-1,4,3,4,1,0,2,1.0,0.0,0.3333333333333333,0.6666666666666666
SF-G23,SF-F28-2,5,16,1,11,4,5,0.2,0.8,0.6875,0.3125
SF-G23,SF-G27,6,26,0,16,6,10,0.0,1.0,0.6153846153846154,0.38461538461538464
SF-G23,SF-M22-2,10,6,1,4,9,2,0.1,0.9,0.6666666666666666,0.3333333333333333
SF-G23,SF-L22,23,17,6,9,17,8,0.2608695652173913,0.7391304347826086,0.5294117647058824,0.47058823529411764
SF-G23,SF-F27,12,12,3,1,9,11,0.25,0.75,0.08333333333333333,0.9166666666666666
SF-G23,SF-N22-2,11,9,4,3,7,6,0.36363636363636365,0.6363636363636364,0.3333333333333333,0.6666666666666666
SF-G23,SF-G28-2,3,2,1,0,2,2,0.3333333333333333,0.6666666666666666,0.0,1.0
SF-G23,SF-M22-1,7,4,0,1,7,3,0.0,1.0,0.25,0.75
SF-G23,SF-K22-2,14,11,5,6,9,5,0.35714285714285715,0.6428571428571429,0.5454545454545454,0.45454545454545453
SF-G23,SF-K24,24,25,4,9,20,16,0.16666666666666666,0.8333333333333334,0.36,0.64
SF-G23,SF-J23-2,13,9,3,6,10,3,0.23076923076923078,0.7692307692307693,0.6666666666666666,0.3333333333333333
SF-G23,SF-G24,32,29,20,17,12,12,0.625,0.375,0.5862068965517241,0.41379310344827586
SF-G23,SF-G25,16,17,7,3,9,14,0.4375,0.5625,0.17647058823529413,0.8235294117647058
SF-G23,SF-F23,52,38,32,13,20,25,0.6153846153846154,0.38461538461538464,0.34210526315789475,0.6578947368421053
SF-G23,SF-E23,28,20,18,8,10,12,0.6428571428571429,0.35714285714285715,0.4,0.6
SF-G23,SF-D24,13,7,9,2,4,5,0.6923076923076923,0.3076923076923077,0.2857142857142857,0.7142857142857143
SF-G23,SF-C22,10,33,5,21,5,12,0.5,0.5,0.6363636363636364,0.36363636363636365
SF-G23,SF-B22,12,15,3,3,9,12,0.25,0.75,0.2,0.8
SF-G23,SF-J17,21,17,0,0,21,17,0.0,1.0,0.0,1.0
SF-G23,SF-I20,8,12,4,8,4,4,0.5,0.5,0.6666666666666666,0.3333333333333333
SF-G23,SF-H16,9,4,1,0,8,4,0.1111111111111111,0.8888888888888888,0.0,1.0
SF-G23,SF-H20,6,7,3,1,3,6,0.5,0.5,0.14285714285714285,0.8571428571428571
SF-G23,SF-H18,3,4,1,0,2,4,0.3333333333333333,0.6666666666666666,0.0,1.0
SF-G23,SF-G19,5,1,2,0,3,1,0.4,0.6,0.0,1.0
SF-G23,SF-G17,1,1,0,1,1,0,0.0,1.0,1.0,0.0
SF-G23,SF-G18,17,7,4,0,13,7,0.23529411764705882,0.7647058823529411,0.0,1.0
SF-G23,SF-G20,8,3,4,1,4,2,0.5,0.5,0.3333333333333333,0.6666666666666666
SF-G23,SF-F19,6,3,1,1,5,2,0.16666666666666666,0.8333333333333334,0.3333333333333333,0.6666666666666666
SF-G23,SF-E18,2,1,1,1,1,0,0.5,0.5,1.0,0.0
SF-G23,SF-H30,1,11,0,10,1,1,0.0,1.0,0.9090909090909091,0.09090909090909091
SF-G23,SF-G30-2,12,7,0,1,12,6,0.0,1.0,0.14285714285714285,0.8571428571428571
SF-G23,SF-E29-2,4,21,1,10,3,11,0.25,0.75,0.47619047619047616,0.5238095238095238
SF-G23,SF-E29-1,7,4,0,3,7,1,0.0,1.0,0.75,0.25
SF-G23,SF-D29,6,11,0,11,6,0,0.0,1.0,1.0,0.0
SF-G23,SF-D28,1,1,0,1,1,0,0.0,1.0,1.0,0.0
SF-G23,SF-G29-2,5,4,0,1,5,3,0.0,1.0,0.25,0.75
SF-G23,SF-G30-1,4,1,0,0,4,1,0.0,1.0,0.0,1.0
SF-G23,SF-G29-3,2,11,0,9,2,2,0.0,1.0,0.8181818181818182,0.18181818181818182
SF-G23,SF-F30-2,5,6,5,5,0,1,1.0,0.0,0.8333333333333334,0.16666666666666666
SF-G23,SF-F29,2,7,0,1,2,6,0.0,1.0,0.14285714285714285,0.8571428571428571
SF-G23,SF-E29-3,1,2,0,1,1,1,0.0,1.0,0.5,0.5
SF-G23,SF-F28-1,6,9,3,5,3,4,0.5,0.5,0.5555555555555556,0.4444444444444444
SF-G23,SF-J10,4,2,4,0,0,2,1.0,0.0,0.0,1.0
SF-G23,SF-J12,1,1,0,0,1,1,0.0,1.0,0.0,1.0
SF-G23,SF-J13,2,7,0,1,2,6,0.0,1.0,0.14285714285714285,0.8571428571428571
SF-G23,SF-G13,2,4,0,2,2,2,0.0,1.0,0.5,0.5
SF-G23,SF-C20,13,7,3,2,10,5,0.23076923076923078,0.7692307692307693,0.2857142857142857,0.7142857142857143
SF-G23,SF-B21,15,15,4,8,11,7,0.26666666666666666,0.7333333333333333,0.5333333333333333,0.4666666666666667
SF-G23,SF-B19,4,12,0,5,4,7,0.0,1.0,0.4166666666666667,0.5833333333333334
SF-G23,SF-A20,1,7,0,3,1,4,0.0,1.0,0.42857142857142855,0.5714285714285714
SF-G23,SF-A19,3,1,1,0,2,1,0.3333333333333333,0.6666666666666666,0.0,1.0
SF-G23,SF-C26,27,12,1,5,26,7,0.037037037037037035,0.9629629629629629,0.4166666666666667,0.5833333333333334
SF-G23,SF-C25,10,8,1,0,9,8,0.1,0.9,0.0,1.0
SF-G23,SF-B25,3,9,0,5,3,4,0.0,1.0,0.5555555555555556,0.4444444444444444
SF-G23,SF-E27,1,2,0,0,1,2,0.0,1.0,0.0,1.0
SF-G23,SF-D27,5,50,1,5,4,45,0.2,0.8,0.1,0.9
SF-G23,SF-J1,1,2,0,2,1,0,0.0,1.0,1.0,0.0
SF-G23,SF-J5,1,2,0,0,1,2,0.0,1.0,0.0,1.0
SF-G23,SF-G6,1,1,0,0,1,1,0.0,1.0,0.0,1.0
SF-G23,SF-G7,4,5,0,0,4,5,0.0,1.0,0.0,1.0
SF-G23,SF-F9,1,7,0,0,1,7,0.0,1.0,0.0,1.0
SF-G23,SF-H25,17,14,8,9,9,5,0.47058823529411764,0.5294117647058824,0.6428571428571429,0.35714285714285715
SF-G23,SF-G26,7,19,4,8,3,11,0.5714285714285714,0.42857142857142855,0.42105263157894735,0.5789473684210527
SF-G23,SF-K21,8,7,2,3,6,4,0.25,0.75,0.42857142857142855,0.5714285714285714
SF-G23,SF-K22-1,6,22,2,9,4,13,0.3333333333333333,0.6666666666666666,0.4090909090909091,0.5909090909090909
SF-G23,SF-J23-1,32,60,6,30,26,30,0.1875,0.8125,0.5,0.5
SF-G23,SF-J22-1,4,10,1,3,3,7,0.25,0.75,0.3,0.7
SF-G23,SF-J22-2,15,28,5,16,10,12,0.3333333333333333,0.6666666666666666,0.5714285714285714,0.42857142857142855
SF-G23,SF-J21,23,23,2,12,21,11,0.08695652173913043,0.9130434782608695,0.5217391304347826,0.4782608695652174
SF-G23,SF-I21,7,3,5,1,2,2,0.7142857142857143,0.2857142857142857,0.3333333333333333,0.6666666666666666
SF-G23,SF-I22,4,7,2,5,2,2,0.5,0.5,0.7142857142857143,0.2857142857142857
SF-G23,SF-I23-2,33,26,18,19,15,7,0.5454545454545454,0.45454545454545453,0.7307692307692307,0.2692307692307692
SF-G23,SF-I24,21,29,10,20,11,9,0.47619047619047616,0.5238095238095238,0.6896551724137931,0.3103448275862069
SF-G23,SF-I23-1,26,26,13,17,13,9,0.5,0.5,0.6538461538461539,0.34615384615384615
SF-G23,SF-F26,13,15,2,7,11,8,0.15384615384615385,0.8461538461538461,0.4666666666666667,0.5333333333333333
SF-G23,SF-M13,2,1,1,1,1,0,0.5,0.5,1.0,0.0
SF-G23,SF-M15,10,6,2,1,8,5,0.2,0.8,0.16666666666666666,0.8333333333333334
SF-G23,SF-L19,4,3,1,0,3,3,0.25,0.75,0.0,1.0
SF-G23,SF-L20,7,6,2,4,5,2,0.2857142857142857,0.7142857142857143,0.6666666666666666,0.3333333333333333
SF-G23,SF-N20-1,7,5,0,1,7,4,0.0,1.0,0.2,0.8
SF-G23,SF-M20,19,16,1,2,18,14,0.05263157894736842,0.9473684210526315,0.125,0.875
SF-G23,SF-K17-2,9,6,1,1,8,5,0.1111111111111111,0.8888888888888888,0.16666666666666666,0.8333333333333334
SF-G23,SF-K20,3,2,0,0,3,2,0.0,1.0,0.0,1.0
SF-G23,SF-K15-,10,14,0,3,10,11,0.0,1.0,0.21428571428571427,0.7857142857142857
SF-G23,SF-K19,2,5,2,1,0,4,1.0,0.0,0.2,0.8
SF-G23,SF-K18,4,2,2,0,2,2,0.5,0.5,0.0,1.0
SF-G23,SF-K17,5,6,1,0,4,6,0.2,0.8,0.0,1.0
SF-G23,SF-J16,3,9,0,0,3,9,0.0,1.0,0.0,1.0
SF-G23,SF-J18,6,7,2,1,4,6,0.3333333333333333,0.6666666666666666,0.14285714285714285,0.8571428571428571
SF-G23,SF-J20,8,12,2,5,6,7,0.25,0.75,0.4166666666666667,0.5833333333333334
SF-G23,SF-J19,7,11,5,3,2,8,0.7142857142857143,0.2857142857142857,0.2727272727272727,0.7272727272727273
SF-G23,SF-M12,2,2,0,0,2,2,0.0,1.0,0.0,1.0
SF-G23,SF-M10,1,1,0,0,1,1,0.0,1.0,0.0,1.0
SF-G23,SF-Q21-2,2,7,1,0,1,7,0.5,0.5,0.0,1.0
SF-G23,SF-Q21-1,3,6,1,0,2,6,0.3333333333333333,0.6666666666666666,0.0,1.0
SF-G23,SF-P21,5,1,2,0,3,1,0.4,0.6,0.0,1.0
SF-G23,SF-O18,7,1,1,0,6,1,0.14285714285714285,0.8571428571428571,0.0,1.0
SF-G23,SF-O19,7,8,1,2,6,6,0.14285714285714285,0.8571428571428571,0.25,0.75
SF-G23,SF-O21,15,27,3,11,12,16,0.2,0.8,0.4074074074074074,0.5925925925925926
SF-G23,SF-O22,6,11,2,3,4,8,0.3333333333333333,0.6666666666666666,0.2727272727272727,0.7272727272727273
SF-G23,SF-N21,8,4,0,0,8,4,0.0,1.0,0.0,1.0
SF-G23,SF-N20-2,2,2,0,0,2,2,0.0,1.0,0.0,1.0
SF-G23,SF-M21,7,6,3,3,4,3,0.42857142857142855,0.5714285714285714,0.5,0.5
SF-G23,SF-L21,12,26,4,11,8,15,0.3333333333333333,0.6666666666666666,0.4230769230769231,0.5769230769230769
SF-G23,SF-Q30,2,6,0,1,2,5,0.0,1.0,0.16666666666666666,0.8333333333333334
SF-G23,SF-P30,1,1,0,0,1,1,0.0,1.0,0.0,1.0
SF-G23,SF-O30,13,14,5,13,8,1,0.38461538461538464,0.6153846153846154,0.9285714285714286,0.07142857142857142
SF-G23,SF-N27,16,6,2,5,14,1,0.125,0.875,0.8333333333333334,0.16666666666666666
SF-G23,SF-N29,7,3,1,0,6,3,0.14285714285714285,0.8571428571428571,0.0,1.0
SF-G23,SF-N28,2,6,0,0,2,6,0.0,1.0,0.0,1.0
SF-G23,SF-L30-1,7,6,3,5,4,1,0.42857142857142855,0.5714285714285714,0.8333333333333334,0.16666666666666666
SF-G23,SF-L29,5,7,0,1,5,6,0.0,1.0,0.14285714285714285,0.8571428571428571
SF-G23,SF-J29-1,1,2,0,0,1,2,0.0,1.0,0.0,1.0
SF-G23,SF-I30,1,5,0,2,1,3,0.0,1.0,0.4,0.6
SF-G23,SF-I27,8,1,2,0,6,1,0.25,0.75,0.0,1.0
SF-G23,SF-I28,3,3,1,0,2,3,0.3333333333333333,0.6666666666666666,0.0,1.0
SF-G23,SF I29-1,4,1,0,0,4,1,0.0,1.0,0.0,1.0
SF-G23,SF-H29,1,1,1,1,0,0,1.0,0.0,1.0,0.0
SF-G23,SF-S24,5,1,3,0,2,1,0.6,0.4,0.0,1.0
SF-G23,SF-R24,3,4,1,2,2,2,0.3333333333333333,0.6666666666666666,0.5,0.5
SF-G23,SF-P26,5,3,0,1,5,2,0.0,1.0,0.3333333333333333,0.6666666666666666
SF-G23,SF-O25-2,1,5,0,0,1,5,0.0,1.0,0.0,1.0
SF-G23,SF-N22-1B,4,1,2,1,2,0,0.5,0.5,1.0,0.0
SF-G23,SF-N26,2,4,1,0,1,4,0.5,0.5,0.0,1.0
SF-G23,SF-N25,1,4,1,2,0,2,1.0,0.0,0.5,0.5
SF-G23,SF-T22,4,4,0,1,4,3,0.0,1.0,0.25,0.75
SF-G23,SF-S22-2,1,4,0,3,1,1,0.0,1.0,0.75,0.25
SF-G23,SF-S22-1,1,1,0,0,1,1,0.0,1.0,0.0,1.0
SF-G23,SF-Q23-3,7,3,3,1,4,2,0.42857142857142855,0.5714285714285714,0.3333333333333333,0.6666666666666666
SF-G23,SF-Q22-1,7,3,1,0,6,3,0.14285714285714285,0.8571428571428571,0.0,1.0
SF-G23,SF-Q22-2,4,8,3,4,1,4,0.75,0.25,0.5,0.5
SF-G23,SF-P22,5,5,4,4,1,1,0.8,0.2,0.8,0.2
SF-G23,SF-W19,5,2,5,0,0,2,1.0,0.0,0.0,1.0
SF-G23,SF-T20,3,1,1,0,2,1,0.3333333333333333,0.6666666666666666,0.0,1.0
SF-G23,SF-V28,15,9,14,9,1,0,0.9333333333333333,0.06666666666666667,1.0,0.0
SF-G23,SF-W14,2,1,0,0,2,1,0.0,1.0,0.0,1.0
SF-G24,SF-M25,15,41,4,6,11,35,0.26666666666666666,0.7333333333333333,0.14634146341463414,0.8536585365853658
SF-G24,SF-M26-2,3,85,0,77,3,8,0.0,1.0,0.9058823529411765,0.09411764705882353
SF-G24,SF-L27,1,6,1,4,0,2,1.0,0.0,0.6666666666666666,0.3333333333333333
SF-G24,SF-K26,59,171,3,153,56,18,0.05084745762711865,0.9491525423728814,0.8947368421052632,0.10526315789473684
SF-G24,SF-J27,4,8,1,4,3,4,0.25,0.75,0.5,0.5
SF-G24,SF-M30,6,20,1,4,5,16,0.16666666666666666,0.8333333333333334,0.2,0.8
SF-G24,SF-L27-2,5,3,4,1,1,2,0.8,0.2,0.3333333333333333,0.6666666666666666
SF-G24,SF-J29-3,16,15,4,7,12,8,0.25,0.75,0.4666666666666667,0.5333333333333333
SF-G24,SF-J29,20,67,0,13,20,54,0.0,1.0,0.19402985074626866,0.8059701492537313
SF-G24,SF-L26,10,7,1,0,9,7,0.1,0.9,0.0,1.0
SF-G24,SF-M28,5,15,0,3,5,12,0.0,1.0,0.2,0.8
SF-G24,SF-M27,1,1,0,1,1,0,0.0,1.0,1.0,0.0
SF-G24,SF-L25,32,44,2,18,30,26,0.0625,0.9375,0.4090909090909091,0.5909090909090909
SF-G24,SF-M24,108,128,53,111,55,17,0.49074074074074076,0.5092592592592593,0.8671875,0.1328125
SF-G24,SF-L24,10,17,1,10,9,7,0.1,0.9,0.5882352941176471,0.4117647058823529
SF-G24,SF-N23,8,15,0,2,8,13,0.0,1.0,0.13333333333333333,0.8666666666666667
SF-G24,SF-N24-2,5,4,0,1,5,3,0.0,1.0,0.25,0.75
SF-G24,SF-K27-2,15,11,1,5,14,6,0.06666666666666667,0.9333333333333333,0.45454545454545453,0.5454545454545454
SF-G24,SF-J26-2,12,15,3,5,9,10,0.25,0.75,0.3333333333333333,0.6666666666666666
SF-G24,SF-L28,1,12,1,6,0,6,1.0,0.0,0.5,0.5
SF-G24,SF-K28,3,3,1,1,2,2,0.3333333333333333,0.6666666666666666,0.3333333333333333,0.6666666666666666
SF-G24,SF-K29-1,10,35,1,21,9,14,0.1,0.9,0.6,0.4
SF-G24,SF-J28-2,7,4,0,0,7,4,0.0,1.0,0.0,1.0
SF-G24,SF-K27,5,5,2,5,3,0,0.4,0.6,1.0,0.0
SF-G24,SF-K25,113,125,53,113,60,12,0.4690265486725664,0.5309734513274337,0.904,0.096
SF-G24,SF-J25,40,63,8,28,32,35,0.2,0.8,0.4444444444444444,0.5555555555555556
SF-G24,SF-H26-2,8,18,1,7,7,11,0.125,0.875,0.3888888888888889,0.6111111111111112
SF-G24,SF-P24,5,5,1,1,4,4,0.2,0.8,0.2,0.8
SF-G24,SF-N22-1A,1,11,0,0,1,11,0.0,1.0,0.0,1.0
SF-G24,SF-J24,25,38,1,15,24,23,0.04,0.96,0.39473684210526316,0.6052631578947368
SF-G24,SF-O24,5,50,2,7,3,43,0.4,0.6,0.14,0.86
SF-G24,SF-J26,3,7,2,1,1,6,0.6666666666666666,0.3333333333333333,0.14285714285714285,0.8571428571428571
SF-G24,SF-I25,49,52,9,36,40,16,0.1836734693877551,0.8163265306122449,0.6923076923076923,0.3076923076923077
SF-G24,SF-K23,2,6,0,2,2,4,0.0,1.0,0.3333333333333333,0.6666666666666666
SF-G24,SF-H26,42,141,3,29,39,112,0.07142857142857142,0.9285714285714286,0.20567375886524822,0.7943262411347518
SF-G24,SF-O23,9,11,1,1,8,10,0.1111111111111111,0.8888888888888888,0.09090909090909091,0.9090909090909091
SF-G24,SF-H27-1,2,14,1,8,1,6,0.5,0.5,0.5714285714285714,0.42857142857142855
SF-G24,SF-F28-2,34,68,5,27,29,41,0.14705882352941177,0.8529411764705882,0.39705882352941174,0.6029411764705882
SF-G24,SF-G27,62,69,15,26,47,43,0.24193548387096775,0.7580645161290323,0.37681159420289856,0.6231884057971014
SF-G24,SF-M22-2,47,47,5,16,42,31,0.10638297872340426,0.8936170212765957,0.3404255319148936,0.6595744680851063
SF-G24,SF-L22,21,28,3,12,18,16,0.14285714285714285,0.8571428571428571,0.42857142857142855,0.5714285714285714
SF-G24,SF-F27,42,123,9,53,33,70,0.21428571428571427,0.7857142857142857,0.43089430894308944,0.5691056910569106
SF-G24,SF-N22-2,66,36,1,17,65,19,0.015151515151515152,0.9848484848484849,0.4722222222222222,0.5277777777777778
SF-G24,SF-G28-2,9,11,1,2,8,9,0.1111111111111111,0.8888888888888888,0.18181818181818182,0.8181818181818182
SF-G24,SF-G28-1,1,6,0,1,1,5,0.0,1.0,0.16666666666666666,0.8333333333333334
SF-G24,SF-M22-1,10,10,2,8,8,2,0.2,0.8,0.8,0.2
SF-G24,SF-O25-1,2,3,0,0,2,3,0.0,1.0,0.0,1.0
SF-G24,SF-K22-2,12,27,3,16,9,11,0.25,0.75,0.5925925925925926,0.4074074074074074
SF-G24,SF-K24,37,55,14,15,23,40,0.3783783783783784,0.6216216216216216,0.2727272727272727,0.7272727272727273
SF-G24,SF-J23-2,42,30,21,5,21,25,0.5,0.5,0.16666666666666666,0.8333333333333334
SF-G24,SF-G23,29,32,17,20,12,12,0.5862068965517241,0.41379310344827586,0.625,0.375
SF-G24,SF-G25,53,65,16,33,37,32,0.3018867924528302,0.6981132075471698,0.5076923076923077,0.49230769230769234
SF-G24,SF-F23,31,30,20,17,11,13,0.6451612903225806,0.3548387096774194,0.5666666666666667,0.43333333333333335
SF-G24,SF-E23,70,34,25,13,45,21,0.35714285714285715,0.6428571428571429,0.38235294117647056,0.6176470588235294
SF-G24,SF-D24,18,2,10,0,8,2,0.5555555555555556,0.4444444444444444,0.0,1.0
SF-G24,SF-C22,32,36,5,9,27,27,0.15625,0.84375,0.25,0.75
SF-G24,SF-B22,35,31,17,14,18,17,0.4857142857142857,0.5142857142857142,0.45161290322580644,0.5483870967741935
SF-G24,SF-J17,24,22,9,3,15,19,0.375,0.625,0.13636363636363635,0.8636363636363636
SF-G24,SF-I19,33,13,2,3,31,10,0.06060606060606061,0.9393939393939394,0.23076923076923078,0.7692307692307693
SF-G24,SF-I20,12,22,0,6,12,16,0.0,1.0,0.2727272727272727,0.7272727272727273
SF-G24,SF-H16,7,6,0,0,7,6,0.0,1.0,0.0,1.0
SF-G24,SF-H19,9,4,1,0,8,4,0.1111111111111111,0.8888888888888888,0.0,1.0
SF-G24,SF-H20,42,40,3,6,39,34,0.07142857142857142,0.9285714285714286,0.15,0.85
SF-G24,SF-H18,5,9,0,0,5,9,0.0,1.0,0.0,1.0
SF-G24,SF-G19,22,17,1,3,21,14,0.045454545454545456,0.9545454545454546,0.17647058823529413,0.8235294117647058
SF-G24,SF-G17,11,11,3,3,8,8,0.2727272727272727,0.7272727272727273,0.2727272727272727,0.7272727272727273
SF-G24,SF-G18,36,17,4,1,32,16,0.1111111111111111,0.8888888888888888,0.058823529411764705,0.9411764705882353
SF-G24,SF-G20,60,43,12,10,48,33,0.2,0.8,0.23255813953488372,0.7674418604651163
SF-G24,SF-F19,5,17,0,4,5,13,0.0,1.0,0.23529411764705882,0.7647058823529411
SF-G24,SF-E18,5,3,3,0,2,3,0.6,0.4,0.0,1.0
SF-G24,SF-E20,9,10,3,1,6,9,0.3333333333333333,0.6666666666666666,0.1,0.9
SF-G24,SF-H30,11,7,0,2,11,5,0.0,1.0,0.2857142857142857,0.7142857142857143
SF-G24,SF-G30-2,32,101,3,42,29,59,0.09375,0.90625,0.4158415841584158,0.5841584158415841
SF-G24,SF-F30-1,2,1,0,0,2,1,0.0,1.0,0.0,1.0
SF-G24,SF-E29-2,91,88,7,31,84,57,0.07692307692307693,0.9230769230769231,0.3522727272727273,0.6477272727272727
SF-G24,SF-E29-1,50,163,2,67,48,96,0.04,0.96,0.4110429447852761,0.588957055214724
SF-G24,SF-D29,15,17,1,5,14,12,0.06666666666666667,0.9333333333333333,0.29411764705882354,0.7058823529411765
SF-G24,SF-D28,5,14,0,10,5,4,0.0,1.0,0.7142857142857143,0.2857142857142857
SF-G24,SF-A27,4,7,0,3,4,4,0.0,1.0,0.42857142857142855,0.5714285714285714
SF-G24,SF-G29-2,4,10,0,4,4,6,0.0,1.0,0.4,0.6
SF-G24,SF-G29-1,27,42,0,8,27,34,0.0,1.0,0.19047619047619047,0.8095238095238095
SF-G24,SF-G30-1,19,20,2,13,17,7,0.10526315789473684,0.8947368421052632,0.65,0.35
SF-G24,SF-G29-3,8,29,4,18,4,11,0.5,0.5,0.6206896551724138,0.3793103448275862
SF-G24,SF-F30-2,8,19,4,7,4,12,0.5,0.5,0.3684210526315789,0.631578947368421
SF-G24,SF-F29,5,22,2,15,3,7,0.4,0.6,0.6818181818181818,0.3181818181818182
SF-G24,SF-E29-3,18,11,0,4,18,7,0.0,1.0,0.36363636363636365,0.6363636363636364
SF-G24,SF-F28-1,19,29,2,10,17,19,0.10526315789473684,0.8947368421052632,0.3448275862068966,0.6551724137931034
SF-G24,SF-E28-2,54,94,2,4,52,90,0.037037037037037035,0.9629629629629629,0.0425531914893617,0.9574468085106383
SF-G24,SF-E28,37,53,2,32,35,21,0.05405405405405406,0.9459459459459459,0.6037735849056604,0.39622641509433965
SF-G24,SF-J10,9,3,1,2,8,1,0.1111111111111111,0.8888888888888888,0.6666666666666666,0.3333333333333333
SF-G24,SF-J12,7,5,2,1,5,4,0.2857142857142857,0.7142857142857143,0.2,0.8
SF-G24,SF-J13,5,11,1,0,4,11,0.2,0.8,0.0,1.0
SF-G24,SF-J15,2,4,0,0,2,4,0.0,1.0,0.0,1.0
SF-G24,SF-J14,1,1,0,0,1,1,0.0,1.0,0.0,1.0
SF-G24,SF-H13,1,2,0,1,1,1,0.0,1.0,0.5,0.5
SF-G24,SF-H12,6,3,0,0,6,3,0.0,1.0,0.0,1.0
SF-G24,SF-G10-2,3,3,2,0,1,3,0.6666666666666666,0.3333333333333333,0.0,1.0
SF-G24,SF-H15,5,3,1,0,4,3,0.2,0.8,0.0,1.0
SF-G24,SF-G9,2,2,0,2,2,0,0.0,1.0,1.0,0.0
SF-G24,SF-G13,13,2,3,0,10,2,0.23076923076923078,0.7692307692307693,0.0,1.0
SF-G24,SF-G11,4,4,1,0,3,4,0.25,0.75,0.0,1.0
SF-G24,SF-G12,5,10,0,2,5,8,0.0,1.0,0.2,0.8
SF-G24,SF-G10-1,4,6,0,1,4,5,0.0,1.0,0.16666666666666666,0.8333333333333334
SF-G24,SF-F15,3,3,0,0,3,3,0.0,1.0,0.0,1.0
SF-G24,SF-F16,9,4,2,0,7,4,0.2222222222222222,0.7777777777777778,0.0,1.0
SF-G24,SF-C21,3,7,0,3,3,4,0.0,1.0,0.42857142857142855,0.5714285714285714
SF-G24,SF-C20,11,54,2,0,9,54,0.18181818181818182,0.8181818181818182,0.0,1.0
SF-G24,SF-B21,5,1,1,0,4,1,0.2,0.8,0.0,1.0
SF-G24,SF-B19,38,47,2,4,36,43,0.05263157894736842,0.9473684210526315,0.0851063829787234,0.9148936170212766
SF-G24,SF-A20,72,63,5,5,67,58,0.06944444444444445,0.9305555555555556,0.07936507936507936,0.9206349206349206
SF-G24,SF-A19,3,11,0,2,3,9,0.0,1.0,0.18181818181818182,0.8181818181818182
SF-G24,SF-C26,23,21,2,2,21,19,0.08695652173913043,0.9130434782608695,0.09523809523809523,0.9047619047619048
SF-G24,SF-C25,48,50,2,4,46,46,0.041666666666666664,0.9583333333333334,0.08,0.92
SF-G24,SF-B25,81,42,1,1,80,41,0.012345679012345678,0.9876543209876543,0.023809523809523808,0.9761904761904762
SF-G24,SF-E27,11,8,0,5,11,3,0.0,1.0,0.625,0.375
SF-G24,SF-B28-2,4,2,1,1,3,1,0.25,0.75,0.5,0.5
SF-G24,SF-D27,17,28,3,13,14,15,0.17647058823529413,0.8235294117647058,0.4642857142857143,0.5357142857142857
SF-G24,SF-C28-2,5,8,0,1,5,7,0.0,1.0,0.125,0.875
SF-G24,SF-C28-1,2,2,0,0,2,2,0.0,1.0,0.0,1.0
SF-G24,SF-B28,7,17,0,7,7,10,0.0,1.0,0.4117647058823529,0.5882352941176471
SF-G24,SF-J1,9,12,1,8,8,4,0.1111111111111111,0.8888888888888888,0.6666666666666666,0.3333333333333333
SF-G24,SF-J3,9,1,0,0,9,1,0.0,1.0,0.0,1.0
SF-G24,SF-J5,3,4,0,0,3,4,0.0,1.0,0.0,1.0
SF-G24,SF-G6,1,7,0,0,1,7,0.0,1.0,0.0,1.0
SF-G24,SF-G5,4,9,2,2,2,7,0.5,0.5,0.2222222222222222,0.7777777777777778
SF-G24,SF-G7,10,9,2,4,8,5,0.2,0.8,0.4444444444444444,0.5555555555555556
SF-G24,SF-F9,4,3,0,1,4,2,0.0,1.0,0.3333333333333333,0.6666666666666666
SF-G24,SF-H25,10,24,1,11,9,13,0.1,0.9,0.4583333333333333,0.5416666666666666
SF-G24,SF-G26,44,43,7,23,37,20,0.1590909090909091,0.8409090909090909,0.5348837209302325,0.46511627906976744
SF-G24,SF-K21,21,15,0,1,21,14,0.0,1.0,0.06666666666666667,0.9333333333333333
SF-G24,SF-K22-1,22,25,5,12,17,13,0.22727272727272727,0.7727272727272727,0.48,0.52
SF-G24,SF-J23-1,153,192,29,98,124,94,0.1895424836601307,0.8104575163398693,0.5104166666666666,0.4895833333333333
SF-G24,SF-J22-1,17,16,3,8,14,8,0.17647058823529413,0.8235294117647058,0.5,0.5
SF-G24,SF-J22-2,27,60,10,35,17,25,0.37037037037037035,0.6296296296296297,0.5833333333333334,0.4166666666666667
SF-G24,SF-J21,32,13,6,6,26,7,0.1875,0.8125,0.46153846153846156,0.5384615384615384
SF-G24,SF-I21,10,8,2,0,8,8,0.2,0.8,0.0,1.0
SF-G24,SF-I22,6,10,2,4,4,6,0.3333333333333333,0.6666666666666666,0.4,0.6
SF-G24,SF-I23-2,52,44,16,25,36,19,0.3076923076923077,0.6923076923076923,0.5681818181818182,0.4318181818181818
SF-G24,SF-I24,32,60,4,34,28,26,0.125,0.875,0.5666666666666667,0.43333333333333335
SF-G24,SF-I23-1,86,66,11,35,75,31,0.12790697674418605,0.872093023255814,0.5303030303030303,0.4696969696969697
SF-G24,SF-F26,56,86,16,39,40,47,0.2857142857142857,0.7142857142857143,0.45348837209302323,0.5465116279069767
SF-G24,SF-M13,20,11,1,2,19,9,0.05,0.95,0.18181818181818182,0.8181818181818182
SF-G24,SF-M15,15,11,2,3,13,8,0.13333333333333333,0.8666666666666667,0.2727272727272727,0.7272727272727273
SF-G24,SF-L19,56,53,1,4,55,49,0.017857142857142856,0.9821428571428571,0.07547169811320754,0.9245283018867925
SF-G24,SF-L20,10,23,0,3,10,20,0.0,1.0,0.13043478260869565,0.8695652173913043
SF-G24,SF-N20-1,8,4,1,1,7,3,0.125,0.875,0.25,0.75
SF-G24,SF-M20,48,26,3,4,45,22,0.0625,0.9375,0.15384615384615385,0.8461538461538461
SF-G24,SF-K17-2,11,7,0,1,11,6,0.0,1.0,0.14285714285714285,0.8571428571428571
SF-G24,SF-K20,17,9,1,2,16,7,0.058823529411764705,0.9411764705882353,0.2222222222222222,0.7777777777777778
SF-G24,SF-K15-,113,84,9,13,104,71,0.07964601769911504,0.9203539823008849,0.15476190476190477,0.8452380952380952
SF-G24,SF-K19,39,25,5,1,34,24,0.1282051282051282,0.8717948717948718,0.04,0.96
SF-G24,SF-K18,25,6,10,2,15,4,0.4,0.6,0.3333333333333333,0.6666666666666666
SF-G24,SF-K17,15,42,2,3,13,39,0.13333333333333333,0.8666666666666667,0.07142857142857142,0.9285714285714286
SF-G24,SF-J16,2,22,0,0,2,22,0.0,1.0,0.0,1.0
SF-G24,SF-J18,21,8,7,0,14,8,0.3333333333333333,0.6666666666666666,0.0,1.0
SF-G24,SF-J20,11,9,4,3,7,6,0.36363636363636365,0.6363636363636364,0.3333333333333333,0.6666666666666666
SF-G24,SF-J19,28,56,9,14,19,42,0.32142857142857145,0.6785714285714286,0.25,0.75
SF-G24,SF-M12,8,5,0,0,8,5,0.0,1.0,0.0,1.0
SF-G24,SF-M10,5,7,0,0,5,7,0.0,1.0,0.0,1.0
SF-G24,SF-M11,8,6,0,1,8,5,0.0,1.0,0.16666666666666666,0.8333333333333334
SF-G24,SF-R19,1,3,0,0,1,3,0.0,1.0,0.0,1.0
SF-G24,SF-R20,5,7,1,0,4,7,0.2,0.8,0.0,1.0
SF-G24,SF-Q21-2,8,2,5,0,3,2,0.625,0.375,0.0,1.0
SF-G24,SF-Q21-1,15,16,0,3,15,13,0.0,1.0,0.1875,0.8125
SF-G24,SF-P21,26,35,0,0,26,35,0.0,1.0,0.0,1.0
SF-G24,SF-O18,14,15,1,0,13,15,0.07142857142857142,0.9285714285714286,0.0,1.0
SF-G24,SF-O19,25,39,2,7,23,32,0.08,0.92,0.1794871794871795,0.8205128205128205
SF-G24,SF-O21,34,32,3,7,31,25,0.08823529411764706,0.9117647058823529,0.21875,0.78125
SF-G24,SF-O22,25,121,1,17,24,104,0.04,0.96,0.14049586776859505,0.859504132231405
SF-G24,SF-N21,9,13,1,3,8,10,0.1111111111111111,0.8888888888888888,0.23076923076923078,0.7692307692307693
SF-G24,SF-N20-2,5,1,0,1,5,0,0.0,1.0,1.0,0.0
SF-G24,SF-M21,13,9,0,6,13,3,0.0,1.0,0.6666666666666666,0.3333333333333333
SF-G24,SF-L21,98,89,10,18,88,71,0.10204081632653061,0.8979591836734694,0.20224719101123595,0.797752808988764
SF-G24,SF-Q30,15,36,0,0,15,36,0.0,1.0,0.0,1.0
SF-G24,SF-P30,1,7,0,1,1,6,0.0,1.0,0.14285714285714285,0.8571428571428571
SF-G24,SF-O30-2,4,6,2,5,2,1,0.5,0.5,0.8333333333333334,0.16666666666666666
SF-G24,SF-O30,13,25,4,4,9,21,0.3076923076923077,0.6923076923076923,0.16,0.84
SF-G24,SF-N27,11,14,2,5,9,9,0.18181818181818182,0.8181818181818182,0.35714285714285715,0.6428571428571429
SF-G24,SF-N29,3,5,1,0,2,5,0.3333333333333333,0.6666666666666666,0.0,1.0
SF-G24,SF-N28,7,25,0,4,7,21,0.0,1.0,0.16,0.84
SF-G24,SF-L30-1,3,18,0,5,3,13,0.0,1.0,0.2777777777777778,0.7222222222222222
SF-G24,SF-L31-1,4,3,1,3,3,0,0.25,0.75,1.0,0.0
SF-G24,SF-K30-2,2,8,0,3,2,5,0.0,1.0,0.375,0.625
SF-G24,SF-L29,3,38,0,1,3,37,0.0,1.0,0.02631578947368421,0.9736842105263158
SF-G24,SF-J29-1,15,49,1,10,14,39,0.06666666666666667,0.9333333333333333,0.20408163265306123,0.7959183673469388
SF-G24,SF-I30,85,96,1,21,84,75,0.011764705882352941,0.9882352941176471,0.21875,0.78125
SF-G24,SF-I29-2,5,14,1,3,4,11,0.2,0.8,0.21428571428571427,0.7857142857142857
SF-G24,SF-I27,13,24,1,10,12,14,0.07692307692307693,0.9230769230769231,0.4166666666666667,0.5833333333333334
SF-G24,SF-I28,62,124,1,15,61,109,0.016129032258064516,0.9838709677419355,0.12096774193548387,0.8790322580645161
SF-G24,SF-I30-2,14,12,2,8,12,4,0.14285714285714285,0.8571428571428571,0.6666666666666666,0.3333333333333333
SF-G24,SF I29-1,12,25,0,0,12,25,0.0,1.0,0.0,1.0
SF-G24,SF-H28,17,15,9,8,8,7,0.5294117647058824,0.47058823529411764,0.5333333333333333,0.4666666666666667
SF-G24,SF-S24,7,17,2,7,5,10,0.2857142857142857,0.7142857142857143,0.4117647058823529,0.5882352941176471
SF-G24,SF-R24,11,15,3,9,8,6,0.2727272727272727,0.7272727272727273,0.6,0.4
SF-G24,SF-R26,2,3,1,2,1,1,0.5,0.5,0.6666666666666666,0.3333333333333333
SF-G24,SF-Q26,2,3,0,0,2,3,0.0,1.0,0.0,1.0
SF-G24,SF-P26,12,39,0,0,12,39,0.0,1.0,0.0,1.0
SF-G24,SF-O25-2,3,17,0,1,3,16,0.0,1.0,0.058823529411764705,0.9411764705882353
SF-G24,SF-N22-1B,10,13,0,3,10,10,0.0,1.0,0.23076923076923078,0.7692307692307693
SF-G24,SF-N26,3,2,0,1,3,1,0.0,1.0,0.5,0.5
SF-G24,SF-N25,7,1,1,1,6,0,0.14285714285714285,0.8571428571428571,1.0,0.0
SF-G24,SF-T21,2,9,1,1,1,8,0.5,0.5,0.1111111111111111,0.8888888888888888
SF-G24,SF-T22,18,25,1,2,17,23,0.05555555555555555,0.9444444444444444,0.08,0.92
SF-G24,SF-S22-2,8,1,1,0,7,1,0.125,0.875,0.0,1.0
SF-G24,SF-S22-1,6,4,0,0,6,4,0.0,1.0,0.0,1.0
SF-G24,SF-Q23-3,15,21,0,4,15,17,0.0,1.0,0.19047619047619047,0.8095238095238095
SF-G24,SF-Q22-1,16,15,0,3,16,12,0.0,1.0,0.2,0.8
SF-G24,SF-Q22-2,38,45,1,5,37,40,0.02631578947368421,0.9736842105263158,0.1111111111111111,0.8888888888888888
SF-G24,SF-P22,18,17,2,3,16,14,0.1111111111111111,0.8888888888888888,0.17647058823529413,0.8235294117647058
SF-G24,SF-W19,1,2,0,1,1,1,0.0,1.0,0.5,0.5
SF-G24,SF-U21,4,6,0,1,4,5,0.0,1.0,0.16666666666666666,0.8333333333333334
SF-G24,SF-S21,3,6,0,1,3,5,0.0,1.0,0.16666666666666666,0.8333333333333334
SF-G24,SF-U30,8,16,0,0,8,16,0.0,1.0,0.0,1.0
SF-G25,SF-M26,1,3,0,0,1,3,0.0,1.0,0.0,1.0
SF-G25,SF-M25,5,15,1,8,4,7,0.2,0.8,0.5333333333333333,0.4666666666666667
SF-G25,SF-M26-2,1,3,0,1,1,2,0.0,1.0,0.3333333333333333,0.6666666666666666
SF-G25,SF-L27,3,4,0,0,3,4,0.0,1.0,0.0,1.0
SF-G25,SF-K26,15,77,0,13,15,64,0.0,1.0,0.16883116883116883,0.8311688311688312
SF-G25,SF-J27,12,12,2,2,10,10,0.16666666666666666,0.8333333333333334,0.16666666666666666,0.8333333333333334
SF-G25,SF-M30,7,3,2,2,5,1,0.2857142857142857,0.7142857142857143,0.6666666666666666,0.3333333333333333
SF-G25,SF-L27-2,10,12,3,2,7,10,0.3,0.7,0.16666666666666666,0.8333333333333334
SF-G25,SF-J29-3,12,18,1,8,11,10,0.08333333333333333,0.9166666666666666,0.4444444444444444,0.5555555555555556
SF-G25,SF-J29,53,56,3,4,50,52,0.05660377358490566,0.9433962264150944,0.07142857142857142,0.9285714285714286
SF-G25,SF-L26,6,23,5,22,1,1,0.8333333333333334,0.16666666666666666,0.9565217391304348,0.043478260869565216
SF-G25,SF-M28,4,2,1,0,3,2,0.25,0.75,0.0,1.0
SF-G25,SF-L25,7,20,0,12,7,8,0.0,1.0,0.6,0.4
SF-G25,SF-M24,15,12,4,7,11,5,0.26666666666666666,0.7333333333333333,0.5833333333333334,0.4166666666666667
SF-G25,SF-L24,7,9,3,5,4,4,0.42857142857142855,0.5714285714285714,0.5555555555555556,0.4444444444444444
SF-G25,SF-N23,4,6,2,3,2,3,0.5,0.5,0.5,0.5
SF-G25,SF-N24-2,4,4,0,1,4,3,0.0,1.0,0.25,0.75
SF-G25,SF-K27-2,5,17,2,6,3,11,0.4,0.6,0.35294117647058826,0.6470588235294118
SF-G25,SF-J26-2,7,6,3,4,4,2,0.42857142857142855,0.5714285714285714,0.6666666666666666,0.3333333333333333
SF-G25,SF-L28,4,4,0,2,4,2,0.0,1.0,0.5,0.5
SF-G25,SF-K28,1,4,0,3,1,1,0.0,1.0,0.75,0.25
SF-G25,SF-K29-1,9,13,2,8,7,5,0.2222222222222222,0.7777777777777778,0.6153846153846154,0.38461538461538464
SF-G25,SF-J28-2,5,8,1,5,4,3,0.2,0.8,0.625,0.375
SF-G25,SF-K27,3,1,1,0,2,1,0.3333333333333333,0.6666666666666666,0.0,1.0
SF-G25,SF-K25,8,11,2,4,6,7,0.25,0.75,0.36363636363636365,0.6363636363636364
SF-G25,SF-J25,12,51,1,6,11,45,0.08333333333333333,0.9166666666666666,0.11764705882352941,0.8823529411764706
SF-G25,SF-H26-2,19,43,5,15,14,28,0.2631578947368421,0.7368421052631579,0.3488372093023256,0.6511627906976745
SF-G25,SF-P24,20,4,1,1,19,3,0.05,0.95,0.25,0.75
SF-G25,SF-N22-1A,1,5,0,1,1,4,0.0,1.0,0.2,0.8
SF-G25,SF-J24,9,13,3,7,6,6,0.3333333333333333,0.6666666666666666,0.5384615384615384,0.46153846153846156
SF-G25,SF-O24,20,16,1,1,19,15,0.05,0.95,0.0625,0.9375
SF-G25,SF-J26,3,6,1,4,2,2,0.3333333333333333,0.6666666666666666,0.6666666666666666,0.3333333333333333
SF-G25,SF-I26-,4,6,3,6,1,0,0.75,0.25,1.0,0.0
SF-G25,SF-I25,60,138,34,120,26,18,0.5666666666666667,0.43333333333333335,0.8695652173913043,0.13043478260869565
SF-G25,SF-K23,5,18,1,15,4,3,0.2,0.8,0.8333333333333334,0.16666666666666666
SF-G25,SF-H26,30,56,10,35,20,21,0.3333333333333333,0.6666666666666666,0.625,0.375
SF-G25,SF-O23,8,12,4,7,4,5,0.5,0.5,0.5833333333333334,0.4166666666666667
SF-G25,SF-H27-1,6,9,2,6,4,3,0.3333333333333333,0.6666666666666666,0.6666666666666666,0.3333333333333333
SF-G25,SF-F28-2,24,51,4,47,20,4,0.16666666666666666,0.8333333333333334,0.9215686274509803,0.0784313725490196
SF-G25,SF-G27,51,98,18,84,33,14,0.35294117647058826,0.6470588235294118,0.8571428571428571,0.14285714285714285
SF-G25,SF-M22-2,17,30,6,12,11,18,0.35294117647058826,0.6470588235294118,0.4,0.6
SF-G25,SF-L22,23,16,6,6,17,10,0.2608695652173913,0.7391304347826086,0.375,0.625
SF-G25,SF-F27,55,91,12,65,43,26,0.21818181818181817,0.7818181818181819,0.7142857142857143,0.2857142857142857
SF-G25,SF-N22-2,12,20,6,8,6,12,0.5,0.5,0.4,0.6
SF-G25,SF-G28-2,3,25,0,22,3,3,0.0,1.0,0.88,0.12
SF-G25,SF-G28-1,2,3,0,2,2,1,0.0,1.0,0.6666666666666666,0.3333333333333333
SF-G25,SF-M22-1,2,6,2,5,0,1,1.0,0.0,0.8333333333333334,0.16666666666666666
SF-G25,SF-O25-1,2,1,0,0,2,1,0.0,1.0,0.0,1.0
SF-G25,SF-K22-2,9,15,4,10,5,5,0.4444444444444444,0.5555555555555556,0.6666666666666666,0.3333333333333333
SF-G25,SF-K24,9,10,2,6,7,4,0.2222222222222222,0.7777777777777778,0.6,0.4
SF-G25,SF-J23-2,7,20,3,13,4,7,0.42857142857142855,0.5714285714285714,0.65,0.35
SF-G25,SF-G23,17,16,3,7,14,9,0.17647058823529413,0.8235294117647058,0.4375,0.5625
SF-G25,SF-G24,65,53,33,16,32,37,0.5076923076923077,0.49230769230769234,0.3018867924528302,0.6981132075471698
SF-G25,SF-F23,8,17,1,8,7,9,0.125,0.875,0.47058823529411764,0.5294117647058824
SF-G25,SF-E23,18,37,5,8,13,29,0.2777777777777778,0.7222222222222222,0.21621621621621623,0.7837837837837838
SF-G25,SF-D24,11,5,6,1,5,4,0.5454545454545454,0.45454545454545453,0.2,0.8
SF-G25,SF-C22,17,11,3,3,14,8,0.17647058823529413,0.8235294117647058,0.2727272727272727,0.7272727272727273
SF-G25,SF-B22,14,13,0,3,14,10,0.0,1.0,0.23076923076923078,0.7692307692307693
SF-G25,SF-J17,11,15,1,1,10,14,0.09090909090909091,0.9090909090909091,0.06666666666666667,0.9333333333333333
SF-G25,SF-I19,10,5,3,1,7,4,0.3,0.7,0.2,0.8
SF-G25,SF-I20,10,9,3,4,7,5,0.3,0.7,0.4444444444444444,0.5555555555555556
SF-G25,SF-H16,5,5,0,0,5,5,0.0,1.0,0.0,1.0
SF-G25,SF-H20,25,13,5,3,20,10,0.2,0.8,0.23076923076923078,0.7692307692307693
SF-G25,SF-H18,3,6,0,0,3,6,0.0,1.0,0.0,1.0
SF-G25,SF-H17,7,1,1,0,6,1,0.14285714285714285,0.8571428571428571,0.0,1.0
SF-G25,SF-G19,7,10,0,4,7,6,0.0,1.0,0.4,0.6
SF-G25,SF-G17,9,11,0,5,9,6,0.0,1.0,0.45454545454545453,0.5454545454545454
SF-G25,SF-G18,11,16,3,4,8,12,0.2727272727272727,0.7272727272727273,0.25,0.75
SF-G25,SF-G20,41,34,6,8,35,26,0.14634146341463414,0.8536585365853658,0.23529411764705882,0.7647058823529411
SF-G25,SF-F19,15,10,1,1,14,9,0.06666666666666667,0.9333333333333333,0.1,0.9
SF-G25,SF-E18,2,7,1,2,1,5,0.5,0.5,0.2857142857142857,0.7142857142857143
SF-G25,SF-E20,12,12,2,5,10,7,0.16666666666666666,0.8333333333333334,0.4166666666666667,0.5833333333333334
SF-G25,SF-H30,3,6,0,5,3,1,0.0,1.0,0.8333333333333334,0.16666666666666666
SF-G25,SF-G30-2,56,56,4,12,52,44,0.07142857142857142,0.9285714285714286,0.21428571428571427,0.7857142857142857
SF-G25,SF-F30-1,9,10,0,3,9,7,0.0,1.0,0.3,0.7
SF-G25,SF-E29-2,67,75,17,36,50,39,0.2537313432835821,0.746268656716418,0.48,0.52
SF-G25,SF-E29-1,21,35,5,17,16,18,0.23809523809523808,0.7619047619047619,0.4857142857142857,0.5142857142857142
SF-G25,SF-D29,19,32,8,26,11,6,0.42105263157894735,0.5789473684210527,0.8125,0.1875
SF-G25,SF-D28,27,43,4,12,23,31,0.14814814814814814,0.8518518518518519,0.27906976744186046,0.7209302325581395
SF-G25,SF-A27,9,9,2,5,7,4,0.2222222222222222,0.7777777777777778,0.5555555555555556,0.4444444444444444
SF-G25,SF-G29-2,18,35,9,6,9,29,0.5,0.5,0.17142857142857143,0.8285714285714286
SF-G25,SF-G29-1,11,20,2,13,9,7,0.18181818181818182,0.8181818181818182,0.65,0.35
SF-G25,SF-G30-1,18,26,5,11,13,15,0.2777777777777778,0.7222222222222222,0.4230769230769231,0.5769230769230769
SF-G25,SF-G29-3,9,10,3,6,6,4,0.3333333333333333,0.6666666666666666,0.6,0.4
SF-G25,SF-F30-2,7,3,1,1,6,2,0.14285714285714285,0.8571428571428571,0.3333333333333333,0.6666666666666666
SF-G25,SF-F29,6,8,1,1,5,7,0.16666666666666666,0.8333333333333334,0.125,0.875
SF-G25,SF-E29-3,10,6,1,2,9,4,0.1,0.9,0.3333333333333333,0.6666666666666666
SF-G25,SF-F28-1,29,79,11,68,18,11,0.3793103448275862,0.6206896551724138,0.8607594936708861,0.13924050632911392
SF-G25,SF-E28-2,4,36,1,20,3,16,0.25,0.75,0.5555555555555556,0.4444444444444444
SF-G25,SF-E28,11,61,5,54,6,7,0.45454545454545453,0.5454545454545454,0.8852459016393442,0.11475409836065574
SF-G25,SF-J10,3,1,0,0,3,1,0.0,1.0,0.0,1.0
SF-G25,SF-J12,1,2,0,0,1,2,0.0,1.0,0.0,1.0
SF-G25,SF-J13,2,6,2,2,0,4,1.0,0.0,0.3333333333333333,0.6666666666666666
SF-G25,SF-H13,6,1,0,0,6,1,0.0,1.0,0.0,1.0
SF-G25,SF-I16,1,1,0,0,1,1,0.0,1.0,0.0,1.0
SF-G25,SF-H12,2,5,0,0,2,5,0.0,1.0,0.0,1.0
SF-G25,SF-G10-2,1,1,0,0,1,1,0.0,1.0,0.0,1.0
SF-G25,SF-H15,3,3,0,0,3,3,0.0,1.0,0.0,1.0
SF-G25,SF-G13,8,9,0,4,8,5,0.0,1.0,0.4444444444444444,0.5555555555555556
SF-G25,SF-G11,1,2,0,1,1,1,0.0,1.0,0.5,0.5
SF-G25,SF-G12,11,8,1,0,10,8,0.09090909090909091,0.9090909090909091,0.0,1.0
SF-G25,SF-G10-1,1,6,0,0,1,6,0.0,1.0,0.0,1.0
SF-G25,SF-F15,3,10,0,1,3,9,0.0,1.0,0.1,0.9
SF-G25,SF-F16,7,7,0,1,7,6,0.0,1.0,0.14285714285714285,0.8571428571428571
SF-G25,SF-C21,6,1,0,0,6,1,0.0,1.0,0.0,1.0
SF-G25,SF-C20,14,10,0,3,14,7,0.0,1.0,0.3,0.7
SF-G25,SF-B21,3,10,1,2,2,8,0.3333333333333333,0.6666666666666666,0.2,0.8
SF-G25,SF-B19,28,16,1,5,27,11,0.03571428571428571,0.9642857142857143,0.3125,0.6875
SF-G25,SF-A20,16,48,1,11,15,37,0.0625,0.9375,0.22916666666666666,0.7708333333333334
SF-G25,SF-A19,3,1,0,1,3,0,0.0,1.0,1.0,0.0
SF-G25,SF-C26,62,17,4,3,58,14,0.06451612903225806,0.9354838709677419,0.17647058823529413,0.8235294117647058
SF-G25,SF-C25,24,29,6,3,18,26,0.25,0.75,0.10344827586206896,0.896551724137931
SF-G25,SF-B25,15,15,4,5,11,10,0.26666666666666666,0.7333333333333333,0.3333333333333333,0.6666666666666666
SF-G25,SF-E27,17,17,2,9,15,8,0.11764705882352941,0.8823529411764706,0.5294117647058824,0.47058823529411764
SF-G25,SF-B28-2,6,7,2,4,4,3,0.3333333333333333,0.6666666666666666,0.5714285714285714,0.42857142857142855
SF-G25,SF-D27,104,38,77,16,27,22,0.7403846153846154,0.25961538461538464,0.42105263157894735,0.5789473684210527
SF-G25,SF-C28-2,108,132,1,4,107,128,0.009259259259259259,0.9907407407407407,0.030303030303030304,0.9696969696969697
SF-G25,SF-C28-1,3,1,0,1,3,0,0.0,1.0,1.0,0.0
SF-G25,SF-B28,13,15,7,9,6,6,0.5384615384615384,0.46153846153846156,0.6,0.4
SF-G25,SF-J1,3,19,0,13,3,6,0.0,1.0,0.6842105263157895,0.3157894736842105
SF-G25,SF-J3,3,4,0,0,3,4,0.0,1.0,0.0,1.0
SF-G25,SF-J5,3,3,0,0,3,3,0.0,1.0,0.0,1.0
SF-G25,SF-G6,1,1,0,0,1,1,0.0,1.0,0.0,1.0
SF-G25,SF-G5,2,4,0,4,2,0,0.0,1.0,1.0,0.0
SF-G25,SF-G7,1,8,0,0,1,8,0.0,1.0,0.0,1.0
SF-G25,SF-H25,8,14,0,10,8,4,0.0,1.0,0.7142857142857143,0.2857142857142857
SF-G25,SF-G26,25,21,10,14,15,7,0.4,0.6,0.6666666666666666,0.3333333333333333
SF-G25,SF-K21,8,4,0,2,8,2,0.0,1.0,0.5,0.5
SF-G25,SF-K22-1,7,31,3,15,4,16,0.42857142857142855,0.5714285714285714,0.4838709677419355,0.5161290322580645
SF-G25,SF-J23-1,57,108,14,39,43,69,0.24561403508771928,0.7543859649122807,0.3611111111111111,0.6388888888888888
SF-G25,SF-J22-1,9,7,1,4,8,3,0.1111111111111111,0.8888888888888888,0.5714285714285714,0.42857142857142855
SF-G25,SF-J22-2,28,50,2,9,26,41,0.07142857142857142,0.9285714285714286,0.18,0.82
SF-G25,SF-J21,23,52,9,29,14,23,0.391304347826087,0.6086956521739131,0.5576923076923077,0.4423076923076923
SF-G25,SF-I21,4,10,1,4,3,6,0.25,0.75,0.4,0.6
SF-G25,SF-I22,21,38,5,13,16,25,0.23809523809523808,0.7619047619047619,0.34210526315789475,0.6578947368421053
SF-G25,SF-I23-2,29,26,14,12,15,14,0.4827586206896552,0.5172413793103449,0.46153846153846156,0.5384615384615384
SF-G25,SF-I24,8,13,3,10,5,3,0.375,0.625,0.7692307692307693,0.23076923076923078
SF-G25,SF-I23-1,7,15,0,10,7,5,0.0,1.0,0.6666666666666666,0.3333333333333333
SF-G25,SF-F26,36,56,8,36,28,20,0.2222222222222222,0.7777777777777778,0.6428571428571429,0.35714285714285715
SF-G25,SF-M13,12,13,4,0,8,13,0.3333333333333333,0.6666666666666666,0.0,1.0
SF-G25,SF-M15,6,10,3,1,3,9,0.5,0.5,0.1,0.9
SF-G25,SF-L19,15,19,2,4,13,15,0.13333333333333333,0.8666666666666667,0.21052631578947367,0.7894736842105263
SF-G25,SF-L20,11,9,1,1,10,8,0.09090909090909091,0.9090909090909091,0.1111111111111111,0.8888888888888888
SF-G25,SF-N20-1,10,12,1,5,9,7,0.1,0.9,0.4166666666666667,0.5833333333333334
SF-G25,SF-M20,45,34,7,13,38,21,0.15555555555555556,0.8444444444444444,0.38235294117647056,0.6176470588235294
SF-G25,SF-K17-2,8,8,2,1,6,7,0.25,0.75,0.125,0.875
SF-G25,SF-K20,16,18,4,6,12,12,0.25,0.75,0.3333333333333333,0.6666666666666666
SF-G25,SF-K15-,18,27,1,11,17,16,0.05555555555555555,0.9444444444444444,0.4074074074074074,0.5925925925925926
SF-G25,SF-K19,23,20,0,2,23,18,0.0,1.0,0.1,0.9
SF-G25,SF-K18,14,7,3,3,11,4,0.21428571428571427,0.7857142857142857,0.42857142857142855,0.5714285714285714
SF-G25,SF-K17,17,20,0,2,17,18,0.0,1.0,0.1,0.9
SF-G25,SF-J16,36,36,0,0,36,36,0.0,1.0,0.0,1.0
SF-G25,SF-J18,21,12,5,1,16,11,0.23809523809523808,0.7619047619047619,0.08333333333333333,0.9166666666666666
SF-G25,SF-J20,18,16,3,9,15,7,0.16666666666666666,0.8333333333333334,0.5625,0.4375
SF-G25,SF-J19,27,49,4,12,23,37,0.14814814814814814,0.8518518518518519,0.24489795918367346,0.7551020408163265
SF-G25,SF-M12,1,6,1,3,0,3,1.0,0.0,0.5,0.5
SF-G25,SF-M10,1,2,1,1,0,1,1.0,0.0,0.5,0.5
SF-G25,SF-M11,10,3,1,0,9,3,0.1,0.9,0.0,1.0
SF-G25,SF-R20,3,2,0,0,3,2,0.0,1.0,0.0,1.0
SF-G25,SF-Q21-2,8,1,0,0,8,1,0.0,1.0,0.0,1.0
SF-G25,SF-P21,6,2,1,0,5,2,0.16666666666666666,0.8333333333333334,0.0,1.0
SF-G25,SF-O18,6,8,0,2,6,6,0.0,1.0,0.25,0.75
SF-G25,SF-O19,6,17,1,6,5,11,0.16666666666666666,0.8333333333333334,0.35294117647058826,0.6470588235294118
SF-G25,SF-O21,17,27,2,11,15,16,0.11764705882352941,0.8823529411764706,0.4074074074074074,0.5925925925925926
SF-G25,SF-O22,13,26,5,7,8,19,0.38461538461538464,0.6153846153846154,0.2692307692307692,0.7307692307692307
SF-G25,SF-N21,3,9,2,5,1,4,0.6666666666666666,0.3333333333333333,0.5555555555555556,0.4444444444444444
SF-G25,SF-N20-2,11,12,0,0,11,12,0.0,1.0,0.0,1.0
SF-G25,SF-M21,5,9,2,3,3,6,0.4,0.6,0.3333333333333333,0.6666666666666666
SF-G25,SF-L21,18,119,3,25,15,94,0.16666666666666666,0.8333333333333334,0.21008403361344538,0.7899159663865546
SF-G25,SF-S29,3,3,0,0,3,3,0.0,1.0,0.0,1.0
SF-G25,SF-Q30,4,6,1,1,3,5,0.25,0.75,0.16666666666666666,0.8333333333333334
SF-G25,SF-P30,11,4,0,2,11,2,0.0,1.0,0.5,0.5
SF-G25,SF-O30-2,8,9,1,2,7,7,0.125,0.875,0.2222222222222222,0.7777777777777778
SF-G25,SF-O30,13,8,0,2,13,6,0.0,1.0,0.25,0.75
SF-G25,SF-N27,5,57,3,15,2,42,0.6,0.4,0.2631578947368421,0.7368421052631579
SF-G25,SF-N29,2,2,0,0,2,2,0.0,1.0,0.0,1.0
SF-G25,SF-N28,5,2,0,0,5,2,0.0,1.0,0.0,1.0
SF-G25,SF-L30-1,16,8,3,4,13,4,0.1875,0.8125,0.5,0.5
SF-G25,SF-L31-1,1,4,0,2,1,2,0.0,1.0,0.5,0.5
SF-G25,SF-K30-2,2,5,1,4,1,1,0.5,0.5,0.8,0.2
SF-G25,SF-L29,33,9,2,3,31,6,0.06060606060606061,0.9393939393939394,0.3333333333333333,0.6666666666666666
SF-G25,SF-J29-1,19,42,2,10,17,32,0.10526315789473684,0.8947368421052632,0.23809523809523808,0.7619047619047619
SF-G25,SF-I30,108,102,61,58,47,44,0.5648148148148148,0.4351851851851852,0.5686274509803921,0.43137254901960786
SF-G25,SF-I29-2,21,7,0,3,21,4,0.0,1.0,0.42857142857142855,0.5714285714285714
SF-G25,SF-I27,7,8,2,5,5,3,0.2857142857142857,0.7142857142857143,0.625,0.375
SF-G25,SF-I28,3,29,1,12,2,17,0.3333333333333333,0.6666666666666666,0.41379310344827586,0.5862068965517241
SF-G25,SF-I30-2,15,19,5,11,10,8,0.3333333333333333,0.6666666666666666,0.5789473684210527,0.42105263157894735
SF-G25,SF I29-1,34,9,1,3,33,6,0.029411764705882353,0.9705882352941176,0.3333333333333333,0.6666666666666666
SF-G25,SF-H28,10,10,4,6,6,4,0.4,0.6,0.6,0.4
SF-G25,SF-S24,2,6,0,3,2,3,0.0,1.0,0.5,0.5
SF-G25,SF-R24,4,20,0,1,4,19,0.0,1.0,0.05,0.95
SF-G25,SF-Q26,1,3,0,1,1,2,0.0,1.0,0.3333333333333333,0.6666666666666666
SF-G25,SF-P26,7,12,3,4,4,8,0.42857142857142855,0.5714285714285714,0.3333333333333333,0.6666666666666666
SF-G25,SF-O25-2,3,3,0,0,3,3,0.0,1.0,0.0,1.0
SF-G25,SF-N22-1B,3,8,1,5,2,3,0.3333333333333333,0.6666666666666666,0.625,0.375
SF-G25,SF-N26,2,3,0,1,2,2,0.0,1.0,0.3333333333333333,0.6666666666666666
SF-G25,SF-N25,3,1,0,0,3,1,0.0,1.0,0.0,1.0
SF-G25,SF-T22,7,13,0,3,7,10,0.0,1.0,0.23076923076923078,0.7692307692307693
SF-G25,SF-S22-1,6,12,3,2,3,10,0.5,0.5,0.16666666666666666,0.8333333333333334
SF-G25,SF-Q23-3,9,10,2,3,7,7,0.2222222222222222,0.7777777777777778,0.3,0.7
SF-G25,SF-Q22-1,5,14,0,3,5,11,0.0,1.0,0.21428571428571427,0.7857142857142857
SF-G25,SF-Q22-2,4,13,1,4,3,9,0.25,0.75,0.3076923076923077,0.6923076923076923
SF-G25,SF-P22,11,19,1,1,10,18,0.09090909090909091,0.9090909090909091,0.05263157894736842,0.9473684210526315
SF-G25,SF-W19,2,2,1,0,1,2,0.5,0.5,0.0,1.0
SF-G25,SF-S21,5,1,3,0,2,1,0.6,0.4,0.0,1.0
SF-G25,SF-V28,1,1,0,0,1,1,0.0,1.0,0.0,1.0
SF-G25,SF-W14,3,2,0,0,3,2,0.0,1.0,0.0,1.0
SF-G25,SF-Y14,1,1,0,0,1,1,0.0,1.0,0.0,1.0
SF-F23,SF-M26,4,1,1,0,3,1,0.25,0.75,0.0,1.0
SF-F23,SF-M25,9,6,1,4,8,2,0.1111111111111111,0.8888888888888888,0.6666666666666666,0.3333333333333333
SF-F23,SF-M26-2,7,31,1,24,6,7,0.14285714285714285,0.8571428571428571,0.7741935483870968,0.22580645161290322
SF-F23,SF-K26,10,14,3,7,7,7,0.3,0.7,0.5,0.5
SF-F23,SF-J27,7,8,3,1,4,7,0.42857142857142855,0.5714285714285714,0.125,0.875
SF-F23,SF-M30,7,6,2,0,5,6,0.2857142857142857,0.7142857142857143,0.0,1.0
SF-F23,SF-L27-2,3,1,1,1,2,0,0.3333333333333333,0.6666666666666666,1.0,0.0
SF-F23,SF-J29-3,12,3,2,1,10,2,0.16666666666666666,0.8333333333333334,0.3333333333333333,0.6666666666666666
SF-F23,SF-J29,44,24,4,7,40,17,0.09090909090909091,0.9090909090909091,0.2916666666666667,0.7083333333333334
SF-F23,SF-L26,1,1,0,1,1,0,0.0,1.0,1.0,0.0
SF-F23,SF-M28,8,9,0,1,8,8,0.0,1.0,0.1111111111111111,0.8888888888888888
SF-F23,SF-M27,1,3,0,2,1,1,0.0,1.0,0.6666666666666666,0.3333333333333333
SF-F23,SF-L25,12,30,0,13,12,17,0.0,1.0,0.43333333333333335,0.5666666666666667
SF-F23,SF-M24,10,24,0,7,10,17,0.0,1.0,0.2916666666666667,0.7083333333333334
SF-F23,SF-L24,10,18,3,10,7,8,0.3,0.7,0.5555555555555556,0.4444444444444444
SF-F23,SF-N23,7,43,5,32,2,11,0.7142857142857143,0.2857142857142857,0.7441860465116279,0.2558139534883721
SF-F23,SF-N24-2,1,2,0,2,1,0,0.0,1.0,1.0,0.0
SF-F23,SF-K27-2,11,8,2,1,9,7,0.18181818181818182,0.8181818181818182,0.125,0.875
SF-F23,SF-J26-2,32,24,4,5,28,19,0.125,0.875,0.20833333333333334,0.7916666666666666
SF-F23,SF-L28,5,5,3,4,2,1,0.6,0.4,0.8,0.2
SF-F23,SF-K28,5,4,1,1,4,3,0.2,0.8,0.25,0.75
SF-F23,SF-K29-1,62,122,7,109,55,13,0.11290322580645161,0.8870967741935484,0.8934426229508197,0.10655737704918032
SF-F23,SF-J28-2,6,2,0,1,6,1,0.0,1.0,0.5,0.5
SF-F23,SF-K27,7,2,3,2,4,0,0.42857142857142855,0.5714285714285714,1.0,0.0
SF-F23,SF-K25,21,15,2,4,19,11,0.09523809523809523,0.9047619047619048,0.26666666666666666,0.7333333333333333
SF-F23,SF-J25,51,38,23,30,28,8,0.45098039215686275,0.5490196078431373,0.7894736842105263,0.21052631578947367
SF-F23,SF-H26-2,10,15,1,9,9,6,0.1,0.9,0.6,0.4
SF-F23,SF-P24,6,9,2,5,4,4,0.3333333333333333,0.6666666666666666,0.5555555555555556,0.4444444444444444
SF-F23,SF-J24,11,7,3,2,8,5,0.2727272727272727,0.7272727272727273,0.2857142857142857,0.7142857142857143
SF-F23,SF-O24,2,35,1,25,1,10,0.5,0.5,0.7142857142857143,0.2857142857142857
SF-F23,SF-J26,7,10,3,4,4,6,0.42857142857142855,0.5714285714285714,0.4,0.6
SF-F23,SF-I26-,38,11,33,7,5,4,0.868421052631579,0.13157894736842105,0.6363636363636364,0.36363636363636365
SF-F23,SF-I25,17,23,11,10,6,13,0.6470588235294118,0.35294117647058826,0.43478260869565216,0.5652173913043478
SF-F23,SF-H26,23,37,8,17,15,20,0.34782608695652173,0.6521739130434783,0.4594594594594595,0.5405405405405406
SF-F23,SF-O23,9,9,3,3,6,6,0.3333333333333333,0.6666666666666666,0.3333333333333333,0.6666666666666666
SF-F23,SF-H27-1,8,3,2,0,6,3,0.25,0.75,0.0,1.0
SF-F23,SF-F28-2,19,84,3,66,16,18,0.15789473684210525,0.8421052631578947,0.7857142857142857,0.21428571428571427
SF-F23,SF-G27,26,69,7,20,19,49,0.2692307692307692,0.7307692307692307,0.2898550724637681,0.7101449275362319
SF-F23,SF-M22-2,29,25,8,6,21,19,0.27586206896551724,0.7241379310344828,0.24,0.76
SF-F23,SF-L22,35,27,24,17,11,10,0.6857142857142857,0.3142857142857143,0.6296296296296297,0.37037037037037035
SF-F23,SF-F27,40,31,6,9,34,22,0.15,0.85,0.2903225806451613,0.7096774193548387
SF-F23,SF-N22-2,25,48,2,12,23,36,0.08,0.92,0.25,0.75
SF-F23,SF-G28-2,39,78,14,26,25,52,0.358974358974359,0.6410256410256411,0.3333333333333333,0.6666666666666666
SF-F23,SF-G28-1,5,24,1,3,4,21,0.2,0.8,0.125,0.875
SF-F23,SF-M22-1,8,36,1,3,7,33,0.125,0.875,0.08333333333333333,0.9166666666666666
SF-F23,SF-O25-1,1,1,0,0,1,1,0.0,1.0,0.0,1.0
SF-F23,SF-K22-2,14,10,6,6,8,4,0.42857142857142855,0.5714285714285714,0.6,0.4
SF-F23,SF-K24,27,43,7,15,20,28,0.25925925925925924,0.7407407407407407,0.3488372093023256,0.6511627906976745
SF-F23,SF-J23-2,12,8,7,2,5,6,0.5833333333333334,0.4166666666666667,0.25,0.75
SF-F23,SF-G23,38,52,13,32,25,20,0.34210526315789475,0.6578947368421053,0.6153846153846154,0.38461538461538464
SF-F23,SF-G24,30,31,17,20,13,11,0.5666666666666667,0.43333333333333335,0.6451612903225806,0.3548387096774194
SF-F23,SF-G25,17,8,8,1,9,7,0.47058823529411764,0.5294117647058824,0.125,0.875
SF-F23,SF-E23,57,44,37,21,20,23,0.6491228070175439,0.3508771929824561,0.4772727272727273,0.5227272727272727
SF-F23,SF-D24,16,15,9,2,7,13,0.5625,0.4375,0.13333333333333333,0.8666666666666667
SF-F23,SF-C22,29,32,15,13,14,19,0.5172413793103449,0.4827586206896552,0.40625,0.59375
SF-F23,SF-B22,31,43,10,13,21,30,0.3225806451612903,0.6774193548387096,0.3023255813953488,0.6976744186046512
SF-F23,SF-J17,17,17,0,0,17,17,0.0,1.0,0.0,1.0
SF-F23,SF-I19,7,7,2,3,5,4,0.2857142857142857,0.7142857142857143,0.42857142857142855,0.5714285714285714
SF-F23,SF-I20,10,9,6,5,4,4,0.6,0.4,0.5555555555555556,0.4444444444444444
SF-F23,SF-H16,2,11,0,0,2,11,0.0,1.0,0.0,1.0
SF-F23,SF-H19,3,47,1,1,2,46,0.3333333333333333,0.6666666666666666,0.02127659574468085,0.9787234042553191
SF-F23,SF-H20,21,21,3,2,18,19,0.14285714285714285,0.8571428571428571,0.09523809523809523,0.9047619047619048
SF-F23,SF-H18,4,2,0,1,4,1,0.0,1.0,0.5,0.5
SF-F23,SF-H17,1,1,1,0,0,1,1.0,0.0,0.0,1.0
SF-F23,SF-G19,16,17,5,7,11,10,0.3125,0.6875,0.4117647058823529,0.5882352941176471
SF-F23,SF-G17,10,11,3,3,7,8,0.3,0.7,0.2727272727272727,0.7272727272727273
SF-F23,SF-G18,30,27,3,4,27,23,0.1,0.9,0.14814814814814814,0.8518518518518519
SF-F23,SF-G20,20,29,6,11,14,18,0.3,0.7,0.3793103448275862,0.6206896551724138
SF-F23,SF-F19,12,11,4,4,8,7,0.3333333333333333,0.6666666666666666,0.36363636363636365,0.6363636363636364
SF-F23,SF-E18,12,9,1,2,11,7,0.08333333333333333,0.9166666666666666,0.2222222222222222,0.7777777777777778
SF-F23,SF-E20,13,5,5,0,8,5,0.38461538461538464,0.6153846153846154,0.0,1.0
SF-F23,SF-H30,6,2,1,0,5,2,0.16666666666666666,0.8333333333333334,0.0,1.0
SF-F23,SF-G30-2,18,23,0,7,18,16,0.0,1.0,0.30434782608695654,0.6956521739130435
SF-F23,SF-F30-1,6,4,0,0,6,4,0.0,1.0,0.0,1.0
SF-F23,SF-E29-2,48,66,4,12,44,54,0.08333333333333333,0.9166666666666666,0.18181818181818182,0.8181818181818182
SF-F23,SF-E29-1,9,13,1,6,8,7,0.1111111111111111,0.8888888888888888,0.46153846153846156,0.5384615384615384
SF-F23,SF-D29,16,10,2,2,14,8,0.125,0.875,0.2,0.8
SF-F23,SF-D28,4,14,1,5,3,9,0.25,0.75,0.35714285714285715,0.6428571428571429
SF-F23,SF-A27,22,27,3,1,19,26,0.13636363636363635,0.8636363636363636,0.037037037037037035,0.9629629629629629
SF-F23,SF-G29-2,24,12,4,2,20,10,0.16666666666666666,0.8333333333333334,0.16666666666666666,0.8333333333333334
SF-F23,SF-G29-1,9,7,0,2,9,5,0.0,1.0,0.2857142857142857,0.7142857142857143
SF-F23,SF-G30-1,12,4,4,2,8,2,0.3333333333333333,0.6666666666666666,0.5,0.5
SF-F23,SF-G29-3,7,8,1,3,6,5,0.14285714285714285,0.8571428571428571,0.375,0.625
SF-F23,SF-F30-2,7,3,5,2,2,1,0.7142857142857143,0.2857142857142857,0.6666666666666666,0.3333333333333333
SF-F23,SF-F29,4,11,0,1,4,10,0.0,1.0,0.09090909090909091,0.9090909090909091
SF-F23,SF-E29-3,3,6,0,3,3,3,0.0,1.0,0.5,0.5
SF-F23,SF-F28-1,12,11,2,3,10,8,0.16666666666666666,0.8333333333333334,0.2727272727272727,0.7272727272727273
SF-F23,SF-E28-2,8,15,1,2,7,13,0.125,0.875,0.13333333333333333,0.8666666666666667
SF-F23,SF-E28,6,8,0,0,6,8,0.0,1.0,0.0,1.0
SF-F23,SF-J10,1,3,0,0,1,3,0.0,1.0,0.0,1.0
SF-F23,SF-J12,11,6,0,0,11,6,0.0,1.0,0.0,1.0
SF-F23,SF-J13,1,16,0,1,1,15,0.0,1.0,0.0625,0.9375
SF-F23,SF-J15,2,6,0,0,2,6,0.0,1.0,0.0,1.0
SF-F23,SF-H13,2,2,0,1,2,1,0.0,1.0,0.5,0.5
SF-F23,SF-I16,4,2,2,0,2,2,0.5,0.5,0.0,1.0
SF-F23,SF-H12,1,6,1,1,0,5,1.0,0.0,0.16666666666666666,0.8333333333333334
SF-F23,SF-G10-2,3,2,2,2,1,0,0.6666666666666666,0.3333333333333333,1.0,0.0
SF-F23,SF-H15,1,2,0,0,1,2,0.0,1.0,0.0,1.0
SF-F23,SF-G9,2,4,1,0,1,4,0.5,0.5,0.0,1.0
SF-F23,SF-G13,8,3,2,0,6,3,0.25,0.75,0.0,1.0
SF-F23,SF-G12,5,8,0,0,5,8,0.0,1.0,0.0,1.0
SF-F23,SF-G10-1,1,4,1,0,0,4,1.0,0.0,0.0,1.0
SF-F23,SF-F15,1,2,0,0,1,2,0.0,1.0,0.0,1.0
SF-F23,SF-F16,5,5,2,1,3,4,0.4,0.6,0.2,0.8
SF-F23,SF-C21,10,3,0,0,10,3,0.0,1.0,0.0,1.0
SF-F23,SF-C20,22,28,3,12,19,16,0.13636363636363635,0.8636363636363636,0.42857142857142855,0.5714285714285714
SF-F23,SF-B21,19,8,5,4,14,4,0.2631578947368421,0.7368421052631579,0.5,0.5
SF-F23,SF-B19,22,50,6,18,16,32,0.2727272727272727,0.7272727272727273,0.36,0.64
SF-F23,SF-A20,35,31,4,12,31,19,0.11428571428571428,0.8857142857142857,0.3870967741935484,0.6129032258064516
SF-F23,SF-A19,4,12,1,8,3,4,0.25,0.75,0.6666666666666666,0.3333333333333333
SF-F23,SF-C26,4,16,0,3,4,13,0.0,1.0,0.1875,0.8125
SF-F23,SF-C25,17,19,1,1,16,18,0.058823529411764705,0.9411764705882353,0.05263157894736842,0.9473684210526315
SF-F23,SF-B25,11,13,2,4,9,9,0.18181818181818182,0.8181818181818182,0.3076923076923077,0.6923076923076923
SF-F23,SF-E27,7,14,1,8,6,6,0.14285714285714285,0.8571428571428571,0.5714285714285714,0.42857142857142855
SF-F23,SF-D27,16,37,3,4,13,33,0.1875,0.8125,0.10810810810810811,0.8918918918918919
SF-F23,SF-C28-2,3,3,0,0,3,3,0.0,1.0,0.0,1.0
SF-F23,SF-C28-1,3,1,1,0,2,1,0.3333333333333333,0.6666666666666666,0.0,1.0
SF-F23,SF-B28,11,9,6,3,5,6,0.5454545454545454,0.45454545454545453,0.3333333333333333,0.6666666666666666
SF-F23,SF-J1,11,9,9,5,2,4,0.8181818181818182,0.18181818181818182,0.5555555555555556,0.4444444444444444
SF-F23,SF-G7,5,3,0,0,5,3,0.0,1.0,0.0,1.0
SF-F23,SF-F9,3,6,0,0,3,6,0.0,1.0,0.0,1.0
SF-F23,SF-H25,5,6,1,1,4,5,0.2,0.8,0.16666666666666666,0.8333333333333334
SF-F23,SF-G26,18,18,5,8,13,10,0.2777777777777778,0.7222222222222222,0.4444444444444444,0.5555555555555556
SF-F23,SF-K21,18,19,2,0,16,19,0.1111111111111111,0.8888888888888888,0.0,1.0
SF-F23,SF-K22-1,12,30,6,15,6,15,0.5,0.5,0.5,0.5
SF-F23,SF-J23-1,67,102,11,49,56,53,0.16417910447761194,0.835820895522388,0.4803921568627451,0.5196078431372549
SF-F23,SF-J22-1,29,17,5,11,24,6,0.1724137931034483,0.8275862068965517,0.6470588235294118,0.35294117647058826
SF-F23,SF-J22-2,28,35,7,20,21,15,0.25,0.75,0.5714285714285714,0.42857142857142855
SF-F23,SF-J21,37,57,6,36,31,21,0.16216216216216217,0.8378378378378378,0.631578947368421,0.3684210526315789
SF-F23,SF-I21,8,5,3,2,5,3,0.375,0.625,0.4,0.6
SF-F23,SF-I22,10,7,6,1,4,6,0.6,0.4,0.14285714285714285,0.8571428571428571
SF-F23,SF-I23-2,38,66,25,48,13,18,0.6578947368421053,0.34210526315789475,0.7272727272727273,0.2727272727272727
SF-F23,SF-I24,28,48,14,36,14,12,0.5,0.5,0.75,0.25
SF-F23,SF-I23-1,64,106,20,77,44,29,0.3125,0.6875,0.7264150943396226,0.27358490566037735
SF-F23,SF-F26,38,33,9,12,29,21,0.23684210526315788,0.7631578947368421,0.36363636363636365,0.6363636363636364
SF-F23,SF-M13,9,3,0,0,9,3,0.0,1.0,0.0,1.0
SF-F23,SF-M15,11,18,1,0,10,18,0.09090909090909091,0.9090909090909091,0.0,1.0
SF-F23,SF-L19,10,18,0,1,10,17,0.0,1.0,0.05555555555555555,0.9444444444444444
SF-F23,SF-L20,8,12,2,1,6,11,0.25,0.75,0.08333333333333333,0.9166666666666666
SF-F23,SF-N20-1,14,6,3,1,11,5,0.21428571428571427,0.7857142857142857,0.16666666666666666,0.8333333333333334
SF-F23,SF-M20,15,20,1,7,14,13,0.06666666666666667,0.9333333333333333,0.35,0.65
SF-F23,SF-K17-2,6,8,0,0,6,8,0.0,1.0,0.0,1.0
SF-F23,SF-K20,11,12,3,1,8,11,0.2727272727272727,0.7272727272727273,0.08333333333333333,0.9166666666666666
SF-F23,SF-K15-,24,28,2,3,22,25,0.08333333333333333,0.9166666666666666,0.10714285714285714,0.8928571428571429
SF-F23,SF-K19,45,59,1,1,44,58,0.022222222222222223,0.9777777777777777,0.01694915254237288,0.9830508474576272
SF-F23,SF-K18,16,18,3,2,13,16,0.1875,0.8125,0.1111111111111111,0.8888888888888888
SF-F23,SF-K17,14,14,2,2,12,12,0.14285714285714285,0.8571428571428571,0.14285714285714285,0.8571428571428571
SF-F23,SF-J16,28,59,5,1,23,58,0.17857142857142858,0.8214285714285714,0.01694915254237288,0.9830508474576272
SF-F23,SF-J18,21,23,8,1,13,22,0.38095238095238093,0.6190476190476191,0.043478260869565216,0.9565217391304348
SF-F23,SF-J20,20,22,4,11,16,11,0.2,0.8,0.5,0.5
SF-F23,SF-J19,40,49,9,22,31,27,0.225,0.775,0.4489795918367347,0.5510204081632653
SF-F23,SF-M12,7,6,3,1,4,5,0.42857142857142855,0.5714285714285714,0.16666666666666666,0.8333333333333334
SF-F23,SF-M10,4,1,1,1,3,0,0.25,0.75,1.0,0.0
SF-F23,SF-M11,9,9,0,0,9,9,0.0,1.0,0.0,1.0
SF-F23,SF-R19,3,2,1,1,2,1,0.3333333333333333,0.6666666666666666,0.5,0.5
SF-F23,SF-R20,5,1,1,0,4,1,0.2,0.8,0.0,1.0
SF-F23,SF-Q21-2,7,5,0,2,7,3,0.0,1.0,0.4,0.6
SF-F23,SF-Q21-1,4,2,2,1,2,1,0.5,0.5,0.5,0.5
SF-F23,SF-P21,21,10,1,0,20,10,0.047619047619047616,0.9523809523809523,0.0,1.0
SF-F23,SF-O18,5,9,0,4,5,5,0.0,1.0,0.4444444444444444,0.5555555555555556
SF-F23,SF-O19,35,55,21,15,14,40,0.6,0.4,0.2727272727272727,0.7272727272727273
SF-F23,SF-O21,24,22,5,9,19,13,0.20833333333333334,0.7916666666666666,0.4090909090909091,0.5909090909090909
SF-F23,SF-O22,10,22,0,6,10,16,0.0,1.0,0.2727272727272727,0.7272727272727273
SF-F23,SF-N21,4,4,1,1,3,3,0.25,0.75,0.25,0.75
SF-F23,SF-N20-2,3,4,0,1,3,3,0.0,1.0,0.25,0.75
SF-F23,SF-M21,11,8,3,3,8,5,0.2727272727272727,0.7272727272727273,0.375,0.625
SF-F23,SF-L21,28,45,3,14,25,31,0.10714285714285714,0.8928571428571429,0.3111111111111111,0.6888888888888889
SF-F23,SF-Q30,9,14,0,0,9,14,0.0,1.0,0.0,1.0
SF-F23,SF-P30,9,16,0,0,9,16,0.0,1.0,0.0,1.0
SF-F23,SF-O30-2,5,5,0,1,5,4,0.0,1.0,0.2,0.8
SF-F23,SF-O30,12,16,2,5,10,11,0.16666666666666666,0.8333333333333334,0.3125,0.6875
SF-F23,SF-N27,26,23,15,12,11,11,0.5769230769230769,0.4230769230769231,0.5217391304347826,0.4782608695652174
SF-F23,SF-N29,9,5,0,0,9,5,0.0,1.0,0.0,1.0
SF-F23,SF-N28,6,6,3,3,3,3,0.5,0.5,0.5,0.5
SF-F23,SF-L31-1,2,3,1,3,1,0,0.5,0.5,1.0,0.0
SF-F23,SF-K30-2,1,1,0,0,1,1,0.0,1.0,0.0,1.0
SF-F23,SF-L29,1,4,0,2,1,2,0.0,1.0,0.5,0.5
SF-F23,SF-J29-1,3,3,0,0,3,3,0.0,1.0,0.0,1.0
SF-F23,SF-I30,6,6,0,2,6,4,0.0,1.0,0.3333333333333333,0.6666666666666666
SF-F23,SF-I29-2,3,1,1,1,2,0,0.3333333333333333,0.6666666666666666,1.0,0.0
SF-F23,SF-I27,21,33,1,12,20,21,0.047619047619047616,0.9523809523809523,0.36363636363636365,0.6363636363636364
SF-F23,SF-I28,6,5,1,1,5,4,0.16666666666666666,0.8333333333333334,0.2,0.8
SF-F23,SF-I30-2,4,1,0,0,4,1,0.0,1.0,0.0,1.0
SF-F23,SF I29-1,4,7,1,1,3,6,0.25,0.75,0.14285714285714285,0.8571428571428571
SF-F23,SF-H28,5,8,3,5,2,3,0.6,0.4,0.625,0.375
SF-F23,SF-H29,4,11,3,1,1,10,0.75,0.25,0.09090909090909091,0.9090909090909091
SF-F23,SF-S24,5,5,0,1,5,4,0.0,1.0,0.2,0.8
SF-F23,SF-R24,12,28,0,5,12,23,0.0,1.0,0.17857142857142858,0.8214285714285714
SF-F23,SF-R26,3,2,0,1,3,1,0.0,1.0,0.5,0.5
SF-F23,SF-Q26,1,4,1,3,0,1,1.0,0.0,0.75,0.25
SF-F23,SF-O25-2,2,11,0,0,2,11,0.0,1.0,0.0,1.0
SF-F23,SF-N26,4,6,0,0,4,6,0.0,1.0,0.0,1.0
SF-F23,SF-N25,2,1,0,0,2,1,0.0,1.0,0.0,1.0
SF-F23,SF-T21,1,1,0,0,1,1,0.0,1.0,0.0,1.0
SF-F23,SF-T22,8,16,2,1,6,15,0.25,0.75,0.0625,0.9375
SF-F23,SF-S22-2,1,1,1,0,0,1,1.0,0.0,0.0,1.0
SF-F23,SF-S22-1,12,6,0,2,12,4,0.0,1.0,0.3333333333333333,0.6666666666666666
SF-F23,SF-Q23-3,5,10,2,1,3,9,0.4,0.6,0.1,0.9
SF-F23,SF-Q22-1,7,9,1,2,6,7,0.14285714285714285,0.8571428571428571,0.2222222222222222,0.7777777777777778
SF-F23,SF-Q22-2,6,52,1,4,5,48,0.16666666666666666,0.8333333333333334,0.07692307692307693,0.9230769230769231
SF-F23,SF-P22,7,6,3,2,4,4,0.42857142857142855,0.5714285714285714,0.3333333333333333,0.6666666666666666
SF-F23,SF-W19,2,5,2,5,0,0,1.0,0.0,1.0,0.0
SF-F23,SF-T20,3,1,0,0,3,1,0.0,1.0,0.0,1.0
SF-F23,SF-V28,6,9,4,9,2,0,0.6666666666666666,0.3333333333333333,1.0,0.0
SF-F23,SF-V32,12,1,10,1,2,0,0.8333333333333334,0.16666666666666666,1.0,0.0
SF-F23,SF-U30,4,10,0,0,4,10,0.0,1.0,0.0,1.0
SF-E23,SF-M26,3,1,0,0,3,1,0.0,1.0,0.0,1.0
SF-E23,SF-M25,2,8,0,3,2,5,0.0,1.0,0.375,0.625
SF-E23,SF-M26-2,7,5,2,2,5,3,0.2857142857142857,0.7142857142857143,0.4,0.6
SF-E23,SF-L27,1,4,0,1,1,3,0.0,1.0,0.25,0.75
SF-E23,SF-K26,8,13,2,7,6,6,0.25,0.75,0.5384615384615384,0.46153846153846156
SF-E23,SF-J27,26,42,1,34,25,8,0.038461538461538464,0.9615384615384616,0.8095238095238095,0.19047619047619047
SF-E23,SF-M30,12,8,2,3,10,5,0.16666666666666666,0.8333333333333334,0.375,0.625
SF-E23,SF-L27-2,2,3,0,3,2,0,0.0,1.0,1.0,0.0
SF-E23,SF-J29-3,4,4,1,3,3,1,0.25,0.75,0.75,0.25
SF-E23,SF-J29,11,12,3,5,8,7,0.2727272727272727,0.7272727272727273,0.4166666666666667,0.5833333333333334
SF-E23,SF-M28,12,9,3,4,9,5,0.25,0.75,0.4444444444444444,0.5555555555555556
SF-E23,SF-M27,2,4,1,0,1,4,0.5,0.5,0.0,1.0
SF-E23,SF-L25,8,22,1,6,7,16,0.125,0.875,0.2727272727272727,0.7272727272727273
SF-E23,SF-M24,6,5,1,1,5,4,0.16666666666666666,0.8333333333333334,0.2,0.8
SF-E23,SF-L24,3,10,1,4,2,6,0.3333333333333333,0.6666666666666666,0.4,0.6
SF-E23,SF-N23,7,22,0,1,7,21,0.0,1.0,0.045454545454545456,0.9545454545454546
SF-E23,SF-N24-2,8,1,0,0,8,1,0.0,1.0,0.0,1.0
SF-E23,SF-K27-2,11,10,3,4,8,6,0.2727272727272727,0.7272727272727273,0.4,0.6
SF-E23,SF-J26-2,21,12,6,3,15,9,0.2857142857142857,0.7142857142857143,0.25,0.75
SF-E23,SF-L28,7,16,3,12,4,4,0.42857142857142855,0.5714285714285714,0.75,0.25
SF-E23,SF-K28,1,3,0,1,1,2,0.0,1.0,0.3333333333333333,0.6666666666666666
SF-E23,SF-K29-1,9,16,2,8,7,8,0.2222222222222222,0.7777777777777778,0.5,0.5
SF-E23,SF-J28-2,5,20,1,1,4,19,0.2,0.8,0.05,0.95
SF-E23,SF-K27,3,4,0,3,3,1,0.0,1.0,0.75,0.25
SF-E23,SF-K25,16,41,3,10,13,31,0.1875,0.8125,0.24390243902439024,0.7560975609756098
SF-E23,SF-J25,14,8,1,4,13,4,0.07142857142857142,0.9285714285714286,0.5,0.5
SF-E23,SF-H26-2,14,28,7,20,7,8,0.5,0.5,0.7142857142857143,0.2857142857142857
SF-E23,SF-P24,13,7,3,3,10,4,0.23076923076923078,0.7692307692307693,0.42857142857142855,0.5714285714285714
SF-E23,SF-J24,9,29,1,18,8,11,0.1111111111111111,0.8888888888888888,0.6206896551724138,0.3793103448275862
SF-E23,SF-O24,20,49,0,10,20,39,0.0,1.0,0.20408163265306123,0.7959183673469388
SF-E23,SF-J26,3,10,0,4,3,6,0.0,1.0,0.4,0.6
SF-E23,SF-I26-,7,2,3,1,4,1,0.42857142857142855,0.5714285714285714,0.5,0.5
SF-E23,SF-I25,24,24,8,17,16,7,0.3333333333333333,0.6666666666666666,0.7083333333333334,0.2916666666666667
SF-E23,SF-K23,1,3,0,1,1,2,0.0,1.0,0.3333333333333333,0.6666666666666666
SF-E23,SF-H26,38,48,17,19,21,29,0.4473684210526316,0.5526315789473685,0.3958333333333333,0.6041666666666666
SF-E23,SF-O23,18,13,2,3,16,10,0.1111111111111111,0.8888888888888888,0.23076923076923078,0.7692307692307693
SF-E23,SF-H27-1,4,6,1,1,3,5,0.25,0.75,0.16666666666666666,0.8333333333333334
SF-E23,SF-F28-2,26,15,2,5,24,10,0.07692307692307693,0.9230769230769231,0.3333333333333333,0.6666666666666666
SF-E23,SF-G27,23,39,6,21,17,18,0.2608695652173913,0.7391304347826086,0.5384615384615384,0.46153846153846156
SF-E23,SF-M22-2,23,28,7,10,16,18,0.30434782608695654,0.6956521739130435,0.35714285714285715,0.6428571428571429
SF-E23,SF-L22,14,20,5,6,9,14,0.35714285714285715,0.6428571428571429,0.3,0.7
SF-E23,SF-F27,29,26,3,5,26,21,0.10344827586206896,0.896551724137931,0.19230769230769232,0.8076923076923077
SF-E23,SF-N22-2,22,20,7,3,15,17,0.3181818181818182,0.6818181818181818,0.15,0.85
SF-E23,SF-G28-2,7,10,2,3,5,7,0.2857142857142857,0.7142857142857143,0.3,0.7
SF-E23,SF-G28-1,6,28,0,18,6,10,0.0,1.0,0.6428571428571429,0.35714285714285715
SF-E23,SF-M22-1,5,19,0,0,5,19,0.0,1.0,0.0,1.0
SF-E23,SF-K22-2,8,13,2,8,6,5,0.25,0.75,0.6153846153846154,0.38461538461538464
SF-E23,SF-K24,11,11,1,4,10,7,0.09090909090909091,0.9090909090909091,0.36363636363636365,0.6363636363636364
SF-E23,SF-J23-2,33,67,4,61,29,6,0.12121212121212122,0.8787878787878788,0.9104477611940298,0.08955223880597014
SF-E23,SF-G23,20,28,8,18,12,10,0.4,0.6,0.6428571428571429,0.35714285714285715
SF-E23,SF-G24,34,70,13,25,21,45,0.38235294117647056,0.6176470588235294,0.35714285714285715,0.6428571428571429
SF-E23,SF-G25,37,18,8,5,29,13,0.21621621621621623,0.7837837837837838,0.2777777777777778,0.7222222222222222
SF-E23,SF-F23,44,57,21,37,23,20,0.4772727272727273,0.5227272727272727,0.6491228070175439,0.3508771929824561
SF-E23,SF-D24,68,16,38,2,30,14,0.5588235294117647,0.4411764705882353,0.125,0.875
SF-E23,SF-C22,55,63,15,39,40,24,0.2727272727272727,0.7272727272727273,0.6190476190476191,0.38095238095238093
SF-E23,SF-B22,104,145,64,100,40,45,0.6153846153846154,0.38461538461538464,0.6896551724137931,0.3103448275862069
SF-E23,SF-J17,9,16,0,2,9,14,0.0,1.0,0.125,0.875
SF-E23,SF-I19,15,8,4,4,11,4,0.26666666666666666,0.7333333333333333,0.5,0.5
SF-E23,SF-I20,8,5,1,1,7,4,0.125,0.875,0.2,0.8
SF-E23,SF-H16,8,14,1,3,7,11,0.125,0.875,0.21428571428571427,0.7857142857142857
SF-E23,SF-H20,20,9,7,1,13,8,0.35,0.65,0.1111111111111111,0.8888888888888888
SF-E23,SF-H18,6,5,0,0,6,5,0.0,1.0,0.0,1.0
SF-E23,SF-H17,3,3,1,0,2,3,0.3333333333333333,0.6666666666666666,0.0,1.0
SF-E23,SF-G19,13,13,2,4,11,9,0.15384615384615385,0.8461538461538461,0.3076923076923077,0.6923076923076923
SF-E23,SF-G17,6,15,0,1,6,14,0.0,1.0,0.06666666666666667,0.9333333333333333
SF-E23,SF-G18,25,20,3,4,22,16,0.12,0.88,0.2,0.8
SF-E23,SF-G20,28,24,5,6,23,18,0.17857142857142858,0.8214285714285714,0.25,0.75
SF-E23,SF-F19,32,31,8,4,24,27,0.25,0.75,0.12903225806451613,0.8709677419354839
SF-E23,SF-E18,25,30,9,8,16,22,0.36,0.64,0.26666666666666666,0.7333333333333333
SF-E23,SF-E20,30,50,12,14,18,36,0.4,0.6,0.28,0.72
SF-E23,SF-H30,4,12,1,10,3,2,0.25,0.75,0.8333333333333334,0.16666666666666666
SF-E23,SF-G30-2,26,32,2,6,24,26,0.07692307692307693,0.9230769230769231,0.1875,0.8125
SF-E23,SF-F30-1,5,5,2,2,3,3,0.4,0.6,0.4,0.6
SF-E23,SF-E29-2,20,34,2,15,18,19,0.1,0.9,0.4411764705882353,0.5588235294117647
SF-E23,SF-E29-1,18,17,3,9,15,8,0.16666666666666666,0.8333333333333334,0.5294117647058824,0.47058823529411764
SF-E23,SF-D29,22,15,1,6,21,9,0.045454545454545456,0.9545454545454546,0.4,0.6
SF-E23,SF-D28,7,8,2,4,5,4,0.2857142857142857,0.7142857142857143,0.5,0.5
SF-E23,SF-A27,7,20,0,11,7,9,0.0,1.0,0.55,0.45
SF-E23,SF-G29-2,36,15,1,2,35,13,0.027777777777777776,0.9722222222222222,0.13333333333333333,0.8666666666666667
SF-E23,SF-G29-1,13,5,1,0,12,5,0.07692307692307693,0.9230769230769231,0.0,1.0
SF-E23,SF-G30-1,7,11,1,3,6,8,0.14285714285714285,0.8571428571428571,0.2727272727272727,0.7272727272727273
SF-E23,SF-G29-3,24,16,3,6,21,10,0.125,0.875,0.375,0.625
SF-E23,SF-F30-2,5,8,1,5,4,3,0.2,0.8,0.625,0.375
SF-E23,SF-F29,1,5,0,2,1,3,0.0,1.0,0.4,0.6
SF-E23,SF-E29-3,3,7,1,2,2,5,0.3333333333333333,0.6666666666666666,0.2857142857142857,0.7142857142857143
SF-E23,SF-F28-1,9,14,0,10,9,4,0.0,1.0,0.7142857142857143,0.2857142857142857
SF-E23,SF-E28-2,5,1,0,0,5,1,0.0,1.0,0.0,1.0
SF-E23,SF-E28,4,6,1,0,3,6,0.25,0.75,0.0,1.0
SF-E23,SF-J10,7,14,3,5,4,9,0.42857142857142855,0.5714285714285714,0.35714285714285715,0.6428571428571429
SF-E23,SF-J12,9,13,1,0,8,13,0.1111111111111111,0.8888888888888888,0.0,1.0
SF-E23,SF-J13,11,12,3,2,8,10,0.2727272727272727,0.7272727272727273,0.16666666666666666,0.8333333333333334
SF-E23,SF-J15,5,8,0,0,5,8,0.0,1.0,0.0,1.0
SF-E23,SF-H13,3,1,1,0,2,1,0.3333333333333333,0.6666666666666666,0.0,1.0
SF-E23,SF-I16,3,2,0,0,3,2,0.0,1.0,0.0,1.0
SF-E23,SF-H12,5,6,1,1,4,5,0.2,0.8,0.16666666666666666,0.8333333333333334
SF-E23,SF-G10-2,2,11,1,0,1,11,0.5,0.5,0.0,1.0
SF-E23,SF-G9,4,1,0,0,4,1,0.0,1.0,0.0,1.0
SF-E23,SF-G13,11,21,0,6,11,15,0.0,1.0,0.2857142857142857,0.7142857142857143
SF-E23,SF-G11,8,6,0,1,8,5,0.0,1.0,0.16666666666666666,0.8333333333333334
SF-E23,SF-G12,14,11,2,1,12,10,0.14285714285714285,0.8571428571428571,0.09090909090909091,0.9090909090909091
SF-E23,SF-F15,15,21,3,7,12,14,0.2,0.8,0.3333333333333333,0.6666666666666666
SF-E23,SF-F16,26,25,2,2,24,23,0.07692307692307693,0.9230769230769231,0.08,0.92
SF-E23,SF-C21,26,9,12,3,14,6,0.46153846153846156,0.5384615384615384,0.3333333333333333,0.6666666666666666
SF-E23,SF-C20,43,83,10,47,33,36,0.23255813953488372,0.7674418604651163,0.5662650602409639,0.43373493975903615
SF-E23,SF-B21,14,26,6,17,8,9,0.42857142857142855,0.5714285714285714,0.6538461538461539,0.34615384615384615
SF-E23,SF-B19,70,98,8,50,62,48,0.11428571428571428,0.8857142857142857,0.5102040816326531,0.4897959183673469
SF-E23,SF-A20,70,87,5,33,65,54,0.07142857142857142,0.9285714285714286,0.3793103448275862,0.6206896551724138
SF-E23,SF-A19,14,27,3,16,11,11,0.21428571428571427,0.7857142857142857,0.5925925925925926,0.4074074074074074
SF-E23,SF-C26,37,56,12,11,25,45,0.32432432432432434,0.6756756756756757,0.19642857142857142,0.8035714285714286
SF-E23,SF-C25,32,59,5,11,27,48,0.15625,0.84375,0.1864406779661017,0.8135593220338984
SF-E23,SF-B25,39,91,5,28,34,63,0.1282051282051282,0.8717948717948718,0.3076923076923077,0.6923076923076923
SF-E23,SF-E27,8,132,0,0,8,132,0.0,1.0,0.0,1.0
SF-E23,SF-B28-2,4,2,0,0,4,2,0.0,1.0,0.0,1.0
SF-E23,SF-D27,20,36,5,14,15,22,0.25,0.75,0.3888888888888889,0.6111111111111112
SF-E23,SF-C28-2,5,5,0,4,5,1,0.0,1.0,0.8,0.2
SF-E23,SF-C28-1,4,4,3,1,1,3,0.75,0.25,0.25,0.75
SF-E23,SF-B28,22,11,12,9,10,2,0.5454545454545454,0.45454545454545453,0.8181818181818182,0.18181818181818182
SF-E23,SF-J1,10,17,0,9,10,8,0.0,1.0,0.5294117647058824,0.47058823529411764
SF-E23,SF-H0,6,6,1,1,5,5,0.16666666666666666,0.8333333333333334,0.16666666666666666,0.8333333333333334
SF-E23,SF-J3,3,3,1,0,2,3,0.3333333333333333,0.6666666666666666,0.0,1.0
SF-E23,SF-J5,5,3,0,1,5,2,0.0,1.0,0.3333333333333333,0.6666666666666666
SF-E23,SF-G6,4,3,0,1,4,2,0.0,1.0,0.3333333333333333,0.6666666666666666
SF-E23,SF-G8,9,5,6,3,3,2,0.6666666666666666,0.3333333333333333,0.6,0.4
SF-E23,SF-G5,4,5,0,4,4,1,0.0,1.0,0.8,0.2
SF-E23,SF-G7,16,12,2,0,14,12,0.125,0.875,0.0,1.0
SF-E23,SF-F9,7,9,2,3,5,6,0.2857142857142857,0.7142857142857143,0.3333333333333333,0.6666666666666666
SF-E23,SF-H25,3,9,1,2,2,7,0.3333333333333333,0.6666666666666666,0.2222222222222222,0.7777777777777778
SF-E23,SF-G26,18,23,3,5,15,18,0.16666666666666666,0.8333333333333334,0.21739130434782608,0.782608695652174
SF-E23,SF-K21,11,13,2,1,9,12,0.18181818181818182,0.8181818181818182,0.07692307692307693,0.9230769230769231
SF-E23,SF-K22-1,12,18,6,9,6,9,0.5,0.5,0.5,0.5
SF-E23,SF-J23-1,89,86,27,46,62,40,0.30337078651685395,0.6966292134831461,0.5348837209302325,0.46511627906976744
SF-E23,SF-J22-1,19,5,6,3,13,2,0.3157894736842105,0.6842105263157895,0.6,0.4
SF-E23,SF-J22-2,32,46,8,25,24,21,0.25,0.75,0.5434782608695652,0.45652173913043476
SF-E23,SF-J21,119,185,83,145,36,40,0.6974789915966386,0.3025210084033613,0.7837837837837838,0.21621621621621623
SF-E23,SF-I21,11,12,3,2,8,10,0.2727272727272727,0.7272727272727273,0.16666666666666666,0.8333333333333334
SF-E23,SF-I22,15,11,2,7,13,4,0.13333333333333333,0.8666666666666667,0.6363636363636364,0.36363636363636365
SF-E23,SF-I23-2,51,55,25,46,26,9,0.49019607843137253,0.5098039215686274,0.8363636363636363,0.16363636363636364
SF-E23,SF-I24,18,45,7,32,11,13,0.3888888888888889,0.6111111111111112,0.7111111111111111,0.28888888888888886
SF-E23,SF-I23-1,46,92,23,82,23,10,0.5,0.5,0.8913043478260869,0.10869565217391304
SF-E23,SF-F26,45,44,7,21,38,23,0.15555555555555556,0.8444444444444444,0.4772727272727273,0.5227272727272727
SF-E23,SF-M13,11,11,0,0,11,11,0.0,1.0,0.0,1.0
SF-E23,SF-M15,36,12,1,0,35,12,0.027777777777777776,0.9722222222222222,0.0,1.0
SF-E23,SF-L19,8,13,2,2,6,11,0.25,0.75,0.15384615384615385,0.8461538461538461
SF-E23,SF-L20,8,15,0,2,8,13,0.0,1.0,0.13333333333333333,0.8666666666666667
SF-E23,SF-N20-1,18,18,3,9,15,9,0.16666666666666666,0.8333333333333334,0.5,0.5
SF-E23,SF-M20,26,26,3,5,23,21,0.11538461538461539,0.8846153846153846,0.19230769230769232,0.8076923076923077
SF-E23,SF-K17-2,5,12,1,1,4,11,0.2,0.8,0.08333333333333333,0.9166666666666666
SF-E23,SF-K20,7,14,0,3,7,11,0.0,1.0,0.21428571428571427,0.7857142857142857
SF-E23,SF-K15-,34,35,1,4,33,31,0.029411764705882353,0.9705882352941176,0.11428571428571428,0.8857142857142857
SF-E23,SF-K19,17,14,4,4,13,10,0.23529411764705882,0.7647058823529411,0.2857142857142857,0.7142857142857143
SF-E23,SF-K18,22,17,4,1,18,16,0.18181818181818182,0.8181818181818182,0.058823529411764705,0.9411764705882353
SF-E23,SF-K17,22,11,4,1,18,10,0.18181818181818182,0.8181818181818182,0.09090909090909091,0.9090909090909091
SF-E23,SF-J16,20,6,3,3,17,3,0.15,0.85,0.5,0.5
SF-E23,SF-J18,31,41,13,8,18,33,0.41935483870967744,0.5806451612903226,0.1951219512195122,0.8048780487804879
SF-E23,SF-J20,27,34,5,13,22,21,0.18518518518518517,0.8148148148148148,0.38235294117647056,0.6176470588235294
SF-E23,SF-J19,47,67,6,15,41,52,0.1276595744680851,0.8723404255319149,0.22388059701492538,0.7761194029850746
SF-E23,SF-M12,4,12,0,1,4,11,0.0,1.0,0.08333333333333333,0.9166666666666666
SF-E23,SF-M10,4,5,0,1,4,4,0.0,1.0,0.2,0.8
SF-E23,SF-M11,15,17,0,0,15,17,0.0,1.0,0.0,1.0
SF-E23,SF-R19,7,3,0,1,7,2,0.0,1.0,0.3333333333333333,0.6666666666666666
SF-E23,SF-R20,16,5,0,0,16,5,0.0,1.0,0.0,1.0
SF-E23,SF-Q21-2,13,19,0,0,13,19,0.0,1.0,0.0,1.0
SF-E23,SF-Q21-1,6,8,5,4,1,4,0.8333333333333334,0.16666666666666666,0.5,0.5
SF-E23,SF-P21,8,11,0,2,8,9,0.0,1.0,0.18181818181818182,0.8181818181818182
SF-E23,SF-O18,4,9,0,1,4,8,0.0,1.0,0.1111111111111111,0.8888888888888888
SF-E23,SF-O19,15,18,4,8,11,10,0.26666666666666666,0.7333333333333333,0.4444444444444444,0.5555555555555556
SF-E23,SF-O21,35,34,3,4,32,30,0.08571428571428572,0.9142857142857143,0.11764705882352941,0.8823529411764706
SF-E23,SF-O22,38,105,5,18,33,87,0.13157894736842105,0.868421052631579,0.17142857142857143,0.8285714285714286
SF-E23,SF-N21,11,7,4,5,7,2,0.36363636363636365,0.6363636363636364,0.7142857142857143,0.2857142857142857
SF-E23,SF-N20-2,11,12,5,2,6,10,0.45454545454545453,0.5454545454545454,0.16666666666666666,0.8333333333333334
SF-E23,SF-M21,7,8,1,2,6,6,0.14285714285714285,0.8571428571428571,0.25,0.75
SF-E23,SF-L21,17,29,2,11,15,18,0.11764705882352941,0.8823529411764706,0.3793103448275862,0.6206896551724138
SF-E23,SF-S29,1,1,1,0,0,1,1.0,0.0,0.0,1.0
SF-E23,SF-Q30,32,4,0,0,32,4,0.0,1.0,0.0,1.0
SF-E23,SF-P30,29,3,0,2,29,1,0.0,1.0,0.6666666666666666,0.3333333333333333
SF-E23,SF-O30-2,3,39,0,2,3,37,0.0,1.0,0.05128205128205128,0.9487179487179487
SF-E23,SF-O30,14,20,2,4,12,16,0.14285714285714285,0.8571428571428571,0.2,0.8
SF-E23,SF-N27,13,4,1,3,12,1,0.07692307692307693,0.9230769230769231,0.75,0.25
SF-E23,SF-N29,24,27,2,1,22,26,0.08333333333333333,0.9166666666666666,0.037037037037037035,0.9629629629629629
SF-E23,SF-N28,23,37,3,5,20,32,0.13043478260869565,0.8695652173913043,0.13513513513513514,0.8648648648648649
SF-E23,SF-L30-1,17,24,7,9,10,15,0.4117647058823529,0.5882352941176471,0.375,0.625
SF-E23,SF-L31-1,1,9,0,5,1,4,0.0,1.0,0.5555555555555556,0.4444444444444444
SF-E23,SF-K30-2,6,1,2,0,4,1,0.3333333333333333,0.6666666666666666,0.0,1.0
SF-E23,SF-L29,7,4,2,1,5,3,0.2857142857142857,0.7142857142857143,0.25,0.75
SF-E23,SF-I30,13,14,1,2,12,12,0.07692307692307693,0.9230769230769231,0.14285714285714285,0.8571428571428571
SF-E23,SF-I29-2,2,5,1,4,1,1,0.5,0.5,0.8,0.2
SF-E23,SF-I27,20,26,2,7,18,19,0.1,0.9,0.2692307692307692,0.7307692307692307
SF-E23,SF-I28,7,6,1,4,6,2,0.14285714285714285,0.8571428571428571,0.6666666666666666,0.3333333333333333
SF-E23,SF-I30-2,9,5,1,2,8,3,0.1111111111111111,0.8888888888888888,0.4,0.6
SF-E23,SF I29-1,5,4,1,3,4,1,0.2,0.8,0.75,0.25
SF-E23,SF-H28,53,5,2,3,51,2,0.03773584905660377,0.9622641509433962,0.6,0.4
SF-E23,SF-H29,27,10,0,0,27,10,0.0,1.0,0.0,1.0
SF-E23,SF-S24,4,3,0,1,4,2,0.0,1.0,0.3333333333333333,0.6666666666666666
SF-E23,SF-R24,5,13,0,4,5,9,0.0,1.0,0.3076923076923077,0.6923076923076923
SF-E23,SF-R26,5,1,0,0,5,1,0.0,1.0,0.0,1.0
SF-E23,SF-Q26,2,10,1,2,1,8,0.5,0.5,0.2,0.8
SF-E23,SF-P26,1,4,0,0,1,4,0.0,1.0,0.0,1.0
SF-E23,SF-O25-2,3,6,1,1,2,5,0.3333333333333333,0.6666666666666666,0.16666666666666666,0.8333333333333334
SF-E23,SF-N22-1B,3,10,1,4,2,6,0.3333333333333333,0.6666666666666666,0.4,0.6
SF-E23,SF-N26,4,3,2,0,2,3,0.5,0.5,0.0,1.0
SF-E23,SF-N25,1,4,1,0,0,4,1.0,0.0,0.0,1.0
SF-E23,SF-T21,1,1,1,0,0,1,1.0,0.0,0.0,1.0
SF-E23,SF-T22,1,5,0,2,1,3,0.0,1.0,0.4,0.6
SF-E23,SF-S22-2,1,3,0,0,1,3,0.0,1.0,0.0,1.0
SF-E23,SF-S22-1,13,16,2,6,11,10,0.15384615384615385,0.8461538461538461,0.375,0.625
SF-E23,SF-Q23-3,9,5,0,1,9,4,0.0,1.0,0.2,0.8
SF-E23,SF-Q22-1,8,14,2,3,6,11,0.25,0.75,0.21428571428571427,0.7857142857142857
SF-E23,SF-Q22-2,38,49,3,4,35,45,0.07894736842105263,0.9210526315789473,0.08163265306122448,0.9183673469387755
SF-E23,SF-P22,17,18,3,9,14,9,0.17647058823529413,0.8235294117647058,0.5,0.5
SF-E23,SF-T20,2,1,0,0,2,1,0.0,1.0,0.0,1.0
SF-E23,SF-S21,33,38,1,0,32,38,0.030303030303030304,0.9696969696969697,0.0,1.0
SF-E23,SF-V29,1,5,0,0,1,5,0.0,1.0,0.0,1.0
SF-E23,SF-V32,13,7,13,5,0,2,1.0,0.0,0.7142857142857143,0.2857142857142857
SF-D24,SF-M26,2,2,2,0,0,2,1.0,0.0,0.0,1.0
SF-D24,SF-M26-2,3,3,0,2,3,1,0.0,1.0,0.6666666666666666,0.3333333333333333
SF-D24,SF-J27,1,3,0,2,1,1,0.0,1.0,0.6666666666666666,0.3333333333333333
SF-D24,SF-M30,2,6,0,1,2,5,0.0,1.0,0.16666666666666666,0.8333333333333334
SF-D24,SF-J29,4,5,0,2,4,3,0.0,1.0,0.4,0.6
SF-D24,SF-L26,4,3,0,1,4,2,0.0,1.0,0.3333333333333333,0.6666666666666666
SF-D24,SF-L25,2,2,0,2,2,0,0.0,1.0,1.0,0.0
SF-D24,SF-M24,1,1,0,1,1,0,0.0,1.0,1.0,0.0
SF-D24,SF-L24,5,5,1,4,4,1,0.2,0.8,0.8,0.2
SF-D24,SF-N23,4,11,0,0,4,11,0.0,1.0,0.0,1.0
SF-D24,SF-N24-2,1,3,0,1,1,2,0.0,1.0,0.3333333333333333,0.6666666666666666
SF-D24,SF-J26-2,1,3,0,3,1,0,0.0,1.0,1.0,0.0
SF-D24,SF-L28,1,1,0,0,1,1,0.0,1.0,0.0,1.0
SF-D24,SF-K29-1,2,39,0,4,2,35,0.0,1.0,0.10256410256410256,0.8974358974358975
SF-D24,SF-J28-2,2,2,0,1,2,1,0.0,1.0,0.5,0.5
SF-D24,SF-K25,12,7,0,6,12,1,0.0,1.0,0.8571428571428571,0.14285714285714285
SF-D24,SF-J25,6,2,0,2,6,0,0.0,1.0,1.0,0.0
SF-D24,SF-H26-2,3,2,2,2,1,0,0.6666666666666666,0.3333333333333333,1.0,0.0
SF-D24,SF-N22-1A,1,1,0,0,1,1,0.0,1.0,0.0,1.0
SF-D24,SF-J24,2,1,0,0,2,1,0.0,1.0,0.0,1.0
SF-D24,SF-O24,1,2,0,1,1,1,0.0,1.0,0.5,0.5
SF-D24,SF-I26-,2,1,2,0,0,1,1.0,0.0,0.0,1.0
SF-D24,SF-I25,6,22,0,9,6,13,0.0,1.0,0.4090909090909091,0.5909090909090909
SF-D24,SF-H26,8,12,1,4,7,8,0.125,0.875,0.3333333333333333,0.6666666666666666
SF-D24,SF-O23,2,3,0,2,2,1,0.0,1.0,0.6666666666666666,0.3333333333333333
SF-D24,SF-F28-2,4,16,1,4,3,12,0.25,0.75,0.25,0.75
SF-D24,SF-G27,5,11,0,6,5,5,0.0,1.0,0.5454545454545454,0.45454545454545453
SF-D24,SF-M22-2,6,6,1,1,5,5,0.16666666666666666,0.8333333333333334,0.16666666666666666,0.8333333333333334
SF-D24,SF-L22,11,18,0,5,11,13,0.0,1.0,0.2777777777777778,0.7222222222222222
SF-D24,SF-F27,8,26,0,7,8,19,0.0,1.0,0.2692307692307692,0.7307692307692307
SF-D24,SF-N22-2,9,4,3,2,6,2,0.3333333333333333,0.6666666666666666,0.5,0.5
SF-D24,SF-G28-2,1,3,1,2,0,1,1.0,0.0,0.6666666666666666,0.3333333333333333
SF-D24,SF-M22-1,5,3,0,0,5,3,0.0,1.0,0.0,1.0
SF-D24,SF-O25-1,1,3,0,1,1,2,0.0,1.0,0.3333333333333333,0.6666666666666666
SF-D24,SF-K22-2,3,6,1,3,2,3,0.3333333333333333,0.6666666666666666,0.5,0.5
SF-D24,SF-J23-2,8,14,2,6,6,8,0.25,0.75,0.42857142857142855,0.5714285714285714
SF-D24,SF-G23,7,13,2,9,5,4,0.2857142857142857,0.7142857142857143,0.6923076923076923,0.3076923076923077
SF-D24,SF-G24,2,18,0,10,2,8,0.0,1.0,0.5555555555555556,0.4444444444444444
SF-D24,SF-G25,5,11,1,6,4,5,0.2,0.8,0.5454545454545454,0.45454545454545453
SF-D24,SF-F23,15,16,2,9,13,7,0.13333333333333333,0.8666666666666667,0.5625,0.4375
SF-D24,SF-E23,16,68,2,38,14,30,0.125,0.875,0.5588235294117647,0.4411764705882353
SF-D24,SF-C22,7,30,1,25,6,5,0.14285714285714285,0.8571428571428571,0.8333333333333334,0.16666666666666666
SF-D24,SF-B22,23,46,4,22,19,24,0.17391304347826086,0.8260869565217391,0.4782608695652174,0.5217391304347826
SF-D24,SF-J17,9,11,0,0,9,11,0.0,1.0,0.0,1.0
SF-D24,SF-I19,4,4,0,1,4,3,0.0,1.0,0.25,0.75
SF-D24,SF-I20,2,2,1,0,1,2,0.5,0.5,0.0,1.0
SF-D24,SF-H16,4,4,0,0,4,4,0.0,1.0,0.0,1.0
SF-D24,SF-G19,6,1,2,1,4,0,0.3333333333333333,0.6666666666666666,1.0,0.0
SF-D24,SF-G17,2,2,0,1,2,1,0.0,1.0,0.5,0.5
SF-D24,SF-G18,7,8,0,3,7,5,0.0,1.0,0.375,0.625
SF-D24,SF-G20,5,9,0,3,5,6,0.0,1.0,0.3333333333333333,0.6666666666666666
SF-D24,SF-F19,10,5,2,0,8,5,0.2,0.8,0.0,1.0
SF-D24,SF-E18,5,12,1,2,4,10,0.2,0.8,0.16666666666666666,0.8333333333333334
SF-D24,SF-E20,13,28,1,16,12,12,0.07692307692307693,0.9230769230769231,0.5714285714285714,0.42857142857142855
SF-D24,SF-G30-2,33,31,0,5,33,26,0.0,1.0,0.16129032258064516,0.8387096774193549
SF-D24,SF-F30-1,2,39,0,32,2,7,0.0,1.0,0.8205128205128205,0.1794871794871795
SF-D24,SF-E29-2,9,23,2,13,7,10,0.2222222222222222,0.7777777777777778,0.5652173913043478,0.43478260869565216
SF-D24,SF-E29-1,4,42,2,32,2,10,0.5,0.5,0.7619047619047619,0.23809523809523808
SF-D24,SF-D29,7,15,0,7,7,8,0.0,1.0,0.4666666666666667,0.5333333333333333
SF-D24,SF-D28,3,20,0,14,3,6,0.0,1.0,0.7,0.3
SF-D24,SF-G29-2,2,3,1,3,1,0,0.5,0.5,1.0,0.0
SF-D24,SF-G29-1,3,4,0,0,3,4,0.0,1.0,0.0,1.0
SF-D24,SF-G30-1,2,8,0,4,2,4,0.0,1.0,0.5,0.5
SF-D24,SF-F30-2,3,2,0,0,3,2,0.0,1.0,0.0,1.0
SF-D24,SF-E29-3,3,10,0,4,3,6,0.0,1.0,0.4,0.6
SF-D24,SF-F28-1,4,10,0,5,4,5,0.0,1.0,0.5,0.5
SF-D24,SF-E28-2,11,8,0,4,11,4,0.0,1.0,0.5,0.5
SF-D24,SF-E28,9,23,1,20,8,3,0.1111111111111111,0.8888888888888888,0.8695652173913043,0.13043478260869565
SF-D24,SF-J10,3,7,2,2,1,5,0.6666666666666666,0.3333333333333333,0.2857142857142857,0.7142857142857143
SF-D24,SF-J12,3,16,1,2,2,14,0.3333333333333333,0.6666666666666666,0.125,0.875
SF-D24,SF-J13,10,6,0,0,10,6,0.0,1.0,0.0,1.0
SF-D24,SF-I16,2,1,0,0,2,1,0.0,1.0,0.0,1.0
SF-D24,SF-H12,1,1,0,1,1,0,0.0,1.0,1.0,0.0
SF-D24,SF-H15,1,2,0,1,1,1,0.0,1.0,0.5,0.5
SF-D24,SF-G9,2,2,0,0,2,2,0.0,1.0,0.0,1.0
SF-D24,SF-G13,8,5,0,2,8,3,0.0,1.0,0.4,0.6
SF-D24,SF-G10-1,1,1,0,0,1,1,0.0,1.0,0.0,1.0
SF-D24,SF-F15,20,30,1,3,19,27,0.05,0.95,0.1,0.9
SF-D24,SF-F16,5,3,0,1,5,2,0.0,1.0,0.3333333333333333,0.6666666666666666
SF-D24,SF-C21,5,17,3,15,2,2,0.6,0.4,0.8823529411764706,0.11764705882352941
SF-D24,SF-C20,30,50,4,24,26,26,0.13333333333333333,0.8666666666666667,0.48,0.52
SF-D24,SF-B21,3,6,0,3,3,3,0.0,1.0,0.5,0.5
SF-D24,SF-B19,10,57,1,35,9,22,0.1,0.9,0.6140350877192983,0.38596491228070173
SF-D24,SF-A20,29,67,3,37,26,30,0.10344827586206896,0.896551724137931,0.5522388059701493,0.44776119402985076
SF-D24,SF-A19,2,8,0,3,2,5,0.0,1.0,0.375,0.625
SF-D24,SF-C26,4,21,1,11,3,10,0.25,0.75,0.5238095238095238,0.47619047619047616
SF-D24,SF-C25,14,32,2,14,12,18,0.14285714285714285,0.8571428571428571,0.4375,0.5625
SF-D24,SF-B25,5,15,1,8,4,7,0.2,0.8,0.5333333333333333,0.4666666666666667
SF-D24,SF-E27,7,10,1,7,6,3,0.14285714285714285,0.8571428571428571,0.7,0.3
SF-D24,SF-B28-2,2,1,2,0,0,1,1.0,0.0,0.0,1.0
SF-D24,SF-D27,3,10,2,1,1,9,0.6666666666666666,0.3333333333333333,0.1,0.9
SF-D24,SF-C28-2,2,5,0,3,2,2,0.0,1.0,0.6,0.4
SF-D24,SF-B28,7,6,1,3,6,3,0.14285714285714285,0.8571428571428571,0.5,0.5
SF-D24,SF-J1,3,6,1,1,2,5,0.3333333333333333,0.6666666666666666,0.16666666666666666,0.8333333333333334
SF-D24,SF-J5,1,3,0,0,1,3,0.0,1.0,0.0,1.0
SF-D24,SF-G8,2,1,0,0,2,1,0.0,1.0,0.0,1.0
SF-D24,SF-G5,28,16,0,0,28,16,0.0,1.0,0.0,1.0
SF-D24,SF-G7,10,6,0,0,10,6,0.0,1.0,0.0,1.0
SF-D24,SF-F9,2,2,0,0,2,2,0.0,1.0,0.0,1.0
SF-D24,SF-H25,1,4,0,3,1,1,0.0,1.0,0.75,0.25
SF-D24,SF-G26,6,6,0,4,6,2,0.0,1.0,0.6666666666666666,0.3333333333333333
SF-D24,SF-K21,4,5,1,1,3,4,0.25,0.75,0.2,0.8
SF-D24,SF-K22-1,3,1,2,0,1,1,0.6666666666666666,0.3333333333333333,0.0,1.0
SF-D24,SF-J23-1,39,13,20,7,19,6,0.5128205128205128,0.48717948717948717,0.5384615384615384,0.46153846153846156
SF-D24,SF-J22-1,5,2,0,2,5,0,0.0,1.0,1.0,0.0
SF-D24,SF-J22-2,5,11,0,2,5,9,0.0,1.0,0.18181818181818182,0.8181818181818182
SF-D24,SF-J21,14,15,0,9,14,6,0.0,1.0,0.6,0.4
SF-D24,SF-I22,5,1,0,1,5,0,0.0,1.0,1.0,0.0
SF-D24,SF-I23-2,18,34,4,21,14,13,0.2222222222222222,0.7777777777777778,0.6176470588235294,0.38235294117647056
SF-D24,SF-I24,8,11,4,3,4,8,0.5,0.5,0.2727272727272727,0.7272727272727273
SF-D24,SF-I23-1,13,11,1,7,12,4,0.07692307692307693,0.9230769230769231,0.6363636363636364,0.36363636363636365
SF-D24,SF-F26,12,25,3,13,9,12,0.25,0.75,0.52,0.48
SF-D24,SF-M13,3,7,0,0,3,7,0.0,1.0,0.0,1.0
SF-D24,SF-M15,4,3,0,0,4,3,0.0,1.0,0.0,1.0
SF-D24,SF-L19,8,5,1,0,7,5,0.125,0.875,0.0,1.0
SF-D24,SF-L20,1,13,0,5,1,8,0.0,1.0,0.38461538461538464,0.6153846153846154
SF-D24,SF-N20-1,2,5,1,4,1,1,0.5,0.5,0.8,0.2
SF-D24,SF-M20,6,11,0,0,6,11,0.0,1.0,0.0,1.0
SF-D24,SF-K17-2,5,9,0,0,5,9,0.0,1.0,0.0,1.0
SF-D24,SF-K20,6,7,0,3,6,4,0.0,1.0,0.42857142857142855,0.5714285714285714
SF-D24,SF-K15-,7,11,2,3,5,8,0.2857142857142857,0.7142857142857143,0.2727272727272727,0.7272727272727273
SF-D24,SF-K19,2,7,0,1,2,6,0.0,1.0,0.14285714285714285,0.8571428571428571
SF-D24,SF-K18,9,5,0,0,9,5,0.0,1.0,0.0,1.0
SF-D24,SF-K17,19,22,2,2,17,20,0.10526315789473684,0.8947368421052632,0.09090909090909091,0.9090909090909091
SF-D24,SF-J16,7,3,1,1,6,2,0.14285714285714285,0.8571428571428571,0.3333333333333333,0.6666666666666666
SF-D24,SF-J18,10,6,2,1,8,5,0.2,0.8,0.16666666666666666,0.8333333333333334
SF-D24,SF-J20,3,1,0,1,3,0,0.0,1.0,1.0,0.0
SF-D24,SF-J19,24,27,1,4,23,23,0.041666666666666664,0.9583333333333334,0.14814814814814814,0.8518518518518519
SF-D24,SF-M12,10,14,0,0,10,14,0.0,1.0,0.0,1.0
SF-D24,SF-M10,6,2,1,1,5,1,0.16666666666666666,0.8333333333333334,0.5,0.5
SF-D24,SF-M11,27,18,0,0,27,18,0.0,1.0,0.0,1.0
SF-D24,SF-R19,1,2,0,0,1,2,0.0,1.0,0.0,1.0
SF-D24,SF-R20,1,1,1,0,0,1,1.0,0.0,0.0,1.0
SF-D24,SF-Q21-2,2,3,0,0,2,3,0.0,1.0,0.0,1.0
SF-D24,SF-O18,2,2,0,1,2,1,0.0,1.0,0.5,0.5
SF-D24,SF-O19,4,8,2,2,2,6,0.5,0.5,0.25,0.75
SF-D24,SF-O21,9,7,0,1,9,6,0.0,1.0,0.14285714285714285,0.8571428571428571
SF-D24,SF-O22,12,5,2,1,10,4,0.16666666666666666,0.8333333333333334,0.2,0.8
SF-D24,SF-N21,2,2,0,0,2,2,0.0,1.0,0.0,1.0
SF-D24,SF-M21,2,4,0,2,2,2,0.0,1.0,0.5,0.5
SF-D24,SF-L21,5,8,0,3,5,5,0.0,1.0,0.375,0.625
SF-D24,SF-P30,7,15,0,0,7,15,0.0,1.0,0.0,1.0
SF-D24,SF-O30-2,1,4,1,0,0,4,1.0,0.0,0.0,1.0
SF-D24,SF-N29,1,1,0,0,1,1,0.0,1.0,0.0,1.0
SF-D24,SF-L30-1,2,37,0,27,2,10,0.0,1.0,0.7297297297297297,0.2702702702702703
SF-D24,SF-I30,2,19,0,4,2,15,0.0,1.0,0.21052631578947367,0.7894736842105263
SF-D24,SF-I29-2,1,5,0,4,1,1,0.0,1.0,0.8,0.2
SF-D24,SF-I27,1,2,0,2,1,0,0.0,1.0,1.0,0.0
SF-D24,SF I29-1,2,14,0,1,2,13,0.0,1.0,0.07142857142857142,0.9285714285714286
SF-D24,SF-R24,1,1,0,0,1,1,0.0,1.0,0.0,1.0
SF-D24,SF-Q26,2,1,0,0,2,1,0.0,1.0,0.0,1.0
SF-D24,SF-P26,2,2,0,0,2,2,0.0,1.0,0.0,1.0
SF-D24,SF-T22,1,1,0,1,1,0,0.0,1.0,1.0,0.0
SF-D24,SF-S22-1,2,5,1,2,1,3,0.5,0.5,0.4,0.6
SF-D24,SF-Q23-3,2,3,0,2,2,1,0.0,1.0,0.6666666666666666,0.3333333333333333
SF-D24,SF-Q22-2,2,1,0,0,2,1,0.0,1.0,0.0,1.0
SF-D24,SF-P22,1,1,0,0,1,1,0.0,1.0,0.0,1.0
SF-D24,SF-V29,1,10,0,0,1,10,0.0,1.0,0.0,1.0
SF-C22,SF-M25,3,4,1,3,2,1,0.3333333333333333,0.6666666666666666,0.75,0.25
SF-C22,SF-M26-2,7,5,2,2,5,3,0.2857142857142857,0.7142857142857143,0.4,0.6
SF-C22,SF-J29,4,5,2,0,2,5,0.5,0.5,0.0,1.0
SF-C22,SF-M28,4,1,0,0,4,1,0.0,1.0,0.0,1.0
SF-C22,SF-L25,12,6,0,2,12,4,0.0,1.0,0.3333333333333333,0.6666666666666666
SF-C22,SF-N23,51,93,0,0,51,93,0.0,1.0,0.0,1.0
SF-C22,SF-N24-2,37,5,0,0,37,5,0.0,1.0,0.0,1.0
SF-C22,SF-K27-2,1,1,0,0,1,1,0.0,1.0,0.0,1.0
SF-C22,SF-J26-2,5,4,0,1,5,3,0.0,1.0,0.25,0.75
SF-C22,SF-L28,3,1,3,0,0,1,1.0,0.0,0.0,1.0
SF-C22,SF-K29-1,40,29,1,23,39,6,0.025,0.975,0.7931034482758621,0.20689655172413793
SF-C22,SF-J28-2,2,2,2,0,0,2,1.0,0.0,0.0,1.0
SF-C22,SF-K27,3,3,2,0,1,3,0.6666666666666666,0.3333333333333333,0.0,1.0
SF-C22,SF-K25,6,2,0,0,6,2,0.0,1.0,0.0,1.0
SF-C22,SF-J25,4,4,2,2,2,2,0.5,0.5,0.5,0.5
SF-C22,SF-H26-2,4,3,2,0,2,3,0.5,0.5,0.0,1.0
SF-C22,SF-J24,7,7,1,3,6,4,0.14285714285714285,0.8571428571428571,0.42857142857142855,0.5714285714285714
SF-C22,SF-I25,13,6,6,2,7,4,0.46153846153846156,0.5384615384615384,0.3333333333333333,0.6666666666666666
SF-C22,SF-K23,3,3,0,0,3,3,0.0,1.0,0.0,1.0
SF-C22,SF-H26,6,6,4,2,2,4,0.6666666666666666,0.3333333333333333,0.3333333333333333,0.6666666666666666
SF-C22,SF-O23,7,3,0,0,7,3,0.0,1.0,0.0,1.0
SF-C22,SF-H27-1,1,3,0,1,1,2,0.0,1.0,0.3333333333333333,0.6666666666666666
SF-C22,SF-F28-2,6,1,0,1,6,0,0.0,1.0,1.0,0.0
SF-C22,SF-G27,7,15,1,1,6,14,0.14285714285714285,0.8571428571428571,0.06666666666666667,0.9333333333333333
SF-C22,SF-M22-2,11,4,1,0,10,4,0.09090909090909091,0.9090909090909091,0.0,1.0
SF-C22,SF-L22,13,10,3,1,10,9,0.23076923076923078,0.7692307692307693,0.1,0.9
SF-C22,SF-F27,11,6,2,2,9,4,0.18181818181818182,0.8181818181818182,0.3333333333333333,0.6666666666666666
SF-C22,SF-N22-2,6,10,1,2,5,8,0.16666666666666666,0.8333333333333334,0.2,0.8
SF-C22,SF-G28-2,19,36,0,1,19,35,0.0,1.0,0.027777777777777776,0.9722222222222222
SF-C22,SF-G28-1,1,1,0,0,1,1,0.0,1.0,0.0,1.0
SF-C22,SF-M22-1,2,2,1,1,1,1,0.5,0.5,0.5,0.5
SF-C22,SF-O25-1,1,1,1,1,0,0,1.0,0.0,1.0,0.0
SF-C22,SF-K22-2,8,20,1,4,7,16,0.125,0.875,0.2,0.8
SF-C22,SF-K24,6,6,0,1,6,5,0.0,1.0,0.16666666666666666,0.8333333333333334
SF-C22,SF-J23-2,8,3,2,3,6,0,0.25,0.75,1.0,0.0
SF-C22,SF-G23,33,10,21,5,12,5,0.6363636363636364,0.36363636363636365,0.5,0.5
SF-C22,SF-G24,36,32,9,5,27,27,0.25,0.75,0.15625,0.84375
SF-C22,SF-G25,11,17,3,3,8,14,0.2727272727272727,0.7272727272727273,0.17647058823529413,0.8235294117647058
SF-C22,SF-F23,32,29,13,15,19,14,0.40625,0.59375,0.5172413793103449,0.4827586206896552
SF-C22,SF-E23,63,55,39,15,24,40,0.6190476190476191,0.38095238095238093,0.2727272727272727,0.7272727272727273
SF-C22,SF-D24,30,7,25,1,5,6,0.8333333333333334,0.16666666666666666,0.14285714285714285,0.8571428571428571
SF-C22,SF-B22,34,51,17,38,17,13,0.5,0.5,0.7450980392156863,0.2549019607843137
SF-C22,SF-J17,6,8,0,0,6,8,0.0,1.0,0.0,1.0
SF-C22,SF-I19,3,4,0,0,3,4,0.0,1.0,0.0,1.0
SF-C22,SF-I20,3,5,0,1,3,4,0.0,1.0,0.2,0.8
SF-C22,SF-H20,5,2,0,1,5,1,0.0,1.0,0.5,0.5
SF-C22,SF-H18,1,2,1,1,0,1,1.0,0.0,0.5,0.5
SF-C22,SF-G19,9,11,1,5,8,6,0.1111111111111111,0.8888888888888888,0.45454545454545453,0.5454545454545454
SF-C22,SF-G17,7,1,0,0,7,1,0.0,1.0,0.0,1.0
SF-C22,SF-G18,8,7,2,0,6,7,0.25,0.75,0.0,1.0
SF-C22,SF-G20,6,10,0,1,6,9,0.0,1.0,0.1,0.9
SF-C22,SF-F19,15,10,2,3,13,7,0.13333333333333333,0.8666666666666667,0.3,0.7
SF-C22,SF-E18,18,10,1,2,17,8,0.05555555555555555,0.9444444444444444,0.2,0.8
SF-C22,SF-E20,15,19,5,6,10,13,0.3333333333333333,0.6666666666666666,0.3157894736842105,0.6842105263157895
SF-C22,SF-H30,3,3,1,2,2,1,0.3333333333333333,0.6666666666666666,0.6666666666666666,0.3333333333333333
SF-C22,SF-G30-2,11,8,1,1,10,7,0.09090909090909091,0.9090909090909091,0.125,0.875
SF-C22,SF-F30-1,7,3,0,1,7,2,0.0,1.0,0.3333333333333333,0.6666666666666666
SF-C22,SF-E29-2,16,98,6,11,10,87,0.375,0.625,0.11224489795918367,0.8877551020408163
SF-C22,SF-E29-1,16,14,4,5,12,9,0.25,0.75,0.35714285714285715,0.6428571428571429
SF-C22,SF-D29,13,14,0,7,13,7,0.0,1.0,0.5,0.5
SF-C22,SF-D28,14,12,1,3,13,9,0.07142857142857142,0.9285714285714286,0.25,0.75
SF-C22,SF-A27,11,33,2,11,9,22,0.18181818181818182,0.8181818181818182,0.3333333333333333,0.6666666666666666
SF-C22,SF-G29-2,3,5,0,1,3,4,0.0,1.0,0.2,0.8
SF-C22,SF-G29-1,20,20,1,2,19,18,0.05,0.95,0.1,0.9
SF-C22,SF-G30-1,8,9,2,7,6,2,0.25,0.75,0.7777777777777778,0.2222222222222222
SF-C22,SF-G29-3,3,6,0,2,3,4,0.0,1.0,0.3333333333333333,0.6666666666666666
SF-C22,SF-F30-2,7,4,3,1,4,3,0.42857142857142855,0.5714285714285714,0.25,0.75
SF-C22,SF-F29,8,1,1,1,7,0,0.125,0.875,1.0,0.0
SF-C22,SF-E29-3,7,9,1,3,6,6,0.14285714285714285,0.8571428571428571,0.3333333333333333,0.6666666666666666
SF-C22,SF-F28-1,3,4,2,2,1,2,0.6666666666666666,0.3333333333333333,0.5,0.5
SF-C22,SF-E28-2,8,1,6,0,2,1,0.75,0.25,0.0,1.0
SF-C22,SF-E28,5,5,2,0,3,5,0.4,0.6,0.0,1.0
SF-C22,SF-J10,6,4,1,0,5,4,0.16666666666666666,0.8333333333333334,0.0,1.0
SF-C22,SF-J12,6,15,2,1,4,14,0.3333333333333333,0.6666666666666666,0.06666666666666667,0.9333333333333333
SF-C22,SF-J13,4,4,1,0,3,4,0.25,0.75,0.0,1.0
SF-C22,SF-H13,1,1,0,0,1,1,0.0,1.0,0.0,1.0
SF-C22,SF-I16,6,4,1,0,5,4,0.16666666666666666,0.8333333333333334,0.0,1.0
SF-C22,SF-H12,6,4,0,0,6,4,0.0,1.0,0.0,1.0
SF-C22,SF-G10-2,2,1,0,0,2,1,0.0,1.0,0.0,1.0
SF-C22,SF-G9,1,1,0,0,1,1,0.0,1.0,0.0,1.0
SF-C22,SF-H14,2,5,0,0,2,5,0.0,1.0,0.0,1.0
SF-C22,SF-G13,14,6,3,1,11,5,0.21428571428571427,0.7857142857142857,0.16666666666666666,0.8333333333333334
SF-C22,SF-G11,3,2,0,0,3,2,0.0,1.0,0.0,1.0
SF-C22,SF-G12,3,4,0,0,3,4,0.0,1.0,0.0,1.0
SF-C22,SF-F15,8,6,3,0,5,6,0.375,0.625,0.0,1.0
SF-C22,SF-F16,15,18,1,2,14,16,0.06666666666666667,0.9333333333333333,0.1111111111111111,0.8888888888888888
SF-C22,SF-C21,48,36,12,23,36,13,0.25,0.75,0.6388888888888888,0.3611111111111111
SF-C22,SF-C20,40,50,14,36,26,14,0.35,0.65,0.72,0.28
SF-C22,SF-B21,9,7,6,4,3,3,0.6666666666666666,0.3333333333333333,0.5714285714285714,0.42857142857142855
SF-C22,SF-B19,44,74,17,49,27,25,0.38636363636363635,0.6136363636363636,0.6621621621621622,0.33783783783783783
SF-C22,SF-A20,67,65,13,40,54,25,0.19402985074626866,0.8059701492537313,0.6153846153846154,0.38461538461538464
SF-C22,SF-A19,6,16,2,13,4,3,0.3333333333333333,0.6666666666666666,0.8125,0.1875
SF-C22,SF-C26,10,5,1,0,9,5,0.1,0.9,0.0,1.0
SF-C22,SF-C25,22,24,0,7,22,17,0.0,1.0,0.2916666666666667,0.7083333333333334
SF-C22,SF-B25,16,31,10,16,6,15,0.625,0.375,0.5161290322580645,0.4838709677419355
SF-C22,SF-E27,1,21,1,1,0,20,1.0,0.0,0.047619047619047616,0.9523809523809523
SF-C22,SF-B28-2,3,9,1,2,2,7,0.3333333333333333,0.6666666666666666,0.2222222222222222,0.7777777777777778
SF-C22,SF-D27,11,3,2,2,9,1,0.18181818181818182,0.8181818181818182,0.6666666666666666,0.3333333333333333
SF-C22,SF-C28-2,1,1,1,0,0,1,1.0,0.0,0.0,1.0
SF-C22,SF-B28,14,7,10,7,4,0,0.7142857142857143,0.2857142857142857,1.0,0.0
SF-C22,SF-J1,1,8,0,3,1,5,0.0,1.0,0.375,0.625
SF-C22,SF-H0,1,1,0,0,1,1,0.0,1.0,0.0,1.0
SF-C22,SF-G8,6,2,0,0,6,2,0.0,1.0,0.0,1.0
SF-C22,SF-G5,2,10,1,1,1,9,0.5,0.5,0.1,0.9
SF-C22,SF-G7,2,5,0,0,2,5,0.0,1.0,0.0,1.0
SF-C22,SF-G26,11,6,1,0,10,6,0.09090909090909091,0.9090909090909091,0.0,1.0
SF-C22,SF-K21,10,6,1,0,9,6,0.1,0.9,0.0,1.0
SF-C22,SF-K22-1,10,14,2,4,8,10,0.2,0.8,0.2857142857142857,0.7142857142857143
SF-C22,SF-J23-1,29,11,6,1,23,10,0.20689655172413793,0.7931034482758621,0.09090909090909091,0.9090909090909091
SF-C22,SF-J22-1,10,10,1,4,9,6,0.1,0.9,0.4,0.6
SF-C22,SF-J22-2,12,14,4,1,8,13,0.3333333333333333,0.6666666666666666,0.07142857142857142,0.9285714285714286
SF-C22,SF-J21,9,21,5,3,4,18,0.5555555555555556,0.4444444444444444,0.14285714285714285,0.8571428571428571
SF-C22,SF-I21,4,4,1,2,3,2,0.25,0.75,0.5,0.5
SF-C22,SF-I22,7,3,2,2,5,1,0.2857142857142857,0.7142857142857143,0.6666666666666666,0.3333333333333333
SF-C22,SF-I23-2,23,25,6,10,17,15,0.2608695652173913,0.7391304347826086,0.4,0.6
SF-C22,SF-I24,8,3,1,1,7,2,0.125,0.875,0.3333333333333333,0.6666666666666666
SF-C22,SF-I23-1,9,4,1,0,8,4,0.1111111111111111,0.8888888888888888,0.0,1.0
SF-C22,SF-F26,32,15,5,4,27,11,0.15625,0.84375,0.26666666666666666,0.7333333333333333
SF-C22,SF-M13,1,1,0,0,1,1,0.0,1.0,0.0,1.0
SF-C22,SF-M15,9,14,2,2,7,12,0.2222222222222222,0.7777777777777778,0.14285714285714285,0.8571428571428571
SF-C22,SF-L19,7,4,0,1,7,3,0.0,1.0,0.25,0.75
SF-C22,SF-L20,7,5,0,2,7,3,0.0,1.0,0.4,0.6
SF-C22,SF-N20-1,8,5,1,0,7,5,0.125,0.875,0.0,1.0
SF-C22,SF-M20,6,6,0,1,6,5,0.0,1.0,0.16666666666666666,0.8333333333333334
SF-C22,SF-K20,6,12,0,1,6,11,0.0,1.0,0.08333333333333333,0.9166666666666666
SF-C22,SF-K15-,17,13,1,0,16,13,0.058823529411764705,0.9411764705882353,0.0,1.0
SF-C22,SF-K19,4,9,0,1,4,8,0.0,1.0,0.1111111111111111,0.8888888888888888
SF-C22,SF-K18,7,6,1,1,6,5,0.14285714285714285,0.8571428571428571,0.16666666666666666,0.8333333333333334
SF-C22,SF-K17,15,11,0,0,15,11,0.0,1.0,0.0,1.0
SF-C22,SF-J16,9,9,0,1,9,8,0.0,1.0,0.1111111111111111,0.8888888888888888
SF-C22,SF-J18,14,5,1,0,13,5,0.07142857142857142,0.9285714285714286,0.0,1.0
SF-C22,SF-J20,2,1,0,0,2,1,0.0,1.0,0.0,1.0
SF-C22,SF-J19,44,29,4,9,40,20,0.09090909090909091,0.9090909090909091,0.3103448275862069,0.6896551724137931
SF-C22,SF-M12,2,2,1,0,1,2,0.5,0.5,0.0,1.0
SF-C22,SF-M10,1,1,0,0,1,1,0.0,1.0,0.0,1.0
SF-C22,SF-M11,3,1,1,0,2,1,0.3333333333333333,0.6666666666666666,0.0,1.0
SF-C22,SF-R19,3,2,2,2,1,0,0.6666666666666666,0.3333333333333333,1.0,0.0
SF-C22,SF-Q21-1,2,5,0,1,2,4,0.0,1.0,0.2,0.8
SF-C22,SF-P21,3,9,0,1,3,8,0.0,1.0,0.1111111111111111,0.8888888888888888
SF-C22,SF-O18,4,6,0,0,4,6,0.0,1.0,0.0,1.0
SF-C22,SF-O19,5,3,0,0,5,3,0.0,1.0,0.0,1.0
SF-C22,SF-O21,11,22,0,2,11,20,0.0,1.0,0.09090909090909091,0.9090909090909091
SF-C22,SF-O22,11,25,0,2,11,23,0.0,1.0,0.08,0.92
SF-C22,SF-N21,4,2,0,2,4,0,0.0,1.0,1.0,0.0
SF-C22,SF-N20-2,3,2,0,0,3,2,0.0,1.0,0.0,1.0
SF-C22,SF-M21,3,2,1,1,2,1,0.3333333333333333,0.6666666666666666,0.5,0.5
SF-C22,SF-L21,8,9,0,1,8,8,0.0,1.0,0.1111111111111111,0.8888888888888888
SF-C22,SF-Q30,2,1,0,0,2,1,0.0,1.0,0.0,1.0
SF-C22,SF-O30-2,1,2,1,2,0,0,1.0,0.0,1.0,0.0
SF-C22,SF-N27,1,3,0,1,1,2,0.0,1.0,0.3333333333333333,0.6666666666666666
SF-C22,SF-N28,4,2,0,0,4,2,0.0,1.0,0.0,1.0
SF-C22,SF-L30-1,4,6,0,1,4,5,0.0,1.0,0.16666666666666666,0.8333333333333334
SF-C22,SF-L31-1,4,3,0,0,4,3,0.0,1.0,0.0,1.0
SF-C22,SF-K30-2,2,1,1,1,1,0,0.5,0.5,1.0,0.0
SF-C22,SF-L29,2,3,0,0,2,3,0.0,1.0,0.0,1.0
SF-C22,SF-J29-1,2,2,0,2,2,0,0.0,1.0,1.0,0.0
SF-C22,SF-I30,1,3,1,1,0,2,1.0,0.0,0.3333333333333333,0.6666666666666666
SF-C22,SF-I29-2,1,1,1,1,0,0,1.0,0.0,1.0,0.0
SF-C22,SF-I27,1,2,1,1,0,1,1.0,0.0,0.5,0.5
SF-C22,SF-H28,5,2,1,0,4,2,0.2,0.8,0.0,1.0
SF-C22,SF-S24,2,1,1,1,1,0,0.5,0.5,1.0,0.0
SF-C22,SF-R24,3,2,0,0,3,2,0.0,1.0,0.0,1.0
SF-C22,SF-R26,1,1,0,0,1,1,0.0,1.0,0.0,1.0
SF-C22,SF-Q26,2,2,1,0,1,2,0.5,0.5,0.0,1.0
SF-C22,SF-P26,2,3,0,0,2,3,0.0,1.0,0.0,1.0
SF-C22,SF-O25-2,1,1,1,0,0,1,1.0,0.0,0.0,1.0
SF-C22,SF-N25,4,1,1,1,3,0,0.25,0.75,1.0,0.0
SF-C22,SF-T22,1,2,0,1,1,1,0.0,1.0,0.5,0.5
SF-C22,SF-S22-1,2,4,0,0,2,4,0.0,1.0,0.0,1.0
SF-C22,SF-Q23-3,5,5,0,0,5,5,0.0,1.0,0.0,1.0
SF-C22,SF-Q22-1,4,17,1,0,3,17,0.25,0.75,0.0,1.0
SF-C22,SF-Q22-2,17,18,1,0,16,18,0.058823529411764705,0.9411764705882353,0.0,1.0
SF-C22,SF-P22,7,10,3,3,4,7,0.42857142857142855,0.5714285714285714,0.3,0.7
SF-C22,SF-W19,2,3,0,2,2,1,0.0,1.0,0.6666666666666666,0.3333333333333333
SF-C22,SF-U21,1,1,0,1,1,0,0.0,1.0,1.0,0.0
SF-B22,SF-M25,2,2,1,2,1,0,0.5,0.5,1.0,0.0
SF-B22,SF-M26-2,2,2,2,0,0,2,1.0,0.0,0.0,1.0
SF-B22,SF-J27,2,3,2,1,0,2,1.0,0.0,0.3333333333333333,0.6666666666666666
SF-B22,SF-M30,6,7,1,6,5,1,0.16666666666666666,0.8333333333333334,0.8571428571428571,0.14285714285714285
SF-B22,SF-J29-3,5,5,3,1,2,4,0.6,0.4,0.2,0.8
SF-B22,SF-J29,8,14,2,3,6,11,0.25,0.75,0.21428571428571427,0.7857142857142857
SF-B22,SF-L26,1,3,0,1,1,2,0.0,1.0,0.3333333333333333,0.6666666666666666
SF-B22,SF-M28,2,2,2,0,0,2,1.0,0.0,0.0,1.0
SF-B22,SF-L25,59,105,2,0,57,105,0.03389830508474576,0.9661016949152542,0.0,1.0
SF-B22,SF-M24,4,6,2,0,2,6,0.5,0.5,0.0,1.0
SF-B22,SF-N23,7,2,3,0,4,2,0.42857142857142855,0.5714285714285714,0.0,1.0
SF-B22,SF-N24-2,2,2,1,1,1,1,0.5,0.5,0.5,0.5
SF-B22,SF-K27-2,4,1,4,1,0,0,1.0,0.0,1.0,0.0
SF-B22,SF-J26-2,6,2,4,2,2,0,0.6666666666666666,0.3333333333333333,1.0,0.0
SF-B22,SF-K29-1,28,11,19,7,9,4,0.6785714285714286,0.32142857142857145,0.6363636363636364,0.36363636363636365
SF-B22,SF-K27,1,1,1,0,0,1,1.0,0.0,0.0,1.0
SF-B22,SF-K25,12,2,7,0,5,2,0.5833333333333334,0.4166666666666667,0.0,1.0
SF-B22,SF-J25,33,12,10,1,23,11,0.30303030303030304,0.696969696969697,0.08333333333333333,0.9166666666666666
SF-B22,SF-H26-2,10,5,8,3,2,2,0.8,0.2,0.6,0.4
SF-B22,SF-J24,2,6,0,1,2,5,0.0,1.0,0.16666666666666666,0.8333333333333334
SF-B22,SF-O24,4,11,2,0,2,11,0.5,0.5,0.0,1.0
SF-B22,SF-J26,1,2,1,1,0,1,1.0,0.0,0.5,0.5
SF-B22,SF-I26-,2,3,2,0,0,3,1.0,0.0,0.0,1.0
SF-B22,SF-I25,9,7,6,4,3,3,0.6666666666666666,0.3333333333333333,0.5714285714285714,0.42857142857142855
SF-B22,SF-H26,29,5,20,2,9,3,0.6896551724137931,0.3103448275862069,0.4,0.6
SF-B22,SF-H27-1,7,6,5,1,2,5,0.7142857142857143,0.2857142857142857,0.16666666666666666,0.8333333333333334
SF-B22,SF-F28-2,40,76,13,8,27,68,0.325,0.675,0.10526315789473684,0.8947368421052632
SF-B22,SF-G27,42,11,23,2,19,9,0.5476190476190477,0.4523809523809524,0.18181818181818182,0.8181818181818182
SF-B22,SF-M22-2,6,12,1,3,5,9,0.16666666666666666,0.8333333333333334,0.25,0.75
SF-B22,SF-L22,10,6,4,1,6,5,0.4,0.6,0.16666666666666666,0.8333333333333334
SF-B22,SF-F27,33,12,9,2,24,10,0.2727272727272727,0.7272727272727273,0.16666666666666666,0.8333333333333334
SF-B22,SF-N22-2,8,14,1,2,7,12,0.125,0.875,0.14285714285714285,0.8571428571428571
SF-B22,SF-G28-2,5,2,1,0,4,2,0.2,0.8,0.0,1.0
SF-B22,SF-G28-1,6,1,5,0,1,1,0.8333333333333334,0.16666666666666666,0.0,1.0
SF-B22,SF-K22-2,8,1,4,0,4,1,0.5,0.5,0.0,1.0
SF-B22,SF-K24,21,11,3,3,18,8,0.14285714285714285,0.8571428571428571,0.2727272727272727,0.7272727272727273
SF-B22,SF-J23-2,11,8,6,4,5,4,0.5454545454545454,0.45454545454545453,0.5,0.5
SF-B22,SF-G23,15,12,3,3,12,9,0.2,0.8,0.25,0.75
SF-B22,SF-G24,31,35,14,17,17,18,0.45161290322580644,0.5483870967741935,0.4857142857142857,0.5142857142857142
SF-B22,SF-G25,13,14,3,0,10,14,0.23076923076923078,0.7692307692307693,0.0,1.0
SF-B22,SF-F23,43,31,13,10,30,21,0.3023255813953488,0.6976744186046512,0.3225806451612903,0.6774193548387096
SF-B22,SF-E23,145,104,100,64,45,40,0.6896551724137931,0.3103448275862069,0.6153846153846154,0.38461538461538464
SF-B22,SF-D24,46,23,22,4,24,19,0.4782608695652174,0.5217391304347826,0.17391304347826086,0.8260869565217391
SF-B22,SF-C22,51,34,38,17,13,17,0.7450980392156863,0.2549019607843137,0.5,0.5
SF-B22,SF-J17,5,3,1,0,4,3,0.2,0.8,0.0,1.0
SF-B22,SF-I19,7,2,2,1,5,1,0.2857142857142857,0.7142857142857143,0.5,0.5
SF-B22,SF-I20,10,1,0,1,10,0,0.0,1.0,1.0,0.0
SF-B22,SF-H20,6,6,4,1,2,5,0.6666666666666666,0.3333333333333333,0.16666666666666666,0.8333333333333334
SF-B22,SF-H17,3,3,0,0,3,3,0.0,1.0,0.0,1.0
SF-B22,SF-G19,5,7,1,6,4,1,0.2,0.8,0.8571428571428571,0.14285714285714285
SF-B22,SF-G17,5,4,5,2,0,2,1.0,0.0,0.5,0.5
SF-B22,SF-G18,8,2,2,1,6,1,0.25,0.75,0.5,0.5
SF-B22,SF-G20,7,16,0,5,7,11,0.0,1.0,0.3125,0.6875
SF-B22,SF-F19,11,12,2,2,9,10,0.18181818181818182,0.8181818181818182,0.16666666666666666,0.8333333333333334
SF-B22,SF-E18,11,11,1,5,10,6,0.09090909090909091,0.9090909090909091,0.45454545454545453,0.5454545454545454
SF-B22,SF-E20,10,16,4,2,6,14,0.4,0.6,0.125,0.875
SF-B22,SF-H30,31,6,26,2,5,4,0.8387096774193549,0.16129032258064516,0.3333333333333333,0.6666666666666666
SF-B22,SF-G30-2,70,45,28,13,42,32,0.4,0.6,0.28888888888888886,0.7111111111111111
SF-B22,SF-F30-1,18,5,15,1,3,4,0.8333333333333334,0.16666666666666666,0.2,0.8
SF-B22,SF-E29-2,52,25,29,6,23,19,0.5576923076923077,0.4423076923076923,0.24,0.76
SF-B22,SF-E29-1,87,70,61,45,26,25,0.7011494252873564,0.2988505747126437,0.6428571428571429,0.35714285714285715
SF-B22,SF-D29,151,42,125,19,26,23,0.8278145695364238,0.17218543046357615,0.4523809523809524,0.5476190476190477
SF-B22,SF-D28,30,27,24,18,6,9,0.8,0.2,0.6666666666666666,0.3333333333333333
SF-B22,SF-A27,108,131,54,86,54,45,0.5,0.5,0.6564885496183206,0.3435114503816794
SF-B22,SF-G29-2,30,2,17,1,13,1,0.5666666666666667,0.43333333333333335,0.5,0.5
SF-B22,SF-G29-1,6,7,1,0,5,7,0.16666666666666666,0.8333333333333334,0.0,1.0
SF-B22,SF-G30-1,30,9,23,3,7,6,0.7666666666666667,0.23333333333333334,0.3333333333333333,0.6666666666666666
SF-B22,SF-G29-3,9,4,6,1,3,3,0.6666666666666666,0.3333333333333333,0.25,0.75
SF-B22,SF-F30-2,37,6,24,1,13,5,0.6486486486486487,0.35135135135135137,0.16666666666666666,0.8333333333333334
SF-B22,SF-F29,13,5,11,1,2,4,0.8461538461538461,0.15384615384615385,0.2,0.8
SF-B22,SF-E29-3,16,5,12,3,4,2,0.75,0.25,0.6,0.4
SF-B22,SF-F28-1,15,14,12,6,3,8,0.8,0.2,0.42857142857142855,0.5714285714285714
SF-B22,SF-E28-2,14,16,9,4,5,12,0.6428571428571429,0.35714285714285715,0.25,0.75
SF-B22,SF-E28,24,9,17,3,7,6,0.7083333333333334,0.2916666666666667,0.3333333333333333,0.6666666666666666
SF-B22,SF-J10,9,13,0,0,9,13,0.0,1.0,0.0,1.0
SF-B22,SF-J12,5,5,0,1,5,4,0.0,1.0,0.2,0.8
SF-B22,SF-J13,5,10,2,6,3,4,0.4,0.6,0.6,0.4
SF-B22,SF-J15,2,3,0,3,2,0,0.0,1.0,1.0,0.0
SF-B22,SF-H13,3,3,0,1,3,2,0.0,1.0,0.3333333333333333,0.6666666666666666
SF-B22,SF-H12,4,1,0,0,4,1,0.0,1.0,0.0,1.0
SF-B22,SF-G9,3,1,1,0,2,1,0.3333333333333333,0.6666666666666666,0.0,1.0
SF-B22,SF-G13,13,1,3,0,10,1,0.23076923076923078,0.7692307692307693,0.0,1.0
SF-B22,SF-G11,1,2,0,0,1,2,0.0,1.0,0.0,1.0
SF-B22,SF-G12,5,3,0,0,5,3,0.0,1.0,0.0,1.0
SF-B22,SF-G10-1,2,6,0,3,2,3,0.0,1.0,0.5,0.5
SF-B22,SF-F15,5,10,2,3,3,7,0.4,0.6,0.3,0.7
SF-B22,SF-F16,8,4,4,1,4,3,0.5,0.5,0.25,0.75
SF-B22,SF-C21,7,9,6,2,1,7,0.8571428571428571,0.14285714285714285,0.2222222222222222,0.7777777777777778
SF-B22,SF-C20,41,48,6,25,35,23,0.14634146341463414,0.8536585365853658,0.5208333333333334,0.4791666666666667
SF-B22,SF-B21,15,16,9,14,6,2,0.6,0.4,0.875,0.125
SF-B22,SF-B19,111,137,43,100,68,37,0.38738738738738737,0.6126126126126126,0.7299270072992701,0.27007299270072993
SF-B22,SF-A20,88,131,32,94,56,37,0.36363636363636365,0.6363636363636364,0.7175572519083969,0.2824427480916031
SF-B22,SF-A19,45,35,24,25,21,10,0.5333333333333333,0.4666666666666667,0.7142857142857143,0.2857142857142857
SF-B22,SF-C26,18,10,5,6,13,4,0.2777777777777778,0.7222222222222222,0.6,0.4
SF-B22,SF-C25,81,82,34,22,47,60,0.41975308641975306,0.5802469135802469,0.2682926829268293,0.7317073170731707
SF-B22,SF-B25,47,89,21,48,26,41,0.44680851063829785,0.5531914893617021,0.5393258426966292,0.4606741573033708
SF-B22,SF-E27,20,21,6,6,14,15,0.3,0.7,0.2857142857142857,0.7142857142857143
SF-B22,SF-B28-2,18,10,9,6,9,4,0.5,0.5,0.6,0.4
SF-B22,SF-D27,81,44,37,13,44,31,0.4567901234567901,0.5432098765432098,0.29545454545454547,0.7045454545454546
SF-B22,SF-C28-2,6,2,2,0,4,2,0.3333333333333333,0.6666666666666666,0.0,1.0
SF-B22,SF-C28-1,39,11,30,6,9,5,0.7692307692307693,0.23076923076923078,0.5454545454545454,0.45454545454545453
SF-B22,SF-B28,137,24,102,19,35,5,0.7445255474452555,0.25547445255474455,0.7916666666666666,0.20833333333333334
SF-B22,SF-J1,6,10,0,1,6,9,0.0,1.0,0.1,0.9
SF-B22,SF-H0,1,4,0,2,1,2,0.0,1.0,0.5,0.5
SF-B22,SF-J5,2,1,1,0,1,1,0.5,0.5,0.0,1.0
SF-B22,SF-G8,3,3,0,1,3,2,0.0,1.0,0.3333333333333333,0.6666666666666666
SF-B22,SF-G5,6,20,3,5,3,15,0.5,0.5,0.25,0.75
SF-B22,SF-G7,1,4,1,2,0,2,1.0,0.0,0.5,0.5
SF-B22,SF-F9,5,5,1,3,4,2,0.2,0.8,0.6,0.4
SF-B22,SF-G26,32,9,17,3,15,6,0.53125,0.46875,0.3333333333333333,0.6666666666666666
SF-B22,SF-K21,25,6,3,0,22,6,0.12,0.88,0.0,1.0
SF-B22,SF-K22-1,6,3,3,2,3,1,0.5,0.5,0.6666666666666666,0.3333333333333333
SF-B22,SF-J23-1,45,28,15,13,30,15,0.3333333333333333,0.6666666666666666,0.4642857142857143,0.5357142857142857
SF-B22,SF-J22-1,13,4,2,0,11,4,0.15384615384615385,0.8461538461538461,0.0,1.0
SF-B22,SF-J22-2,25,18,8,1,17,17,0.32,0.68,0.05555555555555555,0.9444444444444444
SF-B22,SF-J21,27,18,3,0,24,18,0.1111111111111111,0.8888888888888888,0.0,1.0
SF-B22,SF-I21,7,5,1,1,6,4,0.14285714285714285,0.8571428571428571,0.2,0.8
SF-B22,SF-I22,10,5,5,0,5,5,0.5,0.5,0.0,1.0
SF-B22,SF-I23-2,38,48,5,5,33,43,0.13157894736842105,0.868421052631579,0.10416666666666667,0.8958333333333334
SF-B22,SF-I24,33,39,2,3,31,36,0.06060606060606061,0.9393939393939394,0.07692307692307693,0.9230769230769231
SF-B22,SF-I23-1,31,16,13,3,18,13,0.41935483870967744,0.5806451612903226,0.1875,0.8125
SF-B22,SF-F26,40,34,21,8,19,26,0.525,0.475,0.23529411764705882,0.7647058823529411
SF-B22,SF-M13,6,3,0,1,6,2,0.0,1.0,0.3333333333333333,0.6666666666666666
SF-B22,SF-M15,8,7,1,1,7,6,0.125,0.875,0.14285714285714285,0.8571428571428571
SF-B22,SF-L19,4,3,1,0,3,3,0.25,0.75,0.0,1.0
SF-B22,SF-L20,6,6,1,0,5,6,0.16666666666666666,0.8333333333333334,0.0,1.0
SF-B22,SF-N20-1,15,10,3,3,12,7,0.2,0.8,0.3,0.7
SF-B22,SF-M20,5,3,0,1,5,2,0.0,1.0,0.3333333333333333,0.6666666666666666
SF-B22,SF-K17-2,6,1,2,0,4,1,0.3333333333333333,0.6666666666666666,0.0,1.0
SF-B22,SF-K20,39,54,1,2,38,52,0.02564102564102564,0.9743589743589743,0.037037037037037035,0.9629629629629629
SF-B22,SF-K15-,12,5,4,2,8,3,0.3333333333333333,0.6666666666666666,0.4,0.6
SF-B22,SF-K19,19,5,0,1,19,4,0.0,1.0,0.2,0.8
SF-B22,SF-K18,5,5,0,2,5,3,0.0,1.0,0.4,0.6
SF-B22,SF-K17,5,9,0,0,5,9,0.0,1.0,0.0,1.0
SF-B22,SF-J16,4,3,0,0,4,3,0.0,1.0,0.0,1.0
SF-B22,SF-J18,13,7,5,1,8,6,0.38461538461538464,0.6153846153846154,0.14285714285714285,0.8571428571428571
SF-B22,SF-J20,12,3,5,1,7,2,0.4166666666666667,0.5833333333333334,0.3333333333333333,0.6666666666666666
SF-B22,SF-J19,19,16,6,5,13,11,0.3157894736842105,0.6842105263157895,0.3125,0.6875
SF-B22,SF-M12,3,2,1,0,2,2,0.3333333333333333,0.6666666666666666,0.0,1.0
SF-B22,SF-M10,4,1,1,1,3,0,0.25,0.75,1.0,0.0
SF-B22,SF-M11,4,3,1,0,3,3,0.25,0.75,0.0,1.0
SF-B22,SF-O18,3,6,0,3,3,3,0.0,1.0,0.5,0.5
SF-B22,SF-O19,3,2,0,1,3,1,0.0,1.0,0.5,0.5
SF-B22,SF-O21,15,10,6,0,9,10,0.4,0.6,0.0,1.0
SF-B22,SF-O22,6,3,3,1,3,2,0.5,0.5,0.3333333333333333,0.6666666666666666
SF-B22,SF-N20-2,2,1,0,0,2,1,0.0,1.0,0.0,1.0
SF-B22,SF-M21,3,6,1,0,2,6,0.3333333333333333,0.6666666666666666,0.0,1.0
SF-B22,SF-L21,13,4,2,3,11,1,0.15384615384615385,0.8461538461538461,0.75,0.25
SF-B22,SF-Q30,8,3,4,1,4,2,0.5,0.5,0.3333333333333333,0.6666666666666666
SF-B22,SF-P30,9,3,6,2,3,1,0.6666666666666666,0.3333333333333333,0.6666666666666666,0.3333333333333333
SF-B22,SF-O30-2,8,3,4,0,4,3,0.5,0.5,0.0,1.0
SF-B22,SF-O30,15,11,5,3,10,8,0.3333333333333333,0.6666666666666666,0.2727272727272727,0.7272727272727273
SF-B22,SF-N27,1,2,0,0,1,2,0.0,1.0,0.0,1.0
SF-B22,SF-N29,5,3,2,1,3,2,0.4,0.6,0.3333333333333333,0.6666666666666666
SF-B22,SF-N28,8,4,8,0,0,4,1.0,0.0,0.0,1.0
SF-B22,SF-L30-1,16,3,7,0,9,3,0.4375,0.5625,0.0,1.0
SF-B22,SF-L31-1,9,4,6,0,3,4,0.6666666666666666,0.3333333333333333,0.0,1.0
SF-B22,SF-K30-2,10,4,5,0,5,4,0.5,0.5,0.0,1.0
SF-B22,SF-L29,12,6,7,2,5,4,0.5833333333333334,0.4166666666666667,0.3333333333333333,0.6666666666666666
SF-B22,SF-J29-1,6,1,5,0,1,1,0.8333333333333334,0.16666666666666666,0.0,1.0
SF-B22,SF-I30,21,3,10,1,11,2,0.47619047619047616,0.5238095238095238,0.3333333333333333,0.6666666666666666
SF-B22,SF-I27,6,2,2,1,4,1,0.3333333333333333,0.6666666666666666,0.5,0.5
SF-B22,SF-I28,2,1,1,1,1,0,0.5,0.5,1.0,0.0
SF-B22,SF-I30-2,15,7,10,7,5,0,0.6666666666666666,0.3333333333333333,1.0,0.0
SF-B22,SF I29-1,5,2,1,0,4,2,0.2,0.8,0.0,1.0
SF-B22,SF-H28,13,4,9,1,4,3,0.6923076923076923,0.3076923076923077,0.25,0.75
SF-B22,SF-R24,12,7,7,5,5,2,0.5833333333333334,0.4166666666666667,0.7142857142857143,0.2857142857142857
SF-B22,SF-P26,25,50,2,1,23,49,0.08,0.92,0.02,0.98
SF-B22,SF-N22-1B,8,1,2,0,6,1,0.25,0.75,0.0,1.0
SF-B22,SF-N25,5,1,3,0,2,1,0.6,0.4,0.0,1.0
SF-B22,SF-T22,3,1,2,0,1,1,0.6666666666666666,0.3333333333333333,0.0,1.0
SF-B22,SF-Q23-3,2,1,1,1,1,0,0.5,0.5,1.0,0.0
SF-B22,SF-Q22-1,5,5,2,1,3,4,0.4,0.6,0.2,0.8
SF-B22,SF-Q22-2,5,2,2,0,3,2,0.4,0.6,0.0,1.0
SF-B22,SF-W19,3,2,3,2,0,0,1.0,0.0,1.0,0.0
SF-B22,SF-T20,2,2,0,1,2,1,0.0,1.0,0.5,0.5
SF-B22,SF-X29,2,2,1,1,1,1,0.5,0.5,0.5,0.5
SF-B22,SF-V29,13,4,0,0,13,4,0.0,1.0,0.0,1.0
SF-B22,SF-Z16,1,1,1,1,0,0,1.0,0.0,1.0,0.0
SF-J17,SF-M26,1,1,0,1,1,0,0.0,1.0,1.0,0.0
SF-J17,SF-M25,8,3,0,0,8,3,0.0,1.0,0.0,1.0
SF-J17,SF-M26-2,3,6,0,0,3,6,0.0,1.0,0.0,1.0
SF-J17,SF-L27,4,1,0,0,4,1,0.0,1.0,0.0,1.0
SF-J17,SF-K26,3,10,1,5,2,5,0.3333333333333333,0.6666666666666666,0.5,0.5
SF-J17,SF-J27,2,7,0,1,2,6,0.0,1.0,0.14285714285714285,0.8571428571428571
SF-J17,SF-M30,49,46,1,3,48,43,0.02040816326530612,0.9795918367346939,0.06521739130434782,0.9347826086956522
SF-J17,SF-J29-3,10,26,0,16,10,10,0.0,1.0,0.6153846153846154,0.38461538461538464
SF-J17,SF-J29,8,8,1,6,7,2,0.125,0.875,0.75,0.25
SF-J17,SF-L26,1,2,0,0,1,2,0.0,1.0,0.0,1.0
SF-J17,SF-M28,5,1,0,0,5,1,0.0,1.0,0.0,1.0
SF-J17,SF-L25,2,7,0,4,2,3,0.0,1.0,0.5714285714285714,0.42857142857142855
SF-J17,SF-M24,1,1,0,0,1,1,0.0,1.0,0.0,1.0
SF-J17,SF-L24,1,5,0,4,1,1,0.0,1.0,0.8,0.2
SF-J17,SF-N23,1,2,0,0,1,2,0.0,1.0,0.0,1.0
SF-J17,SF-K27-2,17,37,2,8,15,29,0.11764705882352941,0.8823529411764706,0.21621621621621623,0.7837837837837838
SF-J17,SF-J26-2,12,20,9,19,3,1,0.75,0.25,0.95,0.05
SF-J17,SF-K29-1,7,2,0,1,7,1,0.0,1.0,0.5,0.5
SF-J17,SF-J28-2,3,1,1,1,2,0,0.3333333333333333,0.6666666666666666,1.0,0.0
SF-J17,SF-K27,6,4,0,0,6,4,0.0,1.0,0.0,1.0
SF-J17,SF-K25,1,3,0,0,1,3,0.0,1.0,0.0,1.0
SF-J17,SF-J25,9,46,1,14,8,32,0.1111111111111111,0.8888888888888888,0.30434782608695654,0.6956521739130435
SF-J17,SF-H26-2,9,6,0,4,9,2,0.0,1.0,0.6666666666666666,0.3333333333333333
SF-J17,SF-P24,9,6,5,3,4,3,0.5555555555555556,0.4444444444444444,0.5,0.5
SF-J17,SF-J24,2,8,0,3,2,5,0.0,1.0,0.375,0.625
SF-J17,SF-O24,3,2,0,0,3,2,0.0,1.0,0.0,1.0
SF-J17,SF-J26,3,1,1,0,2,1,0.3333333333333333,0.6666666666666666,0.0,1.0
SF-J17,SF-I26-,2,2,0,1,2,1,0.0,1.0,0.5,0.5
SF-J17,SF-I25,16,23,4,18,12,5,0.25,0.75,0.782608695652174,0.21739130434782608
SF-J17,SF-K23,2,1,0,0,2,1,0.0,1.0,0.0,1.0
SF-J17,SF-H26,40,46,3,7,37,39,0.075,0.925,0.15217391304347827,0.8478260869565217
SF-J17,SF-O23,10,10,1,4,9,6,0.1,0.9,0.4,0.6
SF-J17,SF-H27-1,2,1,0,0,2,1,0.0,1.0,0.0,1.0
SF-J17,SF-F28-2,20,20,1,4,19,16,0.05,0.95,0.2,0.8
SF-J17,SF-G27,28,89,0,34,28,55,0.0,1.0,0.38202247191011235,0.6179775280898876
SF-J17,SF-M22-2,16,17,0,6,16,11,0.0,1.0,0.35294117647058826,0.6470588235294118
SF-J17,SF-L22,4,18,0,7,4,11,0.0,1.0,0.3888888888888889,0.6111111111111112
SF-J17,SF-F27,4,7,0,2,4,5,0.0,1.0,0.2857142857142857,0.7142857142857143
SF-J17,SF-N22-2,28,28,0,7,28,21,0.0,1.0,0.25,0.75
SF-J17,SF-G28-2,2,3,0,0,2,3,0.0,1.0,0.0,1.0
SF-J17,SF-M22-1,4,10,0,3,4,7,0.0,1.0,0.3,0.7
SF-J17,SF-O25-1,1,8,0,2,1,6,0.0,1.0,0.25,0.75
SF-J17,SF-K22-2,6,8,2,1,4,7,0.3333333333333333,0.6666666666666666,0.125,0.875
SF-J17,SF-K24,4,7,1,0,3,7,0.25,0.75,0.0,1.0
SF-J17,SF-J23-2,26,54,2,9,24,45,0.07692307692307693,0.9230769230769231,0.16666666666666666,0.8333333333333334
SF-J17,SF-G23,17,21,0,0,17,21,0.0,1.0,0.0,1.0
SF-J17,SF-G24,22,24,3,9,19,15,0.13636363636363635,0.8636363636363636,0.375,0.625
SF-J17,SF-G25,15,11,1,1,14,10,0.06666666666666667,0.9333333333333333,0.09090909090909091,0.9090909090909091
SF-J17,SF-F23,17,17,0,0,17,17,0.0,1.0,0.0,1.0
SF-J17,SF-E23,16,9,2,0,14,9,0.125,0.875,0.0,1.0
SF-J17,SF-D24,11,9,0,0,11,9,0.0,1.0,0.0,1.0
SF-J17,SF-C22,8,6,0,0,8,6,0.0,1.0,0.0,1.0
SF-J17,SF-B22,3,5,0,1,3,4,0.0,1.0,0.2,0.8
SF-J17,SF-I19,11,11,4,6,7,5,0.36363636363636365,0.6363636363636364,0.5454545454545454,0.45454545454545453
SF-J17,SF-I20,12,18,2,4,10,14,0.16666666666666666,0.8333333333333334,0.2222222222222222,0.7777777777777778
SF-J17,SF-H16,65,62,26,13,39,49,0.4,0.6,0.20967741935483872,0.7903225806451613
SF-J17,SF-H19,6,7,0,1,6,6,0.0,1.0,0.14285714285714285,0.8571428571428571
SF-J17,SF-H20,13,15,2,9,11,6,0.15384615384615385,0.8461538461538461,0.6,0.4
SF-J17,SF-H18,14,23,3,6,11,17,0.21428571428571427,0.7857142857142857,0.2608695652173913,0.7391304347826086
SF-J17,SF-H17,7,29,4,1,3,28,0.5714285714285714,0.42857142857142855,0.034482758620689655,0.9655172413793104
SF-J17,SF-G19,21,38,5,10,16,28,0.23809523809523808,0.7619047619047619,0.2631578947368421,0.7368421052631579
SF-J17,SF-G17,11,4,7,0,4,4,0.6363636363636364,0.36363636363636365,0.0,1.0
SF-J17,SF-G18,32,54,3,10,29,44,0.09375,0.90625,0.18518518518518517,0.8148148148148148
SF-J17,SF-G20,26,30,4,13,22,17,0.15384615384615385,0.8461538461538461,0.43333333333333335,0.5666666666666667
SF-J17,SF-F19,21,26,1,6,20,20,0.047619047619047616,0.9523809523809523,0.23076923076923078,0.7692307692307693
SF-J17,SF-E18,9,11,1,2,8,9,0.1111111111111111,0.8888888888888888,0.18181818181818182,0.8181818181818182
SF-J17,SF-E20,30,25,2,6,28,19,0.06666666666666667,0.9333333333333333,0.24,0.76
SF-J17,SF-G30-2,34,18,1,3,33,15,0.029411764705882353,0.9705882352941176,0.16666666666666666,0.8333333333333334
SF-J17,SF-F30-1,2,3,0,1,2,2,0.0,1.0,0.3333333333333333,0.6666666666666666
SF-J17,SF-E29-2,8,24,0,12,8,12,0.0,1.0,0.5,0.5
SF-J17,SF-E29-1,6,3,0,1,6,2,0.0,1.0,0.3333333333333333,0.6666666666666666
SF-J17,SF-D29,1,2,0,0,1,2,0.0,1.0,0.0,1.0
SF-J17,SF-D28,3,5,0,2,3,3,0.0,1.0,0.4,0.6
SF-J17,SF-A27,1,4,0,2,1,2,0.0,1.0,0.5,0.5
SF-J17,SF-G29-2,10,7,1,2,9,5,0.1,0.9,0.2857142857142857,0.7142857142857143
SF-J17,SF-G29-1,3,5,0,2,3,3,0.0,1.0,0.4,0.6
SF-J17,SF-G30-1,6,2,0,0,6,2,0.0,1.0,0.0,1.0
SF-J17,SF-G29-3,3,3,0,1,3,2,0.0,1.0,0.3333333333333333,0.6666666666666666
SF-J17,SF-F30-2,2,1,0,0,2,1,0.0,1.0,0.0,1.0
SF-J17,SF-E29-3,2,68,0,4,2,64,0.0,1.0,0.058823529411764705,0.9411764705882353
SF-J17,SF-F28-1,10,41,0,22,10,19,0.0,1.0,0.5365853658536586,0.4634146341463415
SF-J17,SF-E28-2,3,1,0,1,3,0,0.0,1.0,1.0,0.0
SF-J17,SF-E28,9,11,0,0,9,11,0.0,1.0,0.0,1.0
SF-J17,SF-J10,34,20,8,7,26,13,0.23529411764705882,0.7647058823529411,0.35,0.65
SF-J17,SF-J12,55,49,19,20,36,29,0.34545454545454546,0.6545454545454545,0.40816326530612246,0.5918367346938775
SF-J17,SF-J13,10,16,4,4,6,12,0.4,0.6,0.25,0.75
SF-J17,SF-J15,13,13,8,4,5,9,0.6153846153846154,0.38461538461538464,0.3076923076923077,0.6923076923076923
SF-J17,SF-J14,8,4,1,1,7,3,0.125,0.875,0.25,0.75
SF-J17,SF-H13,6,7,1,1,5,6,0.16666666666666666,0.8333333333333334,0.14285714285714285,0.8571428571428571
SF-J17,SF-I16,9,14,4,6,5,8,0.4444444444444444,0.5555555555555556,0.42857142857142855,0.5714285714285714
SF-J17,SF-H12,11,19,1,4,10,15,0.09090909090909091,0.9090909090909091,0.21052631578947367,0.7894736842105263
SF-J17,SF-G10-2,3,5,1,1,2,4,0.3333333333333333,0.6666666666666666,0.2,0.8
SF-J17,SF-H15,11,10,1,1,10,9,0.09090909090909091,0.9090909090909091,0.1,0.9
SF-J17,SF-G9,5,13,1,1,4,12,0.2,0.8,0.07692307692307693,0.9230769230769231
SF-J17,SF-H14,19,12,1,0,18,12,0.05263157894736842,0.9473684210526315,0.0,1.0
SF-J17,SF-G13,27,29,14,4,13,25,0.5185185185185185,0.48148148148148145,0.13793103448275862,0.8620689655172413
SF-J17,SF-G11,1,5,0,2,1,3,0.0,1.0,0.4,0.6
SF-J17,SF-G12,13,12,3,1,10,11,0.23076923076923078,0.7692307692307693,0.08333333333333333,0.9166666666666666
SF-J17,SF-G10-1,4,2,2,1,2,1,0.5,0.5,0.5,0.5
SF-J17,SF-F15,5,20,0,1,5,19,0.0,1.0,0.05,0.95
SF-J17,SF-F16,7,8,1,3,6,5,0.14285714285714285,0.8571428571428571,0.375,0.625
SF-J17,SF-C21,2,1,0,0,2,1,0.0,1.0,0.0,1.0
SF-J17,SF-B19,3,6,2,3,1,3,0.6666666666666666,0.3333333333333333,0.5,0.5
SF-J17,SF-A20,1,5,0,1,1,4,0.0,1.0,0.2,0.8
SF-J17,SF-C26,2,4,0,0,2,4,0.0,1.0,0.0,1.0
SF-J17,SF-C25,15,17,2,5,13,12,0.13333333333333333,0.8666666666666667,0.29411764705882354,0.7058823529411765
SF-J17,SF-B25,4,13,0,7,4,6,0.0,1.0,0.5384615384615384,0.46153846153846156
SF-J17,SF-E27,2,1,0,0,2,1,0.0,1.0,0.0,1.0
SF-J17,SF-B28-2,13,67,0,4,13,63,0.0,1.0,0.05970149253731343,0.9402985074626866
SF-J17,SF-D27,7,20,0,1,7,19,0.0,1.0,0.05,0.95
SF-J17,SF-C28-2,2,3,0,0,2,3,0.0,1.0,0.0,1.0
SF-J17,SF-J1,60,64,7,19,53,45,0.11666666666666667,0.8833333333333333,0.296875,0.703125
SF-J17,SF-H0,15,13,0,2,15,11,0.0,1.0,0.15384615384615385,0.8461538461538461
SF-J17,SF-J3,6,12,0,1,6,11,0.0,1.0,0.08333333333333333,0.9166666666666666
SF-J17,SF-J5,5,8,2,6,3,2,0.4,0.6,0.75,0.25
SF-J17,SF-G6,3,4,0,1,3,3,0.0,1.0,0.25,0.75
SF-J17,SF-G8,6,6,0,1,6,5,0.0,1.0,0.16666666666666666,0.8333333333333334
SF-J17,SF-G5,8,13,0,2,8,11,0.0,1.0,0.15384615384615385,0.8461538461538461
SF-J17,SF-G7,6,10,2,2,4,8,0.3333333333333333,0.6666666666666666,0.2,0.8
SF-J17,SF-F9,3,8,1,0,2,8,0.3333333333333333,0.6666666666666666,0.0,1.0
SF-J17,SF-H25,4,2,0,0,4,2,0.0,1.0,0.0,1.0
SF-J17,SF-G26,13,16,2,7,11,9,0.15384615384615385,0.8461538461538461,0.4375,0.5625
SF-J17,SF-K21,9,20,1,6,8,14,0.1111111111111111,0.8888888888888888,0.3,0.7
SF-J17,SF-K22-1,17,3,1,0,16,3,0.058823529411764705,0.9411764705882353,0.0,1.0
SF-J17,SF-J23-1,33,22,2,7,31,15,0.06060606060606061,0.9393939393939394,0.3181818181818182,0.6818181818181818
SF-J17,SF-J22-1,11,10,1,5,10,5,0.09090909090909091,0.9090909090909091,0.5,0.5
SF-J17,SF-J22-2,14,16,0,8,14,8,0.0,1.0,0.5,0.5
SF-J17,SF-J21,47,40,1,13,46,27,0.02127659574468085,0.9787234042553191,0.325,0.675
SF-J17,SF-I21,8,10,2,5,6,5,0.25,0.75,0.5,0.5
SF-J17,SF-I22,7,5,0,0,7,5,0.0,1.0,0.0,1.0
SF-J17,SF-I23-2,13,18,0,7,13,11,0.0,1.0,0.3888888888888889,0.6111111111111112
SF-J17,SF-I24,16,38,2,17,14,21,0.125,0.875,0.4473684210526316,0.5526315789473685
SF-J17,SF-I23-1,26,30,0,7,26,23,0.0,1.0,0.23333333333333334,0.7666666666666667
SF-J17,SF-F26,18,13,4,5,14,8,0.2222222222222222,0.7777777777777778,0.38461538461538464,0.6153846153846154
SF-J17,SF-M13,16,13,3,2,13,11,0.1875,0.8125,0.15384615384615385,0.8461538461538461
SF-J17,SF-M15,41,46,19,9,22,37,0.4634146341463415,0.5365853658536586,0.1956521739130435,0.8043478260869565
SF-J17,SF-L19,23,18,4,6,19,12,0.17391304347826086,0.8260869565217391,0.3333333333333333,0.6666666666666666
SF-J17,SF-L20,13,22,3,9,10,13,0.23076923076923078,0.7692307692307693,0.4090909090909091,0.5909090909090909
SF-J17,SF-N20-1,12,12,1,3,11,9,0.08333333333333333,0.9166666666666666,0.25,0.75
SF-J17,SF-M20,49,43,1,10,48,33,0.02040816326530612,0.9795918367346939,0.23255813953488372,0.7674418604651163
SF-J17,SF-K17-2,5,8,0,4,5,4,0.0,1.0,0.5,0.5
SF-J17,SF-K20,51,24,13,8,38,16,0.2549019607843137,0.7450980392156863,0.3333333333333333,0.6666666666666666
SF-J17,SF-K15-,92,129,21,66,71,63,0.22826086956521738,0.7717391304347826,0.5116279069767442,0.4883720930232558
SF-J17,SF-K19,20,26,3,17,17,9,0.15,0.85,0.6538461538461539,0.34615384615384615
SF-J17,SF-K18,40,56,6,29,34,27,0.15,0.85,0.5178571428571429,0.48214285714285715
SF-J17,SF-K17,51,65,23,35,28,30,0.45098039215686275,0.5490196078431373,0.5384615384615384,0.46153846153846156
SF-J17,SF-J16,21,24,9,11,12,13,0.42857142857142855,0.5714285714285714,0.4583333333333333,0.5416666666666666
SF-J17,SF-J18,43,77,9,59,34,18,0.20930232558139536,0.7906976744186046,0.7662337662337663,0.23376623376623376
SF-J17,SF-J20,8,3,4,2,4,1,0.5,0.5,0.6666666666666666,0.3333333333333333
SF-J17,SF-J19,12,14,5,6,7,8,0.4166666666666667,0.5833333333333334,0.42857142857142855,0.5714285714285714
SF-J17,SF-M12,8,16,0,4,8,12,0.0,1.0,0.25,0.75
SF-J17,SF-M10,5,14,0,3,5,11,0.0,1.0,0.21428571428571427,0.7857142857142857
SF-J17,SF-M11,41,33,7,7,34,26,0.17073170731707318,0.8292682926829268,0.21212121212121213,0.7878787878787878
SF-J17,SF-R19,2,4,0,0,2,4,0.0,1.0,0.0,1.0
SF-J17,SF-R20,1,4,0,0,1,4,0.0,1.0,0.0,1.0
SF-J17,SF-Q21-1,5,1,5,1,0,0,1.0,0.0,1.0,0.0
SF-J17,SF-P21,10,10,1,3,9,7,0.1,0.9,0.3,0.7
SF-J17,SF-O18,13,33,1,4,12,29,0.07692307692307693,0.9230769230769231,0.12121212121212122,0.8787878787878788
SF-J17,SF-O19,11,27,1,6,10,21,0.09090909090909091,0.9090909090909091,0.2222222222222222,0.7777777777777778
SF-J17,SF-O21,34,65,1,26,33,39,0.029411764705882353,0.9705882352941176,0.4,0.6
SF-J17,SF-O22,22,31,1,4,21,27,0.045454545454545456,0.9545454545454546,0.12903225806451613,0.8709677419354839
SF-J17,SF-N21,5,13,2,9,3,4,0.4,0.6,0.6923076923076923,0.3076923076923077
SF-J17,SF-N20-2,10,11,3,4,7,7,0.3,0.7,0.36363636363636365,0.6363636363636364
SF-J17,SF-M21,8,8,2,3,6,5,0.25,0.75,0.375,0.625
SF-J17,SF-L21,34,22,3,7,31,15,0.08823529411764706,0.9117647058823529,0.3181818181818182,0.6818181818181818
SF-J17,SF-Q30,2,8,0,0,2,8,0.0,1.0,0.0,1.0
SF-J17,SF-O30,3,5,0,3,3,2,0.0,1.0,0.6,0.4
SF-J17,SF-N29,5,1,0,0,5,1,0.0,1.0,0.0,1.0
SF-J17,SF-N28,3,2,0,0,3,2,0.0,1.0,0.0,1.0
SF-J17,SF-L30-1,106,135,21,39,85,96,0.19811320754716982,0.8018867924528302,0.28888888888888886,0.7111111111111111
SF-J17,SF-K30-2,2,5,0,5,2,0,0.0,1.0,1.0,0.0
SF-J17,SF-L29,6,3,3,1,3,2,0.5,0.5,0.3333333333333333,0.6666666666666666
SF-J17,SF-J29-1,1,2,0,1,1,1,0.0,1.0,0.5,0.5
SF-J17,SF-I29-2,4,1,0,0,4,1,0.0,1.0,0.0,1.0
SF-J17,SF-I27,2,4,0,1,2,3,0.0,1.0,0.25,0.75
SF-J17,SF-I28,5,7,0,1,5,6,0.0,1.0,0.14285714285714285,0.8571428571428571
SF-J17,SF-I30-2,15,16,0,1,15,15,0.0,1.0,0.0625,0.9375
SF-J17,SF I29-1,13,21,0,0,13,21,0.0,1.0,0.0,1.0
SF-J17,SF-H28,3,3,1,1,2,2,0.3333333333333333,0.6666666666666666,0.3333333333333333,0.6666666666666666
SF-J17,SF-H29,2,1,0,0,2,1,0.0,1.0,0.0,1.0
SF-J17,SF-S24,4,5,1,3,3,2,0.25,0.75,0.6,0.4
SF-J17,SF-R24,5,7,1,2,4,5,0.2,0.8,0.2857142857142857,0.7142857142857143
SF-J17,SF-Q26,2,1,1,0,1,1,0.5,0.5,0.0,1.0
SF-J17,SF-P26,12,10,0,0,12,10,0.0,1.0,0.0,1.0
SF-J17,SF-N22-1B,10,3,1,0,9,3,0.1,0.9,0.0,1.0
SF-J17,SF-T21,1,1,0,1,1,0,0.0,1.0,1.0,0.0
SF-J17,SF-T22,8,6,0,0,8,6,0.0,1.0,0.0,1.0
SF-J17,SF-S22-1,19,26,0,4,19,22,0.0,1.0,0.15384615384615385,0.8461538461538461
SF-J17,SF-Q23-3,6,10,0,2,6,8,0.0,1.0,0.2,0.8
SF-J17,SF-Q22-1,12,10,4,3,8,7,0.3333333333333333,0.6666666666666666,0.3,0.7
SF-J17,SF-Q22-2,42,28,4,8,38,20,0.09523809523809523,0.9047619047619048,0.2857142857142857,0.7142857142857143
SF-J17,SF-P22,14,8,0,0,14,8,0.0,1.0,0.0,1.0
SF-J17,SF-T20,6,8,1,1,5,7,0.16666666666666666,0.8333333333333334,0.125,0.875
SF-J17,SF-W29,1,1,0,0,1,1,0.0,1.0,0.0,1.0
SF-J17,SF-V29,6,9,0,0,6,9,0.0,1.0,0.0,1.0
SF-J17,SF-AA15,1,1,1,1,0,0,1.0,0.0,1.0,0.0
SF-I19,SF-M25,9,2,0,1,9,1,0.0,1.0,0.5,0.5
SF-I19,SF-M26-2,1,1,0,0,1,1,0.0,1.0,0.0,1.0
SF-I19,SF-K26,1,3,0,1,1,2,0.0,1.0,0.3333333333333333,0.6666666666666666
SF-I19,SF-M30,11,5,0,1,11,4,0.0,1.0,0.2,0.8
SF-I19,SF-L27-2,1,1,0,0,1,1,0.0,1.0,0.0,1.0
SF-I19,SF-J29-3,1,2,1,1,0,1,1.0,0.0,0.5,0.5
SF-I19,SF-J29,2,2,0,1,2,1,0.0,1.0,0.5,0.5
SF-I19,SF-L26,24,25,0,2,24,23,0.0,1.0,0.08,0.92
SF-I19,SF-M28,8,4,0,4,8,0,0.0,1.0,1.0,0.0
SF-I19,SF-M27,3,48,0,29,3,19,0.0,1.0,0.6041666666666666,0.3958333333333333
SF-I19,SF-L25,6,1,0,1,6,0,0.0,1.0,1.0,0.0
SF-I19,SF-M24,5,6,0,1,5,5,0.0,1.0,0.16666666666666666,0.8333333333333334
SF-I19,SF-N23,3,2,0,1,3,1,0.0,1.0,0.5,0.5
SF-I19,SF-K27-2,7,2,1,0,6,2,0.14285714285714285,0.8571428571428571,0.0,1.0
SF-I19,SF-J26-2,2,1,2,0,0,1,1.0,0.0,0.0,1.0
SF-I19,SF-J28-2,2,2,1,0,1,2,0.5,0.5,0.0,1.0
SF-I19,SF-K25,1,2,0,2,1,0,0.0,1.0,1.0,0.0
SF-I19,SF-H26-2,2,88,2,87,0,1,1.0,0.0,0.9886363636363636,0.011363636363636364
SF-I19,SF-P24,1,5,0,1,1,4,0.0,1.0,0.2,0.8
SF-I19,SF-J26,1,1,0,1,1,0,0.0,1.0,1.0,0.0
SF-I19,SF-I25,4,47,0,47,4,0,0.0,1.0,1.0,0.0
SF-I19,SF-H26,8,30,2,21,6,9,0.25,0.75,0.7,0.3
SF-I19,SF-O23,1,11,0,3,1,8,0.0,1.0,0.2727272727272727,0.7272727272727273
SF-I19,SF-F28-2,3,8,1,4,2,4,0.3333333333333333,0.6666666666666666,0.5,0.5
SF-I19,SF-G27,8,19,0,12,8,7,0.0,1.0,0.631578947368421,0.3684210526315789
SF-I19,SF-M22-2,6,5,0,1,6,4,0.0,1.0,0.2,0.8
SF-I19,SF-F27,2,8,0,5,2,3,0.0,1.0,0.625,0.375
SF-I19,SF-N22-2,13,8,3,3,10,5,0.23076923076923078,0.7692307692307693,0.375,0.625
SF-I19,SF-G28-1,2,3,0,1,2,2,0.0,1.0,0.3333333333333333,0.6666666666666666
SF-I19,SF-M22-1,2,3,0,0,2,3,0.0,1.0,0.0,1.0
SF-I19,SF-K22-2,7,4,2,3,5,1,0.2857142857142857,0.7142857142857143,0.75,0.25
SF-I19,SF-K24,3,4,1,2,2,2,0.3333333333333333,0.6666666666666666,0.5,0.5
SF-I19,SF-J23-2,1,6,0,2,1,4,0.0,1.0,0.3333333333333333,0.6666666666666666
SF-I19,SF-G24,13,33,3,2,10,31,0.23076923076923078,0.7692307692307693,0.06060606060606061,0.9393939393939394
SF-I19,SF-G25,5,10,1,3,4,7,0.2,0.8,0.3,0.7
SF-I19,SF-F23,7,7,3,2,4,5,0.42857142857142855,0.5714285714285714,0.2857142857142857,0.7142857142857143
SF-I19,SF-E23,8,15,4,4,4,11,0.5,0.5,0.26666666666666666,0.7333333333333333
SF-I19,SF-D24,4,4,1,0,3,4,0.25,0.75,0.0,1.0
SF-I19,SF-C22,4,3,0,0,4,3,0.0,1.0,0.0,1.0
SF-I19,SF-B22,2,7,1,2,1,5,0.5,0.5,0.2857142857142857,0.7142857142857143
SF-I19,SF-J17,11,11,6,4,5,7,0.5454545454545454,0.45454545454545453,0.36363636363636365,0.6363636363636364
SF-I19,SF-I20,9,13,5,7,4,6,0.5555555555555556,0.4444444444444444,0.5384615384615384,0.46153846153846156
SF-I19,SF-H16,4,5,1,1,3,4,0.25,0.75,0.2,0.8
SF-I19,SF-H19,7,7,5,3,2,4,0.7142857142857143,0.2857142857142857,0.42857142857142855,0.5714285714285714
SF-I19,SF-H20,12,22,8,9,4,13,0.6666666666666666,0.3333333333333333,0.4090909090909091,0.5909090909090909
SF-I19,SF-H18,14,11,9,3,5,8,0.6428571428571429,0.35714285714285715,0.2727272727272727,0.7272727272727273
SF-I19,SF-G19,24,13,16,6,8,7,0.6666666666666666,0.3333333333333333,0.46153846153846156,0.5384615384615384
SF-I19,SF-G17,6,3,3,1,3,2,0.5,0.5,0.3333333333333333,0.6666666666666666
SF-I19,SF-G18,15,13,11,7,4,6,0.7333333333333333,0.26666666666666666,0.5384615384615384,0.46153846153846156
SF-I19,SF-G20,20,28,8,13,12,15,0.4,0.6,0.4642857142857143,0.5357142857142857
SF-I19,SF-F19,20,25,6,17,14,8,0.3,0.7,0.68,0.32
SF-I19,SF-E18,10,22,4,3,6,19,0.4,0.6,0.13636363636363635,0.8636363636363636
SF-I19,SF-E20,17,15,6,2,11,13,0.35294117647058826,0.6470588235294118,0.13333333333333333,0.8666666666666667
SF-I19,SF-G30-2,6,12,1,2,5,10,0.16666666666666666,0.8333333333333334,0.16666666666666666,0.8333333333333334
SF-I19,SF-F30-1,2,1,0,0,2,1,0.0,1.0,0.0,1.0
SF-I19,SF-E29-2,5,9,1,3,4,6,0.2,0.8,0.3333333333333333,0.6666666666666666
SF-I19,SF-E29-1,1,2,0,0,1,2,0.0,1.0,0.0,1.0
SF-I19,SF-A27,1,1,0,0,1,1,0.0,1.0,0.0,1.0
SF-I19,SF-G29-2,6,5,2,2,4,3,0.3333333333333333,0.6666666666666666,0.4,0.6
SF-I19,SF-G29-1,3,4,0,0,3,4,0.0,1.0,0.0,1.0
SF-I19,SF-G29-3,1,1,0,0,1,1,0.0,1.0,0.0,1.0
SF-I19,SF-F29,3,10,0,6,3,4,0.0,1.0,0.6,0.4
SF-I19,SF-F28-1,6,14,2,9,4,5,0.3333333333333333,0.6666666666666666,0.6428571428571429,0.35714285714285715
SF-I19,SF-E28,1,3,0,0,1,3,0.0,1.0,0.0,1.0
SF-I19,SF-J12,11,7,0,0,11,7,0.0,1.0,0.0,1.0
SF-I19,SF-J13,3,3,0,1,3,2,0.0,1.0,0.3333333333333333,0.6666666666666666
SF-I19,SF-J14,2,1,1,0,1,1,0.5,0.5,0.0,1.0
SF-I19,SF-I16,1,2,0,0,1,2,0.0,1.0,0.0,1.0
SF-I19,SF-H15,1,2,1,1,0,1,1.0,0.0,0.5,0.5
SF-I19,SF-H14,1,3,0,0,1,3,0.0,1.0,0.0,1.0
SF-I19,SF-G13,4,3,0,0,4,3,0.0,1.0,0.0,1.0
SF-I19,SF-G11,2,1,0,0,2,1,0.0,1.0,0.0,1.0
SF-I19,SF-G12,5,2,2,0,3,2,0.4,0.6,0.0,1.0
SF-I19,SF-F15,9,3,6,0,3,3,0.6666666666666666,0.3333333333333333,0.0,1.0
SF-I19,SF-C20,2,9,0,2,2,7,0.0,1.0,0.2222222222222222,0.7777777777777778
SF-I19,SF-B21,1,4,1,0,0,4,1.0,0.0,0.0,1.0
SF-I19,SF-B19,6,6,1,4,5,2,0.16666666666666666,0.8333333333333334,0.6666666666666666,0.3333333333333333
SF-I19,SF-C26,4,1,0,0,4,1,0.0,1.0,0.0,1.0
SF-I19,SF-C25,4,6,1,0,3,6,0.25,0.75,0.0,1.0
SF-I19,SF-D27,1,2,0,1,1,1,0.0,1.0,0.5,0.5
SF-I19,SF-J1,11,6,2,2,9,4,0.18181818181818182,0.8181818181818182,0.3333333333333333,0.6666666666666666
SF-I19,SF-H0,1,2,0,0,1,2,0.0,1.0,0.0,1.0
SF-I19,SF-J3,3,2,1,2,2,0,0.3333333333333333,0.6666666666666666,1.0,0.0
SF-I19,SF-J5,4,4,3,3,1,1,0.75,0.25,0.75,0.25
SF-I19,SF-G6,1,1,1,1,0,0,1.0,0.0,1.0,0.0
SF-I19,SF-G8,2,1,0,0,2,1,0.0,1.0,0.0,1.0
SF-I19,SF-G7,4,2,3,2,1,0,0.75,0.25,1.0,0.0
SF-I19,SF-F9,2,3,0,1,2,2,0.0,1.0,0.3333333333333333,0.6666666666666666
SF-I19,SF-H25,2,6,1,5,1,1,0.5,0.5,0.8333333333333334,0.16666666666666666
SF-I19,SF-G26,13,18,3,7,10,11,0.23076923076923078,0.7692307692307693,0.3888888888888889,0.6111111111111112
SF-I19,SF-K21,4,5,1,0,3,5,0.25,0.75,0.0,1.0
SF-I19,SF-K22-1,4,4,1,2,3,2,0.25,0.75,0.5,0.5
SF-I19,SF-J23-1,9,9,1,2,8,7,0.1111111111111111,0.8888888888888888,0.2222222222222222,0.7777777777777778
SF-I19,SF-J22-1,1,2,0,0,1,2,0.0,1.0,0.0,1.0
SF-I19,SF-J22-2,9,6,4,6,5,0,0.4444444444444444,0.5555555555555556,1.0,0.0
SF-I19,SF-J21,13,15,2,10,11,5,0.15384615384615385,0.8461538461538461,0.6666666666666666,0.3333333333333333
SF-I19,SF-I21,5,9,1,6,4,3,0.2,0.8,0.6666666666666666,0.3333333333333333
SF-I19,SF-I22,22,66,3,63,19,3,0.13636363636363635,0.8636363636363636,0.9545454545454546,0.045454545454545456
SF-I19,SF-I23-2,6,7,2,3,4,4,0.3333333333333333,0.6666666666666666,0.42857142857142855,0.5714285714285714
SF-I19,SF-I24,2,7,2,4,0,3,1.0,0.0,0.5714285714285714,0.42857142857142855
SF-I19,SF-I23-1,11,17,2,7,9,10,0.18181818181818182,0.8181818181818182,0.4117647058823529,0.5882352941176471
SF-I19,SF-F26,13,17,3,4,10,13,0.23076923076923078,0.7692307692307693,0.23529411764705882,0.7647058823529411
SF-I19,SF-M13,5,4,0,0,5,4,0.0,1.0,0.0,1.0
SF-I19,SF-M15,17,21,1,2,16,19,0.058823529411764705,0.9411764705882353,0.09523809523809523,0.9047619047619048
SF-I19,SF-L19,5,4,0,1,5,3,0.0,1.0,0.25,0.75
SF-I19,SF-L20,9,15,1,1,8,14,0.1111111111111111,0.8888888888888888,0.06666666666666667,0.9333333333333333
SF-I19,SF-N20-1,5,4,1,1,4,3,0.2,0.8,0.25,0.75
SF-I19,SF-M20,28,20,1,1,27,19,0.03571428571428571,0.9642857142857143,0.05,0.95
SF-I19,SF-K17-2,3,6,1,4,2,2,0.3333333333333333,0.6666666666666666,0.6666666666666666,0.3333333333333333
SF-I19,SF-K20,5,6,0,0,5,6,0.0,1.0,0.0,1.0
SF-I19,SF-K15-,32,77,4,9,28,68,0.125,0.875,0.11688311688311688,0.8831168831168831
SF-I19,SF-K19,8,9,5,4,3,5,0.625,0.375,0.4444444444444444,0.5555555555555556
SF-I19,SF-K18,4,10,1,4,3,6,0.25,0.75,0.4,0.6
SF-I19,SF-K17,10,10,4,6,6,4,0.4,0.6,0.6,0.4
SF-I19,SF-J16,7,3,3,1,4,2,0.42857142857142855,0.5714285714285714,0.3333333333333333,0.6666666666666666
SF-I19,SF-J18,29,18,22,3,7,15,0.7586206896551724,0.2413793103448276,0.16666666666666666,0.8333333333333334
SF-I19,SF-J20,6,5,1,4,5,1,0.16666666666666666,0.8333333333333334,0.8,0.2
SF-I19,SF-J19,7,6,1,4,6,2,0.14285714285714285,0.8571428571428571,0.6666666666666666,0.3333333333333333
SF-I19,SF-M12,3,4,0,1,3,3,0.0,1.0,0.25,0.75
SF-I19,SF-M10,1,2,0,0,1,2,0.0,1.0,0.0,1.0
SF-I19,SF-M11,5,11,2,1,3,10,0.4,0.6,0.09090909090909091,0.9090909090909091
SF-I19,SF-R19,2,1,0,0,2,1,0.0,1.0,0.0,1.0
SF-I19,SF-Q21-2,2,1,0,0,2,1,0.0,1.0,0.0,1.0
SF-I19,SF-O18,10,5,1,0,9,5,0.1,0.9,0.0,1.0
SF-I19,SF-O19,11,8,0,0,11,8,0.0,1.0,0.0,1.0
SF-I19,SF-O21,7,15,1,4,6,11,0.14285714285714285,0.8571428571428571,0.26666666666666666,0.7333333333333333
SF-I19,SF-O22,9,20,0,2,9,18,0.0,1.0,0.1,0.9
SF-I19,SF-N21,6,3,2,3,4,0,0.3333333333333333,0.6666666666666666,1.0,0.0
SF-I19,SF-N20-2,3,1,0,1,3,0,0.0,1.0,1.0,0.0
SF-I19,SF-M21,1,3,1,1,0,2,1.0,0.0,0.3333333333333333,0.6666666666666666
SF-I19,SF-L21,24,19,1,3,23,16,0.041666666666666664,0.9583333333333334,0.15789473684210525,0.8421052631578947
SF-I19,SF-N28,3,3,1,3,2,0,0.3333333333333333,0.6666666666666666,1.0,0.0
SF-I19,SF-L30-1,7,5,5,2,2,3,0.7142857142857143,0.2857142857142857,0.4,0.6
SF-I19,SF-J29-1,3,1,0,0,3,1,0.0,1.0,0.0,1.0
SF-I19,SF-I29-2,2,2,0,0,2,2,0.0,1.0,0.0,1.0
SF-I19,SF-I30-2,1,2,0,0,1,2,0.0,1.0,0.0,1.0
SF-I19,SF I29-1,13,5,0,0,13,5,0.0,1.0,0.0,1.0
SF-I19,SF-H28,1,1,0,1,1,0,0.0,1.0,1.0,0.0
SF-I19,SF-R24,1,4,0,1,1,3,0.0,1.0,0.25,0.75
SF-I19,SF-P26,1,1,0,0,1,1,0.0,1.0,0.0,1.0
SF-I19,SF-O25-2,1,1,0,0,1,1,0.0,1.0,0.0,1.0
SF-I19,SF-T21,1,1,0,0,1,1,0.0,1.0,0.0,1.0
SF-I19,SF-T22,5,2,0,1,5,1,0.0,1.0,0.5,0.5
SF-I19,SF-Q23-3,3,2,0,0,3,2,0.0,1.0,0.0,1.0
SF-I19,SF-Q22-1,6,6,2,6,4,0,0.3333333333333333,0.6666666666666666,1.0,0.0
SF-I19,SF-Q22-2,1,10,0,3,1,7,0.0,1.0,0.3,0.7
SF-I19,SF-P22,8,15,0,9,8,6,0.0,1.0,0.6,0.4
SF-I19,SF-U21,1,2,1,1,0,1,1.0,0.0,0.5,0.5
SF-I19,SF-V29,2,1,0,0,2,1,0.0,1.0,0.0,1.0
SF-I20,SF-M25,4,6,2,4,2,2,0.5,0.5,0.6666666666666666,0.3333333333333333
SF-I20,SF-M26-2,1,3,1,2,0,1,1.0,0.0,0.6666666666666666,0.3333333333333333
SF-I20,SF-L27,1,1,0,0,1,1,0.0,1.0,0.0,1.0
SF-I20,SF-K26,2,6,1,1,1,5,0.5,0.5,0.16666666666666666,0.8333333333333334
SF-I20,SF-J27,20,14,1,0,19,14,0.05,0.95,0.0,1.0
SF-I20,SF-M30,6,3,1,2,5,1,0.16666666666666666,0.8333333333333334,0.6666666666666666,0.3333333333333333
SF-I20,SF-J29-3,1,5,0,1,1,4,0.0,1.0,0.2,0.8
SF-I20,SF-J29,3,10,1,1,2,9,0.3333333333333333,0.6666666666666666,0.1,0.9
SF-I20,SF-L26,45,42,2,16,43,26,0.044444444444444446,0.9555555555555556,0.38095238095238093,0.6190476190476191
SF-I20,SF-L25,22,34,1,11,21,23,0.045454545454545456,0.9545454545454546,0.3235294117647059,0.6764705882352942
SF-I20,SF-M24,5,2,3,0,2,2,0.6,0.4,0.0,1.0
SF-I20,SF-L24,3,2,2,1,1,1,0.6666666666666666,0.3333333333333333,0.5,0.5
SF-I20,SF-K27-2,2,4,1,1,1,3,0.5,0.5,0.25,0.75
SF-I20,SF-J26-2,10,24,5,1,5,23,0.5,0.5,0.041666666666666664,0.9583333333333334
SF-I20,SF-J28-2,3,1,2,0,1,1,0.6666666666666666,0.3333333333333333,0.0,1.0
SF-I20,SF-K25,11,11,9,10,2,1,0.8181818181818182,0.18181818181818182,0.9090909090909091,0.09090909090909091
SF-I20,SF-J25,8,8,4,5,4,3,0.5,0.5,0.625,0.375
SF-I20,SF-H26-2,50,62,40,53,10,9,0.8,0.2,0.8548387096774194,0.14516129032258066
SF-I20,SF-J24,4,9,0,5,4,4,0.0,1.0,0.5555555555555556,0.4444444444444444
SF-I20,SF-J26,1,2,0,1,1,1,0.0,1.0,0.5,0.5
SF-I20,SF-I26-,6,3,2,1,4,2,0.3333333333333333,0.6666666666666666,0.3333333333333333,0.6666666666666666
SF-I20,SF-I25,43,20,36,9,7,11,0.8372093023255814,0.16279069767441862,0.45,0.55
SF-I20,SF-H26,29,34,20,22,9,12,0.6896551724137931,0.3103448275862069,0.6470588235294118,0.35294117647058826
SF-I20,SF-O23,5,5,0,3,5,2,0.0,1.0,0.6,0.4
SF-I20,SF-H27-1,1,5,1,4,0,1,1.0,0.0,0.8,0.2
SF-I20,SF-G27,19,18,16,10,3,8,0.8421052631578947,0.15789473684210525,0.5555555555555556,0.4444444444444444
SF-I20,SF-M22-2,2,3,0,1,2,2,0.0,1.0,0.3333333333333333,0.6666666666666666
SF-I20,SF-L22,1,2,1,1,0,1,1.0,0.0,0.5,0.5
SF-I20,SF-F27,5,9,2,3,3,6,0.4,0.6,0.3333333333333333,0.6666666666666666
SF-I20,SF-N22-2,5,8,0,1,5,7,0.0,1.0,0.125,0.875
SF-I20,SF-G28-2,1,47,0,27,1,20,0.0,1.0,0.574468085106383,0.425531914893617
SF-I20,SF-M22-1,4,4,2,0,2,4,0.5,0.5,0.0,1.0
SF-I20,SF-K22-2,4,8,3,5,1,3,0.75,0.25,0.625,0.375
SF-I20,SF-K24,13,2,2,0,11,2,0.15384615384615385,0.8461538461538461,0.0,1.0
SF-I20,SF-J23-2,5,2,2,1,3,1,0.4,0.6,0.5,0.5
SF-I20,SF-G23,12,8,8,4,4,4,0.6666666666666666,0.3333333333333333,0.5,0.5
SF-I20,SF-G24,22,12,6,0,16,12,0.2727272727272727,0.7272727272727273,0.0,1.0
SF-I20,SF-G25,9,10,4,3,5,7,0.4444444444444444,0.5555555555555556,0.3,0.7
SF-I20,SF-F23,9,10,5,6,4,4,0.5555555555555556,0.4444444444444444,0.6,0.4
SF-I20,SF-E23,5,8,1,1,4,7,0.2,0.8,0.125,0.875
SF-I20,SF-D24,2,2,0,1,2,1,0.0,1.0,0.5,0.5
SF-I20,SF-C22,5,3,1,0,4,3,0.2,0.8,0.0,1.0
SF-I20,SF-B22,1,10,1,0,0,10,1.0,0.0,0.0,1.0
SF-I20,SF-J17,18,12,4,2,14,10,0.2222222222222222,0.7777777777777778,0.16666666666666666,0.8333333333333334
SF-I20,SF-I19,13,9,7,5,6,4,0.5384615384615384,0.46153846153846156,0.5555555555555556,0.4444444444444444
SF-I20,SF-H16,11,2,7,0,4,2,0.6363636363636364,0.36363636363636365,0.0,1.0
SF-I20,SF-H19,11,6,4,4,7,2,0.36363636363636365,0.6363636363636364,0.6666666666666666,0.3333333333333333
SF-I20,SF-H20,18,5,12,3,6,2,0.6666666666666666,0.3333333333333333,0.6,0.4
SF-I20,SF-H18,4,3,1,0,3,3,0.25,0.75,0.0,1.0
SF-I20,SF-H17,1,1,1,0,0,1,1.0,0.0,0.0,1.0
SF-I20,SF-G19,8,7,5,5,3,2,0.625,0.375,0.7142857142857143,0.2857142857142857
SF-I20,SF-G17,3,2,1,1,2,1,0.3333333333333333,0.6666666666666666,0.5,0.5
SF-I20,SF-G18,6,14,5,9,1,5,0.8333333333333334,0.16666666666666666,0.6428571428571429,0.35714285714285715
SF-I20,SF-G20,14,5,11,3,3,2,0.7857142857142857,0.21428571428571427,0.6,0.4
SF-I20,SF-F19,7,14,2,6,5,8,0.2857142857142857,0.7142857142857143,0.42857142857142855,0.5714285714285714
SF-I20,SF-E18,14,4,3,1,11,3,0.21428571428571427,0.7857142857142857,0.25,0.75
SF-I20,SF-E20,6,7,2,3,4,4,0.3333333333333333,0.6666666666666666,0.42857142857142855,0.5714285714285714
SF-I20,SF-G30-2,8,9,5,6,3,3,0.625,0.375,0.6666666666666666,0.3333333333333333
SF-I20,SF-F30-1,2,2,0,1,2,1,0.0,1.0,0.5,0.5
SF-I20,SF-E29-2,7,9,1,5,6,4,0.14285714285714285,0.8571428571428571,0.5555555555555556,0.4444444444444444
SF-I20,SF-E29-1,2,4,0,4,2,0,0.0,1.0,1.0,0.0
SF-I20,SF-D29,2,1,0,1,2,0,0.0,1.0,1.0,0.0
SF-I20,SF-D28,13,29,3,26,10,3,0.23076923076923078,0.7692307692307693,0.896551724137931,0.10344827586206896
SF-I20,SF-G29-2,3,6,0,1,3,5,0.0,1.0,0.16666666666666666,0.8333333333333334
SF-I20,SF-G30-1,4,15,1,4,3,11,0.25,0.75,0.26666666666666666,0.7333333333333333
SF-I20,SF-F30-2,1,2,0,1,1,1,0.0,1.0,0.5,0.5
SF-I20,SF-F28-1,5,3,0,0,5,3,0.0,1.0,0.0,1.0
SF-I20,SF-E28,6,4,2,0,4,4,0.3333333333333333,0.6666666666666666,0.0,1.0
SF-I20,SF-J10,5,5,3,0,2,5,0.6,0.4,0.0,1.0
SF-I20,SF-J12,1,3,1,2,0,1,1.0,0.0,0.6666666666666666,0.3333333333333333
SF-I20,SF-H13,2,2,0,1,2,1,0.0,1.0,0.5,0.5
SF-I20,SF-I16,1,2,0,0,1,2,0.0,1.0,0.0,1.0
SF-I20,SF-H12,2,5,0,3,2,2,0.0,1.0,0.6,0.4
SF-I20,SF-H15,2,1,1,0,1,1,0.5,0.5,0.0,1.0
SF-I20,SF-G13,1,1,0,1,1,0,0.0,1.0,1.0,0.0
SF-I20,SF-G11,1,2,1,0,0,2,1.0,0.0,0.0,1.0
SF-I20,SF-F15,2,2,0,0,2,2,0.0,1.0,0.0,1.0
SF-I20,SF-C20,1,5,0,0,1,5,0.0,1.0,0.0,1.0
SF-I20,SF-B19,2,10,0,0,2,10,0.0,1.0,0.0,1.0
SF-I20,SF-A19,5,2,1,1,4,1,0.2,0.8,0.5,0.5
SF-I20,SF-C26,4,3,0,1,4,2,0.0,1.0,0.3333333333333333,0.6666666666666666
SF-I20,SF-C25,1,5,0,0,1,5,0.0,1.0,0.0,1.0
SF-I20,SF-D27,4,6,2,0,2,6,0.5,0.5,0.0,1.0
SF-I20,SF-C28-2,20,20,10,15,10,5,0.5,0.5,0.75,0.25
SF-I20,SF-J1,8,8,6,0,2,8,0.75,0.25,0.0,1.0
SF-I20,SF-H25,2,8,1,3,1,5,0.5,0.5,0.375,0.625
SF-I20,SF-G26,12,2,6,0,6,2,0.5,0.5,0.0,1.0
SF-I20,SF-K21,4,1,2,0,2,1,0.5,0.5,0.0,1.0
SF-I20,SF-K22-1,17,17,15,16,2,1,0.8823529411764706,0.11764705882352941,0.9411764705882353,0.058823529411764705
SF-I20,SF-J23-1,13,33,7,14,6,19,0.5384615384615384,0.46153846153846156,0.42424242424242425,0.5757575757575758
SF-I20,SF-J22-1,19,11,6,5,13,6,0.3157894736842105,0.6842105263157895,0.45454545454545453,0.5454545454545454
SF-I20,SF-J22-2,9,9,3,6,6,3,0.3333333333333333,0.6666666666666666,0.6666666666666666,0.3333333333333333
SF-I20,SF-J21,17,27,10,16,7,11,0.5882352941176471,0.4117647058823529,0.5925925925925926,0.4074074074074074
SF-I20,SF-I21,14,12,9,10,5,2,0.6428571428571429,0.35714285714285715,0.8333333333333334,0.16666666666666666
SF-I20,SF-I22,8,13,0,9,8,4,0.0,1.0,0.6923076923076923,0.3076923076923077
SF-I20,SF-I23-2,8,14,4,9,4,5,0.5,0.5,0.6428571428571429,0.35714285714285715
SF-I20,SF-I24,8,10,2,5,6,5,0.25,0.75,0.5,0.5
SF-I20,SF-I23-1,31,32,16,12,15,20,0.5161290322580645,0.4838709677419355,0.375,0.625
SF-I20,SF-F26,15,5,9,1,6,4,0.6,0.4,0.2,0.8
SF-I20,SF-M13,7,10,6,8,1,2,0.8571428571428571,0.14285714285714285,0.8,0.2
SF-I20,SF-M15,3,3,2,1,1,2,0.6666666666666666,0.3333333333333333,0.3333333333333333,0.6666666666666666
SF-I20,SF-L19,2,7,0,3,2,4,0.0,1.0,0.42857142857142855,0.5714285714285714
SF-I20,SF-L20,117,114,113,109,4,5,0.9658119658119658,0.03418803418803419,0.956140350877193,0.043859649122807015
SF-I20,SF-M20,12,13,3,7,9,6,0.25,0.75,0.5384615384615384,0.46153846153846156
SF-I20,SF-K17-2,3,1,2,0,1,1,0.6666666666666666,0.3333333333333333,0.0,1.0
SF-I20,SF-K20,3,2,2,0,1,2,0.6666666666666666,0.3333333333333333,0.0,1.0
SF-I20,SF-K15-,11,17,1,3,10,14,0.09090909090909091,0.9090909090909091,0.17647058823529413,0.8235294117647058
SF-I20,SF-K19,3,3,1,0,2,3,0.3333333333333333,0.6666666666666666,0.0,1.0
SF-I20,SF-K18,6,7,4,2,2,5,0.6666666666666666,0.3333333333333333,0.2857142857142857,0.7142857142857143
SF-I20,SF-K17,11,5,5,1,6,4,0.45454545454545453,0.5454545454545454,0.2,0.8
SF-I20,SF-J16,2,2,1,2,1,0,0.5,0.5,1.0,0.0
SF-I20,SF-J18,5,13,1,7,4,6,0.2,0.8,0.5384615384615384,0.46153846153846156
SF-I20,SF-J20,23,10,14,7,9,3,0.6086956521739131,0.391304347826087,0.7,0.3
SF-I20,SF-J19,8,16,5,12,3,4,0.625,0.375,0.75,0.25
SF-I20,SF-M10,2,4,1,0,1,4,0.5,0.5,0.0,1.0
SF-I20,SF-M11,5,3,2,2,3,1,0.4,0.6,0.6666666666666666,0.3333333333333333
SF-I20,SF-Q21-1,1,2,1,1,0,1,1.0,0.0,0.5,0.5
SF-I20,SF-O18,9,3,2,3,7,0,0.2222222222222222,0.7777777777777778,1.0,0.0
SF-I20,SF-O19,1,5,0,2,1,3,0.0,1.0,0.4,0.6
SF-I20,SF-O21,3,11,0,3,3,8,0.0,1.0,0.2727272727272727,0.7272727272727273
SF-I20,SF-O22,9,3,3,1,6,2,0.3333333333333333,0.6666666666666666,0.3333333333333333,0.6666666666666666
SF-I20,SF-L21,6,6,4,4,2,2,0.6666666666666666,0.3333333333333333,0.6666666666666666,0.3333333333333333
SF-I20,SF-O30,5,2,3,0,2,2,0.6,0.4,0.0,1.0
SF-I20,SF-L30-1,18,21,7,5,11,16,0.3888888888888889,0.6111111111111112,0.23809523809523808,0.7619047619047619
SF-I20,SF-K30-2,5,2,2,1,3,1,0.4,0.6,0.5,0.5
SF-I20,SF-L29,13,7,4,5,9,2,0.3076923076923077,0.6923076923076923,0.7142857142857143,0.2857142857142857
SF-I20,SF-J29-1,1,3,0,0,1,3,0.0,1.0,0.0,1.0
SF-I20,SF-I28,1,2,0,2,1,0,0.0,1.0,1.0,0.0
SF-I20,SF I29-1,2,1,0,0,2,1,0.0,1.0,0.0,1.0
SF-I20,SF-H28,2,4,0,4,2,0,0.0,1.0,1.0,0.0
SF-I20,SF-P26,19,22,0,0,19,22,0.0,1.0,0.0,1.0
SF-I20,SF-S22-1,1,2,0,0,1,2,0.0,1.0,0.0,1.0
SF-I20,SF-Q22-2,2,2,0,0,2,2,0.0,1.0,0.0,1.0
SF-I20,SF-P22,2,1,1,0,1,1,0.5,0.5,0.0,1.0
SF-I20,SF-T20,1,1,0,1,1,0,0.0,1.0,1.0,0.0
SF-I20,SF-S21,2,2,2,1,0,1,1.0,0.0,0.5,0.5
SF-H16,SF-M30,2,1,0,0,2,1,0.0,1.0,0.0,1.0
SF-H16,SF-L26,3,1,0,0,3,1,0.0,1.0,0.0,1.0
SF-H16,SF-M24,1,3,0,2,1,1,0.0,1.0,0.6666666666666666,0.3333333333333333
SF-H16,SF-L24,4,1,1,0,3,1,0.25,0.75,0.0,1.0
SF-H16,SF-N23,4,4,1,1,3,3,0.25,0.75,0.25,0.75
SF-H16,SF-K27-2,1,3,0,0,1,3,0.0,1.0,0.0,1.0
SF-H16,SF-J26-2,1,1,0,1,1,0,0.0,1.0,1.0,0.0
SF-H16,SF-L28,1,1,0,0,1,1,0.0,1.0,0.0,1.0
SF-H16,SF-J25,6,3,1,2,5,1,0.16666666666666666,0.8333333333333334,0.6666666666666666,0.3333333333333333
SF-H16,SF-H26-2,2,1,0,0,2,1,0.0,1.0,0.0,1.0
SF-H16,SF-O24,2,1,0,1,2,0,0.0,1.0,1.0,0.0
SF-H16,SF-H26,1,1,0,0,1,1,0.0,1.0,0.0,1.0
SF-H16,SF-F28-2,2,7,0,0,2,7,0.0,1.0,0.0,1.0
SF-H16,SF-G27,1,3,0,0,1,3,0.0,1.0,0.0,1.0
SF-H16,SF-M22-2,2,9,0,4,2,5,0.0,1.0,0.4444444444444444,0.5555555555555556
SF-H16,SF-F27,2,4,1,2,1,2,0.5,0.5,0.5,0.5
SF-H16,SF-N22-2,2,1,0,0,2,1,0.0,1.0,0.0,1.0
SF-H16,SF-K24,1,4,0,2,1,2,0.0,1.0,0.5,0.5
SF-H16,SF-G23,4,9,0,1,4,8,0.0,1.0,0.1111111111111111,0.8888888888888888
SF-H16,SF-G24,6,7,0,0,6,7,0.0,1.0,0.0,1.0
SF-H16,SF-G25,5,5,0,0,5,5,0.0,1.0,0.0,1.0
SF-H16,SF-F23,11,2,0,0,11,2,0.0,1.0,0.0,1.0
SF-H16,SF-E23,14,8,3,1,11,7,0.21428571428571427,0.7857142857142857,0.125,0.875
SF-H16,SF-D24,4,4,0,0,4,4,0.0,1.0,0.0,1.0
SF-H16,SF-J17,62,65,13,26,49,39,0.20967741935483872,0.7903225806451613,0.4,0.6
SF-H16,SF-I19,5,4,1,1,4,3,0.2,0.8,0.25,0.75
SF-H16,SF-I20,2,11,0,7,2,4,0.0,1.0,0.6363636363636364,0.36363636363636365
SF-H16,SF-H19,6,5,0,0,6,5,0.0,1.0,0.0,1.0
SF-H16,SF-H20,3,12,1,10,2,2,0.3333333333333333,0.6666666666666666,0.8333333333333334,0.16666666666666666
SF-H16,SF-H18,11,17,0,6,11,11,0.0,1.0,0.35294117647058826,0.6470588235294118
SF-H16,SF-H17,7,6,2,3,5,3,0.2857142857142857,0.7142857142857143,0.5,0.5
SF-H16,SF-G19,8,20,0,9,8,11,0.0,1.0,0.45,0.55
SF-H16,SF-G17,9,8,4,0,5,8,0.4444444444444444,0.5555555555555556,0.0,1.0
SF-H16,SF-G18,16,7,3,1,13,6,0.1875,0.8125,0.14285714285714285,0.8571428571428571
SF-H16,SF-G20,22,27,3,13,19,14,0.13636363636363635,0.8636363636363636,0.48148148148148145,0.5185185185185185
SF-H16,SF-F19,8,13,1,3,7,10,0.125,0.875,0.23076923076923078,0.7692307692307693
SF-H16,SF-E18,16,26,7,9,9,17,0.4375,0.5625,0.34615384615384615,0.6538461538461539
SF-H16,SF-E20,7,7,2,2,5,5,0.2857142857142857,0.7142857142857143,0.2857142857142857,0.7142857142857143
SF-H16,SF-G29-2,1,2,0,1,1,1,0.0,1.0,0.5,0.5
SF-H16,SF-J10,11,10,4,5,7,5,0.36363636363636365,0.6363636363636364,0.5,0.5
SF-H16,SF-J12,30,39,5,9,25,30,0.16666666666666666,0.8333333333333334,0.23076923076923078,0.7692307692307693
SF-H16,SF-J13,32,42,3,10,29,32,0.09375,0.90625,0.23809523809523808,0.7619047619047619
SF-H16,SF-J15,38,16,22,5,16,11,0.5789473684210527,0.42105263157894735,0.3125,0.6875
SF-H16,SF-J14,15,8,8,2,7,6,0.5333333333333333,0.4666666666666667,0.25,0.75
SF-H16,SF-H13,20,30,4,12,16,18,0.2,0.8,0.4,0.6
SF-H16,SF-I16,86,73,68,30,18,43,0.7906976744186046,0.20930232558139536,0.410958904109589,0.589041095890411
SF-H16,SF-H12,22,25,3,14,19,11,0.13636363636363635,0.8636363636363636,0.56,0.44
SF-H16,SF-G10-2,11,11,2,3,9,8,0.18181818181818182,0.8181818181818182,0.2727272727272727,0.7272727272727273
SF-H16,SF-H15,28,28,17,17,11,11,0.6071428571428571,0.39285714285714285,0.6071428571428571,0.39285714285714285
SF-H16,SF-G9,14,15,6,5,8,10,0.42857142857142855,0.5714285714285714,0.3333333333333333,0.6666666666666666
SF-H16,SF-H14,18,18,7,13,11,5,0.3888888888888889,0.6111111111111112,0.7222222222222222,0.2777777777777778
SF-H16,SF-G13,36,28,14,8,22,20,0.3888888888888889,0.6111111111111112,0.2857142857142857,0.7142857142857143
SF-H16,SF-G11,9,11,3,3,6,8,0.3333333333333333,0.6666666666666666,0.2727272727272727,0.7272727272727273
SF-H16,SF-G12,28,19,4,6,24,13,0.14285714285714285,0.8571428571428571,0.3157894736842105,0.6842105263157895
SF-H16,SF-G10-1,3,8,1,2,2,6,0.3333333333333333,0.6666666666666666,0.25,0.75
SF-H16,SF-F15,26,19,10,5,16,14,0.38461538461538464,0.6153846153846154,0.2631578947368421,0.7368421052631579
SF-H16,SF-F16,16,11,8,4,8,7,0.5,0.5,0.36363636363636365,0.6363636363636364
SF-H16,SF-C21,1,2,0,0,1,2,0.0,1.0,0.0,1.0
SF-H16,SF-C20,7,2,1,0,6,2,0.14285714285714285,0.8571428571428571,0.0,1.0
SF-H16,SF-B19,5,15,0,7,5,8,0.0,1.0,0.4666666666666667,0.5333333333333333
SF-H16,SF-A20,1,5,0,3,1,2,0.0,1.0,0.6,0.4
SF-H16,SF-C26,1,2,1,2,0,0,1.0,0.0,1.0,0.0
SF-H16,SF-C25,4,5,0,0,4,5,0.0,1.0,0.0,1.0
SF-H16,SF-D27,1,1,0,0,1,1,0.0,1.0,0.0,1.0
SF-H16,SF-J1,12,15,0,2,12,13,0.0,1.0,0.13333333333333333,0.8666666666666667
SF-H16,SF-H0,1,4,0,0,1,4,0.0,1.0,0.0,1.0
SF-H16,SF-J3,4,12,1,3,3,9,0.25,0.75,0.25,0.75
SF-H16,SF-J5,3,6,0,3,3,3,0.0,1.0,0.5,0.5
SF-H16,SF-G6,2,3,1,1,1,2,0.5,0.5,0.3333333333333333,0.6666666666666666
SF-H16,SF-G8,11,11,3,6,8,5,0.2727272727272727,0.7272727272727273,0.5454545454545454,0.45454545454545453
SF-H16,SF-G5,27,10,1,0,26,10,0.037037037037037035,0.9629629629629629,0.0,1.0
SF-H16,SF-G7,33,25,5,0,28,25,0.15151515151515152,0.8484848484848485,0.0,1.0
SF-H16,SF-F9,4,9,1,4,3,5,0.25,0.75,0.4444444444444444,0.5555555555555556
SF-H16,SF-G26,4,3,0,1,4,2,0.0,1.0,0.3333333333333333,0.6666666666666666
SF-H16,SF-K21,12,21,0,7,12,14,0.0,1.0,0.3333333333333333,0.6666666666666666
SF-H16,SF-J23-1,5,10,0,1,5,9,0.0,1.0,0.1,0.9
SF-H16,SF-J22-1,2,2,0,0,2,2,0.0,1.0,0.0,1.0
SF-H16,SF-J21,17,11,0,3,17,8,0.0,1.0,0.2727272727272727,0.7272727272727273
SF-H16,SF-I21,9,4,0,1,9,3,0.0,1.0,0.25,0.75
SF-H16,SF-I22,2,2,0,1,2,1,0.0,1.0,0.5,0.5
SF-H16,SF-I23-2,5,2,0,0,5,2,0.0,1.0,0.0,1.0
SF-H16,SF-I23-1,2,12,0,0,2,12,0.0,1.0,0.0,1.0
SF-H16,SF-F26,6,17,0,2,6,15,0.0,1.0,0.11764705882352941,0.8823529411764706
SF-H16,SF-M13,42,24,4,7,38,17,0.09523809523809523,0.9047619047619048,0.2916666666666667,0.7083333333333334
SF-H16,SF-M15,38,48,5,10,33,38,0.13157894736842105,0.868421052631579,0.20833333333333334,0.7916666666666666
SF-H16,SF-L19,5,8,1,2,4,6,0.2,0.8,0.25,0.75
SF-H16,SF-L20,11,7,3,2,8,5,0.2727272727272727,0.7272727272727273,0.2857142857142857,0.7142857142857143
SF-H16,SF-N20-1,2,2,0,0,2,2,0.0,1.0,0.0,1.0
SF-H16,SF-M20,5,22,0,4,5,18,0.0,1.0,0.18181818181818182,0.8181818181818182
SF-H16,SF-K17-2,18,40,1,17,17,23,0.05555555555555555,0.9444444444444444,0.425,0.575
SF-H16,SF-K20,22,15,5,2,17,13,0.22727272727272727,0.7727272727272727,0.13333333333333333,0.8666666666666667
SF-H16,SF-K15-,53,87,12,35,41,52,0.22641509433962265,0.7735849056603774,0.40229885057471265,0.5977011494252874
SF-H16,SF-K19,29,22,2,5,27,17,0.06896551724137931,0.9310344827586207,0.22727272727272727,0.7727272727272727
SF-H16,SF-K18,45,52,4,25,41,27,0.08888888888888889,0.9111111111111111,0.4807692307692308,0.5192307692307693
SF-H16,SF-K17,66,69,13,28,53,41,0.19696969696969696,0.803030303030303,0.4057971014492754,0.5942028985507246
SF-H16,SF-J16,60,99,19,66,41,33,0.31666666666666665,0.6833333333333333,0.6666666666666666,0.3333333333333333
SF-H16,SF-J18,46,62,5,19,41,43,0.10869565217391304,0.8913043478260869,0.3064516129032258,0.6935483870967742
SF-H16,SF-J20,2,7,0,4,2,3,0.0,1.0,0.5714285714285714,0.42857142857142855
SF-H16,SF-J19,19,27,4,6,15,21,0.21052631578947367,0.7894736842105263,0.2222222222222222,0.7777777777777778
SF-H16,SF-M12,25,12,4,1,21,11,0.16,0.84,0.08333333333333333,0.9166666666666666
SF-H16,SF-M10,13,17,0,2,13,15,0.0,1.0,0.11764705882352941,0.8823529411764706
SF-H16,SF-M11,16,18,0,2,16,16,0.0,1.0,0.1111111111111111,0.8888888888888888
SF-H16,SF-R19,1,7,0,0,1,7,0.0,1.0,0.0,1.0
SF-H16,SF-R20,2,3,0,0,2,3,0.0,1.0,0.0,1.0
SF-H16,SF-Q21-2,1,1,0,0,1,1,0.0,1.0,0.0,1.0
SF-H16,SF-P21,3,6,0,1,3,5,0.0,1.0,0.16666666666666666,0.8333333333333334
SF-H16,SF-O18,1,3,0,0,1,3,0.0,1.0,0.0,1.0
SF-H16,SF-O19,2,3,0,1,2,2,0.0,1.0,0.3333333333333333,0.6666666666666666
SF-H16,SF-O21,7,17,0,2,7,15,0.0,1.0,0.11764705882352941,0.8823529411764706
SF-H16,SF-O22,9,6,3,3,6,3,0.3333333333333333,0.6666666666666666,0.5,0.5
SF-H16,SF-N21,8,6,5,3,3,3,0.625,0.375,0.5,0.5
SF-H16,SF-N20-2,3,1,0,0,3,1,0.0,1.0,0.0,1.0
SF-H16,SF-M21,5,5,0,3,5,2,0.0,1.0,0.6,0.4
SF-H16,SF-L21,9,7,0,4,9,3,0.0,1.0,0.5714285714285714,0.42857142857142855
SF-H16,SF-N27,2,1,0,0,2,1,0.0,1.0,0.0,1.0
SF-H16,SF-L30-1,2,2,0,0,2,2,0.0,1.0,0.0,1.0
SF-H16,SF-N22-1B,2,1,0,1,2,0,0.0,1.0,1.0,0.0
SF-H16,SF-T22,2,1,0,0,2,1,0.0,1.0,0.0,1.0
SF-H16,SF-S22-1,11,6,0,0,11,6,0.0,1.0,0.0,1.0
SF-H16,SF-Q23-3,1,2,0,0,1,2,0.0,1.0,0.0,1.0
SF-H16,SF-Q22-2,2,2,0,2,2,0,0.0,1.0,1.0,0.0
SF-H16,SF-T20,1,1,0,0,1,1,0.0,1.0,0.0,1.0
SF-H19,SF-M30,3,2,2,2,1,0,0.6666666666666666,0.3333333333333333,1.0,0.0
SF-H19,SF-J25,1,1,1,1,0,0,1.0,0.0,1.0,0.0
SF-H19,SF-P24,2,2,1,1,1,1,0.5,0.5,0.5,0.5
SF-H19,SF-H26,1,6,0,3,1,3,0.0,1.0,0.5,0.5
SF-H19,SF-F28-2,1,5,1,4,0,1,1.0,0.0,0.8,0.2
SF-H19,SF-G27,4,6,0,2,4,4,0.0,1.0,0.3333333333333333,0.6666666666666666
SF-H19,SF-L22,1,2,1,1,0,1,1.0,0.0,0.5,0.5
SF-H19,SF-F27,1,2,0,0,1,2,0.0,1.0,0.0,1.0
SF-H19,SF-N22-2,2,3,1,0,1,3,0.5,0.5,0.0,1.0
SF-H19,SF-K24,3,2,0,0,3,2,0.0,1.0,0.0,1.0
SF-H19,SF-G24,4,9,0,1,4,8,0.0,1.0,0.1111111111111111,0.8888888888888888
SF-H19,SF-F23,47,3,1,1,46,2,0.02127659574468085,0.9787234042553191,0.3333333333333333,0.6666666666666666
SF-H19,SF-J17,7,6,1,0,6,6,0.14285714285714285,0.8571428571428571,0.0,1.0
SF-H19,SF-I19,7,7,3,5,4,2,0.42857142857142855,0.5714285714285714,0.7142857142857143,0.2857142857142857
SF-H19,SF-I20,6,11,4,4,2,7,0.6666666666666666,0.3333333333333333,0.36363636363636365,0.6363636363636364
SF-H19,SF-H16,5,6,0,0,5,6,0.0,1.0,0.0,1.0
SF-H19,SF-H20,9,9,8,8,1,1,0.8888888888888888,0.1111111111111111,0.8888888888888888,0.1111111111111111
SF-H19,SF-H18,13,3,12,2,1,1,0.9230769230769231,0.07692307692307693,0.6666666666666666,0.3333333333333333
SF-H19,SF-H17,9,4,4,0,5,4,0.4444444444444444,0.5555555555555556,0.0,1.0
SF-H19,SF-G19,23,13,11,9,12,4,0.4782608695652174,0.5217391304347826,0.6923076923076923,0.3076923076923077
SF-H19,SF-G18,1,5,1,3,0,2,1.0,0.0,0.6,0.4
SF-H19,SF-G20,7,8,5,6,2,2,0.7142857142857143,0.2857142857142857,0.75,0.25
SF-H19,SF-F19,1,2,1,2,0,0,1.0,0.0,1.0,0.0
SF-H19,SF-E18,2,1,1,0,1,1,0.5,0.5,0.0,1.0
SF-H19,SF-F30-2,1,22,0,6,1,16,0.0,1.0,0.2727272727272727,0.7272727272727273
SF-H19,SF-F28-1,4,3,4,3,0,0,1.0,0.0,1.0,0.0
SF-H19,SF-J10,3,2,0,0,3,2,0.0,1.0,0.0,1.0
SF-H19,SF-J15,9,7,2,1,7,6,0.2222222222222222,0.7777777777777778,0.14285714285714285,0.8571428571428571
SF-H19,SF-J14,1,1,0,1,1,0,0.0,1.0,1.0,0.0
SF-H19,SF-I16,6,1,4,1,2,0,0.6666666666666666,0.3333333333333333,1.0,0.0
SF-H19,SF-H12,14,7,11,2,3,5,0.7857142857142857,0.21428571428571427,0.2857142857142857,0.7142857142857143
SF-H19,SF-H14,4,1,0,0,4,1,0.0,1.0,0.0,1.0
SF-H19,SF-G13,1,1,1,0,0,1,1.0,0.0,0.0,1.0
SF-H19,SF-G12,2,4,0,1,2,3,0.0,1.0,0.25,0.75
SF-H19,SF-F15,1,5,0,2,1,3,0.0,1.0,0.4,0.6
SF-H19,SF-B19,1,1,0,1,1,0,0.0,1.0,1.0,0.0
SF-H19,SF-B25,1,3,0,0,1,3,0.0,1.0,0.0,1.0
SF-H19,SF-D27,2,2,0,0,2,2,0.0,1.0,0.0,1.0
SF-H19,SF-J1,2,5,0,2,2,3,0.0,1.0,0.4,0.6
SF-H19,SF-H0,2,1,0,0,2,1,0.0,1.0,0.0,1.0
SF-H19,SF-G7,3,1,3,1,0,0,1.0,0.0,1.0,0.0
SF-H19,SF-K21,2,1,1,0,1,1,0.5,0.5,0.0,1.0
SF-H19,SF-J23-1,1,7,0,7,1,0,0.0,1.0,1.0,0.0
SF-H19,SF-J22-1,3,1,2,0,1,1,0.6666666666666666,0.3333333333333333,0.0,1.0
SF-H19,SF-J21,12,13,4,7,8,6,0.3333333333333333,0.6666666666666666,0.5384615384615384,0.46153846153846156
SF-H19,SF-I21,1,4,0,3,1,1,0.0,1.0,0.75,0.25
SF-H19,SF-I22,3,4,2,1,1,3,0.6666666666666666,0.3333333333333333,0.25,0.75
SF-H19,SF-I23-2,1,1,0,1,1,0,0.0,1.0,1.0,0.0
SF-H19,SF-I23-1,3,1,2,1,1,0,0.6666666666666666,0.3333333333333333,1.0,0.0
SF-H19,SF-F26,11,20,0,0,11,20,0.0,1.0,0.0,1.0
SF-H19,SF-M15,1,3,0,2,1,1,0.0,1.0,0.6666666666666666,0.3333333333333333
SF-H19,SF-L19,4,4,1,1,3,3,0.25,0.75,0.25,0.75
SF-H19,SF-L20,2,1,0,1,2,0,0.0,1.0,1.0,0.0
SF-H19,SF-M20,3,2,1,0,2,2,0.3333333333333333,0.6666666666666666,0.0,1.0
SF-H19,SF-K20,15,7,10,0,5,7,0.6666666666666666,0.3333333333333333,0.0,1.0
SF-H19,SF-K15-,7,12,3,6,4,6,0.42857142857142855,0.5714285714285714,0.5,0.5
SF-H19,SF-K19,8,19,2,3,6,16,0.25,0.75,0.15789473684210525,0.8421052631578947
SF-H19,SF-K18,3,4,0,2,3,2,0.0,1.0,0.5,0.5
SF-H19,SF-K17,6,5,3,1,3,4,0.5,0.5,0.2,0.8
SF-H19,SF-J18,13,12,8,5,5,7,0.6153846153846154,0.38461538461538464,0.4166666666666667,0.5833333333333334
SF-H19,SF-J20,3,1,1,1,2,0,0.3333333333333333,0.6666666666666666,1.0,0.0
SF-H19,SF-J19,15,7,10,3,5,4,0.6666666666666666,0.3333333333333333,0.42857142857142855,0.5714285714285714
SF-H19,SF-M11,2,4,1,1,1,3,0.5,0.5,0.25,0.75
SF-H19,SF-O18,1,3,0,0,1,3,0.0,1.0,0.0,1.0
SF-H19,SF-O19,11,5,0,0,11,5,0.0,1.0,0.0,1.0
SF-H19,SF-O21,1,5,0,2,1,3,0.0,1.0,0.4,0.6
SF-H19,SF-O22,2,1,1,0,1,1,0.5,0.5,0.0,1.0
SF-H19,SF-L21,5,2,1,0,4,2,0.2,0.8,0.0,1.0
SF-H19,SF-I30-2,3,3,2,2,1,1,0.6666666666666666,0.3333333333333333,0.6666666666666666,0.3333333333333333
SF-H19,SF-H28,13,12,13,11,0,1,1.0,0.0,0.9166666666666666,0.08333333333333333
SF-H19,SF-Q23-3,1,2,0,0,1,2,0.0,1.0,0.0,1.0
SF-H20,SF-M25,2,4,2,1,0,3,1.0,0.0,0.25,0.75
SF-H20,SF-M26-2,7,5,3,3,4,2,0.42857142857142855,0.5714285714285714,0.6,0.4
SF-H20,SF-L27,1,8,0,8,1,0,0.0,1.0,1.0,0.0
SF-H20,SF-K26,10,28,1,21,9,7,0.1,0.9,0.75,0.25
SF-H20,SF-M30,4,3,0,3,4,0,0.0,1.0,1.0,0.0
SF-H20,SF-J29,7,12,2,1,5,11,0.2857142857142857,0.7142857142857143,0.08333333333333333,0.9166666666666666
SF-H20,SF-L26,4,1,2,0,2,1,0.5,0.5,0.0,1.0
SF-H20,SF-M28,7,1,1,1,6,0,0.14285714285714285,0.8571428571428571,1.0,0.0
SF-H20,SF-M27,2,1,0,1,2,0,0.0,1.0,1.0,0.0
SF-H20,SF-L25,2,2,0,2,2,0,0.0,1.0,1.0,0.0
SF-H20,SF-M24,1,1,0,0,1,1,0.0,1.0,0.0,1.0
SF-H20,SF-L24,5,9,3,8,2,1,0.6,0.4,0.8888888888888888,0.1111111111111111
SF-H20,SF-N23,1,2,0,1,1,1,0.0,1.0,0.5,0.5
SF-H20,SF-K27-2,12,6,5,2,7,4,0.4166666666666667,0.5833333333333334,0.3333333333333333,0.6666666666666666
SF-H20,SF-J26-2,7,13,5,10,2,3,0.7142857142857143,0.2857142857142857,0.7692307692307693,0.23076923076923078
SF-H20,SF-L28,3,2,2,1,1,1,0.6666666666666666,0.3333333333333333,0.5,0.5
SF-H20,SF-K29-1,3,2,2,2,1,0,0.6666666666666666,0.3333333333333333,1.0,0.0
SF-H20,SF-K27,5,1,2,0,3,1,0.4,0.6,0.0,1.0
SF-H20,SF-K25,4,11,1,8,3,3,0.25,0.75,0.7272727272727273,0.2727272727272727
SF-H20,SF-J25,51,43,48,37,3,6,0.9411764705882353,0.058823529411764705,0.8604651162790697,0.13953488372093023
SF-H20,SF-H26-2,3,3,0,0,3,3,0.0,1.0,0.0,1.0
SF-H20,SF-P24,1,1,0,0,1,1,0.0,1.0,0.0,1.0
SF-H20,SF-N22-1A,1,1,1,1,0,0,1.0,0.0,1.0,0.0
SF-H20,SF-J24,11,21,5,9,6,12,0.45454545454545453,0.5454545454545454,0.42857142857142855,0.5714285714285714
SF-H20,SF-J26,2,4,1,1,1,3,0.5,0.5,0.25,0.75
SF-H20,SF-I26-,7,5,3,3,4,2,0.42857142857142855,0.5714285714285714,0.6,0.4
SF-H20,SF-I25,16,9,7,5,9,4,0.4375,0.5625,0.5555555555555556,0.4444444444444444
SF-H20,SF-H26,18,24,10,17,8,7,0.5555555555555556,0.4444444444444444,0.7083333333333334,0.2916666666666667
SF-H20,SF-O23,1,3,0,2,1,1,0.0,1.0,0.6666666666666666,0.3333333333333333
SF-H20,SF-H27-1,4,3,3,1,1,2,0.75,0.25,0.3333333333333333,0.6666666666666666
SF-H20,SF-F28-2,8,8,5,5,3,3,0.625,0.375,0.625,0.375
SF-H20,SF-G27,13,20,3,10,10,10,0.23076923076923078,0.7692307692307693,0.5,0.5
SF-H20,SF-M22-2,11,11,4,5,7,6,0.36363636363636365,0.6363636363636364,0.45454545454545453,0.5454545454545454
SF-H20,SF-L22,6,5,1,1,5,4,0.16666666666666666,0.8333333333333334,0.2,0.8
SF-H20,SF-F27,5,5,0,0,5,5,0.0,1.0,0.0,1.0
SF-H20,SF-N22-2,20,23,7,10,13,13,0.35,0.65,0.43478260869565216,0.5652173913043478
SF-H20,SF-G28-2,5,3,5,2,0,1,1.0,0.0,0.6666666666666666,0.3333333333333333
SF-H20,SF-M22-1,4,1,2,0,2,1,0.5,0.5,0.0,1.0
SF-H20,SF-K22-2,8,12,4,5,4,7,0.5,0.5,0.4166666666666667,0.5833333333333334
SF-H20,SF-K24,6,3,3,1,3,2,0.5,0.5,0.3333333333333333,0.6666666666666666
SF-H20,SF-J23-2,7,8,5,6,2,2,0.7142857142857143,0.2857142857142857,0.75,0.25
SF-H20,SF-G23,7,6,1,3,6,3,0.14285714285714285,0.8571428571428571,0.5,0.5
SF-H20,SF-G24,40,42,6,3,34,39,0.15,0.85,0.07142857142857142,0.9285714285714286
SF-H20,SF-G25,13,25,3,5,10,20,0.23076923076923078,0.7692307692307693,0.2,0.8
SF-H20,SF-F23,21,21,2,3,19,18,0.09523809523809523,0.9047619047619048,0.14285714285714285,0.8571428571428571
SF-H20,SF-E23,9,20,1,7,8,13,0.1111111111111111,0.8888888888888888,0.35,0.65
SF-H20,SF-C22,2,5,1,0,1,5,0.5,0.5,0.0,1.0
SF-H20,SF-B22,6,6,1,4,5,2,0.16666666666666666,0.8333333333333334,0.6666666666666666,0.3333333333333333
SF-H20,SF-J17,15,13,9,2,6,11,0.6,0.4,0.15384615384615385,0.8461538461538461
SF-H20,SF-I19,22,12,9,8,13,4,0.4090909090909091,0.5909090909090909,0.6666666666666666,0.3333333333333333
SF-H20,SF-I20,5,18,3,12,2,6,0.6,0.4,0.6666666666666666,0.3333333333333333
SF-H20,SF-H16,12,3,10,1,2,2,0.8333333333333334,0.16666666666666666,0.3333333333333333,0.6666666666666666
SF-H20,SF-H19,9,9,8,8,1,1,0.8888888888888888,0.1111111111111111,0.8888888888888888,0.1111111111111111
SF-H20,SF-H18,11,7,9,4,2,3,0.8181818181818182,0.18181818181818182,0.5714285714285714,0.42857142857142855
SF-H20,SF-H17,6,19,4,13,2,6,0.6666666666666666,0.3333333333333333,0.6842105263157895,0.3157894736842105
SF-H20,SF-G19,8,8,5,4,3,4,0.625,0.375,0.5,0.5
SF-H20,SF-G17,11,4,7,2,4,2,0.6363636363636364,0.36363636363636365,0.5,0.5
SF-H20,SF-G18,26,15,11,6,15,9,0.4230769230769231,0.5769230769230769,0.4,0.6
SF-H20,SF-G20,48,25,33,15,15,10,0.6875,0.3125,0.6,0.4
SF-H20,SF-F19,10,16,2,4,8,12,0.2,0.8,0.25,0.75
SF-H20,SF-E18,2,15,2,4,0,11,1.0,0.0,0.26666666666666666,0.7333333333333333
SF-H20,SF-E20,16,12,10,0,6,12,0.625,0.375,0.0,1.0
SF-H20,SF-H30,3,1,2,0,1,1,0.6666666666666666,0.3333333333333333,0.0,1.0
SF-H20,SF-G30-2,1,3,0,0,1,3,0.0,1.0,0.0,1.0
SF-H20,SF-F30-1,1,3,0,0,1,3,0.0,1.0,0.0,1.0
SF-H20,SF-E29-2,15,13,8,10,7,3,0.5333333333333333,0.4666666666666667,0.7692307692307693,0.23076923076923078
SF-H20,SF-E29-1,4,6,4,4,0,2,1.0,0.0,0.6666666666666666,0.3333333333333333
SF-H20,SF-D28,1,4,0,2,1,2,0.0,1.0,0.5,0.5
SF-H20,SF-A27,1,1,1,0,0,1,1.0,0.0,0.0,1.0
SF-H20,SF-G29-2,4,6,2,4,2,2,0.5,0.5,0.6666666666666666,0.3333333333333333
SF-H20,SF-G30-1,2,6,1,2,1,4,0.5,0.5,0.3333333333333333,0.6666666666666666
SF-H20,SF-F30-2,5,4,2,1,3,3,0.4,0.6,0.25,0.75
SF-H20,SF-E29-3,1,1,0,0,1,1,0.0,1.0,0.0,1.0
SF-H20,SF-F28-1,2,8,0,5,2,3,0.0,1.0,0.625,0.375
SF-H20,SF-J10,1,6,1,1,0,5,1.0,0.0,0.16666666666666666,0.8333333333333334
SF-H20,SF-J12,5,9,2,0,3,9,0.4,0.6,0.0,1.0
SF-H20,SF-J13,2,2,0,0,2,2,0.0,1.0,0.0,1.0
SF-H20,SF-J15,1,4,0,0,1,4,0.0,1.0,0.0,1.0
SF-H20,SF-H12,2,3,0,0,2,3,0.0,1.0,0.0,1.0
SF-H20,SF-H15,1,2,0,0,1,2,0.0,1.0,0.0,1.0
SF-H20,SF-G13,1,2,0,0,1,2,0.0,1.0,0.0,1.0
SF-H20,SF-G12,1,2,1,0,0,2,1.0,0.0,0.0,1.0
SF-H20,SF-F16,4,8,4,1,0,7,1.0,0.0,0.125,0.875
SF-H20,SF-C20,2,4,1,0,1,4,0.5,0.5,0.0,1.0
SF-H20,SF-B21,2,1,0,0,2,1,0.0,1.0,0.0,1.0
SF-H20,SF-B19,2,8,0,3,2,5,0.0,1.0,0.375,0.625
SF-H20,SF-A20,3,4,0,2,3,2,0.0,1.0,0.5,0.5
SF-H20,SF-C26,1,3,0,1,1,2,0.0,1.0,0.3333333333333333,0.6666666666666666
SF-H20,SF-C25,2,3,0,0,2,3,0.0,1.0,0.0,1.0
SF-H20,SF-B25,2,2,0,0,2,2,0.0,1.0,0.0,1.0
SF-H20,SF-E27,4,4,2,2,2,2,0.5,0.5,0.5,0.5
SF-H20,SF-D27,2,1,0,0,2,1,0.0,1.0,0.0,1.0
SF-H20,SF-C28-2,2,1,2,1,0,0,1.0,0.0,1.0,0.0
SF-H20,SF-J1,4,8,1,3,3,5,0.25,0.75,0.375,0.625
SF-H20,SF-H0,2,5,0,4,2,1,0.0,1.0,0.8,0.2
SF-H20,SF-J3,1,1,1,1,0,0,1.0,0.0,1.0,0.0
SF-H20,SF-J5,3,3,1,1,2,2,0.3333333333333333,0.6666666666666666,0.3333333333333333,0.6666666666666666
SF-H20,SF-G7,1,4,1,0,0,4,1.0,0.0,0.0,1.0
SF-H20,SF-F9,4,6,0,0,4,6,0.0,1.0,0.0,1.0
SF-H20,SF-H25,11,12,5,5,6,7,0.45454545454545453,0.5454545454545454,0.4166666666666667,0.5833333333333334
SF-H20,SF-G26,29,5,4,3,25,2,0.13793103448275862,0.8620689655172413,0.6,0.4
SF-H20,SF-K21,21,18,13,5,8,13,0.6190476190476191,0.38095238095238093,0.2777777777777778,0.7222222222222222
SF-H20,SF-K22-1,6,7,4,3,2,4,0.6666666666666666,0.3333333333333333,0.42857142857142855,0.5714285714285714
SF-H20,SF-J23-1,32,21,15,10,17,11,0.46875,0.53125,0.47619047619047616,0.5238095238095238
SF-H20,SF-J22-1,16,13,4,5,12,8,0.25,0.75,0.38461538461538464,0.6153846153846154
SF-H20,SF-J22-2,52,45,20,24,32,21,0.38461538461538464,0.6153846153846154,0.5333333333333333,0.4666666666666667
SF-H20,SF-J21,69,73,50,55,19,18,0.7246376811594203,0.2753623188405797,0.7534246575342466,0.2465753424657534
SF-H20,SF-I21,31,40,19,21,12,19,0.6129032258064516,0.3870967741935484,0.525,0.475
SF-H20,SF-I22,21,21,7,12,14,9,0.3333333333333333,0.6666666666666666,0.5714285714285714,0.42857142857142855
SF-H20,SF-I23-2,32,25,22,12,10,13,0.6875,0.3125,0.48,0.52
SF-H20,SF-I24,9,15,5,9,4,6,0.5555555555555556,0.4444444444444444,0.6,0.4
SF-H20,SF-I23-1,28,18,6,7,22,11,0.21428571428571427,0.7857142857142857,0.3888888888888889,0.6111111111111112
SF-H20,SF-F26,13,12,4,5,9,7,0.3076923076923077,0.6923076923076923,0.4166666666666667,0.5833333333333334
SF-H20,SF-M13,9,2,4,0,5,2,0.4444444444444444,0.5555555555555556,0.0,1.0
SF-H20,SF-M15,17,10,5,0,12,10,0.29411764705882354,0.7058823529411765,0.0,1.0
SF-H20,SF-L19,3,6,0,2,3,4,0.0,1.0,0.3333333333333333,0.6666666666666666
SF-H20,SF-L20,9,8,3,0,6,8,0.3333333333333333,0.6666666666666666,0.0,1.0
SF-H20,SF-N20-1,4,4,2,1,2,3,0.5,0.5,0.25,0.75
SF-H20,SF-M20,27,26,2,5,25,21,0.07407407407407407,0.9259259259259259,0.19230769230769232,0.8076923076923077
SF-H20,SF-K17-2,4,2,2,0,2,2,0.5,0.5,0.0,1.0
SF-H20,SF-K20,10,21,4,9,6,12,0.4,0.6,0.42857142857142855,0.5714285714285714
SF-H20,SF-K15-,22,12,8,8,14,4,0.36363636363636365,0.6363636363636364,0.6666666666666666,0.3333333333333333
SF-H20,SF-K19,6,13,2,5,4,8,0.3333333333333333,0.6666666666666666,0.38461538461538464,0.6153846153846154
SF-H20,SF-K18,7,7,3,2,4,5,0.42857142857142855,0.5714285714285714,0.2857142857142857,0.7142857142857143
SF-H20,SF-K17,15,10,12,7,3,3,0.8,0.2,0.7,0.3
SF-H20,SF-J16,4,5,3,1,1,4,0.75,0.25,0.2,0.8
SF-H20,SF-J18,22,21,11,3,11,18,0.5,0.5,0.14285714285714285,0.8571428571428571
SF-H20,SF-J20,86,117,67,97,19,20,0.7790697674418605,0.22093023255813954,0.8290598290598291,0.17094017094017094
SF-H20,SF-J19,29,27,20,20,9,7,0.6896551724137931,0.3103448275862069,0.7407407407407407,0.25925925925925924
SF-H20,SF-M12,5,1,1,0,4,1,0.2,0.8,0.0,1.0
SF-H20,SF-M10,3,1,2,0,1,1,0.6666666666666666,0.3333333333333333,0.0,1.0
SF-H20,SF-M11,6,9,5,5,1,4,0.8333333333333334,0.16666666666666666,0.5555555555555556,0.4444444444444444
SF-H20,SF-Q21-2,1,1,0,1,1,0,0.0,1.0,1.0,0.0
SF-H20,SF-P21,9,4,0,0,9,4,0.0,1.0,0.0,1.0
SF-H20,SF-O18,8,5,0,0,8,5,0.0,1.0,0.0,1.0
SF-H20,SF-O19,6,10,0,2,6,8,0.0,1.0,0.2,0.8
SF-H20,SF-O21,19,12,9,3,10,9,0.47368421052631576,0.5263157894736842,0.25,0.75
SF-H20,SF-O22,10,14,1,5,9,9,0.1,0.9,0.35714285714285715,0.6428571428571429
SF-H20,SF-N21,2,5,0,1,2,4,0.0,1.0,0.2,0.8
SF-H20,SF-N20-2,4,1,4,1,0,0,1.0,0.0,1.0,0.0
SF-H20,SF-M21,16,43,6,29,10,14,0.375,0.625,0.6744186046511628,0.32558139534883723
SF-H20,SF-L21,8,15,0,1,8,14,0.0,1.0,0.06666666666666667,0.9333333333333333
SF-H20,SF-S29,1,1,0,0,1,1,0.0,1.0,0.0,1.0
SF-H20,SF-Q30,4,3,0,1,4,2,0.0,1.0,0.3333333333333333,0.6666666666666666
SF-H20,SF-O30-2,2,2,0,1,2,1,0.0,1.0,0.5,0.5
SF-H20,SF-O30,6,2,1,0,5,2,0.16666666666666666,0.8333333333333334,0.0,1.0
SF-H20,SF-N27,3,5,2,3,1,2,0.6666666666666666,0.3333333333333333,0.6,0.4
SF-H20,SF-N29,2,1,1,1,1,0,0.5,0.5,1.0,0.0
SF-H20,SF-N28,3,3,1,3,2,0,0.3333333333333333,0.6666666666666666,1.0,0.0
SF-H20,SF-L30-1,22,13,13,13,9,0,0.5909090909090909,0.4090909090909091,1.0,0.0
SF-H20,SF-L29,5,3,5,1,0,2,1.0,0.0,0.3333333333333333,0.6666666666666666
SF-H20,SF-J29-1,2,1,0,0,2,1,0.0,1.0,0.0,1.0
SF-H20,SF-I27,15,6,1,2,14,4,0.06666666666666667,0.9333333333333333,0.3333333333333333,0.6666666666666666
SF-H20,SF-I28,10,2,1,2,9,0,0.1,0.9,1.0,0.0
SF-H20,SF-I30-2,3,2,1,1,2,1,0.3333333333333333,0.6666666666666666,0.5,0.5
SF-H20,SF-H28,6,10,3,6,3,4,0.5,0.5,0.6,0.4
SF-H20,SF-S24,3,4,0,0,3,4,0.0,1.0,0.0,1.0
SF-H20,SF-R24,5,4,2,3,3,1,0.4,0.6,0.75,0.25
SF-H20,SF-P26,4,4,0,2,4,2,0.0,1.0,0.5,0.5
SF-H20,SF-O25-2,2,2,0,2,2,0,0.0,1.0,1.0,0.0
SF-H20,SF-T22,3,1,3,1,0,0,1.0,0.0,1.0,0.0
SF-H20,SF-S22-1,37,36,2,0,35,36,0.05405405405405406,0.9459459459459459,0.0,1.0
SF-H20,SF-Q23-3,4,1,0,0,4,1,0.0,1.0,0.0,1.0
SF-H20,SF-Q22-1,5,2,1,1,4,1,0.2,0.8,0.5,0.5
SF-H20,SF-Q22-2,8,7,1,5,7,2,0.125,0.875,0.7142857142857143,0.2857142857142857
SF-H20,SF-P22,5,5,2,4,3,1,0.4,0.6,0.8,0.2
SF-H20,SF-T20,22,7,20,5,2,2,0.9090909090909091,0.09090909090909091,0.7142857142857143,0.2857142857142857
SF-H20,SF-S21,1,1,0,0,1,1,0.0,1.0,0.0,1.0
SF-H18,SF-K26,1,1,1,1,0,0,1.0,0.0,1.0,0.0
SF-H18,SF-J27,1,1,0,0,1,1,0.0,1.0,0.0,1.0
SF-H18,SF-K29-1,2,2,1,1,1,1,0.5,0.5,0.5,0.5
SF-H18,SF-K25,2,3,0,1,2,2,0.0,1.0,0.3333333333333333,0.6666666666666666
SF-H18,SF-H26-2,1,3,0,0,1,3,0.0,1.0,0.0,1.0
SF-H18,SF-P24,1,1,0,0,1,1,0.0,1.0,0.0,1.0
SF-H18,SF-I25,2,1,2,0,0,1,1.0,0.0,0.0,1.0
SF-H18,SF-H26,6,7,1,0,5,7,0.16666666666666666,0.8333333333333334,0.0,1.0
SF-H18,SF-O23,1,1,0,0,1,1,0.0,1.0,0.0,1.0
SF-H18,SF-G27,5,6,1,1,4,5,0.2,0.8,0.16666666666666666,0.8333333333333334
SF-H18,SF-M22-2,1,3,0,0,1,3,0.0,1.0,0.0,1.0
SF-H18,SF-N22-2,3,5,0,3,3,2,0.0,1.0,0.6,0.4
SF-H18,SF-O25-1,1,2,0,0,1,2,0.0,1.0,0.0,1.0
SF-H18,SF-K24,1,1,0,0,1,1,0.0,1.0,0.0,1.0
SF-H18,SF-G23,4,3,0,1,4,2,0.0,1.0,0.3333333333333333,0.6666666666666666
SF-H18,SF-G24,9,5,0,0,9,5,0.0,1.0,0.0,1.0
SF-H18,SF-G25,6,3,0,0,6,3,0.0,1.0,0.0,1.0
SF-H18,SF-F23,2,4,1,0,1,4,0.5,0.5,0.0,1.0
SF-H18,SF-E23,5,6,0,0,5,6,0.0,1.0,0.0,1.0
SF-H18,SF-C22,2,1,1,1,1,0,0.5,0.5,1.0,0.0
SF-H18,SF-J17,23,14,6,3,17,11,0.2608695652173913,0.7391304347826086,0.21428571428571427,0.7857142857142857
SF-H18,SF-I19,11,14,3,9,8,5,0.2727272727272727,0.7272727272727273,0.6428571428571429,0.35714285714285715
SF-H18,SF-I20,3,4,0,1,3,3,0.0,1.0,0.25,0.75
SF-H18,SF-H16,17,11,6,0,11,11,0.35294117647058826,0.6470588235294118,0.0,1.0
SF-H18,SF-H19,3,13,2,12,1,1,0.6666666666666666,0.3333333333333333,0.9230769230769231,0.07692307692307693
SF-H18,SF-H20,7,11,4,9,3,2,0.5714285714285714,0.42857142857142855,0.8181818181818182,0.18181818181818182
SF-H18,SF-H17,17,8,10,0,7,8,0.5882352941176471,0.4117647058823529,0.0,1.0
SF-H18,SF-G19,16,22,9,19,7,3,0.5625,0.4375,0.8636363636363636,0.13636363636363635
SF-H18,SF-G17,6,9,0,4,6,5,0.0,1.0,0.4444444444444444,0.5555555555555556
SF-H18,SF-G18,19,6,15,2,4,4,0.7894736842105263,0.21052631578947367,0.3333333333333333,0.6666666666666666
SF-H18,SF-G20,17,10,8,8,9,2,0.47058823529411764,0.5294117647058824,0.8,0.2
SF-H18,SF-F19,8,12,4,7,4,5,0.5,0.5,0.5833333333333334,0.4166666666666667
SF-H18,SF-E18,6,2,5,1,1,1,0.8333333333333334,0.16666666666666666,0.5,0.5
SF-H18,SF-E20,16,4,11,2,5,2,0.6875,0.3125,0.5,0.5
SF-H18,SF-F30-1,1,1,1,1,0,0,1.0,0.0,1.0,0.0
SF-H18,SF-E29-2,2,1,0,0,2,1,0.0,1.0,0.0,1.0
SF-H18,SF-D28,1,2,0,0,1,2,0.0,1.0,0.0,1.0
SF-H18,SF-G29-2,1,3,0,0,1,3,0.0,1.0,0.0,1.0
SF-H18,SF-G30-1,2,1,1,1,1,0,0.5,0.5,1.0,0.0
SF-H18,SF-E29-3,3,7,0,0,3,7,0.0,1.0,0.0,1.0
SF-H18,SF-J10,2,4,1,3,1,1,0.5,0.5,0.75,0.25
SF-H18,SF-J12,3,10,0,2,3,8,0.0,1.0,0.2,0.8
SF-H18,SF-J13,4,4,1,0,3,4,0.25,0.75,0.0,1.0
SF-H18,SF-J15,3,1,0,0,3,1,0.0,1.0,0.0,1.0
SF-H18,SF-J14,1,3,0,1,1,2,0.0,1.0,0.3333333333333333,0.6666666666666666
SF-H18,SF-H13,2,9,0,0,2,9,0.0,1.0,0.0,1.0
SF-H18,SF-H12,4,2,0,1,4,1,0.0,1.0,0.5,0.5
SF-H18,SF-G10-2,2,1,0,0,2,1,0.0,1.0,0.0,1.0
SF-H18,SF-H15,2,1,0,0,2,1,0.0,1.0,0.0,1.0
SF-H18,SF-G9,7,6,4,3,3,3,0.5714285714285714,0.42857142857142855,0.5,0.5
SF-H18,SF-H14,5,2,4,1,1,1,0.8,0.2,0.5,0.5
SF-H18,SF-G13,10,4,0,1,10,3,0.0,1.0,0.25,0.75
SF-H18,SF-G12,14,3,0,0,14,3,0.0,1.0,0.0,1.0
SF-H18,SF-G10-1,2,2,0,0,2,2,0.0,1.0,0.0,1.0
SF-H18,SF-F15,2,3,1,1,1,2,0.5,0.5,0.3333333333333333,0.6666666666666666
SF-H18,SF-F16,3,1,2,0,1,1,0.6666666666666666,0.3333333333333333,0.0,1.0
SF-H18,SF-C21,1,2,0,1,1,1,0.0,1.0,0.5,0.5
SF-H18,SF-C20,5,6,0,0,5,6,0.0,1.0,0.0,1.0
SF-H18,SF-B19,1,1,0,0,1,1,0.0,1.0,0.0,1.0
SF-H18,SF-C26,1,3,0,3,1,0,0.0,1.0,1.0,0.0
SF-H18,SF-C25,1,3,0,1,1,2,0.0,1.0,0.3333333333333333,0.6666666666666666
SF-H18,SF-J1,1,3,0,1,1,2,0.0,1.0,0.3333333333333333,0.6666666666666666
SF-H18,SF-G7,1,1,1,0,0,1,1.0,0.0,0.0,1.0
SF-H18,SF-F9,2,1,0,0,2,1,0.0,1.0,0.0,1.0
SF-H18,SF-G26,3,1,0,0,3,1,0.0,1.0,0.0,1.0
SF-H18,SF-K21,3,2,1,1,2,1,0.3333333333333333,0.6666666666666666,0.5,0.5
SF-H18,SF-J23-1,2,3,0,1,2,2,0.0,1.0,0.3333333333333333,0.6666666666666666
SF-H18,SF-J22-1,3,3,1,1,2,2,0.3333333333333333,0.6666666666666666,0.3333333333333333,0.6666666666666666
SF-H18,SF-J22-2,3,2,0,1,3,1,0.0,1.0,0.5,0.5
SF-H18,SF-J21,10,10,2,3,8,7,0.2,0.8,0.3,0.7
SF-H18,SF-I21,2,5,0,3,2,2,0.0,1.0,0.6,0.4
SF-H18,SF-I22,6,4,1,3,5,1,0.16666666666666666,0.8333333333333334,0.75,0.25
SF-H18,SF-I23-2,1,2,0,0,1,2,0.0,1.0,0.0,1.0
SF-H18,SF-I24,3,1,1,0,2,1,0.3333333333333333,0.6666666666666666,0.0,1.0
SF-H18,SF-I23-1,5,9,1,4,4,5,0.2,0.8,0.4444444444444444,0.5555555555555556
SF-H18,SF-F26,5,12,2,3,3,9,0.4,0.6,0.25,0.75
SF-H18,SF-M13,6,2,0,0,6,2,0.0,1.0,0.0,1.0
SF-H18,SF-M15,7,9,2,4,5,5,0.2857142857142857,0.7142857142857143,0.4444444444444444,0.5555555555555556
SF-H18,SF-L19,3,3,1,0,2,3,0.3333333333333333,0.6666666666666666,0.0,1.0
SF-H18,SF-L20,3,8,1,0,2,8,0.3333333333333333,0.6666666666666666,0.0,1.0
SF-H18,SF-N20-1,1,1,0,0,1,1,0.0,1.0,0.0,1.0
SF-H18,SF-M20,6,4,1,1,5,3,0.16666666666666666,0.8333333333333334,0.25,0.75
SF-H18,SF-K17-2,7,3,4,1,3,2,0.5714285714285714,0.42857142857142855,0.3333333333333333,0.6666666666666666
SF-H18,SF-K20,12,16,2,5,10,11,0.16666666666666666,0.8333333333333334,0.3125,0.6875
SF-H18,SF-K15-,18,17,2,3,16,14,0.1111111111111111,0.8888888888888888,0.17647058823529413,0.8235294117647058
SF-H18,SF-K19,7,21,1,4,6,17,0.14285714285714285,0.8571428571428571,0.19047619047619047,0.8095238095238095
SF-H18,SF-K18,26,17,6,2,20,15,0.23076923076923078,0.7692307692307693,0.11764705882352941,0.8823529411764706
SF-H18,SF-K17,10,7,1,4,9,3,0.1,0.9,0.5714285714285714,0.42857142857142855
SF-H18,SF-J16,6,4,1,0,5,4,0.16666666666666666,0.8333333333333334,0.0,1.0
SF-H18,SF-J18,32,51,7,12,25,39,0.21875,0.78125,0.23529411764705882,0.7647058823529411
SF-H18,SF-J20,4,6,1,2,3,4,0.25,0.75,0.3333333333333333,0.6666666666666666
SF-H18,SF-J19,9,8,3,1,6,7,0.3333333333333333,0.6666666666666666,0.125,0.875
SF-H18,SF-M12,1,3,0,0,1,3,0.0,1.0,0.0,1.0
SF-H18,SF-M11,12,12,1,3,11,9,0.08333333333333333,0.9166666666666666,0.25,0.75
SF-H18,SF-P21,5,2,2,0,3,2,0.4,0.6,0.0,1.0
SF-H18,SF-O18,1,10,0,0,1,10,0.0,1.0,0.0,1.0
SF-H18,SF-O19,3,5,0,0,3,5,0.0,1.0,0.0,1.0
SF-H18,SF-O21,3,11,0,0,3,11,0.0,1.0,0.0,1.0
SF-H18,SF-O22,2,5,0,2,2,3,0.0,1.0,0.4,0.6
SF-H18,SF-N21,4,3,0,1,4,2,0.0,1.0,0.3333333333333333,0.6666666666666666
SF-H18,SF-N20-2,5,3,1,0,4,3,0.2,0.8,0.0,1.0
SF-H18,SF-M21,4,2,0,0,4,2,0.0,1.0,0.0,1.0
SF-H18,SF-L21,5,9,0,3,5,6,0.0,1.0,0.3333333333333333,0.6666666666666666
SF-H18,SF-O30,2,1,0,0,2,1,0.0,1.0,0.0,1.0
SF-H18,SF-L30-1,2,10,1,9,1,1,0.5,0.5,0.9,0.1
SF-H18,SF-I28,1,1,0,1,1,0,0.0,1.0,1.0,0.0
SF-H18,SF-I30-2,2,1,2,1,0,0,1.0,0.0,1.0,0.0
SF-H18,SF-R24,3,4,0,1,3,3,0.0,1.0,0.25,0.75
SF-H18,SF-N22-1B,1,1,0,0,1,1,0.0,1.0,0.0,1.0
SF-H18,SF-T22,1,1,0,1,1,0,0.0,1.0,1.0,0.0
SF-H18,SF-S22-1,3,1,0,1,3,0,0.0,1.0,1.0,0.0
SF-H18,SF-Q23-3,1,1,0,0,1,1,0.0,1.0,0.0,1.0
SF-H18,SF-Q22-2,2,6,1,1,1,5,0.5,0.5,0.16666666666666666,0.8333333333333334
SF-H18,SF-P22,3,2,0,0,3,2,0.0,1.0,0.0,1.0
SF-H18,SF-W19,2,2,0,0,2,2,0.0,1.0,0.0,1.0
SF-H18,SF-W19-2,1,1,0,0,1,1,0.0,1.0,0.0,1.0
SF-H17,SF-M25,1,1,0,0,1,1,0.0,1.0,0.0,1.0
SF-H17,SF-L25,2,1,2,0,0,1,1.0,0.0,0.0,1.0
SF-H17,SF-M24,1,1,0,0,1,1,0.0,1.0,0.0,1.0
SF-H17,SF-J25,4,2,3,2,1,0,0.75,0.25,1.0,0.0
SF-H17,SF-P24,2,1,0,0,2,1,0.0,1.0,0.0,1.0
SF-H17,SF-I25,1,3,1,2,0,1,1.0,0.0,0.6666666666666666,0.3333333333333333
SF-H17,SF-H26,2,7,0,0,2,7,0.0,1.0,0.0,1.0
SF-H17,SF-G27,3,7,0,2,3,5,0.0,1.0,0.2857142857142857,0.7142857142857143
SF-H17,SF-M22-2,1,5,0,1,1,4,0.0,1.0,0.2,0.8
SF-H17,SF-F27,2,1,0,0,2,1,0.0,1.0,0.0,1.0
SF-H17,SF-N22-2,1,6,0,1,1,5,0.0,1.0,0.16666666666666666,0.8333333333333334
SF-H17,SF-K24,1,1,0,0,1,1,0.0,1.0,0.0,1.0
SF-H17,SF-G25,1,7,0,1,1,6,0.0,1.0,0.14285714285714285,0.8571428571428571
SF-H17,SF-F23,1,1,0,1,1,0,0.0,1.0,1.0,0.0
SF-H17,SF-E23,3,3,0,1,3,2,0.0,1.0,0.3333333333333333,0.6666666666666666
SF-H17,SF-B22,3,3,0,0,3,3,0.0,1.0,0.0,1.0
SF-H17,SF-J17,29,7,1,4,28,3,0.034482758620689655,0.9655172413793104,0.5714285714285714,0.42857142857142855
SF-H17,SF-I20,1,1,0,1,1,0,0.0,1.0,1.0,0.0
SF-H17,SF-H16,6,7,3,2,3,5,0.5,0.5,0.2857142857142857,0.7142857142857143
SF-H17,SF-H19,4,9,0,4,4,5,0.0,1.0,0.4444444444444444,0.5555555555555556
SF-H17,SF-H20,19,6,13,4,6,2,0.6842105263157895,0.3157894736842105,0.6666666666666666,0.3333333333333333
SF-H17,SF-H18,8,17,0,10,8,7,0.0,1.0,0.5882352941176471,0.4117647058823529
SF-H17,SF-G19,3,7,1,4,2,3,0.3333333333333333,0.6666666666666666,0.5714285714285714,0.42857142857142855
SF-H17,SF-G17,5,17,3,5,2,12,0.6,0.4,0.29411764705882354,0.7058823529411765
SF-H17,SF-G18,12,15,1,11,11,4,0.08333333333333333,0.9166666666666666,0.7333333333333333,0.26666666666666666
SF-H17,SF-G20,3,9,1,5,2,4,0.3333333333333333,0.6666666666666666,0.5555555555555556,0.4444444444444444
SF-H17,SF-F19,4,5,1,1,3,4,0.25,0.75,0.2,0.8
SF-H17,SF-E18,4,4,2,3,2,1,0.5,0.5,0.75,0.25
SF-H17,SF-E20,2,1,0,1,2,0,0.0,1.0,1.0,0.0
SF-H17,SF-F30-1,10,1,0,0,10,1,0.0,1.0,0.0,1.0
SF-H17,SF-A27,1,1,0,1,1,0,0.0,1.0,1.0,0.0
SF-H17,SF-G30-1,8,3,0,1,8,2,0.0,1.0,0.3333333333333333,0.6666666666666666
SF-H17,SF-J10,1,2,0,0,1,2,0.0,1.0,0.0,1.0
SF-H17,SF-J12,10,8,0,0,10,8,0.0,1.0,0.0,1.0
SF-H17,SF-J13,2,1,0,0,2,1,0.0,1.0,0.0,1.0
SF-H17,SF-J15,18,6,5,0,13,6,0.2777777777777778,0.7222222222222222,0.0,1.0
SF-H17,SF-H13,70,56,0,0,70,56,0.0,1.0,0.0,1.0
SF-H17,SF-I16,3,1,3,0,0,1,1.0,0.0,0.0,1.0
SF-H17,SF-H12,3,3,0,0,3,3,0.0,1.0,0.0,1.0
SF-H17,SF-G9,1,2,0,0,1,2,0.0,1.0,0.0,1.0
SF-H17,SF-H14,2,5,0,0,2,5,0.0,1.0,0.0,1.0
SF-H17,SF-G13,24,3,0,0,24,3,0.0,1.0,0.0,1.0
SF-H17,SF-G12,4,5,0,0,4,5,0.0,1.0,0.0,1.0
SF-H17,SF-G10-1,4,1,0,0,4,1,0.0,1.0,0.0,1.0
SF-H17,SF-F15,2,2,1,0,1,2,0.5,0.5,0.0,1.0
SF-H17,SF-F16,3,1,2,0,1,1,0.6666666666666666,0.3333333333333333,0.0,1.0
SF-H17,SF-C20,1,39,0,0,1,39,0.0,1.0,0.0,1.0
SF-H17,SF-B19,2,1,0,1,2,0,0.0,1.0,1.0,0.0
SF-H17,SF-J3,1,1,1,1,0,0,1.0,0.0,1.0,0.0
SF-H17,SF-G7,2,2,1,0,1,2,0.5,0.5,0.0,1.0
SF-H17,SF-H25,2,1,1,0,1,1,0.5,0.5,0.0,1.0
SF-H17,SF-K21,4,8,0,1,4,7,0.0,1.0,0.125,0.875
SF-H17,SF-J23-1,2,3,1,1,1,2,0.5,0.5,0.3333333333333333,0.6666666666666666
SF-H17,SF-J22-2,3,2,2,1,1,1,0.6666666666666666,0.3333333333333333,0.5,0.5
SF-H17,SF-J21,13,2,0,0,13,2,0.0,1.0,0.0,1.0
SF-H17,SF-I21,3,4,0,0,3,4,0.0,1.0,0.0,1.0
SF-H17,SF-I22,5,1,0,0,5,1,0.0,1.0,0.0,1.0
SF-H17,SF-I23-1,1,5,0,2,1,3,0.0,1.0,0.4,0.6
SF-H17,SF-F26,2,5,0,0,2,5,0.0,1.0,0.0,1.0
SF-H17,SF-M13,6,5,0,1,6,4,0.0,1.0,0.2,0.8
SF-H17,SF-M15,4,4,1,1,3,3,0.25,0.75,0.25,0.75
SF-H17,SF-L19,3,4,0,0,3,4,0.0,1.0,0.0,1.0
SF-H17,SF-L20,6,12,0,1,6,11,0.0,1.0,0.08333333333333333,0.9166666666666666
SF-H17,SF-M20,2,5,0,0,2,5,0.0,1.0,0.0,1.0
SF-H17,SF-K17-2,2,2,1,0,1,2,0.5,0.5,0.0,1.0
SF-H17,SF-K20,7,3,0,1,7,2,0.0,1.0,0.3333333333333333,0.6666666666666666
SF-H17,SF-K18,10,18,0,4,10,14,0.0,1.0,0.2222222222222222,0.7777777777777778
SF-H17,SF-K17,4,5,1,1,3,4,0.25,0.75,0.2,0.8
SF-H17,SF-J16,12,7,0,0,12,7,0.0,1.0,0.0,1.0
SF-H17,SF-J18,12,28,0,3,12,25,0.0,1.0,0.10714285714285714,0.8928571428571429
SF-H17,SF-J20,2,3,2,2,0,1,1.0,0.0,0.6666666666666666,0.3333333333333333
SF-H17,SF-J19,1,4,0,4,1,0,0.0,1.0,1.0,0.0
SF-H17,SF-M12,2,7,1,3,1,4,0.5,0.5,0.42857142857142855,0.5714285714285714
SF-H17,SF-M11,3,5,1,0,2,5,0.3333333333333333,0.6666666666666666,0.0,1.0
SF-H17,SF-P21,2,4,0,0,2,4,0.0,1.0,0.0,1.0
SF-H17,SF-O18,6,3,0,0,6,3,0.0,1.0,0.0,1.0
SF-H17,SF-O19,12,6,0,0,12,6,0.0,1.0,0.0,1.0
SF-H17,SF-O21,16,10,0,0,16,10,0.0,1.0,0.0,1.0
SF-H17,SF-N21,1,1,0,0,1,1,0.0,1.0,0.0,1.0
SF-H17,SF-N20-2,6,5,0,0,6,5,0.0,1.0,0.0,1.0
SF-H17,SF-M21,5,2,0,0,5,2,0.0,1.0,0.0,1.0
SF-H17,SF-L21,1,4,0,0,1,4,0.0,1.0,0.0,1.0
SF-H17,SF-L29,2,1,1,0,1,1,0.5,0.5,0.0,1.0
SF-H17,SF-W19,1,1,0,0,1,1,0.0,1.0,0.0,1.0
SF-G19,SF-M25,3,2,0,0,3,2,0.0,1.0,0.0,1.0
SF-G19,SF-M26-2,4,14,1,11,3,3,0.25,0.75,0.7857142857142857,0.21428571428571427
SF-G19,SF-L27,4,2,1,2,3,0,0.25,0.75,1.0,0.0
SF-G19,SF-K26,3,12,0,3,3,9,0.0,1.0,0.25,0.75
SF-G19,SF-J27,1,7,0,1,1,6,0.0,1.0,0.14285714285714285,0.8571428571428571
SF-G19,SF-M30,4,6,0,0,4,6,0.0,1.0,0.0,1.0
SF-G19,SF-J29-3,1,6,1,4,0,2,1.0,0.0,0.6666666666666666,0.3333333333333333
SF-G19,SF-J29,2,10,1,2,1,8,0.5,0.5,0.2,0.8
SF-G19,SF-L26,19,34,8,24,11,10,0.42105263157894735,0.5789473684210527,0.7058823529411765,0.29411764705882354
SF-G19,SF-M28,8,3,0,0,8,3,0.0,1.0,0.0,1.0
SF-G19,SF-M27,10,40,0,36,10,4,0.0,1.0,0.9,0.1
SF-G19,SF-L25,3,1,3,0,0,1,1.0,0.0,0.0,1.0
SF-G19,SF-M24,1,3,0,0,1,3,0.0,1.0,0.0,1.0
SF-G19,SF-L24,1,1,0,0,1,1,0.0,1.0,0.0,1.0
SF-G19,SF-N23,1,2,0,0,1,2,0.0,1.0,0.0,1.0
SF-G19,SF-K27-2,6,9,1,4,5,5,0.16666666666666666,0.8333333333333334,0.4444444444444444,0.5555555555555556
SF-G19,SF-J26-2,4,3,0,1,4,2,0.0,1.0,0.3333333333333333,0.6666666666666666
SF-G19,SF-L28,1,2,0,1,1,1,0.0,1.0,0.5,0.5
SF-G19,SF-K29-1,4,3,2,2,2,1,0.5,0.5,0.6666666666666666,0.3333333333333333
SF-G19,SF-J28-2,2,1,2,0,0,1,1.0,0.0,0.0,1.0
SF-G19,SF-K27,1,1,1,1,0,0,1.0,0.0,1.0,0.0
SF-G19,SF-K25,13,7,1,7,12,0,0.07692307692307693,0.9230769230769231,1.0,0.0
SF-G19,SF-J25,16,19,5,6,11,13,0.3125,0.6875,0.3157894736842105,0.6842105263157895
SF-G19,SF-H26-2,5,2,1,1,4,1,0.2,0.8,0.5,0.5
SF-G19,SF-P24,3,3,0,0,3,3,0.0,1.0,0.0,1.0
SF-G19,SF-J24,2,5,0,0,2,5,0.0,1.0,0.0,1.0
SF-G19,SF-O24,1,1,0,0,1,1,0.0,1.0,0.0,1.0
SF-G19,SF-J26,1,2,0,1,1,1,0.0,1.0,0.5,0.5
SF-G19,SF-I26-,1,2,0,0,1,2,0.0,1.0,0.0,1.0
SF-G19,SF-I25,2,7,1,5,1,2,0.5,0.5,0.7142857142857143,0.2857142857142857
SF-G19,SF-H26,9,10,3,4,6,6,0.3333333333333333,0.6666666666666666,0.4,0.6
SF-G19,SF-O23,3,2,1,1,2,1,0.3333333333333333,0.6666666666666666,0.5,0.5
SF-G19,SF-F28-2,2,3,1,0,1,3,0.5,0.5,0.0,1.0
SF-G19,SF-G27,7,22,1,5,6,17,0.14285714285714285,0.8571428571428571,0.22727272727272727,0.7727272727272727
SF-G19,SF-M22-2,1,1,0,0,1,1,0.0,1.0,0.0,1.0
SF-G19,SF-L22,9,8,3,3,6,5,0.3333333333333333,0.6666666666666666,0.375,0.625
SF-G19,SF-F27,2,3,0,0,2,3,0.0,1.0,0.0,1.0
SF-G19,SF-N22-2,9,11,4,4,5,7,0.4444444444444444,0.5555555555555556,0.36363636363636365,0.6363636363636364
SF-G19,SF-M22-1,1,8,0,7,1,1,0.0,1.0,0.875,0.125
SF-G19,SF-K22-2,6,2,2,2,4,0,0.3333333333333333,0.6666666666666666,1.0,0.0
SF-G19,SF-K24,6,2,0,0,6,2,0.0,1.0,0.0,1.0
SF-G19,SF-J23-2,7,9,2,2,5,7,0.2857142857142857,0.7142857142857143,0.2222222222222222,0.7777777777777778
SF-G19,SF-G23,1,5,0,2,1,3,0.0,1.0,0.4,0.6
SF-G19,SF-G24,17,22,3,1,14,21,0.17647058823529413,0.8235294117647058,0.045454545454545456,0.9545454545454546
SF-G19,SF-G25,10,7,4,0,6,7,0.4,0.6,0.0,1.0
SF-G19,SF-F23,17,16,7,5,10,11,0.4117647058823529,0.5882352941176471,0.3125,0.6875
SF-G19,SF-E23,13,13,4,2,9,11,0.3076923076923077,0.6923076923076923,0.15384615384615385,0.8461538461538461
SF-G19,SF-D24,1,6,1,2,0,4,1.0,0.0,0.3333333333333333,0.6666666666666666
SF-G19,SF-C22,11,9,5,1,6,8,0.45454545454545453,0.5454545454545454,0.1111111111111111,0.8888888888888888
SF-G19,SF-B22,7,5,6,1,1,4,0.8571428571428571,0.14285714285714285,0.2,0.8
SF-G19,SF-J17,38,21,10,5,28,16,0.2631578947368421,0.7368421052631579,0.23809523809523808,0.7619047619047619
SF-G19,SF-I19,13,24,6,16,7,8,0.46153846153846156,0.5384615384615384,0.6666666666666666,0.3333333333333333
SF-G19,SF-I20,7,8,5,5,2,3,0.7142857142857143,0.2857142857142857,0.625,0.375
SF-G19,SF-H16,20,8,9,0,11,8,0.45,0.55,0.0,1.0
SF-G19,SF-H19,13,23,9,11,4,12,0.6923076923076923,0.3076923076923077,0.4782608695652174,0.5217391304347826
SF-G19,SF-H20,8,8,4,5,4,3,0.5,0.5,0.625,0.375
SF-G19,SF-H18,22,16,19,9,3,7,0.8636363636363636,0.13636363636363635,0.5625,0.4375
SF-G19,SF-H17,7,3,4,1,3,2,0.5714285714285714,0.42857142857142855,0.3333333333333333,0.6666666666666666
SF-G19,SF-G17,32,12,23,7,9,5,0.71875,0.28125,0.5833333333333334,0.4166666666666667
SF-G19,SF-G18,33,18,25,15,8,3,0.7575757575757576,0.24242424242424243,0.8333333333333334,0.16666666666666666
SF-G19,SF-G20,17,7,8,2,9,5,0.47058823529411764,0.5294117647058824,0.2857142857142857,0.7142857142857143
SF-G19,SF-F19,52,55,36,33,16,22,0.6923076923076923,0.3076923076923077,0.6,0.4
SF-G19,SF-E18,54,25,18,6,36,19,0.3333333333333333,0.6666666666666666,0.24,0.76
SF-G19,SF-E20,21,6,6,3,15,3,0.2857142857142857,0.7142857142857143,0.5,0.5
SF-G19,SF-E29-2,3,5,1,2,2,3,0.3333333333333333,0.6666666666666666,0.4,0.6
SF-G19,SF-E29-1,3,5,3,2,0,3,1.0,0.0,0.4,0.6
SF-G19,SF-D28,1,1,0,0,1,1,0.0,1.0,0.0,1.0
SF-G19,SF-A27,1,6,0,2,1,4,0.0,1.0,0.3333333333333333,0.6666666666666666
SF-G19,SF-G30-1,5,2,5,2,0,0,1.0,0.0,1.0,0.0
SF-G19,SF-F30-2,1,7,0,1,1,6,0.0,1.0,0.14285714285714285,0.8571428571428571
SF-G19,SF-F29,1,2,0,1,1,1,0.0,1.0,0.5,0.5
SF-G19,SF-E29-3,2,4,0,4,2,0,0.0,1.0,1.0,0.0
SF-G19,SF-F28-1,1,2,0,0,1,2,0.0,1.0,0.0,1.0
SF-G19,SF-E28-2,1,1,1,1,0,0,1.0,0.0,1.0,0.0
SF-G19,SF-E28,1,1,0,1,1,0,0.0,1.0,1.0,0.0
SF-G19,SF-J10,6,7,2,4,4,3,0.3333333333333333,0.6666666666666666,0.5714285714285714,0.42857142857142855
SF-G19,SF-J12,10,8,5,3,5,5,0.5,0.5,0.375,0.625
SF-G19,SF-J13,4,8,3,3,1,5,0.75,0.25,0.375,0.625
SF-G19,SF-J15,5,4,2,0,3,4,0.4,0.6,0.0,1.0
SF-G19,SF-H13,3,4,2,2,1,2,0.6666666666666666,0.3333333333333333,0.5,0.5
SF-G19,SF-I16,1,2,0,0,1,2,0.0,1.0,0.0,1.0
SF-G19,SF-H12,2,6,0,0,2,6,0.0,1.0,0.0,1.0
SF-G19,SF-H15,3,6,1,0,2,6,0.3333333333333333,0.6666666666666666,0.0,1.0
SF-G19,SF-G13,8,6,7,1,1,5,0.875,0.125,0.16666666666666666,0.8333333333333334
SF-G19,SF-G11,2,2,2,1,0,1,1.0,0.0,0.5,0.5
SF-G19,SF-G12,15,13,5,8,10,5,0.3333333333333333,0.6666666666666666,0.6153846153846154,0.38461538461538464
SF-G19,SF-G10-1,2,1,0,0,2,1,0.0,1.0,0.0,1.0
SF-G19,SF-F15,7,4,6,0,1,4,0.8571428571428571,0.14285714285714285,0.0,1.0
SF-G19,SF-F16,11,5,7,2,4,3,0.6363636363636364,0.36363636363636365,0.4,0.6
SF-G19,SF-C20,5,4,1,0,4,4,0.2,0.8,0.0,1.0
SF-G19,SF-B21,2,5,1,5,1,0,0.5,0.5,1.0,0.0
SF-G19,SF-B19,2,14,2,7,0,7,1.0,0.0,0.5,0.5
SF-G19,SF-A20,5,4,3,0,2,4,0.6,0.4,0.0,1.0
SF-G19,SF-A19,3,6,1,1,2,5,0.3333333333333333,0.6666666666666666,0.16666666666666666,0.8333333333333334
SF-G19,SF-C26,7,4,0,1,7,3,0.0,1.0,0.25,0.75
SF-G19,SF-C25,6,14,0,2,6,12,0.0,1.0,0.14285714285714285,0.8571428571428571
SF-G19,SF-B25,4,8,0,1,4,7,0.0,1.0,0.125,0.875
SF-G19,SF-D27,2,1,0,0,2,1,0.0,1.0,0.0,1.0
SF-G19,SF-J1,17,19,11,6,6,13,0.6470588235294118,0.35294117647058826,0.3157894736842105,0.6842105263157895
SF-G19,SF-H0,3,2,0,2,3,0,0.0,1.0,1.0,0.0
SF-G19,SF-G8,1,2,1,1,0,1,1.0,0.0,0.5,0.5
SF-G19,SF-G5,9,3,1,2,8,1,0.1111111111111111,0.8888888888888888,0.6666666666666666,0.3333333333333333
SF-G19,SF-G7,6,4,1,0,5,4,0.16666666666666666,0.8333333333333334,0.0,1.0
SF-G19,SF-F9,1,6,1,1,0,5,1.0,0.0,0.16666666666666666,0.8333333333333334
SF-G19,SF-H25,1,1,1,1,0,0,1.0,0.0,1.0,0.0
SF-G19,SF-G26,4,6,1,2,3,4,0.25,0.75,0.3333333333333333,0.6666666666666666
SF-G19,SF-K21,20,3,17,1,3,2,0.85,0.15,0.3333333333333333,0.6666666666666666
SF-G19,SF-K22-1,3,2,0,1,3,1,0.0,1.0,0.5,0.5
SF-G19,SF-J23-1,36,49,5,14,31,35,0.1388888888888889,0.8611111111111112,0.2857142857142857,0.7142857142857143
SF-G19,SF-J22-1,6,6,3,0,3,6,0.5,0.5,0.0,1.0
SF-G19,SF-J22-2,13,14,3,7,10,7,0.23076923076923078,0.7692307692307693,0.5,0.5
SF-G19,SF-J21,28,28,17,13,11,15,0.6071428571428571,0.39285714285714285,0.4642857142857143,0.5357142857142857
SF-G19,SF-I21,13,13,3,10,10,3,0.23076923076923078,0.7692307692307693,0.7692307692307693,0.23076923076923078
SF-G19,SF-I22,9,11,3,6,6,5,0.3333333333333333,0.6666666666666666,0.5454545454545454,0.45454545454545453
SF-G19,SF-I23-2,14,15,6,11,8,4,0.42857142857142855,0.5714285714285714,0.7333333333333333,0.26666666666666666
SF-G19,SF-I24,9,13,4,8,5,5,0.4444444444444444,0.5555555555555556,0.6153846153846154,0.38461538461538464
SF-G19,SF-I23-1,9,14,1,3,8,11,0.1111111111111111,0.8888888888888888,0.21428571428571427,0.7857142857142857
SF-G19,SF-F26,18,11,3,3,15,8,0.16666666666666666,0.8333333333333334,0.2727272727272727,0.7272727272727273
SF-G19,SF-M13,5,2,3,0,2,2,0.6,0.4,0.0,1.0
SF-G19,SF-M15,16,5,9,0,7,5,0.5625,0.4375,0.0,1.0
SF-G19,SF-L19,13,6,3,1,10,5,0.23076923076923078,0.7692307692307693,0.16666666666666666,0.8333333333333334
SF-G19,SF-L20,4,6,1,3,3,3,0.25,0.75,0.5,0.5
SF-G19,SF-N20-1,2,2,0,0,2,2,0.0,1.0,0.0,1.0
SF-G19,SF-M20,153,131,144,119,9,12,0.9411764705882353,0.058823529411764705,0.9083969465648855,0.0916030534351145
SF-G19,SF-K17-2,8,6,2,2,6,4,0.25,0.75,0.3333333333333333,0.6666666666666666
SF-G19,SF-K20,26,26,8,6,18,20,0.3076923076923077,0.6923076923076923,0.23076923076923078,0.7692307692307693
SF-G19,SF-K15-,33,24,11,9,22,15,0.3333333333333333,0.6666666666666666,0.375,0.625
SF-G19,SF-K19,12,12,5,0,7,12,0.4166666666666667,0.5833333333333334,0.0,1.0
SF-G19,SF-K18,26,24,6,4,20,20,0.23076923076923078,0.7692307692307693,0.16666666666666666,0.8333333333333334
SF-G19,SF-K17,32,15,17,6,15,9,0.53125,0.46875,0.4,0.6
SF-G19,SF-J16,15,5,10,1,5,4,0.6666666666666666,0.3333333333333333,0.2,0.8
SF-G19,SF-J18,27,26,4,9,23,17,0.14814814814814814,0.8518518518518519,0.34615384615384615,0.6538461538461539
SF-G19,SF-J20,33,29,28,24,5,5,0.8484848484848485,0.15151515151515152,0.8275862068965517,0.1724137931034483
SF-G19,SF-J19,85,84,61,52,24,32,0.7176470588235294,0.2823529411764706,0.6190476190476191,0.38095238095238093
SF-G19,SF-M12,5,6,0,3,5,3,0.0,1.0,0.5,0.5
SF-G19,SF-M10,1,3,1,0,0,3,1.0,0.0,0.0,1.0
SF-G19,SF-M11,7,10,1,6,6,4,0.14285714285714285,0.8571428571428571,0.6,0.4
SF-G19,SF-R19,1,2,0,0,1,2,0.0,1.0,0.0,1.0
SF-G19,SF-R20,2,5,0,0,2,5,0.0,1.0,0.0,1.0
SF-G19,SF-Q21-2,1,2,0,0,1,2,0.0,1.0,0.0,1.0
SF-G19,SF-P21,3,2,0,1,3,1,0.0,1.0,0.5,0.5
SF-G19,SF-O18,4,12,0,0,4,12,0.0,1.0,0.0,1.0
SF-G19,SF-O19,7,9,0,3,7,6,0.0,1.0,0.3333333333333333,0.6666666666666666
SF-G19,SF-O21,5,6,1,2,4,4,0.2,0.8,0.3333333333333333,0.6666666666666666
SF-G19,SF-O22,2,11,0,7,2,4,0.0,1.0,0.6363636363636364,0.36363636363636365
SF-G19,SF-N20-2,2,5,0,0,2,5,0.0,1.0,0.0,1.0
SF-G19,SF-M21,13,6,11,1,2,5,0.8461538461538461,0.15384615384615385,0.16666666666666666,0.8333333333333334
SF-G19,SF-L21,10,9,0,1,10,8,0.0,1.0,0.1111111111111111,0.8888888888888888
SF-G19,SF-Q30,1,4,0,0,1,4,0.0,1.0,0.0,1.0
SF-G19,SF-O30,5,1,1,1,4,0,0.2,0.8,1.0,0.0
SF-G19,SF-N27,1,4,0,3,1,1,0.0,1.0,0.75,0.25
SF-G19,SF-N28,7,8,0,6,7,2,0.0,1.0,0.75,0.25
SF-G19,SF-L30-1,6,5,2,0,4,5,0.3333333333333333,0.6666666666666666,0.0,1.0
SF-G19,SF-L29,3,7,1,4,2,3,0.3333333333333333,0.6666666666666666,0.5714285714285714,0.42857142857142855
SF-G19,SF-I27,5,9,2,4,3,5,0.4,0.6,0.4444444444444444,0.5555555555555556
SF-G19,SF-I28,2,1,0,0,2,1,0.0,1.0,0.0,1.0
SF-G19,SF-I30-2,4,2,1,2,3,0,0.25,0.75,1.0,0.0
SF-G19,SF I29-1,2,2,0,0,2,2,0.0,1.0,0.0,1.0
SF-G19,SF-H28,6,5,3,0,3,5,0.5,0.5,0.0,1.0
SF-G19,SF-S24,2,1,0,0,2,1,0.0,1.0,0.0,1.0
SF-G19,SF-R24,7,6,0,4,7,2,0.0,1.0,0.6666666666666666,0.3333333333333333
SF-G19,SF-P26,1,1,1,0,0,1,1.0,0.0,0.0,1.0
SF-G19,SF-T22,2,2,1,1,1,1,0.5,0.5,0.5,0.5
SF-G19,SF-S22-1,1,1,0,0,1,1,0.0,1.0,0.0,1.0
SF-G19,SF-Q22-1,2,5,0,1,2,4,0.0,1.0,0.2,0.8
SF-G19,SF-Q22-2,3,4,1,2,2,2,0.3333333333333333,0.6666666666666666,0.5,0.5
SF-G19,SF-P22,4,5,2,2,2,3,0.5,0.5,0.4,0.6
SF-G19,SF-W19-2,1,1,0,0,1,1,0.0,1.0,0.0,1.0
SF-G19,SF-U21,1,1,0,1,1,0,0.0,1.0,1.0,0.0
SF-G19,SF-T20,2,2,0,0,2,2,0.0,1.0,0.0,1.0
SF-G19,SF-Y25,1,1,0,0,1,1,0.0,1.0,0.0,1.0
SF-G17,SF-K26,2,7,0,2,2,5,0.0,1.0,0.2857142857142857,0.7142857142857143
SF-G17,SF-J27,2,5,0,1,2,4,0.0,1.0,0.2,0.8
SF-G17,SF-M30,1,11,0,0,1,11,0.0,1.0,0.0,1.0
SF-G17,SF-J29,11,5,0,0,11,5,0.0,1.0,0.0,1.0
SF-G17,SF-L26,2,1,0,0,2,1,0.0,1.0,0.0,1.0
SF-G17,SF-J26-2,2,1,0,0,2,1,0.0,1.0,0.0,1.0
SF-G17,SF-L28,2,1,0,1,2,0,0.0,1.0,1.0,0.0
SF-G17,SF-J28-2,2,3,0,0,2,3,0.0,1.0,0.0,1.0
SF-G17,SF-J25,1,2,0,0,1,2,0.0,1.0,0.0,1.0
SF-G17,SF-H26-2,3,7,0,5,3,2,0.0,1.0,0.7142857142857143,0.2857142857142857
SF-G17,SF-O24,1,1,0,0,1,1,0.0,1.0,0.0,1.0
SF-G17,SF-J26,2,1,0,0,2,1,0.0,1.0,0.0,1.0
SF-G17,SF-H26,10,4,2,0,8,4,0.2,0.8,0.0,1.0
SF-G17,SF-O23,1,2,0,1,1,1,0.0,1.0,0.5,0.5
SF-G17,SF-F28-2,1,2,0,0,1,2,0.0,1.0,0.0,1.0
SF-G17,SF-G27,2,16,0,1,2,15,0.0,1.0,0.0625,0.9375
SF-G17,SF-M22-2,2,5,0,0,2,5,0.0,1.0,0.0,1.0
SF-G17,SF-L22,4,8,0,3,4,5,0.0,1.0,0.375,0.625
SF-G17,SF-F27,4,6,0,1,4,5,0.0,1.0,0.16666666666666666,0.8333333333333334
SF-G17,SF-N22-2,2,3,0,0,2,3,0.0,1.0,0.0,1.0
SF-G17,SF-G28-2,2,4,0,1,2,3,0.0,1.0,0.25,0.75
SF-G17,SF-M22-1,1,3,0,0,1,3,0.0,1.0,0.0,1.0
SF-G17,SF-G23,1,1,1,0,0,1,1.0,0.0,0.0,1.0
SF-G17,SF-G24,11,11,3,3,8,8,0.2727272727272727,0.7272727272727273,0.2727272727272727,0.7272727272727273
SF-G17,SF-G25,11,9,5,0,6,9,0.45454545454545453,0.5454545454545454,0.0,1.0
SF-G17,SF-F23,11,10,3,3,8,7,0.2727272727272727,0.7272727272727273,0.3,0.7
SF-G17,SF-E23,15,6,1,0,14,6,0.06666666666666667,0.9333333333333333,0.0,1.0
SF-G17,SF-D24,2,2,1,0,1,2,0.5,0.5,0.0,1.0
SF-G17,SF-C22,1,7,0,0,1,7,0.0,1.0,0.0,1.0
SF-G17,SF-B22,4,5,2,5,2,0,0.5,0.5,1.0,0.0
SF-G17,SF-J17,4,11,0,7,4,4,0.0,1.0,0.6363636363636364,0.36363636363636365
SF-G17,SF-I19,3,6,1,3,2,3,0.3333333333333333,0.6666666666666666,0.5,0.5
SF-G17,SF-I20,2,3,1,1,1,2,0.5,0.5,0.3333333333333333,0.6666666666666666
SF-G17,SF-H16,8,9,0,4,8,5,0.0,1.0,0.4444444444444444,0.5555555555555556
SF-G17,SF-H20,4,11,2,7,2,4,0.5,0.5,0.6363636363636364,0.36363636363636365
SF-G17,SF-H18,9,6,4,0,5,6,0.4444444444444444,0.5555555555555556,0.0,1.0
SF-G17,SF-H17,17,5,5,3,12,2,0.29411764705882354,0.7058823529411765,0.6,0.4
SF-G17,SF-G19,12,32,7,23,5,9,0.5833333333333334,0.4166666666666667,0.71875,0.28125
SF-G17,SF-G18,28,29,15,17,13,12,0.5357142857142857,0.4642857142857143,0.5862068965517241,0.41379310344827586
SF-G17,SF-G20,40,36,14,11,26,25,0.35,0.65,0.3055555555555556,0.6944444444444444
SF-G17,SF-F19,13,13,7,6,6,7,0.5384615384615384,0.46153846153846156,0.46153846153846156,0.5384615384615384
SF-G17,SF-E18,8,8,1,7,7,1,0.125,0.875,0.875,0.125
SF-G17,SF-E20,19,16,2,8,17,8,0.10526315789473684,0.8947368421052632,0.5,0.5
SF-G17,SF-G30-2,1,5,0,3,1,2,0.0,1.0,0.6,0.4
SF-G17,SF-E29-2,3,9,1,2,2,7,0.3333333333333333,0.6666666666666666,0.2222222222222222,0.7777777777777778
SF-G17,SF-E29-1,3,3,1,1,2,2,0.3333333333333333,0.6666666666666666,0.3333333333333333,0.6666666666666666
SF-G17,SF-G29-2,3,2,0,0,3,2,0.0,1.0,0.0,1.0
SF-G17,SF-G29-1,1,5,0,0,1,5,0.0,1.0,0.0,1.0
SF-G17,SF-G30-1,1,2,0,2,1,0,0.0,1.0,1.0,0.0
SF-G17,SF-F28-1,1,2,0,0,1,2,0.0,1.0,0.0,1.0
SF-G17,SF-J10,4,5,0,5,4,0,0.0,1.0,1.0,0.0
SF-G17,SF-J12,3,2,1,0,2,2,0.3333333333333333,0.6666666666666666,0.0,1.0
SF-G17,SF-J13,4,4,1,1,3,3,0.25,0.75,0.25,0.75
SF-G17,SF-J15,4,4,0,0,4,4,0.0,1.0,0.0,1.0
SF-G17,SF-H13,3,19,0,0,3,19,0.0,1.0,0.0,1.0
SF-G17,SF-I16,7,3,2,1,5,2,0.2857142857142857,0.7142857142857143,0.3333333333333333,0.6666666666666666
SF-G17,SF-H12,1,5,0,0,1,5,0.0,1.0,0.0,1.0
SF-G17,SF-H15,2,2,1,1,1,1,0.5,0.5,0.5,0.5
SF-G17,SF-G9,39,28,38,24,1,4,0.9743589743589743,0.02564102564102564,0.8571428571428571,0.14285714285714285
SF-G17,SF-H14,6,2,1,0,5,2,0.16666666666666666,0.8333333333333334,0.0,1.0
SF-G17,SF-G13,9,6,2,2,7,4,0.2222222222222222,0.7777777777777778,0.3333333333333333,0.6666666666666666
SF-G17,SF-G11,4,2,2,1,2,1,0.5,0.5,0.5,0.5
SF-G17,SF-G12,5,13,3,8,2,5,0.6,0.4,0.6153846153846154,0.38461538461538464
SF-G17,SF-F15,3,4,1,3,2,1,0.3333333333333333,0.6666666666666666,0.75,0.25
SF-G17,SF-F16,4,8,1,3,3,5,0.25,0.75,0.375,0.625
SF-G17,SF-C20,3,16,0,2,3,14,0.0,1.0,0.125,0.875
SF-G17,SF-A20,3,4,1,1,2,3,0.3333333333333333,0.6666666666666666,0.25,0.75
SF-G17,SF-A19,2,4,0,2,2,2,0.0,1.0,0.5,0.5
SF-G17,SF-C26,4,1,0,0,4,1,0.0,1.0,0.0,1.0
SF-G17,SF-C25,11,6,0,2,11,4,0.0,1.0,0.3333333333333333,0.6666666666666666
SF-G17,SF-B25,2,1,0,0,2,1,0.0,1.0,0.0,1.0
SF-G17,SF-B28-2,1,3,0,0,1,3,0.0,1.0,0.0,1.0
SF-G17,SF-J1,5,13,1,3,4,10,0.2,0.8,0.23076923076923078,0.7692307692307693
SF-G17,SF-H0,7,7,0,2,7,5,0.0,1.0,0.2857142857142857,0.7142857142857143
SF-G17,SF-G5,6,4,2,2,4,2,0.3333333333333333,0.6666666666666666,0.5,0.5
SF-G17,SF-G7,3,7,0,7,3,0,0.0,1.0,1.0,0.0
SF-G17,SF-F9,1,4,0,0,1,4,0.0,1.0,0.0,1.0
SF-G17,SF-G26,3,1,0,1,3,0,0.0,1.0,1.0,0.0
SF-G17,SF-K21,9,11,0,4,9,7,0.0,1.0,0.36363636363636365,0.6363636363636364
SF-G17,SF-J23-1,19,15,0,7,19,8,0.0,1.0,0.4666666666666667,0.5333333333333333
SF-G17,SF-J22-2,17,16,2,0,15,16,0.11764705882352941,0.8823529411764706,0.0,1.0
SF-G17,SF-J21,7,14,1,3,6,11,0.14285714285714285,0.8571428571428571,0.21428571428571427,0.7857142857142857
SF-G17,SF-I21,4,3,0,0,4,3,0.0,1.0,0.0,1.0
SF-G17,SF-I22,4,4,1,2,3,2,0.25,0.75,0.5,0.5
SF-G17,SF-I23-2,1,3,0,1,1,2,0.0,1.0,0.3333333333333333,0.6666666666666666
SF-G17,SF-I24,2,1,0,0,2,1,0.0,1.0,0.0,1.0
SF-G17,SF-I23-1,2,2,0,0,2,2,0.0,1.0,0.0,1.0
SF-G17,SF-F26,22,28,0,7,22,21,0.0,1.0,0.25,0.75
SF-G17,SF-M13,3,10,0,1,3,9,0.0,1.0,0.1,0.9
SF-G17,SF-M15,9,7,1,2,8,5,0.1111111111111111,0.8888888888888888,0.2857142857142857,0.7142857142857143
SF-G17,SF-L20,12,18,0,0,12,18,0.0,1.0,0.0,1.0
SF-G17,SF-N20-1,1,1,0,0,1,1,0.0,1.0,0.0,1.0
SF-G17,SF-M20,3,7,0,0,3,7,0.0,1.0,0.0,1.0
SF-G17,SF-K17-2,2,11,1,8,1,3,0.5,0.5,0.7272727272727273,0.2727272727272727
SF-G17,SF-K20,4,3,0,0,4,3,0.0,1.0,0.0,1.0
SF-G17,SF-K15-,10,4,3,4,7,0,0.3,0.7,1.0,0.0
SF-G17,SF-K19,12,7,2,4,10,3,0.16666666666666666,0.8333333333333334,0.5714285714285714,0.42857142857142855
SF-G17,SF-K18,6,13,1,2,5,11,0.16666666666666666,0.8333333333333334,0.15384615384615385,0.8461538461538461
SF-G17,SF-K17,4,5,0,0,4,5,0.0,1.0,0.0,1.0
SF-G17,SF-J16,1,4,0,0,1,4,0.0,1.0,0.0,1.0
SF-G17,SF-J18,13,15,2,7,11,8,0.15384615384615385,0.8461538461538461,0.4666666666666667,0.5333333333333333
SF-G17,SF-J20,6,1,4,1,2,0,0.6666666666666666,0.3333333333333333,1.0,0.0
SF-G17,SF-J19,7,16,3,8,4,8,0.42857142857142855,0.5714285714285714,0.5,0.5
SF-G17,SF-M12,5,7,1,1,4,6,0.2,0.8,0.14285714285714285,0.8571428571428571
SF-G17,SF-M10,1,4,0,1,1,3,0.0,1.0,0.25,0.75
SF-G17,SF-M11,5,6,1,2,4,4,0.2,0.8,0.3333333333333333,0.6666666666666666
SF-G17,SF-Q21-1,1,1,0,0,1,1,0.0,1.0,0.0,1.0
SF-G17,SF-P21,3,1,1,0,2,1,0.3333333333333333,0.6666666666666666,0.0,1.0
SF-G17,SF-O18,5,4,0,0,5,4,0.0,1.0,0.0,1.0
SF-G17,SF-O19,3,2,0,0,3,2,0.0,1.0,0.0,1.0
SF-G17,SF-O21,5,8,0,1,5,7,0.0,1.0,0.125,0.875
SF-G17,SF-O22,10,7,2,0,8,7,0.2,0.8,0.0,1.0
SF-G17,SF-N21,1,2,0,1,1,1,0.0,1.0,0.5,0.5
SF-G17,SF-M21,3,2,2,0,1,2,0.6666666666666666,0.3333333333333333,0.0,1.0
SF-G17,SF-L21,6,4,0,1,6,3,0.0,1.0,0.25,0.75
SF-G17,SF-I27,3,2,1,1,2,1,0.3333333333333333,0.6666666666666666,0.5,0.5
SF-G17,SF-I28,1,4,1,3,0,1,1.0,0.0,0.75,0.25
SF-G17,SF I29-1,2,3,1,0,1,3,0.5,0.5,0.0,1.0
SF-G17,SF-S24,2,2,0,0,2,2,0.0,1.0,0.0,1.0
SF-G17,SF-P26,2,8,0,0,2,8,0.0,1.0,0.0,1.0
SF-G17,SF-T22,12,4,0,1,12,3,0.0,1.0,0.25,0.75
SF-G17,SF-Q22-1,2,1,1,0,1,1,0.5,0.5,0.0,1.0
SF-G17,SF-Q22-2,1,1,0,0,1,1,0.0,1.0,0.0,1.0
SF-G17,SF-P22,2,1,0,0,2,1,0.0,1.0,0.0,1.0
SF-G18,SF-M25,5,4,4,2,1,2,0.8,0.2,0.5,0.5
SF-G18,SF-M26-2,1,2,1,2,0,0,1.0,0.0,1.0,0.0
SF-G18,SF-L27,1,4,0,1,1,3,0.0,1.0,0.25,0.75
SF-G18,SF-J27,46,45,1,0,45,45,0.021739130434782608,0.9782608695652174,0.0,1.0
SF-G18,SF-M30,35,25,2,4,33,21,0.05714285714285714,0.9428571428571428,0.16,0.84
SF-G18,SF-J29,2,8,1,3,1,5,0.5,0.5,0.375,0.625
SF-G18,SF-K27-2,3,6,2,1,1,5,0.6666666666666666,0.3333333333333333,0.16666666666666666,0.8333333333333334
SF-G18,SF-J26-2,9,4,2,1,7,3,0.2222222222222222,0.7777777777777778,0.25,0.75
SF-G18,SF-K29-1,3,4,0,1,3,3,0.0,1.0,0.25,0.75
SF-G18,SF-J28-2,1,2,0,0,1,2,0.0,1.0,0.0,1.0
SF-G18,SF-K25,1,3,0,0,1,3,0.0,1.0,0.0,1.0
SF-G18,SF-J25,3,5,1,2,2,3,0.3333333333333333,0.6666666666666666,0.4,0.6
SF-G18,SF-H26-2,2,5,0,1,2,4,0.0,1.0,0.2,0.8
SF-G18,SF-P24,3,6,0,1,3,5,0.0,1.0,0.16666666666666666,0.8333333333333334
SF-G18,SF-O24,1,1,1,1,0,0,1.0,0.0,1.0,0.0
SF-G18,SF-J26,3,1,0,1,3,0,0.0,1.0,1.0,0.0
SF-G18,SF-I26-,4,2,2,2,2,0,0.5,0.5,1.0,0.0
SF-G18,SF-I25,4,2,0,1,4,1,0.0,1.0,0.5,0.5
SF-G18,SF-H26,8,11,4,6,4,5,0.5,0.5,0.5454545454545454,0.45454545454545453
SF-G18,SF-O23,2,3,0,1,2,2,0.0,1.0,0.3333333333333333,0.6666666666666666
SF-G18,SF-H27-1,3,3,0,0,3,3,0.0,1.0,0.0,1.0
SF-G18,SF-F28-2,6,10,0,9,6,1,0.0,1.0,0.9,0.1
SF-G18,SF-G27,13,12,4,4,9,8,0.3076923076923077,0.6923076923076923,0.3333333333333333,0.6666666666666666
SF-G18,SF-M22-2,6,7,0,2,6,5,0.0,1.0,0.2857142857142857,0.7142857142857143
SF-G18,SF-L22,3,5,1,0,2,5,0.3333333333333333,0.6666666666666666,0.0,1.0
SF-G18,SF-F27,14,13,0,2,14,11,0.0,1.0,0.15384615384615385,0.8461538461538461
SF-G18,SF-N22-2,7,17,1,0,6,17,0.14285714285714285,0.8571428571428571,0.0,1.0
SF-G18,SF-G28-2,1,3,0,1,1,2,0.0,1.0,0.3333333333333333,0.6666666666666666
SF-G18,SF-G28-1,6,6,0,1,6,5,0.0,1.0,0.16666666666666666,0.8333333333333334
SF-G18,SF-M22-1,2,1,0,0,2,1,0.0,1.0,0.0,1.0
SF-G18,SF-K22-2,5,5,2,4,3,1,0.4,0.6,0.8,0.2
SF-G18,SF-K24,2,4,0,1,2,3,0.0,1.0,0.25,0.75
SF-G18,SF-J23-2,2,7,0,0,2,7,0.0,1.0,0.0,1.0
SF-G18,SF-G23,7,17,0,4,7,13,0.0,1.0,0.23529411764705882,0.7647058823529411
SF-G18,SF-G24,17,36,1,4,16,32,0.058823529411764705,0.9411764705882353,0.1111111111111111,0.8888888888888888
SF-G18,SF-G25,16,11,4,3,12,8,0.25,0.75,0.2727272727272727,0.7272727272727273
SF-G18,SF-F23,27,30,4,3,23,27,0.14814814814814814,0.8518518518518519,0.1,0.9
SF-G18,SF-E23,20,25,4,3,16,22,0.2,0.8,0.12,0.88
SF-G18,SF-D24,8,7,3,0,5,7,0.375,0.625,0.0,1.0
SF-G18,SF-C22,7,8,0,2,7,6,0.0,1.0,0.25,0.75
SF-G18,SF-B22,2,8,1,2,1,6,0.5,0.5,0.25,0.75
SF-G18,SF-J17,54,32,10,3,44,29,0.18518518518518517,0.8148148148148148,0.09375,0.90625
SF-G18,SF-I19,13,15,7,11,6,4,0.5384615384615384,0.46153846153846156,0.7333333333333333,0.26666666666666666
SF-G18,SF-I20,14,6,9,5,5,1,0.6428571428571429,0.35714285714285715,0.8333333333333334,0.16666666666666666
SF-G18,SF-H16,7,16,1,3,6,13,0.14285714285714285,0.8571428571428571,0.1875,0.8125
SF-G18,SF-H19,5,1,3,1,2,0,0.6,0.4,1.0,0.0
SF-G18,SF-H20,15,26,6,11,9,15,0.4,0.6,0.4230769230769231,0.5769230769230769
SF-G18,SF-H18,6,19,2,15,4,4,0.3333333333333333,0.6666666666666666,0.7894736842105263,0.21052631578947367
SF-G18,SF-H17,15,12,11,1,4,11,0.7333333333333333,0.26666666666666666,0.08333333333333333,0.9166666666666666
SF-G18,SF-G19,18,33,15,25,3,8,0.8333333333333334,0.16666666666666666,0.7575757575757576,0.24242424242424243
SF-G18,SF-G17,29,28,17,15,12,13,0.5862068965517241,0.41379310344827586,0.5357142857142857,0.4642857142857143
SF-G18,SF-G20,71,111,38,66,33,45,0.5352112676056338,0.4647887323943662,0.5945945945945946,0.40540540540540543
SF-G18,SF-F19,27,23,14,12,13,11,0.5185185185185185,0.48148148148148145,0.5217391304347826,0.4782608695652174
SF-G18,SF-E18,28,13,23,6,5,7,0.8214285714285714,0.17857142857142858,0.46153846153846156,0.5384615384615384
SF-G18,SF-E20,23,25,5,3,18,22,0.21739130434782608,0.782608695652174,0.12,0.88
SF-G18,SF-G30-2,2,6,2,2,0,4,1.0,0.0,0.3333333333333333,0.6666666666666666
SF-G18,SF-F30-1,1,1,0,0,1,1,0.0,1.0,0.0,1.0
SF-G18,SF-E29-2,25,5,17,0,8,5,0.68,0.32,0.0,1.0
SF-G18,SF-D28,6,11,0,0,6,11,0.0,1.0,0.0,1.0
SF-G18,SF-G29-2,25,60,1,3,24,57,0.04,0.96,0.05,0.95
SF-G18,SF-G29-1,14,32,3,27,11,5,0.21428571428571427,0.7857142857142857,0.84375,0.15625
SF-G18,SF-G30-1,13,5,11,5,2,0,0.8461538461538461,0.15384615384615385,1.0,0.0
SF-G18,SF-G29-3,8,3,0,0,8,3,0.0,1.0,0.0,1.0
SF-G18,SF-F29,2,1,0,1,2,0,0.0,1.0,1.0,0.0
SF-G18,SF-E29-3,28,17,0,1,28,16,0.0,1.0,0.058823529411764705,0.9411764705882353
SF-G18,SF-F28-1,6,5,1,0,5,5,0.16666666666666666,0.8333333333333334,0.0,1.0
SF-G18,SF-E28,1,1,0,0,1,1,0.0,1.0,0.0,1.0
SF-G18,SF-J10,7,7,0,1,7,6,0.0,1.0,0.14285714285714285,0.8571428571428571
SF-G18,SF-J12,37,17,3,2,34,15,0.08108108108108109,0.918918918918919,0.11764705882352941,0.8823529411764706
SF-G18,SF-J13,7,3,2,0,5,3,0.2857142857142857,0.7142857142857143,0.0,1.0
SF-G18,SF-J15,11,9,3,1,8,8,0.2727272727272727,0.7272727272727273,0.1111111111111111,0.8888888888888888
SF-G18,SF-H13,9,10,3,1,6,9,0.3333333333333333,0.6666666666666666,0.1,0.9
SF-G18,SF-I16,8,13,4,4,4,9,0.5,0.5,0.3076923076923077,0.6923076923076923
SF-G18,SF-H12,13,32,3,0,10,32,0.23076923076923078,0.7692307692307693,0.0,1.0
SF-G18,SF-G10-2,4,1,0,1,4,0,0.0,1.0,1.0,0.0
SF-G18,SF-H15,3,7,2,0,1,7,0.6666666666666666,0.3333333333333333,0.0,1.0
SF-G18,SF-G9,3,6,0,1,3,5,0.0,1.0,0.16666666666666666,0.8333333333333334
SF-G18,SF-H14,2,2,2,1,0,1,1.0,0.0,0.5,0.5
SF-G18,SF-G13,12,18,1,0,11,18,0.08333333333333333,0.9166666666666666,0.0,1.0
SF-G18,SF-G11,3,9,0,1,3,8,0.0,1.0,0.1111111111111111,0.8888888888888888
SF-G18,SF-G12,9,5,2,2,7,3,0.2222222222222222,0.7777777777777778,0.4,0.6
SF-G18,SF-G10-1,3,2,1,0,2,2,0.3333333333333333,0.6666666666666666,0.0,1.0
SF-G18,SF-F15,16,21,13,3,3,18,0.8125,0.1875,0.14285714285714285,0.8571428571428571
SF-G18,SF-F16,27,12,20,2,7,10,0.7407407407407407,0.25925925925925924,0.16666666666666666,0.8333333333333334
SF-G18,SF-C21,2,4,0,1,2,3,0.0,1.0,0.25,0.75
SF-G18,SF-C20,2,9,0,1,2,8,0.0,1.0,0.1111111111111111,0.8888888888888888
SF-G18,SF-B21,3,6,0,3,3,3,0.0,1.0,0.5,0.5
SF-G18,SF-B19,5,8,0,3,5,5,0.0,1.0,0.375,0.625
SF-G18,SF-A20,3,7,1,0,2,7,0.3333333333333333,0.6666666666666666,0.0,1.0
SF-G18,SF-C26,5,3,0,1,5,2,0.0,1.0,0.3333333333333333,0.6666666666666666
SF-G18,SF-C25,18,12,1,0,17,12,0.05555555555555555,0.9444444444444444,0.0,1.0
SF-G18,SF-B25,5,4,0,0,5,4,0.0,1.0,0.0,1.0
SF-G18,SF-B28-2,4,2,0,0,4,2,0.0,1.0,0.0,1.0
SF-G18,SF-D27,1,8,1,1,0,7,1.0,0.0,0.125,0.875
SF-G18,SF-C28-2,1,1,0,0,1,1,0.0,1.0,0.0,1.0
SF-G18,SF-J1,11,14,3,9,8,5,0.2727272727272727,0.7272727272727273,0.6428571428571429,0.35714285714285715
SF-G18,SF-H0,2,1,0,1,2,0,0.0,1.0,1.0,0.0
SF-G18,SF-J5,1,5,0,0,1,5,0.0,1.0,0.0,1.0
SF-G18,SF-G6,2,1,1,1,1,0,0.5,0.5,1.0,0.0
SF-G18,SF-G5,3,5,0,2,3,3,0.0,1.0,0.4,0.6
SF-G18,SF-G7,3,5,1,2,2,3,0.3333333333333333,0.6666666666666666,0.4,0.6
SF-G18,SF-F9,4,10,2,2,2,8,0.5,0.5,0.2,0.8
SF-G18,SF-H25,1,7,0,7,1,0,0.0,1.0,1.0,0.0
SF-G18,SF-G26,1,5,0,2,1,3,0.0,1.0,0.4,0.6
SF-G18,SF-K21,15,18,4,1,11,17,0.26666666666666666,0.7333333333333333,0.05555555555555555,0.9444444444444444
SF-G18,SF-K22-1,2,6,1,2,1,4,0.5,0.5,0.3333333333333333,0.6666666666666666
SF-G18,SF-J23-1,18,38,5,7,13,31,0.2777777777777778,0.7222222222222222,0.18421052631578946,0.8157894736842105
SF-G18,SF-J22-1,11,9,2,1,9,8,0.18181818181818182,0.8181818181818182,0.1111111111111111,0.8888888888888888
SF-G18,SF-J22-2,9,15,1,2,8,13,0.1111111111111111,0.8888888888888888,0.13333333333333333,0.8666666666666667
SF-G18,SF-J21,10,25,1,10,9,15,0.1,0.9,0.4,0.6
SF-G18,SF-I21,6,13,0,8,6,5,0.0,1.0,0.6153846153846154,0.38461538461538464
SF-G18,SF-I22,27,39,11,4,16,35,0.4074074074074074,0.5925925925925926,0.10256410256410256,0.8974358974358975
SF-G18,SF-I23-2,11,23,5,13,6,10,0.45454545454545453,0.5454545454545454,0.5652173913043478,0.43478260869565216
SF-G18,SF-I24,6,54,2,51,4,3,0.3333333333333333,0.6666666666666666,0.9444444444444444,0.05555555555555555
SF-G18,SF-I23-1,51,62,35,57,16,5,0.6862745098039216,0.3137254901960784,0.9193548387096774,0.08064516129032258
SF-G18,SF-F26,17,49,2,4,15,45,0.11764705882352941,0.8823529411764706,0.08163265306122448,0.9183673469387755
SF-G18,SF-M13,37,42,7,6,30,36,0.1891891891891892,0.8108108108108109,0.14285714285714285,0.8571428571428571
SF-G18,SF-M15,17,16,3,3,14,13,0.17647058823529413,0.8235294117647058,0.1875,0.8125
SF-G18,SF-L19,17,15,1,1,16,14,0.058823529411764705,0.9411764705882353,0.06666666666666667,0.9333333333333333
SF-G18,SF-L20,15,14,0,1,15,13,0.0,1.0,0.07142857142857142,0.9285714285714286
SF-G18,SF-N20-1,6,5,0,1,6,4,0.0,1.0,0.2,0.8
SF-G18,SF-M20,28,30,2,5,26,25,0.07142857142857142,0.9285714285714286,0.16666666666666666,0.8333333333333334
SF-G18,SF-K17-2,8,9,1,0,7,9,0.125,0.875,0.0,1.0
SF-G18,SF-K20,24,18,3,3,21,15,0.125,0.875,0.16666666666666666,0.8333333333333334
SF-G18,SF-K15-,18,27,7,12,11,15,0.3888888888888889,0.6111111111111112,0.4444444444444444,0.5555555555555556
SF-G18,SF-K19,26,22,6,3,20,19,0.23076923076923078,0.7692307692307693,0.13636363636363635,0.8636363636363636
SF-G18,SF-K18,22,32,2,3,20,29,0.09090909090909091,0.9090909090909091,0.09375,0.90625
SF-G18,SF-K17,11,11,4,2,7,9,0.36363636363636365,0.6363636363636364,0.18181818181818182,0.8181818181818182
SF-G18,SF-J16,11,9,6,1,5,8,0.5454545454545454,0.45454545454545453,0.1111111111111111,0.8888888888888888
SF-G18,SF-J18,157,162,33,13,124,149,0.21019108280254778,0.7898089171974523,0.08024691358024691,0.9197530864197531
SF-G18,SF-J20,31,4,17,1,14,3,0.5483870967741935,0.45161290322580644,0.25,0.75
SF-G18,SF-J19,23,27,12,12,11,15,0.5217391304347826,0.4782608695652174,0.4444444444444444,0.5555555555555556
SF-G18,SF-O12,1,1,0,0,1,1,0.0,1.0,0.0,1.0
SF-G18,SF-M12,18,16,5,4,13,12,0.2777777777777778,0.7222222222222222,0.25,0.75
SF-G18,SF-M10,62,55,58,45,4,10,0.9354838709677419,0.06451612903225806,0.8181818181818182,0.18181818181818182
SF-G18,SF-M11,50,37,1,1,49,36,0.02,0.98,0.02702702702702703,0.972972972972973
SF-G18,SF-R19,5,5,0,0,5,5,0.0,1.0,0.0,1.0
SF-G18,SF-R20,1,3,0,0,1,3,0.0,1.0,0.0,1.0
SF-G18,SF-Q21-1,3,5,0,0,3,5,0.0,1.0,0.0,1.0
SF-G18,SF-P21,5,3,0,0,5,3,0.0,1.0,0.0,1.0
SF-G18,SF-O18,17,28,1,3,16,25,0.058823529411764705,0.9411764705882353,0.10714285714285714,0.8928571428571429
SF-G18,SF-O19,15,12,0,1,15,11,0.0,1.0,0.08333333333333333,0.9166666666666666
SF-G18,SF-O21,27,27,1,1,26,26,0.037037037037037035,0.9629629629629629,0.037037037037037035,0.9629629629629629
SF-G18,SF-O22,8,16,0,2,8,14,0.0,1.0,0.125,0.875
SF-G18,SF-N21,31,9,1,1,30,8,0.03225806451612903,0.967741935483871,0.1111111111111111,0.8888888888888888
SF-G18,SF-N20-2,85,20,2,1,83,19,0.023529411764705882,0.9764705882352941,0.05,0.95
SF-G18,SF-M21,3,5,0,0,3,5,0.0,1.0,0.0,1.0
SF-G18,SF-L21,6,10,1,0,5,10,0.16666666666666666,0.8333333333333334,0.0,1.0
SF-G18,SF-O30,12,8,0,0,12,8,0.0,1.0,0.0,1.0
SF-G18,SF-N27,4,2,3,0,1,2,0.75,0.25,0.0,1.0
SF-G18,SF-N29,6,4,1,2,5,2,0.16666666666666666,0.8333333333333334,0.5,0.5
SF-G18,SF-L30-1,8,15,4,3,4,12,0.5,0.5,0.2,0.8
SF-G18,SF-L29,3,4,0,2,3,2,0.0,1.0,0.5,0.5
SF-G18,SF-J29-1,1,1,0,1,1,0,0.0,1.0,1.0,0.0
SF-G18,SF-I29-2,3,2,0,0,3,2,0.0,1.0,0.0,1.0
SF-G18,SF-I27,10,23,1,13,9,10,0.1,0.9,0.5652173913043478,0.43478260869565216
SF-G18,SF-I28,2,5,0,2,2,3,0.0,1.0,0.4,0.6
SF-G18,SF I29-1,2,3,0,0,2,3,0.0,1.0,0.0,1.0
SF-G18,SF-S24,5,1,3,0,2,1,0.6,0.4,0.0,1.0
SF-G18,SF-R24,14,16,1,6,13,10,0.07142857142857142,0.9285714285714286,0.375,0.625
SF-G18,SF-P26,4,4,0,0,4,4,0.0,1.0,0.0,1.0
SF-G18,SF-O25-2,2,2,0,0,2,2,0.0,1.0,0.0,1.0
SF-G18,SF-N26,3,2,2,0,1,2,0.6666666666666666,0.3333333333333333,0.0,1.0
SF-G18,SF-T22,3,4,1,0,2,4,0.3333333333333333,0.6666666666666666,0.0,1.0
SF-G18,SF-S22-1,2,3,0,1,2,2,0.0,1.0,0.3333333333333333,0.6666666666666666
SF-G18,SF-Q23-3,3,3,0,0,3,3,0.0,1.0,0.0,1.0
SF-G18,SF-Q22-1,8,8,1,1,7,7,0.125,0.875,0.125,0.875
SF-G18,SF-Q22-2,7,14,2,6,5,8,0.2857142857142857,0.7142857142857143,0.42857142857142855,0.5714285714285714
SF-G18,SF-P22,9,8,2,4,7,4,0.2222222222222222,0.7777777777777778,0.5,0.5
SF-G18,SF-W19,1,4,0,0,1,4,0.0,1.0,0.0,1.0
SF-G18,SF-U21,3,1,0,0,3,1,0.0,1.0,0.0,1.0
SF-G18,SF-T20,1,3,0,0,1,3,0.0,1.0,0.0,1.0
SF-G18,SF-Y27,2,6,0,0,2,6,0.0,1.0,0.0,1.0
SF-G18,SF-X19,3,1,0,0,3,1,0.0,1.0,0.0,1.0
SF-G20,SF-M25,4,1,1,1,3,0,0.25,0.75,1.0,0.0
SF-G20,SF-M26-2,1,18,0,14,1,4,0.0,1.0,0.7777777777777778,0.2222222222222222
SF-G20,SF-L27,3,1,0,1,3,0,0.0,1.0,1.0,0.0
SF-G20,SF-K26,5,9,1,6,4,3,0.2,0.8,0.6666666666666666,0.3333333333333333
SF-G20,SF-J27,1,2,0,1,1,1,0.0,1.0,0.5,0.5
SF-G20,SF-J29-3,5,3,2,1,3,2,0.4,0.6,0.3333333333333333,0.6666666666666666
SF-G20,SF-J29,40,48,5,3,35,45,0.125,0.875,0.0625,0.9375
SF-G20,SF-L26,6,1,2,0,4,1,0.3333333333333333,0.6666666666666666,0.0,1.0
SF-G20,SF-M28,2,2,1,0,1,2,0.5,0.5,0.0,1.0
SF-G20,SF-M27,1,8,0,7,1,1,0.0,1.0,0.875,0.125
SF-G20,SF-L25,7,5,0,0,7,5,0.0,1.0,0.0,1.0
SF-G20,SF-L24,4,5,1,1,3,4,0.25,0.75,0.2,0.8
SF-G20,SF-N23,1,2,0,0,1,2,0.0,1.0,0.0,1.0
SF-G20,SF-K27-2,6,10,1,1,5,9,0.16666666666666666,0.8333333333333334,0.1,0.9
SF-G20,SF-J26-2,7,8,2,6,5,2,0.2857142857142857,0.7142857142857143,0.75,0.25
SF-G20,SF-K28-3,2,1,0,0,2,1,0.0,1.0,0.0,1.0
SF-G20,SF-L28,4,6,0,3,4,3,0.0,1.0,0.5,0.5
SF-G20,SF-K29-1,3,9,1,4,2,5,0.3333333333333333,0.6666666666666666,0.4444444444444444,0.5555555555555556
SF-G20,SF-J28-2,8,7,0,0,8,7,0.0,1.0,0.0,1.0
SF-G20,SF-K25,8,5,4,1,4,4,0.5,0.5,0.2,0.8
SF-G20,SF-J25,16,25,6,7,10,18,0.375,0.625,0.28,0.72
SF-G20,SF-H26-2,3,3,0,0,3,3,0.0,1.0,0.0,1.0
SF-G20,SF-P24,4,6,1,3,3,3,0.25,0.75,0.5,0.5
SF-G20,SF-J24,8,12,2,3,6,9,0.25,0.75,0.25,0.75
SF-G20,SF-J26,1,1,0,0,1,1,0.0,1.0,0.0,1.0
SF-G20,SF-I26-,4,12,0,3,4,9,0.0,1.0,0.25,0.75
SF-G20,SF-I25,11,19,9,13,2,6,0.8181818181818182,0.18181818181818182,0.6842105263157895,0.3157894736842105
SF-G20,SF-K23,1,2,0,0,1,2,0.0,1.0,0.0,1.0
SF-G20,SF-H26,8,28,0,16,8,12,0.0,1.0,0.5714285714285714,0.42857142857142855
SF-G20,SF-O23,9,9,4,3,5,6,0.4444444444444444,0.5555555555555556,0.3333333333333333,0.6666666666666666
SF-G20,SF-H27-1,4,1,2,0,2,1,0.5,0.5,0.0,1.0
SF-G20,SF-F28-2,16,12,7,11,9,1,0.4375,0.5625,0.9166666666666666,0.08333333333333333
SF-G20,SF-G27,24,27,8,19,16,8,0.3333333333333333,0.6666666666666666,0.7037037037037037,0.2962962962962963
SF-G20,SF-M22-2,10,9,1,5,9,4,0.1,0.9,0.5555555555555556,0.4444444444444444
SF-G20,SF-L22,38,13,0,0,38,13,0.0,1.0,0.0,1.0
SF-G20,SF-F27,46,53,6,8,40,45,0.13043478260869565,0.8695652173913043,0.1509433962264151,0.8490566037735849
SF-G20,SF-N22-2,12,12,2,3,10,9,0.16666666666666666,0.8333333333333334,0.25,0.75
SF-G20,SF-G28-2,2,10,0,0,2,10,0.0,1.0,0.0,1.0
SF-G20,SF-M22-1,4,3,1,2,3,1,0.25,0.75,0.6666666666666666,0.3333333333333333
SF-G20,SF-K22-2,14,1,0,0,14,1,0.0,1.0,0.0,1.0
SF-G20,SF-K24,6,4,2,1,4,3,0.3333333333333333,0.6666666666666666,0.25,0.75
SF-G20,SF-J23-2,7,7,3,4,4,3,0.42857142857142855,0.5714285714285714,0.5714285714285714,0.42857142857142855
SF-G20,SF-G23,3,8,1,4,2,4,0.3333333333333333,0.6666666666666666,0.5,0.5
SF-G20,SF-G24,43,60,10,12,33,48,0.23255813953488372,0.7674418604651163,0.2,0.8
SF-G20,SF-G25,34,41,8,6,26,35,0.23529411764705882,0.7647058823529411,0.14634146341463414,0.8536585365853658
SF-G20,SF-F23,29,20,11,6,18,14,0.3793103448275862,0.6206896551724138,0.3,0.7
SF-G20,SF-E23,24,28,6,5,18,23,0.25,0.75,0.17857142857142858,0.8214285714285714
SF-G20,SF-D24,9,5,3,0,6,5,0.3333333333333333,0.6666666666666666,0.0,1.0
SF-G20,SF-C22,10,6,1,0,9,6,0.1,0.9,0.0,1.0
SF-G20,SF-B22,16,7,5,0,11,7,0.3125,0.6875,0.0,1.0
SF-G20,SF-J17,30,26,13,4,17,22,0.43333333333333335,0.5666666666666667,0.15384615384615385,0.8461538461538461
SF-G20,SF-I19,28,20,13,8,15,12,0.4642857142857143,0.5357142857142857,0.4,0.6
SF-G20,SF-I20,5,14,3,11,2,3,0.6,0.4,0.7857142857142857,0.21428571428571427
SF-G20,SF-H16,27,22,13,3,14,19,0.48148148148148145,0.5185185185185185,0.13636363636363635,0.8636363636363636
SF-G20,SF-H19,8,7,6,5,2,2,0.75,0.25,0.7142857142857143,0.2857142857142857
SF-G20,SF-H20,25,48,15,33,10,15,0.6,0.4,0.6875,0.3125
SF-G20,SF-H18,10,17,8,8,2,9,0.8,0.2,0.47058823529411764,0.5294117647058824
SF-G20,SF-H17,9,3,5,1,4,2,0.5555555555555556,0.4444444444444444,0.3333333333333333,0.6666666666666666
SF-G20,SF-G19,7,17,2,8,5,9,0.2857142857142857,0.7142857142857143,0.47058823529411764,0.5294117647058824
SF-G20,SF-G17,36,40,11,14,25,26,0.3055555555555556,0.6944444444444444,0.35,0.65
SF-G20,SF-G18,111,71,66,38,45,33,0.5945945945945946,0.40540540540540543,0.5352112676056338,0.4647887323943662
SF-G20,SF-F19,20,14,11,9,9,5,0.55,0.45,0.6428571428571429,0.35714285714285715
SF-G20,SF-E18,22,12,13,4,9,8,0.5909090909090909,0.4090909090909091,0.3333333333333333,0.6666666666666666
SF-G20,SF-E20,86,19,47,4,39,15,0.5465116279069767,0.45348837209302323,0.21052631578947367,0.7894736842105263
SF-G20,SF-H30,1,1,0,1,1,0,0.0,1.0,1.0,0.0
SF-G20,SF-G30-2,5,9,0,0,5,9,0.0,1.0,0.0,1.0
SF-G20,SF-E29-2,8,10,0,2,8,8,0.0,1.0,0.2,0.8
SF-G20,SF-E29-1,7,12,4,2,3,10,0.5714285714285714,0.42857142857142855,0.16666666666666666,0.8333333333333334
SF-G20,SF-D29,4,2,4,0,0,2,1.0,0.0,0.0,1.0
SF-G20,SF-D28,3,4,0,4,3,0,0.0,1.0,1.0,0.0
SF-G20,SF-A27,5,7,1,4,4,3,0.2,0.8,0.5714285714285714,0.42857142857142855
SF-G20,SF-G29-2,11,17,3,3,8,14,0.2727272727272727,0.7272727272727273,0.17647058823529413,0.8235294117647058
SF-G20,SF-G29-1,1,4,0,1,1,3,0.0,1.0,0.25,0.75
SF-G20,SF-G30-1,11,7,0,3,11,4,0.0,1.0,0.42857142857142855,0.5714285714285714
SF-G20,SF-G29-3,49,48,2,23,47,25,0.04081632653061224,0.9591836734693877,0.4791666666666667,0.5208333333333334
SF-G20,SF-F29,8,12,2,7,6,5,0.25,0.75,0.5833333333333334,0.4166666666666667
SF-G20,SF-E29-3,3,9,2,0,1,9,0.6666666666666666,0.3333333333333333,0.0,1.0
SF-G20,SF-F28-1,1,21,0,0,1,21,0.0,1.0,0.0,1.0
SF-G20,SF-E28-2,1,1,0,0,1,1,0.0,1.0,0.0,1.0
SF-G20,SF-E28,2,3,0,0,2,3,0.0,1.0,0.0,1.0
SF-G20,SF-J10,5,5,1,1,4,4,0.2,0.8,0.2,0.8
SF-G20,SF-J12,7,7,1,2,6,5,0.14285714285714285,0.8571428571428571,0.2857142857142857,0.7142857142857143
SF-G20,SF-J13,4,6,2,1,2,5,0.5,0.5,0.16666666666666666,0.8333333333333334
SF-G20,SF-J15,4,6,4,0,0,6,1.0,0.0,0.0,1.0
SF-G20,SF-H13,6,2,1,0,5,2,0.16666666666666666,0.8333333333333334,0.0,1.0
SF-G20,SF-I16,4,2,1,0,3,2,0.25,0.75,0.0,1.0
SF-G20,SF-H12,5,1,2,1,3,0,0.4,0.6,1.0,0.0
SF-G20,SF-G10-2,2,2,0,0,2,2,0.0,1.0,0.0,1.0
SF-G20,SF-H15,12,18,9,1,3,17,0.75,0.25,0.05555555555555555,0.9444444444444444
SF-G20,SF-G9,10,14,6,8,4,6,0.6,0.4,0.5714285714285714,0.42857142857142855
SF-G20,SF-H14,2,3,0,0,2,3,0.0,1.0,0.0,1.0
SF-G20,SF-G13,18,7,8,5,10,2,0.4444444444444444,0.5555555555555556,0.7142857142857143,0.2857142857142857
SF-G20,SF-G11,3,4,0,2,3,2,0.0,1.0,0.5,0.5
SF-G20,SF-G12,9,13,3,3,6,10,0.3333333333333333,0.6666666666666666,0.23076923076923078,0.7692307692307693
SF-G20,SF-G10-1,2,2,0,0,2,2,0.0,1.0,0.0,1.0
SF-G20,SF-F15,6,3,5,1,1,2,0.8333333333333334,0.16666666666666666,0.3333333333333333,0.6666666666666666
SF-G20,SF-F16,18,10,12,1,6,9,0.6666666666666666,0.3333333333333333,0.1,0.9
SF-G20,SF-C21,6,9,0,6,6,3,0.0,1.0,0.6666666666666666,0.3333333333333333
SF-G20,SF-C20,5,7,5,4,0,3,1.0,0.0,0.5714285714285714,0.42857142857142855
SF-G20,SF-B21,1,4,1,2,0,2,1.0,0.0,0.5,0.5
SF-G20,SF-B19,3,11,1,7,2,4,0.3333333333333333,0.6666666666666666,0.6363636363636364,0.36363636363636365
SF-G20,SF-A20,8,8,5,2,3,6,0.625,0.375,0.25,0.75
SF-G20,SF-A19,2,2,1,1,1,1,0.5,0.5,0.5,0.5
SF-G20,SF-C26,12,23,2,0,10,23,0.16666666666666666,0.8333333333333334,0.0,1.0
SF-G20,SF-C25,12,10,1,1,11,9,0.08333333333333333,0.9166666666666666,0.1,0.9
SF-G20,SF-B25,6,6,0,2,6,4,0.0,1.0,0.3333333333333333,0.6666666666666666
SF-G20,SF-E27,1,4,0,4,1,0,0.0,1.0,1.0,0.0
SF-G20,SF-D27,2,6,1,4,1,2,0.5,0.5,0.6666666666666666,0.3333333333333333
SF-G20,SF-C28-2,1,1,1,0,0,1,1.0,0.0,0.0,1.0
SF-G20,SF-C28-1,3,1,0,0,3,1,0.0,1.0,0.0,1.0
SF-G20,SF-J1,7,11,3,2,4,9,0.42857142857142855,0.5714285714285714,0.18181818181818182,0.8181818181818182
SF-G20,SF-H0,12,18,12,15,0,3,1.0,0.0,0.8333333333333334,0.16666666666666666
SF-G20,SF-J3,7,2,4,2,3,0,0.5714285714285714,0.42857142857142855,1.0,0.0
SF-G20,SF-J5,15,11,1,1,14,10,0.06666666666666667,0.9333333333333333,0.09090909090909091,0.9090909090909091
SF-G20,SF-G6,4,3,2,2,2,1,0.5,0.5,0.6666666666666666,0.3333333333333333
SF-G20,SF-G8,3,1,2,0,1,1,0.6666666666666666,0.3333333333333333,0.0,1.0
SF-G20,SF-G5,3,2,0,1,3,1,0.0,1.0,0.5,0.5
SF-G20,SF-G7,8,14,0,3,8,11,0.0,1.0,0.21428571428571427,0.7857142857142857
SF-G20,SF-F9,1,4,1,2,0,2,1.0,0.0,0.5,0.5
SF-G20,SF-H25,3,8,2,3,1,5,0.6666666666666666,0.3333333333333333,0.375,0.625
SF-G20,SF-G26,12,7,0,3,12,4,0.0,1.0,0.42857142857142855,0.5714285714285714
SF-G20,SF-K21,50,52,17,2,33,50,0.34,0.66,0.038461538461538464,0.9615384615384616
SF-G20,SF-K22-1,38,2,2,2,36,0,0.05263157894736842,0.9473684210526315,1.0,0.0
SF-G20,SF-J23-1,25,41,5,18,20,23,0.2,0.8,0.43902439024390244,0.5609756097560976
SF-G20,SF-J22-1,46,42,8,6,38,36,0.17391304347826086,0.8260869565217391,0.14285714285714285,0.8571428571428571
SF-G20,SF-J22-2,24,28,6,16,18,12,0.25,0.75,0.5714285714285714,0.42857142857142855
SF-G20,SF-J21,39,42,20,22,19,20,0.5128205128205128,0.48717948717948717,0.5238095238095238,0.47619047619047616
SF-G20,SF-I21,17,14,10,4,7,10,0.5882352941176471,0.4117647058823529,0.2857142857142857,0.7142857142857143
SF-G20,SF-I22,14,14,4,4,10,10,0.2857142857142857,0.7142857142857143,0.2857142857142857,0.7142857142857143
SF-G20,SF-I23-2,15,13,5,7,10,6,0.3333333333333333,0.6666666666666666,0.5384615384615384,0.46153846153846156
SF-G20,SF-I24,4,19,2,13,2,6,0.5,0.5,0.6842105263157895,0.3157894736842105
SF-G20,SF-I23-1,18,11,6,5,12,6,0.3333333333333333,0.6666666666666666,0.45454545454545453,0.5454545454545454
SF-G20,SF-F26,43,32,7,8,36,24,0.16279069767441862,0.8372093023255814,0.25,0.75
SF-G20,SF-M13,9,4,3,1,6,3,0.3333333333333333,0.6666666666666666,0.25,0.75
SF-G20,SF-M15,14,16,4,1,10,15,0.2857142857142857,0.7142857142857143,0.0625,0.9375
SF-G20,SF-L19,16,12,4,3,12,9,0.25,0.75,0.25,0.75
SF-G20,SF-L20,11,12,5,2,6,10,0.45454545454545453,0.5454545454545454,0.16666666666666666,0.8333333333333334
SF-G20,SF-N20-1,7,5,1,0,6,5,0.14285714285714285,0.8571428571428571,0.0,1.0
SF-G20,SF-M20,16,14,1,7,15,7,0.0625,0.9375,0.5,0.5
SF-G20,SF-K17-2,7,9,0,2,7,7,0.0,1.0,0.2222222222222222,0.7777777777777778
SF-G20,SF-K20,15,14,2,9,13,5,0.13333333333333333,0.8666666666666667,0.6428571428571429,0.35714285714285715
SF-G20,SF-K15-,25,40,5,9,20,31,0.2,0.8,0.225,0.775
SF-G20,SF-K19,38,44,4,2,34,42,0.10526315789473684,0.8947368421052632,0.045454545454545456,0.9545454545454546
SF-G20,SF-K18,19,18,4,4,15,14,0.21052631578947367,0.7894736842105263,0.2222222222222222,0.7777777777777778
SF-G20,SF-K17,15,13,5,3,10,10,0.3333333333333333,0.6666666666666666,0.23076923076923078,0.7692307692307693
SF-G20,SF-J16,8,13,2,5,6,8,0.25,0.75,0.38461538461538464,0.6153846153846154
SF-G20,SF-J18,24,39,9,3,15,36,0.375,0.625,0.07692307692307693,0.9230769230769231
SF-G20,SF-J20,69,54,54,46,15,8,0.782608695652174,0.21739130434782608,0.8518518518518519,0.14814814814814814
SF-G20,SF-J19,50,53,36,25,14,28,0.72,0.28,0.4716981132075472,0.5283018867924528
SF-G20,SF-M12,7,7,3,3,4,4,0.42857142857142855,0.5714285714285714,0.42857142857142855,0.5714285714285714
SF-G20,SF-M10,2,3,1,0,1,3,0.5,0.5,0.0,1.0
SF-G20,SF-M11,10,7,4,2,6,5,0.4,0.6,0.2857142857142857,0.7142857142857143
SF-G20,SF-R20,3,3,0,1,3,2,0.0,1.0,0.3333333333333333,0.6666666666666666
SF-G20,SF-Q21-1,3,5,2,3,1,2,0.6666666666666666,0.3333333333333333,0.6,0.4
SF-G20,SF-P21,3,8,1,2,2,6,0.3333333333333333,0.6666666666666666,0.25,0.75
SF-G20,SF-O18,11,9,0,3,11,6,0.0,1.0,0.3333333333333333,0.6666666666666666
SF-G20,SF-O19,5,4,1,2,4,2,0.2,0.8,0.5,0.5
SF-G20,SF-O21,16,24,1,8,15,16,0.0625,0.9375,0.3333333333333333,0.6666666666666666
SF-G20,SF-O22,22,32,11,11,11,21,0.5,0.5,0.34375,0.65625
SF-G20,SF-N21,8,19,2,5,6,14,0.25,0.75,0.2631578947368421,0.7368421052631579
SF-G20,SF-N20-2,2,2,1,1,1,1,0.5,0.5,0.5,0.5
SF-G20,SF-M21,8,8,2,1,6,7,0.25,0.75,0.125,0.875
SF-G20,SF-L21,26,53,2,2,24,51,0.07692307692307693,0.9230769230769231,0.03773584905660377,0.9622641509433962
SF-G20,SF-Q30,3,1,0,0,3,1,0.0,1.0,0.0,1.0
SF-G20,SF-O30-2,1,2,0,2,1,0,0.0,1.0,1.0,0.0
SF-G20,SF-O30,3,2,2,1,1,1,0.6666666666666666,0.3333333333333333,0.5,0.5
SF-G20,SF-N27,2,3,0,1,2,2,0.0,1.0,0.3333333333333333,0.6666666666666666
SF-G20,SF-N29,3,3,2,3,1,0,0.6666666666666666,0.3333333333333333,1.0,0.0
SF-G20,SF-N28,3,5,0,4,3,1,0.0,1.0,0.8,0.2
SF-G20,SF-L30-1,4,10,0,7,4,3,0.0,1.0,0.7,0.3
SF-G20,SF-L29,4,7,0,2,4,5,0.0,1.0,0.2857142857142857,0.7142857142857143
SF-G20,SF-J29-1,7,2,0,1,7,1,0.0,1.0,0.5,0.5
SF-G20,SF-I30,5,6,0,2,5,4,0.0,1.0,0.3333333333333333,0.6666666666666666
SF-G20,SF-I27,9,30,0,10,9,20,0.0,1.0,0.3333333333333333,0.6666666666666666
SF-G20,SF-I28,6,2,0,0,6,2,0.0,1.0,0.0,1.0
SF-G20,SF-I30-2,2,1,0,0,2,1,0.0,1.0,0.0,1.0
SF-G20,SF I29-1,21,36,2,2,19,34,0.09523809523809523,0.9047619047619048,0.05555555555555555,0.9444444444444444
SF-G20,SF-H28,4,11,2,6,2,5,0.5,0.5,0.5454545454545454,0.45454545454545453
SF-G20,SF-H29,1,1,0,0,1,1,0.0,1.0,0.0,1.0
SF-G20,SF-R24,2,6,1,3,1,3,0.5,0.5,0.5,0.5
SF-G20,SF-P26,3,4,1,0,2,4,0.3333333333333333,0.6666666666666666,0.0,1.0
SF-G20,SF-O25-2,1,5,0,4,1,1,0.0,1.0,0.8,0.2
SF-G20,SF-N22-1B,1,2,0,2,1,0,0.0,1.0,1.0,0.0
SF-G20,SF-T22,5,6,0,3,5,3,0.0,1.0,0.5,0.5
SF-G20,SF-S22-1,2,11,0,1,2,10,0.0,1.0,0.09090909090909091,0.9090909090909091
SF-G20,SF-Q23-3,2,5,0,3,2,2,0.0,1.0,0.6,0.4
SF-G20,SF-Q22-1,12,25,0,3,12,22,0.0,1.0,0.12,0.88
SF-G20,SF-Q22-2,3,6,0,0,3,6,0.0,1.0,0.0,1.0
SF-G20,SF-P22,29,22,7,12,22,10,0.2413793103448276,0.7586206896551724,0.5454545454545454,0.45454545454545453
SF-G20,SF-W19,1,1,0,0,1,1,0.0,1.0,0.0,1.0
SF-G20,SF-T20,1,2,0,0,1,2,0.0,1.0,0.0,1.0
SF-G20,SF-Y14,7,9,0,0,7,9,0.0,1.0,0.0,1.0
SF-F19,SF-K26,4,3,1,0,3,3,0.25,0.75,0.0,1.0
SF-F19,SF-M30,7,6,1,1,6,5,0.14285714285714285,0.8571428571428571,0.16666666666666666,0.8333333333333334
SF-F19,SF-J29-3,2,2,0,0,2,2,0.0,1.0,0.0,1.0
SF-F19,SF-J29,3,1,0,0,3,1,0.0,1.0,0.0,1.0
SF-F19,SF-L26,1,1,0,0,1,1,0.0,1.0,0.0,1.0
SF-F19,SF-L25,1,3,0,0,1,3,0.0,1.0,0.0,1.0
SF-F19,SF-M24,1,3,0,0,1,3,0.0,1.0,0.0,1.0
SF-F19,SF-N23,1,1,0,0,1,1,0.0,1.0,0.0,1.0
SF-F19,SF-K27-2,1,1,0,1,1,0,0.0,1.0,1.0,0.0
SF-F19,SF-J26-2,4,3,1,1,3,2,0.25,0.75,0.3333333333333333,0.6666666666666666
SF-F19,SF-L28,3,1,1,1,2,0,0.3333333333333333,0.6666666666666666,1.0,0.0
SF-F19,SF-K29-1,3,3,0,0,3,3,0.0,1.0,0.0,1.0
SF-F19,SF-K25,5,2,0,1,5,1,0.0,1.0,0.5,0.5
SF-F19,SF-J25,13,10,5,4,8,6,0.38461538461538464,0.6153846153846154,0.4,0.6
SF-F19,SF-H26-2,3,1,0,1,3,0,0.0,1.0,1.0,0.0
SF-F19,SF-P24,5,3,1,0,4,3,0.2,0.8,0.0,1.0
SF-F19,SF-J24,5,4,1,1,4,3,0.2,0.8,0.25,0.75
SF-F19,SF-O24,1,2,1,0,0,2,1.0,0.0,0.0,1.0
SF-F19,SF-J26,1,2,0,1,1,1,0.0,1.0,0.5,0.5
SF-F19,SF-I26-,1,1,0,0,1,1,0.0,1.0,0.0,1.0
SF-F19,SF-I25,5,6,1,5,4,1,0.2,0.8,0.8333333333333334,0.16666666666666666
SF-F19,SF-H26,20,33,0,1,20,32,0.0,1.0,0.030303030303030304,0.9696969696969697
SF-F19,SF-O23,7,3,2,0,5,3,0.2857142857142857,0.7142857142857143,0.0,1.0
SF-F19,SF-F28-2,10,8,0,2,10,6,0.0,1.0,0.25,0.75
SF-F19,SF-G27,7,8,1,2,6,6,0.14285714285714285,0.8571428571428571,0.25,0.75
SF-F19,SF-M22-2,10,4,3,0,7,4,0.3,0.7,0.0,1.0
SF-F19,SF-L22,6,10,2,4,4,6,0.3333333333333333,0.6666666666666666,0.4,0.6
SF-F19,SF-F27,14,5,0,1,14,4,0.0,1.0,0.2,0.8
SF-F19,SF-N22-2,7,5,0,0,7,5,0.0,1.0,0.0,1.0
SF-F19,SF-G28-2,2,4,0,0,2,4,0.0,1.0,0.0,1.0
SF-F19,SF-M22-1,1,2,0,1,1,1,0.0,1.0,0.5,0.5
SF-F19,SF-K22-2,4,2,1,1,3,1,0.25,0.75,0.5,0.5
SF-F19,SF-K24,12,7,2,3,10,4,0.16666666666666666,0.8333333333333334,0.42857142857142855,0.5714285714285714
SF-F19,SF-J23-2,4,2,1,1,3,1,0.25,0.75,0.5,0.5
SF-F19,SF-G23,3,6,1,1,2,5,0.3333333333333333,0.6666666666666666,0.16666666666666666,0.8333333333333334
SF-F19,SF-G24,17,5,4,0,13,5,0.23529411764705882,0.7647058823529411,0.0,1.0
SF-F19,SF-G25,10,15,1,1,9,14,0.1,0.9,0.06666666666666667,0.9333333333333333
SF-F19,SF-F23,11,12,4,4,7,8,0.36363636363636365,0.6363636363636364,0.3333333333333333,0.6666666666666666
SF-F19,SF-E23,31,32,4,8,27,24,0.12903225806451613,0.8709677419354839,0.25,0.75
SF-F19,SF-D24,5,10,0,2,5,8,0.0,1.0,0.2,0.8
SF-F19,SF-C22,10,15,3,2,7,13,0.3,0.7,0.13333333333333333,0.8666666666666667
SF-F19,SF-B22,12,11,2,2,10,9,0.16666666666666666,0.8333333333333334,0.18181818181818182,0.8181818181818182
SF-F19,SF-J17,26,21,6,1,20,20,0.23076923076923078,0.7692307692307693,0.047619047619047616,0.9523809523809523
SF-F19,SF-I19,25,20,17,6,8,14,0.68,0.32,0.3,0.7
SF-F19,SF-I20,14,7,6,2,8,5,0.42857142857142855,0.5714285714285714,0.2857142857142857,0.7142857142857143
SF-F19,SF-H16,13,8,3,1,10,7,0.23076923076923078,0.7692307692307693,0.125,0.875
SF-F19,SF-H19,2,1,2,1,0,0,1.0,0.0,1.0,0.0
SF-F19,SF-H20,16,10,4,2,12,8,0.25,0.75,0.2,0.8
SF-F19,SF-H18,12,8,7,4,5,4,0.5833333333333334,0.4166666666666667,0.5,0.5
SF-F19,SF-H17,5,4,1,1,4,3,0.2,0.8,0.25,0.75
SF-F19,SF-G19,55,52,33,36,22,16,0.6,0.4,0.6923076923076923,0.3076923076923077
SF-F19,SF-G17,13,13,6,7,7,6,0.46153846153846156,0.5384615384615384,0.5384615384615384,0.46153846153846156
SF-F19,SF-G18,23,27,12,14,11,13,0.5217391304347826,0.4782608695652174,0.5185185185185185,0.48148148148148145
SF-F19,SF-G20,14,20,9,11,5,9,0.6428571428571429,0.35714285714285715,0.55,0.45
SF-F19,SF-E18,42,41,15,12,27,29,0.35714285714285715,0.6428571428571429,0.2926829268292683,0.7073170731707317
SF-F19,SF-E20,24,11,12,4,12,7,0.5,0.5,0.36363636363636365,0.6363636363636364
SF-F19,SF-G30-2,2,7,0,1,2,6,0.0,1.0,0.14285714285714285,0.8571428571428571
SF-F19,SF-E29-2,3,2,0,0,3,2,0.0,1.0,0.0,1.0
SF-F19,SF-D28,1,2,0,0,1,2,0.0,1.0,0.0,1.0
SF-F19,SF-G29-2,2,1,1,1,1,0,0.5,0.5,1.0,0.0
SF-F19,SF-G29-1,2,2,0,0,2,2,0.0,1.0,0.0,1.0
SF-F19,SF-G29-3,1,1,0,0,1,1,0.0,1.0,0.0,1.0
SF-F19,SF-F28-1,25,31,1,3,24,28,0.04,0.96,0.0967741935483871,0.9032258064516129
SF-F19,SF-E28-2,2,4,0,2,2,2,0.0,1.0,0.5,0.5
SF-F19,SF-E28,3,4,0,0,3,4,0.0,1.0,0.0,1.0
SF-F19,SF-J10,7,3,2,0,5,3,0.2857142857142857,0.7142857142857143,0.0,1.0
SF-F19,SF-J12,13,10,2,0,11,10,0.15384615384615385,0.8461538461538461,0.0,1.0
SF-F19,SF-J13,2,1,0,0,2,1,0.0,1.0,0.0,1.0
SF-F19,SF-J15,3,3,1,0,2,3,0.3333333333333333,0.6666666666666666,0.0,1.0
SF-F19,SF-J14,1,4,0,1,1,3,0.0,1.0,0.25,0.75
SF-F19,SF-H13,8,3,1,0,7,3,0.125,0.875,0.0,1.0
SF-F19,SF-I16,4,16,1,1,3,15,0.25,0.75,0.0625,0.9375
SF-F19,SF-H12,15,16,0,0,15,16,0.0,1.0,0.0,1.0
SF-F19,SF-G10-2,2,3,0,2,2,1,0.0,1.0,0.6666666666666666,0.3333333333333333
SF-F19,SF-H15,3,3,1,0,2,3,0.3333333333333333,0.6666666666666666,0.0,1.0
SF-F19,SF-G9,9,3,4,1,5,2,0.4444444444444444,0.5555555555555556,0.3333333333333333,0.6666666666666666
SF-F19,SF-G13,9,12,2,4,7,8,0.2222222222222222,0.7777777777777778,0.3333333333333333,0.6666666666666666
SF-F19,SF-G12,22,30,4,4,18,26,0.18181818181818182,0.8181818181818182,0.13333333333333333,0.8666666666666667
SF-F19,SF-G10-1,16,7,3,1,13,6,0.1875,0.8125,0.14285714285714285,0.8571428571428571
SF-F19,SF-F15,30,32,22,7,8,25,0.7333333333333333,0.26666666666666666,0.21875,0.78125
SF-F19,SF-F16,21,23,12,10,9,13,0.5714285714285714,0.42857142857142855,0.43478260869565216,0.5652173913043478
SF-F19,SF-C21,4,2,3,1,1,1,0.75,0.25,0.5,0.5
SF-F19,SF-C20,4,34,0,13,4,21,0.0,1.0,0.38235294117647056,0.6176470588235294
SF-F19,SF-B21,3,5,1,0,2,5,0.3333333333333333,0.6666666666666666,0.0,1.0
SF-F19,SF-B19,8,19,0,6,8,13,0.0,1.0,0.3157894736842105,0.6842105263157895
SF-F19,SF-A20,11,21,3,6,8,15,0.2727272727272727,0.7272727272727273,0.2857142857142857,0.7142857142857143
SF-F19,SF-A19,20,19,0,2,20,17,0.0,1.0,0.10526315789473684,0.8947368421052632
SF-F19,SF-C26,14,4,0,0,14,4,0.0,1.0,0.0,1.0
SF-F19,SF-C25,7,14,0,2,7,12,0.0,1.0,0.14285714285714285,0.8571428571428571
SF-F19,SF-B25,24,25,1,1,23,24,0.041666666666666664,0.9583333333333334,0.04,0.96
SF-F19,SF-E27,2,2,1,0,1,2,0.5,0.5,0.0,1.0
SF-F19,SF-D27,3,8,0,1,3,7,0.0,1.0,0.125,0.875
SF-F19,SF-C28-2,1,2,0,0,1,2,0.0,1.0,0.0,1.0
SF-F19,SF-C28-1,1,1,0,0,1,1,0.0,1.0,0.0,1.0
SF-F19,SF-J1,6,9,2,2,4,7,0.3333333333333333,0.6666666666666666,0.2222222222222222,0.7777777777777778
SF-F19,SF-H0,1,1,1,0,0,1,1.0,0.0,0.0,1.0
SF-F19,SF-J3,4,2,3,2,1,0,0.75,0.25,1.0,0.0
SF-F19,SF-J5,4,2,0,1,4,1,0.0,1.0,0.5,0.5
SF-F19,SF-G8,8,1,1,0,7,1,0.125,0.875,0.0,1.0
SF-F19,SF-G5,11,14,1,5,10,9,0.09090909090909091,0.9090909090909091,0.35714285714285715,0.6428571428571429
SF-F19,SF-G7,22,14,9,5,13,9,0.4090909090909091,0.5909090909090909,0.35714285714285715,0.6428571428571429
SF-F19,SF-F9,14,14,7,2,7,12,0.5,0.5,0.14285714285714285,0.8571428571428571
SF-F19,SF-G26,3,2,0,1,3,1,0.0,1.0,0.5,0.5
SF-F19,SF-K21,29,13,10,3,19,10,0.3448275862068966,0.6551724137931034,0.23076923076923078,0.7692307692307693
SF-F19,SF-K22-1,13,13,11,12,2,1,0.8461538461538461,0.15384615384615385,0.9230769230769231,0.07692307692307693
SF-F19,SF-J23-1,14,8,0,2,14,6,0.0,1.0,0.25,0.75
SF-F19,SF-J22-1,56,55,7,5,49,50,0.125,0.875,0.09090909090909091,0.9090909090909091
SF-F19,SF-J22-2,18,12,1,6,17,6,0.05555555555555555,0.9444444444444444,0.5,0.5
SF-F19,SF-J21,47,37,15,11,32,26,0.3191489361702128,0.6808510638297872,0.2972972972972973,0.7027027027027027
SF-F19,SF-I21,39,70,16,33,23,37,0.41025641025641024,0.5897435897435898,0.4714285714285714,0.5285714285714286
SF-F19,SF-I22,6,5,2,2,4,3,0.3333333333333333,0.6666666666666666,0.4,0.6
SF-F19,SF-I23-2,14,25,5,15,9,10,0.35714285714285715,0.6428571428571429,0.6,0.4
SF-F19,SF-I24,7,83,7,77,0,6,1.0,0.0,0.927710843373494,0.07228915662650602
SF-F19,SF-I23-1,3,3,2,2,1,1,0.6666666666666666,0.3333333333333333,0.6666666666666666,0.3333333333333333
SF-F19,SF-F26,12,17,0,3,12,14,0.0,1.0,0.17647058823529413,0.8235294117647058
SF-F19,SF-M13,25,14,2,0,23,14,0.08,0.92,0.0,1.0
SF-F19,SF-M15,23,14,3,1,20,13,0.13043478260869565,0.8695652173913043,0.07142857142857142,0.9285714285714286
SF-F19,SF-L19,2,4,1,2,1,2,0.5,0.5,0.5,0.5
SF-F19,SF-L20,11,4,2,1,9,3,0.18181818181818182,0.8181818181818182,0.25,0.75
SF-F19,SF-M20,12,13,1,3,11,10,0.08333333333333333,0.9166666666666666,0.23076923076923078,0.7692307692307693
SF-F19,SF-K17-2,9,4,4,2,5,2,0.4444444444444444,0.5555555555555556,0.5,0.5
SF-F19,SF-K20,16,25,6,2,10,23,0.375,0.625,0.08,0.92
SF-F19,SF-K15-,19,25,3,3,16,22,0.15789473684210525,0.8421052631578947,0.12,0.88
SF-F19,SF-K19,26,20,6,1,20,19,0.23076923076923078,0.7692307692307693,0.05,0.95
SF-F19,SF-K18,22,29,5,4,17,25,0.22727272727272727,0.7727272727272727,0.13793103448275862,0.8620689655172413
SF-F19,SF-K17,44,21,6,2,38,19,0.13636363636363635,0.8636363636363636,0.09523809523809523,0.9047619047619048
SF-F19,SF-J16,66,51,12,2,54,49,0.18181818181818182,0.8181818181818182,0.0392156862745098,0.9607843137254902
SF-F19,SF-J18,51,20,15,5,36,15,0.29411764705882354,0.7058823529411765,0.25,0.75
SF-F19,SF-J20,15,13,10,9,5,4,0.6666666666666666,0.3333333333333333,0.6923076923076923,0.3076923076923077
SF-F19,SF-J19,98,63,53,29,45,34,0.5408163265306123,0.45918367346938777,0.4603174603174603,0.5396825396825397
SF-F19,SF-M12,3,4,0,0,3,4,0.0,1.0,0.0,1.0
SF-F19,SF-M10,5,7,1,2,4,5,0.2,0.8,0.2857142857142857,0.7142857142857143
SF-F19,SF-M11,7,5,1,1,6,4,0.14285714285714285,0.8571428571428571,0.2,0.8
SF-F19,SF-R19,10,5,0,0,10,5,0.0,1.0,0.0,1.0
SF-F19,SF-Q21-2,1,1,0,0,1,1,0.0,1.0,0.0,1.0
SF-F19,SF-Q21-1,2,2,0,0,2,2,0.0,1.0,0.0,1.0
SF-F19,SF-P21,6,2,1,0,5,2,0.16666666666666666,0.8333333333333334,0.0,1.0
SF-F19,SF-O18,52,38,1,1,51,37,0.019230769230769232,0.9807692307692307,0.02631578947368421,0.9736842105263158
SF-F19,SF-O19,12,7,0,0,12,7,0.0,1.0,0.0,1.0
SF-F19,SF-O21,15,13,3,2,12,11,0.2,0.8,0.15384615384615385,0.8461538461538461
SF-F19,SF-O22,18,19,0,1,18,18,0.0,1.0,0.05263157894736842,0.9473684210526315
SF-F19,SF-N21,7,1,0,0,7,1,0.0,1.0,0.0,1.0
SF-F19,SF-N20-2,3,2,0,0,3,2,0.0,1.0,0.0,1.0
SF-F19,SF-M21,8,6,1,2,7,4,0.125,0.875,0.3333333333333333,0.6666666666666666
SF-F19,SF-L21,6,18,0,3,6,15,0.0,1.0,0.16666666666666666,0.8333333333333334
SF-F19,SF-P30,3,2,0,1,3,1,0.0,1.0,0.5,0.5
SF-F19,SF-N27,2,2,2,0,0,2,1.0,0.0,0.0,1.0
SF-F19,SF-N28,5,3,0,0,5,3,0.0,1.0,0.0,1.0
SF-F19,SF-L30-1,1,2,0,1,1,1,0.0,1.0,0.5,0.5
SF-F19,SF-J29-1,1,1,0,0,1,1,0.0,1.0,0.0,1.0
SF-F19,SF-I27,1,1,1,0,0,1,1.0,0.0,0.0,1.0
SF-F19,SF-I28,6,5,0,0,6,5,0.0,1.0,0.0,1.0
SF-F19,SF I29-1,18,8,3,1,15,7,0.16666666666666666,0.8333333333333334,0.125,0.875
SF-F19,SF-H28,5,3,1,2,4,1,0.2,0.8,0.6666666666666666,0.3333333333333333
SF-F19,SF-S24,1,3,1,1,0,2,1.0,0.0,0.3333333333333333,0.6666666666666666
SF-F19,SF-R24,5,3,1,1,4,2,0.2,0.8,0.3333333333333333,0.6666666666666666
SF-F19,SF-R26,2,1,1,0,1,1,0.5,0.5,0.0,1.0
SF-F19,SF-Q26,3,2,0,0,3,2,0.0,1.0,0.0,1.0
SF-F19,SF-O25-2,5,1,0,1,5,0,0.0,1.0,1.0,0.0
SF-F19,SF-T21,4,2,0,0,4,2,0.0,1.0,0.0,1.0
SF-F19,SF-S22-1,1,1,0,0,1,1,0.0,1.0,0.0,1.0
SF-F19,SF-Q23-3,2,3,0,0,2,3,0.0,1.0,0.0,1.0
SF-F19,SF-Q22-1,12,4,0,3,12,1,0.0,1.0,0.75,0.25
SF-F19,SF-Q22-2,8,6,2,3,6,3,0.25,0.75,0.5,0.5
SF-F19,SF-P22,7,3,0,1,7,2,0.0,1.0,0.3333333333333333,0.6666666666666666
SF-F19,SF-T20,1,3,0,0,1,3,0.0,1.0,0.0,1.0
SF-E18,SF-K26,1,3,1,2,0,1,1.0,0.0,0.6666666666666666,0.3333333333333333
SF-E18,SF-M30,4,29,2,17,2,12,0.5,0.5,0.5862068965517241,0.41379310344827586
SF-E18,SF-J29,1,1,0,0,1,1,0.0,1.0,0.0,1.0
SF-E18,SF-L25,1,1,0,0,1,1,0.0,1.0,0.0,1.0
SF-E18,SF-L24,2,5,1,4,1,1,0.5,0.5,0.8,0.2
SF-E18,SF-N24-2,1,1,0,0,1,1,0.0,1.0,0.0,1.0
SF-E18,SF-K27-2,1,3,0,1,1,2,0.0,1.0,0.3333333333333333,0.6666666666666666
SF-E18,SF-J26-2,91,99,62,87,29,12,0.6813186813186813,0.31868131868131866,0.8787878787878788,0.12121212121212122
SF-E18,SF-J28-2,1,3,0,0,1,3,0.0,1.0,0.0,1.0
SF-E18,SF-K25,18,1,0,0,18,1,0.0,1.0,0.0,1.0
SF-E18,SF-J25,28,17,13,16,15,1,0.4642857142857143,0.5357142857142857,0.9411764705882353,0.058823529411764705
SF-E18,SF-H26-2,14,2,0,0,14,2,0.0,1.0,0.0,1.0
SF-E18,SF-P24,4,9,3,4,1,5,0.75,0.25,0.4444444444444444,0.5555555555555556
SF-E18,SF-J24,27,72,0,1,27,71,0.0,1.0,0.013888888888888888,0.9861111111111112
SF-E18,SF-J26,27,44,0,40,27,4,0.0,1.0,0.9090909090909091,0.09090909090909091
SF-E18,SF-I25,5,1,0,0,5,1,0.0,1.0,0.0,1.0
SF-E18,SF-K23,1,1,0,0,1,1,0.0,1.0,0.0,1.0
SF-E18,SF-H26,7,7,0,0,7,7,0.0,1.0,0.0,1.0
SF-E18,SF-H27-1,1,3,0,1,1,2,0.0,1.0,0.3333333333333333,0.6666666666666666
SF-E18,SF-F28-2,4,11,0,2,4,9,0.0,1.0,0.18181818181818182,0.8181818181818182
SF-E18,SF-G27,11,11,0,3,11,8,0.0,1.0,0.2727272727272727,0.7272727272727273
SF-E18,SF-M22-2,4,6,1,4,3,2,0.25,0.75,0.6666666666666666,0.3333333333333333
SF-E18,SF-L22,5,7,1,3,4,4,0.2,0.8,0.42857142857142855,0.5714285714285714
SF-E18,SF-F27,14,11,1,4,13,7,0.07142857142857142,0.9285714285714286,0.36363636363636365,0.6363636363636364
SF-E18,SF-N22-2,2,7,1,2,1,5,0.5,0.5,0.2857142857142857,0.7142857142857143
SF-E18,SF-M22-1,7,4,0,1,7,3,0.0,1.0,0.25,0.75
SF-E18,SF-O25-1,1,10,0,2,1,8,0.0,1.0,0.2,0.8
SF-E18,SF-K22-2,1,1,1,1,0,0,1.0,0.0,1.0,0.0
SF-E18,SF-J23-2,11,30,1,2,10,28,0.09090909090909091,0.9090909090909091,0.06666666666666667,0.9333333333333333
SF-E18,SF-G23,1,2,1,1,0,1,1.0,0.0,0.5,0.5
SF-E18,SF-G24,3,5,0,3,3,2,0.0,1.0,0.6,0.4
SF-E18,SF-G25,7,2,2,1,5,1,0.2857142857142857,0.7142857142857143,0.5,0.5
SF-E18,SF-F23,9,12,2,1,7,11,0.2222222222222222,0.7777777777777778,0.08333333333333333,0.9166666666666666
SF-E18,SF-E23,30,25,8,9,22,16,0.26666666666666666,0.7333333333333333,0.36,0.64
SF-E18,SF-D24,12,5,2,1,10,4,0.16666666666666666,0.8333333333333334,0.2,0.8
SF-E18,SF-C22,10,18,2,1,8,17,0.2,0.8,0.05555555555555555,0.9444444444444444
SF-E18,SF-B22,11,11,5,1,6,10,0.45454545454545453,0.5454545454545454,0.09090909090909091,0.9090909090909091
SF-E18,SF-J17,11,9,2,1,9,8,0.18181818181818182,0.8181818181818182,0.1111111111111111,0.8888888888888888
SF-E18,SF-I19,22,10,3,4,19,6,0.13636363636363635,0.8636363636363636,0.4,0.6
SF-E18,SF-I20,4,14,1,3,3,11,0.25,0.75,0.21428571428571427,0.7857142857142857
SF-E18,SF-H16,26,16,9,7,17,9,0.34615384615384615,0.6538461538461539,0.4375,0.5625
SF-E18,SF-H19,1,2,0,1,1,1,0.0,1.0,0.5,0.5
SF-E18,SF-H20,15,2,4,2,11,0,0.26666666666666666,0.7333333333333333,1.0,0.0
SF-E18,SF-H18,2,6,1,5,1,1,0.5,0.5,0.8333333333333334,0.16666666666666666
SF-E18,SF-H17,4,4,3,2,1,2,0.75,0.25,0.5,0.5
SF-E18,SF-G19,25,54,6,18,19,36,0.24,0.76,0.3333333333333333,0.6666666666666666
SF-E18,SF-G17,8,8,7,1,1,7,0.875,0.125,0.125,0.875
SF-E18,SF-G18,13,28,6,23,7,5,0.46153846153846156,0.5384615384615384,0.8214285714285714,0.17857142857142858
SF-E18,SF-G20,12,22,4,13,8,9,0.3333333333333333,0.6666666666666666,0.5909090909090909,0.4090909090909091
SF-E18,SF-F19,41,42,12,15,29,27,0.2926829268292683,0.7073170731707317,0.35714285714285715,0.6428571428571429
SF-E18,SF-E20,18,19,7,6,11,13,0.3888888888888889,0.6111111111111112,0.3157894736842105,0.6842105263157895
SF-E18,SF-G30-2,5,4,0,0,5,4,0.0,1.0,0.0,1.0
SF-E18,SF-E29-2,1,4,0,0,1,4,0.0,1.0,0.0,1.0
SF-E18,SF-D29,3,3,0,0,3,3,0.0,1.0,0.0,1.0
SF-E18,SF-D28,1,7,0,2,1,5,0.0,1.0,0.2857142857142857,0.7142857142857143
SF-E18,SF-G29-2,1,6,1,0,0,6,1.0,0.0,0.0,1.0
SF-E18,SF-G30-1,2,3,0,1,2,2,0.0,1.0,0.3333333333333333,0.6666666666666666
SF-E18,SF-F29,1,2,1,1,0,1,1.0,0.0,0.5,0.5
SF-E18,SF-F28-1,4,1,0,0,4,1,0.0,1.0,0.0,1.0
SF-E18,SF-E28-2,2,1,0,0,2,1,0.0,1.0,0.0,1.0
SF-E18,SF-E28,2,1,0,1,2,0,0.0,1.0,1.0,0.0
SF-E18,SF-J10,9,5,5,1,4,4,0.5555555555555556,0.4444444444444444,0.2,0.8
SF-E18,SF-J12,11,13,4,4,7,9,0.36363636363636365,0.6363636363636364,0.3076923076923077,0.6923076923076923
SF-E18,SF-J13,7,11,4,2,3,9,0.5714285714285714,0.42857142857142855,0.18181818181818182,0.8181818181818182
SF-E18,SF-H13,11,6,2,1,9,5,0.18181818181818182,0.8181818181818182,0.16666666666666666,0.8333333333333334
SF-E18,SF-I16,6,16,0,2,6,14,0.0,1.0,0.125,0.875
SF-E18,SF-H12,6,3,1,0,5,3,0.16666666666666666,0.8333333333333334,0.0,1.0
SF-E18,SF-H15,2,1,0,0,2,1,0.0,1.0,0.0,1.0
SF-E18,SF-G9,2,5,0,1,2,4,0.0,1.0,0.2,0.8
SF-E18,SF-H14,5,6,0,4,5,2,0.0,1.0,0.6666666666666666,0.3333333333333333
SF-E18,SF-G13,21,23,7,14,14,9,0.3333333333333333,0.6666666666666666,0.6086956521739131,0.391304347826087
SF-E18,SF-G11,3,4,0,1,3,3,0.0,1.0,0.25,0.75
SF-E18,SF-G12,15,19,3,6,12,13,0.2,0.8,0.3157894736842105,0.6842105263157895
SF-E18,SF-G10-1,4,3,1,1,3,2,0.25,0.75,0.3333333333333333,0.6666666666666666
SF-E18,SF-F15,14,21,7,4,7,17,0.5,0.5,0.19047619047619047,0.8095238095238095
SF-E18,SF-F16,15,9,8,4,7,5,0.5333333333333333,0.4666666666666667,0.4444444444444444,0.5555555555555556
SF-E18,SF-C21,3,5,1,4,2,1,0.3333333333333333,0.6666666666666666,0.8,0.2
SF-E18,SF-C20,8,25,1,14,7,11,0.125,0.875,0.56,0.44
SF-E18,SF-B21,2,6,2,3,0,3,1.0,0.0,0.5,0.5
SF-E18,SF-B19,7,13,2,2,5,11,0.2857142857142857,0.7142857142857143,0.15384615384615385,0.8461538461538461
SF-E18,SF-A20,4,11,2,4,2,7,0.5,0.5,0.36363636363636365,0.6363636363636364
SF-E18,SF-A19,3,5,2,2,1,3,0.6666666666666666,0.3333333333333333,0.4,0.6
SF-E18,SF-C26,5,9,0,1,5,8,0.0,1.0,0.1111111111111111,0.8888888888888888
SF-E18,SF-C25,17,16,4,0,13,16,0.23529411764705882,0.7647058823529411,0.0,1.0
SF-E18,SF-B25,2,7,0,1,2,6,0.0,1.0,0.14285714285714285,0.8571428571428571
SF-E18,SF-E27,4,10,0,0,4,10,0.0,1.0,0.0,1.0
SF-E18,SF-D27,5,3,0,2,5,1,0.0,1.0,0.6666666666666666,0.3333333333333333
SF-E18,SF-J1,4,11,1,5,3,6,0.25,0.75,0.45454545454545453,0.5454545454545454
SF-E18,SF-H0,3,4,0,0,3,4,0.0,1.0,0.0,1.0
SF-E18,SF-J5,2,3,0,2,2,1,0.0,1.0,0.6666666666666666,0.3333333333333333
SF-E18,SF-G8,4,5,1,1,3,4,0.25,0.75,0.2,0.8
SF-E18,SF-G5,10,14,1,4,9,10,0.1,0.9,0.2857142857142857,0.7142857142857143
SF-E18,SF-G7,15,22,1,8,14,14,0.06666666666666667,0.9333333333333333,0.36363636363636365,0.6363636363636364
SF-E18,SF-F9,21,17,3,6,18,11,0.14285714285714285,0.8571428571428571,0.35294117647058826,0.6470588235294118
SF-E18,SF-H25,1,1,0,1,1,0,0.0,1.0,1.0,0.0
SF-E18,SF-G26,4,6,0,3,4,3,0.0,1.0,0.5,0.5
SF-E18,SF-K21,10,13,4,2,6,11,0.4,0.6,0.15384615384615385,0.8461538461538461
SF-E18,SF-K22-1,11,10,0,0,11,10,0.0,1.0,0.0,1.0
SF-E18,SF-J23-1,12,14,1,7,11,7,0.08333333333333333,0.9166666666666666,0.5,0.5
SF-E18,SF-J22-1,7,4,0,0,7,4,0.0,1.0,0.0,1.0
SF-E18,SF-J22-2,23,13,2,4,21,9,0.08695652173913043,0.9130434782608695,0.3076923076923077,0.6923076923076923
SF-E18,SF-J21,15,20,4,2,11,18,0.26666666666666666,0.7333333333333333,0.1,0.9
SF-E18,SF-I21,2,2,0,0,2,2,0.0,1.0,0.0,1.0
SF-E18,SF-I22,2,1,0,1,2,0,0.0,1.0,1.0,0.0
SF-E18,SF-I23-2,4,5,1,0,3,5,0.25,0.75,0.0,1.0
SF-E18,SF-I24,5,1,1,1,4,0,0.2,0.8,1.0,0.0
SF-E18,SF-I23-1,4,4,1,3,3,1,0.25,0.75,0.75,0.25
SF-E18,SF-F26,43,31,4,4,39,27,0.09302325581395349,0.9069767441860465,0.12903225806451613,0.8709677419354839
SF-E18,SF-M13,3,11,0,3,3,8,0.0,1.0,0.2727272727272727,0.7272727272727273
SF-E18,SF-M15,8,8,1,3,7,5,0.125,0.875,0.375,0.625
SF-E18,SF-L19,8,3,1,1,7,2,0.125,0.875,0.3333333333333333,0.6666666666666666
SF-E18,SF-L20,4,3,1,0,3,3,0.25,0.75,0.0,1.0
SF-E18,SF-N20-1,1,7,0,2,1,5,0.0,1.0,0.2857142857142857,0.7142857142857143
SF-E18,SF-M20,14,21,1,6,13,15,0.07142857142857142,0.9285714285714286,0.2857142857142857,0.7142857142857143
SF-E18,SF-K17-2,3,6,0,2,3,4,0.0,1.0,0.3333333333333333,0.6666666666666666
SF-E18,SF-K20,10,6,5,0,5,6,0.5,0.5,0.0,1.0
SF-E18,SF-K15-,21,23,2,5,19,18,0.09523809523809523,0.9047619047619048,0.21739130434782608,0.782608695652174
SF-E18,SF-K19,11,16,5,3,6,13,0.45454545454545453,0.5454545454545454,0.1875,0.8125
SF-E18,SF-K18,20,17,4,4,16,13,0.2,0.8,0.23529411764705882,0.7647058823529411
SF-E18,SF-K17,11,9,2,3,9,6,0.18181818181818182,0.8181818181818182,0.3333333333333333,0.6666666666666666
SF-E18,SF-J16,3,5,1,3,2,2,0.3333333333333333,0.6666666666666666,0.6,0.4
SF-E18,SF-J18,36,48,7,16,29,32,0.19444444444444445,0.8055555555555556,0.3333333333333333,0.6666666666666666
SF-E18,SF-J20,6,6,2,6,4,0,0.3333333333333333,0.6666666666666666,1.0,0.0
SF-E18,SF-J19,29,26,7,7,22,19,0.2413793103448276,0.7586206896551724,0.2692307692307692,0.7307692307692307
SF-E18,SF-M12,3,3,0,0,3,3,0.0,1.0,0.0,1.0
SF-E18,SF-M10,2,4,1,0,1,4,0.5,0.5,0.0,1.0
SF-E18,SF-M11,8,11,0,1,8,10,0.0,1.0,0.09090909090909091,0.9090909090909091
SF-E18,SF-R19,4,1,0,0,4,1,0.0,1.0,0.0,1.0
SF-E18,SF-R20,2,1,0,0,2,1,0.0,1.0,0.0,1.0
SF-E18,SF-Q21-2,2,3,0,0,2,3,0.0,1.0,0.0,1.0
SF-E18,SF-Q21-1,4,2,3,0,1,2,0.75,0.25,0.0,1.0
SF-E18,SF-P21,4,1,1,0,3,1,0.25,0.75,0.0,1.0
SF-E18,SF-O18,5,11,1,0,4,11,0.2,0.8,0.0,1.0
SF-E18,SF-O19,3,9,0,4,3,5,0.0,1.0,0.4444444444444444,0.5555555555555556
SF-E18,SF-O21,8,13,2,1,6,12,0.25,0.75,0.07692307692307693,0.9230769230769231
SF-E18,SF-O22,7,8,0,0,7,8,0.0,1.0,0.0,1.0
SF-E18,SF-N21,4,4,2,0,2,4,0.5,0.5,0.0,1.0
SF-E18,SF-M21,2,3,1,1,1,2,0.5,0.5,0.3333333333333333,0.6666666666666666
SF-E18,SF-L21,13,5,0,0,13,5,0.0,1.0,0.0,1.0
SF-E18,SF-Q30,1,1,0,0,1,1,0.0,1.0,0.0,1.0
SF-E18,SF-O30,1,2,0,0,1,2,0.0,1.0,0.0,1.0
SF-E18,SF-N27,10,5,0,0,10,5,0.0,1.0,0.0,1.0
SF-E18,SF-L30-1,1,8,1,3,0,5,1.0,0.0,0.375,0.625
SF-E18,SF-I27,3,15,0,15,3,0,0.0,1.0,1.0,0.0
SF-E18,SF-I28,1,1,0,1,1,0,0.0,1.0,1.0,0.0
SF-E18,SF-H28,1,2,0,0,1,2,0.0,1.0,0.0,1.0
SF-E18,SF-S24,2,1,0,0,2,1,0.0,1.0,0.0,1.0
SF-E18,SF-R24,6,2,0,0,6,2,0.0,1.0,0.0,1.0
SF-E18,SF-O25-2,3,1,1,1,2,0,0.3333333333333333,0.6666666666666666,1.0,0.0
SF-E18,SF-N26,9,5,0,0,9,5,0.0,1.0,0.0,1.0
SF-E18,SF-T22,1,2,0,0,1,2,0.0,1.0,0.0,1.0
SF-E18,SF-S22-1,2,1,1,1,1,0,0.5,0.5,1.0,0.0
SF-E18,SF-Q22-2,8,2,5,0,3,2,0.625,0.375,0.0,1.0
SF-E18,SF-P22,7,2,2,1,5,1,0.2857142857142857,0.7142857142857143,0.5,0.5
SF-E18,SF-U30,3,8,0,0,3,8,0.0,1.0,0.0,1.0
SF-E18,SF-Z6,1,1,0,1,1,0,0.0,1.0,1.0,0.0
SF-E20,SF-M26-2,3,3,1,3,2,0,0.3333333333333333,0.6666666666666666,1.0,0.0
SF-E20,SF-K26,2,6,1,1,1,5,0.5,0.5,0.16666666666666666,0.8333333333333334
SF-E20,SF-J27,2,6,2,6,0,0,1.0,0.0,1.0,0.0
SF-E20,SF-J29-3,1,1,0,0,1,1,0.0,1.0,0.0,1.0
SF-E20,SF-J29,5,5,2,1,3,4,0.4,0.6,0.2,0.8
SF-E20,SF-L25,1,1,0,0,1,1,0.0,1.0,0.0,1.0
SF-E20,SF-L24,1,1,0,1,1,0,0.0,1.0,1.0,0.0
SF-E20,SF-N24-2,1,2,0,1,1,1,0.0,1.0,0.5,0.5
SF-E20,SF-J26-2,7,15,1,4,6,11,0.14285714285714285,0.8571428571428571,0.26666666666666666,0.7333333333333333
SF-E20,SF-K29-1,3,2,0,1,3,1,0.0,1.0,0.5,0.5
SF-E20,SF-K25,2,3,0,1,2,2,0.0,1.0,0.3333333333333333,0.6666666666666666
SF-E20,SF-J25,2,2,0,1,2,1,0.0,1.0,0.5,0.5
SF-E20,SF-P24,4,5,3,2,1,3,0.75,0.25,0.4,0.6
SF-E20,SF-O24,8,13,0,0,8,13,0.0,1.0,0.0,1.0
SF-E20,SF-J26,2,7,1,6,1,1,0.5,0.5,0.8571428571428571,0.14285714285714285
SF-E20,SF-I25,2,1,1,1,1,0,0.5,0.5,1.0,0.0
SF-E20,SF-H26,5,6,1,1,4,5,0.2,0.8,0.16666666666666666,0.8333333333333334
SF-E20,SF-O23,13,3,0,1,13,2,0.0,1.0,0.3333333333333333,0.6666666666666666
SF-E20,SF-F28-2,3,3,0,1,3,2,0.0,1.0,0.3333333333333333,0.6666666666666666
SF-E20,SF-G27,5,4,1,2,4,2,0.2,0.8,0.5,0.5
SF-E20,SF-M22-2,5,2,0,0,5,2,0.0,1.0,0.0,1.0
SF-E20,SF-L22,3,3,0,1,3,2,0.0,1.0,0.3333333333333333,0.6666666666666666
SF-E20,SF-F27,131,138,1,0,130,138,0.007633587786259542,0.9923664122137404,0.0,1.0
SF-E20,SF-N22-2,11,8,1,0,10,8,0.09090909090909091,0.9090909090909091,0.0,1.0
SF-E20,SF-G28-2,2,1,0,0,2,1,0.0,1.0,0.0,1.0
SF-E20,SF-M22-1,3,9,0,1,3,8,0.0,1.0,0.1111111111111111,0.8888888888888888
SF-E20,SF-K22-2,2,4,0,1,2,3,0.0,1.0,0.25,0.75
SF-E20,SF-J23-2,2,4,1,0,1,4,0.5,0.5,0.0,1.0
SF-E20,SF-G24,10,9,1,3,9,6,0.1,0.9,0.3333333333333333,0.6666666666666666
SF-E20,SF-G25,12,12,5,2,7,10,0.4166666666666667,0.5833333333333334,0.16666666666666666,0.8333333333333334
SF-E20,SF-F23,5,13,0,5,5,8,0.0,1.0,0.38461538461538464,0.6153846153846154
SF-E20,SF-E23,50,30,14,12,36,18,0.28,0.72,0.4,0.6
SF-E20,SF-D24,28,13,16,1,12,12,0.5714285714285714,0.42857142857142855,0.07692307692307693,0.9230769230769231
SF-E20,SF-C22,19,15,6,5,13,10,0.3157894736842105,0.6842105263157895,0.3333333333333333,0.6666666666666666
SF-E20,SF-B22,16,10,2,4,14,6,0.125,0.875,0.4,0.6
SF-E20,SF-J17,25,30,6,2,19,28,0.24,0.76,0.06666666666666667,0.9333333333333333
SF-E20,SF-I19,15,17,2,6,13,11,0.13333333333333333,0.8666666666666667,0.35294117647058826,0.6470588235294118
SF-E20,SF-I20,7,6,3,2,4,4,0.42857142857142855,0.5714285714285714,0.3333333333333333,0.6666666666666666
SF-E20,SF-H16,7,7,2,2,5,5,0.2857142857142857,0.7142857142857143,0.2857142857142857,0.7142857142857143
SF-E20,SF-H20,12,16,0,10,12,6,0.0,1.0,0.625,0.375
SF-E20,SF-H18,4,16,2,11,2,5,0.5,0.5,0.6875,0.3125
SF-E20,SF-H17,1,2,1,0,0,2,1.0,0.0,0.0,1.0
SF-E20,SF-G19,6,21,3,6,3,15,0.5,0.5,0.2857142857142857,0.7142857142857143
SF-E20,SF-G17,16,19,8,2,8,17,0.5,0.5,0.10526315789473684,0.8947368421052632
SF-E20,SF-G18,25,23,3,5,22,18,0.12,0.88,0.21739130434782608,0.782608695652174
SF-E20,SF-G20,19,86,4,47,15,39,0.21052631578947367,0.7894736842105263,0.5465116279069767,0.45348837209302323
SF-E20,SF-F19,11,24,4,12,7,12,0.36363636363636365,0.6363636363636364,0.5,0.5
SF-E20,SF-E18,19,18,6,7,13,11,0.3157894736842105,0.6842105263157895,0.3888888888888889,0.6111111111111112
SF-E20,SF-H30,1,2,0,1,1,1,0.0,1.0,0.5,0.5
SF-E20,SF-G30-2,4,6,0,1,4,5,0.0,1.0,0.16666666666666666,0.8333333333333334
SF-E20,SF-E29-2,35,43,0,1,35,42,0.0,1.0,0.023255813953488372,0.9767441860465116
SF-E20,SF-E29-1,2,1,0,1,2,0,0.0,1.0,1.0,0.0
SF-E20,SF-D29,1,3,0,0,1,3,0.0,1.0,0.0,1.0
SF-E20,SF-D28,7,5,2,2,5,3,0.2857142857142857,0.7142857142857143,0.4,0.6
SF-E20,SF-G29-1,2,3,0,1,2,2,0.0,1.0,0.3333333333333333,0.6666666666666666
SF-E20,SF-G30-1,1,4,0,1,1,3,0.0,1.0,0.25,0.75
SF-E20,SF-G29-3,1,1,1,1,0,0,1.0,0.0,1.0,0.0
SF-E20,SF-F30-2,7,26,1,1,6,25,0.14285714285714285,0.8571428571428571,0.038461538461538464,0.9615384615384616
SF-E20,SF-F29,1,3,0,2,1,1,0.0,1.0,0.6666666666666666,0.3333333333333333
SF-E20,SF-E29-3,5,2,0,0,5,2,0.0,1.0,0.0,1.0
SF-E20,SF-F28-1,5,13,0,0,5,13,0.0,1.0,0.0,1.0
SF-E20,SF-E28-2,10,17,0,0,10,17,0.0,1.0,0.0,1.0
SF-E20,SF-J10,2,2,1,0,1,2,0.5,0.5,0.0,1.0
SF-E20,SF-J12,15,13,3,4,12,9,0.2,0.8,0.3076923076923077,0.6923076923076923
SF-E20,SF-J13,49,26,0,2,49,24,0.0,1.0,0.07692307692307693,0.9230769230769231
SF-E20,SF-J15,7,3,0,0,7,3,0.0,1.0,0.0,1.0
SF-E20,SF-H13,16,10,6,4,10,6,0.375,0.625,0.4,0.6
SF-E20,SF-I16,13,8,0,1,13,7,0.0,1.0,0.125,0.875
SF-E20,SF-H12,5,6,0,0,5,6,0.0,1.0,0.0,1.0
SF-E20,SF-G10-2,1,5,0,1,1,4,0.0,1.0,0.2,0.8
SF-E20,SF-H15,3,2,3,0,0,2,1.0,0.0,0.0,1.0
SF-E20,SF-G9,9,8,3,2,6,6,0.3333333333333333,0.6666666666666666,0.25,0.75
SF-E20,SF-H14,2,3,2,1,0,2,1.0,0.0,0.3333333333333333,0.6666666666666666
SF-E20,SF-G13,8,19,4,5,4,14,0.5,0.5,0.2631578947368421,0.7368421052631579
SF-E20,SF-G11,6,4,3,3,3,1,0.5,0.5,0.75,0.25
SF-E20,SF-G12,10,10,1,5,9,5,0.1,0.9,0.5,0.5
SF-E20,SF-G10-1,7,1,1,0,6,1,0.14285714285714285,0.8571428571428571,0.0,1.0
SF-E20,SF-F15,41,30,7,9,34,21,0.17073170731707318,0.8292682926829268,0.3,0.7
SF-E20,SF-F16,22,13,4,3,18,10,0.18181818181818182,0.8181818181818182,0.23076923076923078,0.7692307692307693
SF-E20,SF-C21,3,6,1,4,2,2,0.3333333333333333,0.6666666666666666,0.6666666666666666,0.3333333333333333
SF-E20,SF-C20,6,26,1,14,5,12,0.16666666666666666,0.8333333333333334,0.5384615384615384,0.46153846153846156
SF-E20,SF-B21,2,7,1,2,1,5,0.5,0.5,0.2857142857142857,0.7142857142857143
SF-E20,SF-B19,13,28,4,20,9,8,0.3076923076923077,0.6923076923076923,0.7142857142857143,0.2857142857142857
SF-E20,SF-A20,10,16,0,7,10,9,0.0,1.0,0.4375,0.5625
SF-E20,SF-A19,3,15,1,3,2,12,0.3333333333333333,0.6666666666666666,0.2,0.8
SF-E20,SF-C26,7,11,0,1,7,10,0.0,1.0,0.09090909090909091,0.9090909090909091
SF-E20,SF-C25,25,22,5,1,20,21,0.2,0.8,0.045454545454545456,0.9545454545454546
SF-E20,SF-B25,6,20,2,2,4,18,0.3333333333333333,0.6666666666666666,0.1,0.9
SF-E20,SF-E27,3,7,0,0,3,7,0.0,1.0,0.0,1.0
SF-E20,SF-D27,12,3,2,1,10,2,0.16666666666666666,0.8333333333333334,0.3333333333333333,0.6666666666666666
SF-E20,SF-C28-2,1,1,0,0,1,1,0.0,1.0,0.0,1.0
SF-E20,SF-C28-1,2,1,2,1,0,0,1.0,0.0,1.0,0.0
SF-E20,SF-J1,5,9,0,5,5,4,0.0,1.0,0.5555555555555556,0.4444444444444444
SF-E20,SF-H0,3,5,0,2,3,3,0.0,1.0,0.4,0.6
SF-E20,SF-J3,2,2,0,0,2,2,0.0,1.0,0.0,1.0
SF-E20,SF-J5,4,2,1,0,3,2,0.25,0.75,0.0,1.0
SF-E20,SF-G8,4,1,0,0,4,1,0.0,1.0,0.0,1.0
SF-E20,SF-G5,9,24,4,5,5,19,0.4444444444444444,0.5555555555555556,0.20833333333333334,0.7916666666666666
SF-E20,SF-G7,52,33,1,0,51,33,0.019230769230769232,0.9807692307692307,0.0,1.0
SF-E20,SF-F9,44,52,1,4,43,48,0.022727272727272728,0.9772727272727273,0.07692307692307693,0.9230769230769231
SF-E20,SF-G26,2,2,0,0,2,2,0.0,1.0,0.0,1.0
SF-E20,SF-K21,14,12,2,5,12,7,0.14285714285714285,0.8571428571428571,0.4166666666666667,0.5833333333333334
SF-E20,SF-K22-1,1,2,0,0,1,2,0.0,1.0,0.0,1.0
SF-E20,SF-J23-1,13,13,0,3,13,10,0.0,1.0,0.23076923076923078,0.7692307692307693
SF-E20,SF-J22-1,10,15,0,3,10,12,0.0,1.0,0.2,0.8
SF-E20,SF-J22-2,8,11,1,6,7,5,0.125,0.875,0.5454545454545454,0.45454545454545453
SF-E20,SF-J21,25,39,4,11,21,28,0.16,0.84,0.28205128205128205,0.717948717948718
SF-E20,SF-I21,13,17,3,6,10,11,0.23076923076923078,0.7692307692307693,0.35294117647058826,0.6470588235294118
SF-E20,SF-I23-2,6,4,1,0,5,4,0.16666666666666666,0.8333333333333334,0.0,1.0
SF-E20,SF-I24,2,2,0,0,2,2,0.0,1.0,0.0,1.0
SF-E20,SF-I23-1,9,1,3,1,6,0,0.3333333333333333,0.6666666666666666,1.0,0.0
SF-E20,SF-F26,22,9,0,2,22,7,0.0,1.0,0.2222222222222222,0.7777777777777778
SF-E20,SF-M13,5,8,0,0,5,8,0.0,1.0,0.0,1.0
SF-E20,SF-M15,9,13,0,2,9,11,0.0,1.0,0.15384615384615385,0.8461538461538461
SF-E20,SF-L19,23,22,2,7,21,15,0.08695652173913043,0.9130434782608695,0.3181818181818182,0.6818181818181818
SF-E20,SF-L20,5,8,0,4,5,4,0.0,1.0,0.5,0.5
SF-E20,SF-N20-1,13,15,4,12,9,3,0.3076923076923077,0.6923076923076923,0.8,0.2
SF-E20,SF-M20,19,16,2,2,17,14,0.10526315789473684,0.8947368421052632,0.125,0.875
SF-E20,SF-K17-2,10,6,0,0,10,6,0.0,1.0,0.0,1.0
SF-E20,SF-K20,36,29,1,2,35,27,0.027777777777777776,0.9722222222222222,0.06896551724137931,0.9310344827586207
SF-E20,SF-K15-,18,16,2,4,16,12,0.1111111111111111,0.8888888888888888,0.25,0.75
SF-E20,SF-K19,21,11,0,2,21,9,0.0,1.0,0.18181818181818182,0.8181818181818182
SF-E20,SF-K18,11,16,1,2,10,14,0.09090909090909091,0.9090909090909091,0.125,0.875
SF-E20,SF-K17,9,11,1,3,8,8,0.1111111111111111,0.8888888888888888,0.2727272727272727,0.7272727272727273
SF-E20,SF-J16,8,18,1,0,7,18,0.125,0.875,0.0,1.0
SF-E20,SF-J18,21,19,1,0,20,19,0.047619047619047616,0.9523809523809523,0.0,1.0
SF-E20,SF-J20,9,30,4,26,5,4,0.4444444444444444,0.5555555555555556,0.8666666666666667,0.13333333333333333
SF-E20,SF-J19,44,39,16,17,28,22,0.36363636363636365,0.6363636363636364,0.4358974358974359,0.5641025641025641
SF-E20,SF-M12,38,29,0,1,38,28,0.0,1.0,0.034482758620689655,0.9655172413793104
SF-E20,SF-M10,39,42,0,1,39,41,0.0,1.0,0.023809523809523808,0.9761904761904762
SF-E20,SF-M11,18,12,0,0,18,12,0.0,1.0,0.0,1.0
SF-E20,SF-Q21-2,4,2,0,1,4,1,0.0,1.0,0.5,0.5
SF-E20,SF-Q21-1,4,2,0,0,4,2,0.0,1.0,0.0,1.0
SF-E20,SF-P21,3,1,0,0,3,1,0.0,1.0,0.0,1.0
SF-E20,SF-O18,5,6,0,0,5,6,0.0,1.0,0.0,1.0
SF-E20,SF-O19,18,19,0,2,18,17,0.0,1.0,0.10526315789473684,0.8947368421052632
SF-E20,SF-O21,13,12,0,2,13,10,0.0,1.0,0.16666666666666666,0.8333333333333334
SF-E20,SF-O22,12,15,0,3,12,12,0.0,1.0,0.2,0.8
SF-E20,SF-N21,1,1,0,0,1,1,0.0,1.0,0.0,1.0
SF-E20,SF-N20-2,2,2,0,1,2,1,0.0,1.0,0.5,0.5
SF-E20,SF-M21,27,6,0,3,27,3,0.0,1.0,0.5,0.5
SF-E20,SF-L21,21,14,0,2,21,12,0.0,1.0,0.14285714285714285,0.8571428571428571
SF-E20,SF-P30,11,3,0,1,11,2,0.0,1.0,0.3333333333333333,0.6666666666666666
SF-E20,SF-O30,2,1,1,1,1,0,0.5,0.5,1.0,0.0
SF-E20,SF-N27,1,2,0,0,1,2,0.0,1.0,0.0,1.0
SF-E20,SF-L29,2,4,0,2,2,2,0.0,1.0,0.5,0.5
SF-E20,SF-I30,1,2,0,1,1,1,0.0,1.0,0.5,0.5
SF-E20,SF-I27,1,4,0,2,1,2,0.0,1.0,0.5,0.5
SF-E20,SF-I30-2,1,1,0,0,1,1,0.0,1.0,0.0,1.0
SF-E20,SF-S24,2,5,0,1,2,4,0.0,1.0,0.2,0.8
SF-E20,SF-R24,2,2,0,0,2,2,0.0,1.0,0.0,1.0
SF-E20,SF-O25-2,3,3,0,0,3,3,0.0,1.0,0.0,1.0
SF-E20,SF-T22,2,1,0,0,2,1,0.0,1.0,0.0,1.0
SF-E20,SF-Q22-2,15,11,10,10,5,1,0.6666666666666666,0.3333333333333333,0.9090909090909091,0.09090909090909091
SF-E20,SF-P22,5,5,0,2,5,3,0.0,1.0,0.4,0.6
SF-E20,SF-T20,7,3,0,0,7,3,0.0,1.0,0.0,1.0
SF-H30,SF-M25,4,2,3,0,1,2,0.75,0.25,0.0,1.0
SF-H30,SF-M26-2,24,16,12,5,12,11,0.5,0.5,0.3125,0.6875
SF-H30,SF-L27,8,7,5,5,3,2,0.625,0.375,0.7142857142857143,0.2857142857142857
SF-H30,SF-K26,1,6,1,2,0,4,1.0,0.0,0.3333333333333333,0.6666666666666666
SF-H30,SF-J27,1,1,0,0,1,1,0.0,1.0,0.0,1.0
SF-H30,SF-M30,33,58,20,35,13,23,0.6060606060606061,0.3939393939393939,0.603448275862069,0.39655172413793105
SF-H30,SF-L27-2,3,4,0,4,3,0,0.0,1.0,1.0,0.0
SF-H30,SF-J29-3,26,56,24,42,2,14,0.9230769230769231,0.07692307692307693,0.75,0.25
SF-H30,SF-J29,21,19,16,13,5,6,0.7619047619047619,0.23809523809523808,0.6842105263157895,0.3157894736842105
SF-H30,SF-L26,7,4,5,3,2,1,0.7142857142857143,0.2857142857142857,0.75,0.25
SF-H30,SF-M28,17,21,11,16,6,5,0.6470588235294118,0.35294117647058826,0.7619047619047619,0.23809523809523808
SF-H30,SF-M27,7,4,5,3,2,1,0.7142857142857143,0.2857142857142857,0.75,0.25
SF-H30,SF-L25,3,6,2,3,1,3,0.6666666666666666,0.3333333333333333,0.5,0.5
SF-H30,SF-M24,6,3,4,0,2,3,0.6666666666666666,0.3333333333333333,0.0,1.0
SF-H30,SF-L24,1,5,1,3,0,2,1.0,0.0,0.6,0.4
SF-H30,SF-N23,4,2,2,2,2,0,0.5,0.5,1.0,0.0
SF-H30,SF-N24-2,3,1,1,0,2,1,0.3333333333333333,0.6666666666666666,0.0,1.0
SF-H30,SF-K27-2,9,17,8,8,1,9,0.8888888888888888,0.1111111111111111,0.47058823529411764,0.5294117647058824
SF-H30,SF-J26-2,62,62,62,58,0,4,1.0,0.0,0.9354838709677419,0.06451612903225806
SF-H30,SF-K28-3,2,1,2,1,0,0,1.0,0.0,1.0,0.0
SF-H30,SF-L28,49,46,25,31,24,15,0.5102040816326531,0.4897959183673469,0.6739130434782609,0.32608695652173914
SF-H30,SF-K28,15,11,11,7,4,4,0.7333333333333333,0.26666666666666666,0.6363636363636364,0.36363636363636365
SF-H30,SF-K29-1,107,88,79,63,28,25,0.7383177570093458,0.2616822429906542,0.7159090909090909,0.2840909090909091
SF-H30,SF-J28-2,6,2,4,1,2,1,0.6666666666666666,0.3333333333333333,0.5,0.5
SF-H30,SF-K27,3,1,1,0,2,1,0.3333333333333333,0.6666666666666666,0.0,1.0
SF-H30,SF-K25,3,4,2,3,1,1,0.6666666666666666,0.3333333333333333,0.75,0.25
SF-H30,SF-J25,17,15,11,5,6,10,0.6470588235294118,0.35294117647058826,0.3333333333333333,0.6666666666666666
SF-H30,SF-P24,11,2,3,1,8,1,0.2727272727272727,0.7272727272727273,0.5,0.5
SF-H30,SF-J24,29,6,7,1,22,5,0.2413793103448276,0.7586206896551724,0.16666666666666666,0.8333333333333334
SF-H30,SF-O24,6,2,2,0,4,2,0.3333333333333333,0.6666666666666666,0.0,1.0
SF-H30,SF-I25,3,5,2,1,1,4,0.6666666666666666,0.3333333333333333,0.2,0.8
SF-H30,SF-H26,20,12,10,6,10,6,0.5,0.5,0.5,0.5
SF-H30,SF-O23,3,4,1,0,2,4,0.3333333333333333,0.6666666666666666,0.0,1.0
SF-H30,SF-H27-1,4,10,4,6,0,4,1.0,0.0,0.6,0.4
SF-H30,SF-F28-2,9,17,7,13,2,4,0.7777777777777778,0.2222222222222222,0.7647058823529411,0.23529411764705882
SF-H30,SF-G27,38,37,22,23,16,14,0.5789473684210527,0.42105263157894735,0.6216216216216216,0.3783783783783784
SF-H30,SF-M22-2,4,5,3,0,1,5,0.75,0.25,0.0,1.0
SF-H30,SF-L22,1,6,0,2,1,4,0.0,1.0,0.3333333333333333,0.6666666666666666
SF-H30,SF-F27,9,13,7,9,2,4,0.7777777777777778,0.2222222222222222,0.6923076923076923,0.3076923076923077
SF-H30,SF-N22-2,3,9,2,9,1,0,0.6666666666666666,0.3333333333333333,1.0,0.0
SF-H30,SF-G28-1,3,3,1,2,2,1,0.3333333333333333,0.6666666666666666,0.6666666666666666,0.3333333333333333
SF-H30,SF-M22-1,3,1,1,0,2,1,0.3333333333333333,0.6666666666666666,0.0,1.0
SF-H30,SF-O25-1,5,3,3,2,2,1,0.6,0.4,0.6666666666666666,0.3333333333333333
SF-H30,SF-K22-2,3,1,2,0,1,1,0.6666666666666666,0.3333333333333333,0.0,1.0
SF-H30,SF-K24,2,2,1,0,1,2,0.5,0.5,0.0,1.0
SF-H30,SF-G23,11,1,10,0,1,1,0.9090909090909091,0.09090909090909091,0.0,1.0
SF-H30,SF-G24,7,11,2,0,5,11,0.2857142857142857,0.7142857142857143,0.0,1.0
SF-H30,SF-G25,6,3,5,0,1,3,0.8333333333333334,0.16666666666666666,0.0,1.0
SF-H30,SF-F23,2,6,0,1,2,5,0.0,1.0,0.16666666666666666,0.8333333333333334
SF-H30,SF-E23,12,4,10,1,2,3,0.8333333333333334,0.16666666666666666,0.25,0.75
SF-H30,SF-C22,3,3,2,1,1,2,0.6666666666666666,0.3333333333333333,0.3333333333333333,0.6666666666666666
SF-H30,SF-B22,6,31,2,26,4,5,0.3333333333333333,0.6666666666666666,0.8387096774193549,0.16129032258064516
SF-H30,SF-H20,1,3,0,2,1,1,0.0,1.0,0.6666666666666666,0.3333333333333333
SF-H30,SF-G20,1,1,1,0,0,1,1.0,0.0,0.0,1.0
SF-H30,SF-E20,2,1,1,0,1,1,0.5,0.5,0.0,1.0
SF-H30,SF-G30-2,52,40,42,30,10,10,0.8076923076923077,0.19230769230769232,0.75,0.25
SF-H30,SF-F30-1,17,41,13,33,4,8,0.7647058823529411,0.23529411764705882,0.8048780487804879,0.1951219512195122
SF-H30,SF-E29-2,57,68,39,43,18,25,0.6842105263157895,0.3157894736842105,0.6323529411764706,0.36764705882352944
SF-H30,SF-E29-1,54,140,44,120,10,20,0.8148148148148148,0.18518518518518517,0.8571428571428571,0.14285714285714285
SF-H30,SF-D29,91,199,71,157,20,42,0.7802197802197802,0.21978021978021978,0.7889447236180904,0.21105527638190955
SF-H30,SF-D28,40,54,25,22,15,32,0.625,0.375,0.4074074074074074,0.5925925925925926
SF-H30,SF-A27,32,87,24,75,8,12,0.75,0.25,0.8620689655172413,0.13793103448275862
SF-H30,SF-G29-2,6,26,5,22,1,4,0.8333333333333334,0.16666666666666666,0.8461538461538461,0.15384615384615385
SF-H30,SF-G29-1,7,9,5,4,2,5,0.7142857142857143,0.2857142857142857,0.4444444444444444,0.5555555555555556
SF-H30,SF-G30-1,30,23,21,14,9,9,0.7,0.3,0.6086956521739131,0.391304347826087
SF-H30,SF-G29-3,21,12,13,9,8,3,0.6190476190476191,0.38095238095238093,0.75,0.25
SF-H30,SF-F30-2,14,13,13,8,1,5,0.9285714285714286,0.07142857142857142,0.6153846153846154,0.38461538461538464
SF-H30,SF-F29,6,5,6,3,0,2,1.0,0.0,0.6,0.4
SF-H30,SF-E29-3,7,7,5,5,2,2,0.7142857142857143,0.2857142857142857,0.7142857142857143,0.2857142857142857
SF-H30,SF-F28-1,7,22,5,19,2,3,0.7142857142857143,0.2857142857142857,0.8636363636363636,0.13636363636363635
SF-H30,SF-E28-2,1,3,0,1,1,2,0.0,1.0,0.3333333333333333,0.6666666666666666
SF-H30,SF-E28,18,18,8,9,10,9,0.4444444444444444,0.5555555555555556,0.5,0.5
SF-H30,SF-J12,2,1,0,0,2,1,0.0,1.0,0.0,1.0
SF-H30,SF-F16,2,3,0,0,2,3,0.0,1.0,0.0,1.0
SF-H30,SF-C20,1,8,0,2,1,6,0.0,1.0,0.25,0.75
SF-H30,SF-B19,12,36,2,18,10,18,0.16666666666666666,0.8333333333333334,0.5,0.5
SF-H30,SF-A20,27,53,14,36,13,17,0.5185185185185185,0.48148148148148145,0.6792452830188679,0.32075471698113206
SF-H30,SF-A19,4,8,3,5,1,3,0.75,0.25,0.625,0.375
SF-H30,SF-C26,37,32,18,9,19,23,0.4864864864864865,0.5135135135135135,0.28125,0.71875
SF-H30,SF-C25,25,21,4,6,21,15,0.16,0.84,0.2857142857142857,0.7142857142857143
SF-H30,SF-B25,41,71,31,59,10,12,0.7560975609756098,0.24390243902439024,0.8309859154929577,0.16901408450704225
SF-H30,SF-E27,3,6,2,4,1,2,0.6666666666666666,0.3333333333333333,0.6666666666666666,0.3333333333333333
SF-H30,SF-B28-2,10,12,7,8,3,4,0.7,0.3,0.6666666666666666,0.3333333333333333
SF-H30,SF-D27,20,42,19,41,1,1,0.95,0.05,0.9761904761904762,0.023809523809523808
SF-H30,SF-C28-2,7,8,0,4,7,4,0.0,1.0,0.5,0.5
SF-H30,SF-C28-1,17,12,14,7,3,5,0.8235294117647058,0.17647058823529413,0.5833333333333334,0.4166666666666667
SF-H30,SF-B28,123,149,102,123,21,26,0.8292682926829268,0.17073170731707318,0.825503355704698,0.174496644295302
SF-H30,SF-H0,1,1,0,0,1,1,0.0,1.0,0.0,1.0
SF-H30,SF-H25,4,1,1,0,3,1,0.25,0.75,0.0,1.0
SF-H30,SF-G26,12,14,4,4,8,10,0.3333333333333333,0.6666666666666666,0.2857142857142857,0.7142857142857143
SF-H30,SF-K21,1,1,0,0,1,1,0.0,1.0,0.0,1.0
SF-H30,SF-J23-1,26,14,13,7,13,7,0.5,0.5,0.5,0.5
SF-H30,SF-J21,3,7,3,1,0,6,1.0,0.0,0.14285714285714285,0.8571428571428571
SF-H30,SF-I22,3,2,0,0,3,2,0.0,1.0,0.0,1.0
SF-H30,SF-I23-2,8,4,2,4,6,0,0.25,0.75,1.0,0.0
SF-H30,SF-I24,3,2,1,0,2,2,0.3333333333333333,0.6666666666666666,0.0,1.0
SF-H30,SF-I23-1,3,3,2,0,1,3,0.6666666666666666,0.3333333333333333,0.0,1.0
SF-H30,SF-F26,15,16,3,8,12,8,0.2,0.8,0.5,0.5
SF-H30,SF-M15,1,1,1,0,0,1,1.0,0.0,0.0,1.0
SF-H30,SF-L20,2,1,0,1,2,0,0.0,1.0,1.0,0.0
SF-H30,SF-M20,2,1,0,0,2,1,0.0,1.0,0.0,1.0
SF-H30,SF-K20,5,2,5,2,0,0,1.0,0.0,1.0,0.0
SF-H30,SF-K15-,2,1,0,0,2,1,0.0,1.0,0.0,1.0
SF-H30,SF-K19,4,3,2,0,2,3,0.5,0.5,0.0,1.0
SF-H30,SF-K18,3,5,1,4,2,1,0.3333333333333333,0.6666666666666666,0.8,0.2
SF-H30,SF-K17,3,1,2,0,1,1,0.6666666666666666,0.3333333333333333,0.0,1.0
SF-H30,SF-J18,1,3,0,0,1,3,0.0,1.0,0.0,1.0
SF-H30,SF-J20,3,4,3,2,0,2,1.0,0.0,0.5,0.5
SF-H30,SF-J19,1,2,0,0,1,2,0.0,1.0,0.0,1.0
SF-H30,SF-Q21-2,2,4,0,0,2,4,0.0,1.0,0.0,1.0
SF-H30,SF-Q21-1,1,2,1,0,0,2,1.0,0.0,0.0,1.0
SF-H30,SF-O18,1,3,0,1,1,2,0.0,1.0,0.3333333333333333,0.6666666666666666
SF-H30,SF-O19,7,2,5,0,2,2,0.7142857142857143,0.2857142857142857,0.0,1.0
SF-H30,SF-O21,12,12,4,3,8,9,0.3333333333333333,0.6666666666666666,0.25,0.75
SF-H30,SF-O22,4,5,0,0,4,5,0.0,1.0,0.0,1.0
SF-H30,SF-N21,2,2,1,0,1,2,0.5,0.5,0.0,1.0
SF-H30,SF-M21,3,2,1,0,2,2,0.3333333333333333,0.6666666666666666,0.0,1.0
SF-H30,SF-L21,1,1,1,0,0,1,1.0,0.0,0.0,1.0
SF-H30,SF-S29,1,6,0,3,1,3,0.0,1.0,0.5,0.5
SF-H30,SF-S30,6,12,5,11,1,1,0.8333333333333334,0.16666666666666666,0.9166666666666666,0.08333333333333333
SF-H30,SF-Q30,86,16,12,4,74,12,0.13953488372093023,0.8604651162790697,0.25,0.75
SF-H30,SF-P30,31,23,13,19,18,4,0.41935483870967744,0.5806451612903226,0.8260869565217391,0.17391304347826086
SF-H30,SF-O30-2,89,65,41,51,48,14,0.4606741573033708,0.5393258426966292,0.7846153846153846,0.2153846153846154
SF-H30,SF-O30,64,94,34,50,30,44,0.53125,0.46875,0.5319148936170213,0.46808510638297873
SF-H30,SF-N27,24,30,7,10,17,20,0.2916666666666667,0.7083333333333334,0.3333333333333333,0.6666666666666666
SF-H30,SF-N29,2,16,2,9,0,7,1.0,0.0,0.5625,0.4375
SF-H30,SF-N28,21,32,13,21,8,11,0.6190476190476191,0.38095238095238093,0.65625,0.34375
SF-H30,SF-L30-1,70,83,57,65,13,18,0.8142857142857143,0.18571428571428572,0.7831325301204819,0.21686746987951808
SF-H30,SF-L31-1,54,61,45,49,9,12,0.8333333333333334,0.16666666666666666,0.8032786885245902,0.19672131147540983
SF-H30,SF-K30-2,31,22,27,16,4,6,0.8709677419354839,0.12903225806451613,0.7272727272727273,0.2727272727272727
SF-H30,SF-L29,53,76,29,53,24,23,0.5471698113207547,0.4528301886792453,0.6973684210526315,0.3026315789473684
SF-H30,SF-J29-1,26,52,17,32,9,20,0.6538461538461539,0.34615384615384615,0.6153846153846154,0.38461538461538464
SF-H30,SF-I30,44,28,37,22,7,6,0.8409090909090909,0.1590909090909091,0.7857142857142857,0.21428571428571427
SF-H30,SF-I29-2,6,2,3,1,3,1,0.5,0.5,0.5,0.5
SF-H30,SF-I27,7,5,7,1,0,4,1.0,0.0,0.2,0.8
SF-H30,SF-I28,6,5,2,3,4,2,0.3333333333333333,0.6666666666666666,0.6,0.4
SF-H30,SF-I30-2,24,9,14,7,10,2,0.5833333333333334,0.4166666666666667,0.7777777777777778,0.2222222222222222
SF-H30,SF I29-1,1,1,0,1,1,0,0.0,1.0,1.0,0.0
SF-H30,SF-H28,6,8,1,4,5,4,0.16666666666666666,0.8333333333333334,0.5,0.5
SF-H30,SF-S24,6,5,2,2,4,3,0.3333333333333333,0.6666666666666666,0.4,0.6
SF-H30,SF-R24,4,10,3,4,1,6,0.75,0.25,0.4,0.6
SF-H30,SF-R26,5,1,0,0,5,1,0.0,1.0,0.0,1.0
SF-H30,SF-Q26,3,3,2,2,1,1,0.6666666666666666,0.3333333333333333,0.6666666666666666,0.3333333333333333
SF-H30,SF-P26,3,5,0,0,3,5,0.0,1.0,0.0,1.0
SF-H30,SF-O25-2,9,10,5,5,4,5,0.5555555555555556,0.4444444444444444,0.5,0.5
SF-H30,SF-N22-1B,1,5,0,5,1,0,0.0,1.0,1.0,0.0
SF-H30,SF-N26,3,3,0,2,3,1,0.0,1.0,0.6666666666666666,0.3333333333333333
SF-H30,SF-N25,1,3,0,3,1,0,0.0,1.0,1.0,0.0
SF-H30,SF-T22,3,1,0,1,3,0,0.0,1.0,1.0,0.0
SF-H30,SF-S22-2,2,3,0,0,2,3,0.0,1.0,0.0,1.0
SF-H30,SF-Q23-3,6,6,0,3,6,3,0.0,1.0,0.5,0.5
SF-H30,SF-Q22-1,3,5,3,1,0,4,1.0,0.0,0.2,0.8
SF-H30,SF-Q22-2,6,4,5,4,1,0,0.8333333333333334,0.16666666666666666,1.0,0.0
SF-H30,SF-W19,8,2,6,0,2,2,0.75,0.25,0.0,1.0
SF-H30,SF-S21,2,4,1,1,1,3,0.5,0.5,0.25,0.75
SF-H30,SF-Z28,4,4,4,3,0,1,1.0,0.0,0.75,0.25
SF-H30,SF-V29,1,6,0,4,1,2,0.0,1.0,0.6666666666666666,0.3333333333333333
SF-H30,SF-V30,1,1,1,1,0,0,1.0,0.0,1.0,0.0
SF-H30,SF-V31,1,1,1,1,0,0,1.0,0.0,1.0,0.0
SF-H30,SF-U30,3,1,0,0,3,1,0.0,1.0,0.0,1.0
SF-H30,SF-Y25,1,1,1,0,0,1,1.0,0.0,0.0,1.0
SF-G30-2,SF-M25,14,49,8,13,6,36,0.5714285714285714,0.42857142857142855,0.2653061224489796,0.7346938775510204
SF-G30-2,SF-M26-2,22,30,16,20,6,10,0.7272727272727273,0.2727272727272727,0.6666666666666666,0.3333333333333333
SF-G30-2,SF-L27,9,14,6,8,3,6,0.6666666666666666,0.3333333333333333,0.5714285714285714,0.42857142857142855
SF-G30-2,SF-K26,9,32,4,23,5,9,0.4444444444444444,0.5555555555555556,0.71875,0.28125
SF-G30-2,SF-J27,6,5,2,2,4,3,0.3333333333333333,0.6666666666666666,0.4,0.6
SF-G30-2,SF-M30,77,49,67,32,10,17,0.8701298701298701,0.12987012987012986,0.6530612244897959,0.3469387755102041
SF-G30-2,SF-L27-2,7,19,6,16,1,3,0.8571428571428571,0.14285714285714285,0.8421052631578947,0.15789473684210525
SF-G30-2,SF-J29-3,27,38,19,22,8,16,0.7037037037037037,0.2962962962962963,0.5789473684210527,0.42105263157894735
SF-G30-2,SF-J29,23,18,12,8,11,10,0.5217391304347826,0.4782608695652174,0.4444444444444444,0.5555555555555556
SF-G30-2,SF-L26,8,9,6,3,2,6,0.75,0.25,0.3333333333333333,0.6666666666666666
SF-G30-2,SF-M28,46,15,5,7,41,8,0.10869565217391304,0.8913043478260869,0.4666666666666667,0.5333333333333333
SF-G30-2,SF-M27,5,6,2,3,3,3,0.4,0.6,0.5,0.5
SF-G30-2,SF-L25,9,12,6,5,3,7,0.6666666666666666,0.3333333333333333,0.4166666666666667,0.5833333333333334
SF-G30-2,SF-M24,11,7,4,3,7,4,0.36363636363636365,0.6363636363636364,0.42857142857142855,0.5714285714285714
SF-G30-2,SF-L24,9,10,4,5,5,5,0.4444444444444444,0.5555555555555556,0.5,0.5
SF-G30-2,SF-N23,5,9,0,1,5,8,0.0,1.0,0.1111111111111111,0.8888888888888888
SF-G30-2,SF-K27-2,42,39,24,22,18,17,0.5714285714285714,0.42857142857142855,0.5641025641025641,0.4358974358974359
SF-G30-2,SF-J26-2,16,6,6,3,10,3,0.375,0.625,0.5,0.5
SF-G30-2,SF-K28-3,2,3,1,3,1,0,0.5,0.5,1.0,0.0
SF-G30-2,SF-L28,10,26,4,15,6,11,0.4,0.6,0.5769230769230769,0.4230769230769231
SF-G30-2,SF-K28,7,10,5,7,2,3,0.7142857142857143,0.2857142857142857,0.7,0.3
SF-G30-2,SF-K29-1,41,51,30,38,11,13,0.7317073170731707,0.2682926829268293,0.7450980392156863,0.2549019607843137
SF-G30-2,SF-J28-2,24,23,15,7,9,16,0.625,0.375,0.30434782608695654,0.6956521739130435
SF-G30-2,SF-K27,6,15,1,6,5,9,0.16666666666666666,0.8333333333333334,0.4,0.6
SF-G30-2,SF-K25,15,12,3,3,12,9,0.2,0.8,0.25,0.75
SF-G30-2,SF-J25,24,37,7,18,17,19,0.2916666666666667,0.7083333333333334,0.4864864864864865,0.5135135135135135
SF-G30-2,SF-H26-2,6,9,3,2,3,7,0.5,0.5,0.2222222222222222,0.7777777777777778
SF-G30-2,SF-P24,8,8,2,1,6,7,0.25,0.75,0.125,0.875
SF-G30-2,SF-N22-1A,2,2,0,0,2,2,0.0,1.0,0.0,1.0
SF-G30-2,SF-J24,14,17,5,3,9,14,0.35714285714285715,0.6428571428571429,0.17647058823529413,0.8235294117647058
SF-G30-2,SF-O24,5,6,0,1,5,5,0.0,1.0,0.16666666666666666,0.8333333333333334
SF-G30-2,SF-J26,1,11,0,3,1,8,0.0,1.0,0.2727272727272727,0.7272727272727273
SF-G30-2,SF-I25,14,10,8,3,6,7,0.5714285714285714,0.42857142857142855,0.3,0.7
SF-G30-2,SF-H26,10,24,6,10,4,14,0.6,0.4,0.4166666666666667,0.5833333333333334
SF-G30-2,SF-O23,21,31,2,9,19,22,0.09523809523809523,0.9047619047619048,0.2903225806451613,0.7096774193548387
SF-G30-2,SF-H27-1,14,16,10,10,4,6,0.7142857142857143,0.2857142857142857,0.625,0.375
SF-G30-2,SF-F28-2,31,40,16,24,15,16,0.5161290322580645,0.4838709677419355,0.6,0.4
SF-G30-2,SF-G27,77,81,31,33,46,48,0.4025974025974026,0.5974025974025974,0.4074074074074074,0.5925925925925926
SF-G30-2,SF-M22-2,11,11,3,3,8,8,0.2727272727272727,0.7272727272727273,0.2727272727272727,0.7272727272727273
SF-G30-2,SF-L22,12,20,1,3,11,17,0.08333333333333333,0.9166666666666666,0.15,0.85
SF-G30-2,SF-F27,43,38,8,23,35,15,0.18604651162790697,0.813953488372093,0.6052631578947368,0.39473684210526316
SF-G30-2,SF-N22-2,9,13,5,8,4,5,0.5555555555555556,0.4444444444444444,0.6153846153846154,0.38461538461538464
SF-G30-2,SF-G28-2,3,3,1,2,2,1,0.3333333333333333,0.6666666666666666,0.6666666666666666,0.3333333333333333
SF-G30-2,SF-G28-1,17,14,4,9,13,5,0.23529411764705882,0.7647058823529411,0.6428571428571429,0.35714285714285715
SF-G30-2,SF-M22-1,10,16,1,2,9,14,0.1,0.9,0.125,0.875
SF-G30-2,SF-O25-1,3,3,1,1,2,2,0.3333333333333333,0.6666666666666666,0.3333333333333333,0.6666666666666666
SF-G30-2,SF-K22-2,16,5,10,1,6,4,0.625,0.375,0.2,0.8
SF-G30-2,SF-K24,10,12,5,2,5,10,0.5,0.5,0.16666666666666666,0.8333333333333334
SF-G30-2,SF-J23-2,6,4,1,1,5,3,0.16666666666666666,0.8333333333333334,0.25,0.75
SF-G30-2,SF-G23,7,12,1,0,6,12,0.14285714285714285,0.8571428571428571,0.0,1.0
SF-G30-2,SF-G24,101,32,42,3,59,29,0.4158415841584158,0.5841584158415841,0.09375,0.90625
SF-G30-2,SF-G25,56,56,12,4,44,52,0.21428571428571427,0.7857142857142857,0.07142857142857142,0.9285714285714286
SF-G30-2,SF-F23,23,18,7,0,16,18,0.30434782608695654,0.6956521739130435,0.0,1.0
SF-G30-2,SF-E23,32,26,6,2,26,24,0.1875,0.8125,0.07692307692307693,0.9230769230769231
SF-G30-2,SF-D24,31,33,5,0,26,33,0.16129032258064516,0.8387096774193549,0.0,1.0
SF-G30-2,SF-C22,8,11,1,1,7,10,0.125,0.875,0.09090909090909091,0.9090909090909091
SF-G30-2,SF-B22,45,70,13,28,32,42,0.28888888888888886,0.7111111111111111,0.4,0.6
SF-G30-2,SF-J17,18,34,3,1,15,33,0.16666666666666666,0.8333333333333334,0.029411764705882353,0.9705882352941176
SF-G30-2,SF-I19,12,6,2,1,10,5,0.16666666666666666,0.8333333333333334,0.16666666666666666,0.8333333333333334
SF-G30-2,SF-I20,9,8,6,5,3,3,0.6666666666666666,0.3333333333333333,0.625,0.375
SF-G30-2,SF-H20,3,1,0,0,3,1,0.0,1.0,0.0,1.0
SF-G30-2,SF-G17,5,1,3,0,2,1,0.6,0.4,0.0,1.0
SF-G30-2,SF-G18,6,2,2,2,4,0,0.3333333333333333,0.6666666666666666,1.0,0.0
SF-G30-2,SF-G20,9,5,0,0,9,5,0.0,1.0,0.0,1.0
SF-G30-2,SF-F19,7,2,1,0,6,2,0.14285714285714285,0.8571428571428571,0.0,1.0
SF-G30-2,SF-E18,4,5,0,0,4,5,0.0,1.0,0.0,1.0
SF-G30-2,SF-E20,6,4,1,0,5,4,0.16666666666666666,0.8333333333333334,0.0,1.0
SF-G30-2,SF-H30,40,52,30,42,10,10,0.75,0.25,0.8076923076923077,0.19230769230769232
SF-G30-2,SF-F30-1,159,84,106,49,53,35,0.6666666666666666,0.3333333333333333,0.5833333333333334,0.4166666666666667
SF-G30-2,SF-E29-2,69,52,49,32,20,20,0.7101449275362319,0.2898550724637681,0.6153846153846154,0.38461538461538464
SF-G30-2,SF-E29-1,69,115,54,93,15,22,0.782608695652174,0.21739130434782608,0.808695652173913,0.19130434782608696
SF-G30-2,SF-D29,89,114,68,84,21,30,0.7640449438202247,0.23595505617977527,0.7368421052631579,0.2631578947368421
SF-G30-2,SF-D28,58,43,36,25,22,18,0.6206896551724138,0.3793103448275862,0.5813953488372093,0.4186046511627907
SF-G30-2,SF-A27,58,55,33,40,25,15,0.5689655172413793,0.43103448275862066,0.7272727272727273,0.2727272727272727
SF-G30-2,SF-G29-2,24,25,18,13,6,12,0.75,0.25,0.52,0.48
SF-G30-2,SF-G29-1,101,128,22,36,79,92,0.21782178217821782,0.7821782178217822,0.28125,0.71875
SF-G30-2,SF-G30-1,59,27,53,16,6,11,0.8983050847457628,0.1016949152542373,0.5925925925925926,0.4074074074074074
SF-G30-2,SF-G29-3,30,20,20,17,10,3,0.6666666666666666,0.3333333333333333,0.85,0.15
SF-G30-2,SF-F30-2,34,40,30,36,4,4,0.8823529411764706,0.11764705882352941,0.9,0.1
SF-G30-2,SF-F29,15,11,8,5,7,6,0.5333333333333333,0.4666666666666667,0.45454545454545453,0.5454545454545454
SF-G30-2,SF-E29-3,32,16,8,10,24,6,0.25,0.75,0.625,0.375
SF-G30-2,SF-F28-1,24,41,11,25,13,16,0.4583333333333333,0.5416666666666666,0.6097560975609756,0.3902439024390244
SF-G30-2,SF-E28-2,14,18,10,14,4,4,0.7142857142857143,0.2857142857142857,0.7777777777777778,0.2222222222222222
SF-G30-2,SF-E28,14,9,7,8,7,1,0.5,0.5,0.8888888888888888,0.1111111111111111
SF-G30-2,SF-J12,15,4,3,0,12,4,0.2,0.8,0.0,1.0
SF-G30-2,SF-J13,2,4,0,0,2,4,0.0,1.0,0.0,1.0
SF-G30-2,SF-H13,1,1,0,0,1,1,0.0,1.0,0.0,1.0
SF-G30-2,SF-H12,7,3,4,0,3,3,0.5714285714285714,0.42857142857142855,0.0,1.0
SF-G30-2,SF-G9,2,2,0,0,2,2,0.0,1.0,0.0,1.0
SF-G30-2,SF-G13,2,3,0,0,2,3,0.0,1.0,0.0,1.0
SF-G30-2,SF-G11,2,1,0,0,2,1,0.0,1.0,0.0,1.0
SF-G30-2,SF-G10-1,11,11,0,0,11,11,0.0,1.0,0.0,1.0
SF-G30-2,SF-F15,1,2,0,0,1,2,0.0,1.0,0.0,1.0
SF-G30-2,SF-C21,12,10,6,3,6,7,0.5,0.5,0.3,0.7
SF-G30-2,SF-C20,6,10,1,2,5,8,0.16666666666666666,0.8333333333333334,0.2,0.8
SF-G30-2,SF-B21,14,4,0,2,14,2,0.0,1.0,0.5,0.5
SF-G30-2,SF-B19,31,49,13,20,18,29,0.41935483870967744,0.5806451612903226,0.40816326530612246,0.5918367346938775
SF-G30-2,SF-A20,33,28,17,11,16,17,0.5151515151515151,0.48484848484848486,0.39285714285714285,0.6071428571428571
SF-G30-2,SF-A19,5,1,2,1,3,0,0.4,0.6,1.0,0.0
SF-G30-2,SF-C26,50,51,19,10,31,41,0.38,0.62,0.19607843137254902,0.803921568627451
SF-G30-2,SF-C25,120,75,48,19,72,56,0.4,0.6,0.25333333333333335,0.7466666666666667
SF-G30-2,SF-B25,75,93,30,58,45,35,0.4,0.6,0.6236559139784946,0.3763440860215054
SF-G30-2,SF-E27,46,37,28,25,18,12,0.6086956521739131,0.391304347826087,0.6756756756756757,0.32432432432432434
SF-G30-2,SF-B28-2,8,6,5,3,3,3,0.625,0.375,0.5,0.5
SF-G30-2,SF-D27,24,23,22,9,2,14,0.9166666666666666,0.08333333333333333,0.391304347826087,0.6086956521739131
SF-G30-2,SF-C28-2,16,13,9,12,7,1,0.5625,0.4375,0.9230769230769231,0.07692307692307693
SF-G30-2,SF-C28-1,83,24,75,20,8,4,0.9036144578313253,0.0963855421686747,0.8333333333333334,0.16666666666666666
SF-G30-2,SF-B28,86,78,54,68,32,10,0.627906976744186,0.37209302325581395,0.8717948717948718,0.1282051282051282
SF-G30-2,SF-G5,2,2,0,0,2,2,0.0,1.0,0.0,1.0
SF-G30-2,SF-G7,1,4,0,2,1,2,0.0,1.0,0.5,0.5
SF-G30-2,SF-F9,1,1,0,0,1,1,0.0,1.0,0.0,1.0
SF-G30-2,SF-H25,3,2,0,1,3,1,0.0,1.0,0.5,0.5
SF-G30-2,SF-G26,17,38,2,8,15,30,0.11764705882352941,0.8823529411764706,0.21052631578947367,0.7894736842105263
SF-G30-2,SF-K21,15,9,5,1,10,8,0.3333333333333333,0.6666666666666666,0.1111111111111111,0.8888888888888888
SF-G30-2,SF-K22-1,19,20,9,1,10,19,0.47368421052631576,0.5263157894736842,0.05,0.95
SF-G30-2,SF-J23-1,61,41,27,3,34,38,0.4426229508196721,0.5573770491803278,0.07317073170731707,0.926829268292683
SF-G30-2,SF-J22-1,19,14,6,3,13,11,0.3157894736842105,0.6842105263157895,0.21428571428571427,0.7857142857142857
SF-G30-2,SF-J22-2,6,12,2,4,4,8,0.3333333333333333,0.6666666666666666,0.3333333333333333,0.6666666666666666
SF-G30-2,SF-J21,26,20,17,8,9,12,0.6538461538461539,0.34615384615384615,0.4,0.6
SF-G30-2,SF-I21,1,4,0,4,1,0,0.0,1.0,1.0,0.0
SF-G30-2,SF-I22,3,5,2,0,1,5,0.6666666666666666,0.3333333333333333,0.0,1.0
SF-G30-2,SF-I23-2,6,14,2,8,4,6,0.3333333333333333,0.6666666666666666,0.5714285714285714,0.42857142857142855
SF-G30-2,SF-I24,17,10,8,6,9,4,0.47058823529411764,0.5294117647058824,0.6,0.4
SF-G30-2,SF-I23-1,14,21,5,16,9,5,0.35714285714285715,0.6428571428571429,0.7619047619047619,0.23809523809523808
SF-G30-2,SF-F26,59,34,30,19,29,15,0.5084745762711864,0.4915254237288136,0.5588235294117647,0.4411764705882353
SF-G30-2,SF-M13,14,2,0,0,14,2,0.0,1.0,0.0,1.0
SF-G30-2,SF-M15,19,13,2,0,17,13,0.10526315789473684,0.8947368421052632,0.0,1.0
SF-G30-2,SF-L19,8,4,4,2,4,2,0.5,0.5,0.5,0.5
SF-G30-2,SF-L20,7,9,1,3,6,6,0.14285714285714285,0.8571428571428571,0.3333333333333333,0.6666666666666666
SF-G30-2,SF-N20-1,5,5,2,1,3,4,0.4,0.6,0.2,0.8
SF-G30-2,SF-M20,19,14,2,2,17,12,0.10526315789473684,0.8947368421052632,0.14285714285714285,0.8571428571428571
SF-G30-2,SF-K17-2,4,6,1,0,3,6,0.25,0.75,0.0,1.0
SF-G30-2,SF-K20,13,15,6,0,7,15,0.46153846153846156,0.5384615384615384,0.0,1.0
SF-G30-2,SF-K15-,20,19,0,0,20,19,0.0,1.0,0.0,1.0
SF-G30-2,SF-K19,10,8,2,2,8,6,0.2,0.8,0.25,0.75
SF-G30-2,SF-K18,7,7,1,0,6,7,0.14285714285714285,0.8571428571428571,0.0,1.0
SF-G30-2,SF-K17,8,7,1,0,7,7,0.125,0.875,0.0,1.0
SF-G30-2,SF-J16,4,5,1,1,3,4,0.25,0.75,0.2,0.8
SF-G30-2,SF-J18,23,15,12,6,11,9,0.5217391304347826,0.4782608695652174,0.4,0.6
SF-G30-2,SF-J20,4,4,2,1,2,3,0.5,0.5,0.25,0.75
SF-G30-2,SF-J19,16,10,5,2,11,8,0.3125,0.6875,0.2,0.8
SF-G30-2,SF-M10,1,1,1,0,0,1,1.0,0.0,0.0,1.0
SF-G30-2,SF-M11,3,2,0,0,3,2,0.0,1.0,0.0,1.0
SF-G30-2,SF-R19,6,2,2,0,4,2,0.3333333333333333,0.6666666666666666,0.0,1.0
SF-G30-2,SF-R20,2,2,1,0,1,2,0.5,0.5,0.0,1.0
SF-G30-2,SF-Q21-2,4,4,0,0,4,4,0.0,1.0,0.0,1.0
SF-G30-2,SF-Q21-1,4,1,0,0,4,1,0.0,1.0,0.0,1.0
SF-G30-2,SF-P21,3,4,1,0,2,4,0.3333333333333333,0.6666666666666666,0.0,1.0
SF-G30-2,SF-O18,5,4,1,0,4,4,0.2,0.8,0.0,1.0
SF-G30-2,SF-O19,19,12,2,1,17,11,0.10526315789473684,0.8947368421052632,0.08333333333333333,0.9166666666666666
SF-G30-2,SF-O21,10,11,1,4,9,7,0.1,0.9,0.36363636363636365,0.6363636363636364
SF-G30-2,SF-O22,3,12,0,5,3,7,0.0,1.0,0.4166666666666667,0.5833333333333334
SF-G30-2,SF-N21,4,2,0,1,4,1,0.0,1.0,0.5,0.5
SF-G30-2,SF-N20-2,8,7,3,0,5,7,0.375,0.625,0.0,1.0
SF-G30-2,SF-M21,8,9,2,2,6,7,0.25,0.75,0.2222222222222222,0.7777777777777778
SF-G30-2,SF-L21,20,27,5,3,15,24,0.25,0.75,0.1111111111111111,0.8888888888888888
SF-G30-2,SF-S29,1,2,0,1,1,1,0.0,1.0,0.5,0.5
SF-G30-2,SF-S30,18,3,0,3,18,0,0.0,1.0,1.0,0.0
SF-G30-2,SF-Q30,25,23,7,10,18,13,0.28,0.72,0.43478260869565216,0.5652173913043478
SF-G30-2,SF-P30,14,23,4,11,10,12,0.2857142857142857,0.7142857142857143,0.4782608695652174,0.5217391304347826
SF-G30-2,SF-O30-2,24,48,16,36,8,12,0.6666666666666666,0.3333333333333333,0.75,0.25
SF-G30-2,SF-O30,27,49,13,18,14,31,0.48148148148148145,0.5185185185185185,0.3673469387755102,0.6326530612244898
SF-G30-2,SF-N27,8,23,3,5,5,18,0.375,0.625,0.21739130434782608,0.782608695652174
SF-G30-2,SF-N29,3,13,0,10,3,3,0.0,1.0,0.7692307692307693,0.23076923076923078
SF-G30-2,SF-N28,43,36,12,13,31,23,0.27906976744186046,0.7209302325581395,0.3611111111111111,0.6388888888888888
SF-G30-2,SF-L30-1,38,65,33,50,5,15,0.868421052631579,0.13157894736842105,0.7692307692307693,0.23076923076923078
SF-G30-2,SF-L31-1,26,36,14,21,12,15,0.5384615384615384,0.46153846153846156,0.5833333333333334,0.4166666666666667
SF-G30-2,SF-K30-2,9,23,6,13,3,10,0.6666666666666666,0.3333333333333333,0.5652173913043478,0.43478260869565216
SF-G30-2,SF-L29,16,43,7,24,9,19,0.4375,0.5625,0.5581395348837209,0.4418604651162791
SF-G30-2,SF-J29-1,34,72,22,50,12,22,0.6470588235294118,0.35294117647058826,0.6944444444444444,0.3055555555555556
SF-G30-2,SF-I30,25,36,13,24,12,12,0.52,0.48,0.6666666666666666,0.3333333333333333
SF-G30-2,SF-I29-2,3,10,1,6,2,4,0.3333333333333333,0.6666666666666666,0.6,0.4
SF-G30-2,SF-I27,42,36,7,6,35,30,0.16666666666666666,0.8333333333333334,0.16666666666666666,0.8333333333333334
SF-G30-2,SF-I28,36,48,6,12,30,36,0.16666666666666666,0.8333333333333334,0.25,0.75
SF-G30-2,SF-I30-2,10,19,9,13,1,6,0.9,0.1,0.6842105263157895,0.3157894736842105
SF-G30-2,SF I29-1,19,8,12,3,7,5,0.631578947368421,0.3684210526315789,0.375,0.625
SF-G30-2,SF-H28,33,15,14,6,19,9,0.42424242424242425,0.5757575757575758,0.4,0.6
SF-G30-2,SF-H29,5,2,1,1,4,1,0.2,0.8,0.5,0.5
SF-G30-2,SF-S24,3,3,0,1,3,2,0.0,1.0,0.3333333333333333,0.6666666666666666
SF-G30-2,SF-R24,12,13,5,7,7,6,0.4166666666666667,0.5833333333333334,0.5384615384615384,0.46153846153846156
SF-G30-2,SF-R26,2,4,1,1,1,3,0.5,0.5,0.25,0.75
SF-G30-2,SF-Q26,5,4,3,3,2,1,0.6,0.4,0.75,0.25
SF-G30-2,SF-P26,13,10,7,0,6,10,0.5384615384615384,0.46153846153846156,0.0,1.0
SF-G30-2,SF-O25-2,1,5,1,3,0,2,1.0,0.0,0.6,0.4
SF-G30-2,SF-N22-1B,1,2,1,2,0,0,1.0,0.0,1.0,0.0
SF-G30-2,SF-N26,6,4,4,1,2,3,0.6666666666666666,0.3333333333333333,0.25,0.75
SF-G30-2,SF-N25,2,2,1,1,1,1,0.5,0.5,0.5,0.5
SF-G30-2,SF-T22,2,2,0,0,2,2,0.0,1.0,0.0,1.0
SF-G30-2,SF-S22-1,2,5,0,1,2,4,0.0,1.0,0.2,0.8
SF-G30-2,SF-Q23-3,4,9,0,2,4,7,0.0,1.0,0.2222222222222222,0.7777777777777778
SF-G30-2,SF-Q22-1,4,5,0,1,4,4,0.0,1.0,0.2,0.8
SF-G30-2,SF-Q22-2,2,8,0,3,2,5,0.0,1.0,0.375,0.625
SF-G30-2,SF-P22,4,1,3,1,1,0,0.75,0.25,1.0,0.0
SF-G30-2,SF-T20,1,2,1,1,0,1,1.0,0.0,0.5,0.5
SF-G30-2,SF-S21,1,2,1,0,0,2,1.0,0.0,0.0,1.0
SF-G30-2,SF-V28,12,5,0,0,12,5,0.0,1.0,0.0,1.0
SF-G30-2,SF-V30,1,2,1,1,0,1,1.0,0.0,0.5,0.5
SF-G30-2,SF-V32,3,6,3,6,0,0,1.0,0.0,1.0,0.0
SF-G30-2,SF-U30,2,3,1,1,1,2,0.5,0.5,0.3333333333333333,0.6666666666666666
SF-G30-2,SF-Y25,4,4,0,0,4,4,0.0,1.0,0.0,1.0
SF-F30-1,SF-M26,2,2,0,0,2,2,0.0,1.0,0.0,1.0
SF-F30-1,SF-M25,2,1,1,0,1,1,0.5,0.5,0.0,1.0
SF-F30-1,SF-M26-2,3,8,1,1,2,7,0.3333333333333333,0.6666666666666666,0.125,0.875
SF-F30-1,SF-L27,5,5,1,4,4,1,0.2,0.8,0.8,0.2
SF-F30-1,SF-K26,2,9,0,4,2,5,0.0,1.0,0.4444444444444444,0.5555555555555556
SF-F30-1,SF-J27,4,8,4,6,0,2,1.0,0.0,0.75,0.25
SF-F30-1,SF-M30,25,34,6,15,19,19,0.24,0.76,0.4411764705882353,0.5588235294117647
SF-F30-1,SF-J29-3,5,21,3,15,2,6,0.6,0.4,0.7142857142857143,0.2857142857142857
SF-F30-1,SF-J29,13,10,6,4,7,6,0.46153846153846156,0.5384615384615384,0.4,0.6
SF-F30-1,SF-M28,4,7,3,5,1,2,0.75,0.25,0.7142857142857143,0.2857142857142857
SF-F30-1,SF-L25,3,2,3,2,0,0,1.0,0.0,1.0,0.0
SF-F30-1,SF-M24,8,6,6,3,2,3,0.75,0.25,0.5,0.5
SF-F30-1,SF-L24,5,2,2,1,3,1,0.4,0.6,0.5,0.5
SF-F30-1,SF-N24-2,1,1,1,1,0,0,1.0,0.0,1.0,0.0
SF-F30-1,SF-K27-2,4,8,4,7,0,1,1.0,0.0,0.875,0.125
SF-F30-1,SF-J26-2,13,2,9,2,4,0,0.6923076923076923,0.3076923076923077,1.0,0.0
SF-F30-1,SF-L28,8,12,6,9,2,3,0.75,0.25,0.75,0.25
SF-F30-1,SF-K29-1,83,47,43,30,40,17,0.5180722891566265,0.4819277108433735,0.6382978723404256,0.3617021276595745
SF-F30-1,SF-J28-2,3,3,3,2,0,1,1.0,0.0,0.6666666666666666,0.3333333333333333
SF-F30-1,SF-K25,40,28,6,4,34,24,0.15,0.85,0.14285714285714285,0.8571428571428571
SF-F30-1,SF-J25,14,26,10,19,4,7,0.7142857142857143,0.2857142857142857,0.7307692307692307,0.2692307692307692
SF-F30-1,SF-H26-2,10,2,5,0,5,2,0.5,0.5,0.0,1.0
SF-F30-1,SF-P24,1,2,0,0,1,2,0.0,1.0,0.0,1.0
SF-F30-1,SF-J24,14,7,2,2,12,5,0.14285714285714285,0.8571428571428571,0.2857142857142857,0.7142857142857143
SF-F30-1,SF-O24,2,5,1,0,1,5,0.5,0.5,0.0,1.0
SF-F30-1,SF-J26,9,10,5,1,4,9,0.5555555555555556,0.4444444444444444,0.1,0.9
SF-F30-1,SF-I26-,13,13,10,9,3,4,0.7692307692307693,0.23076923076923078,0.6923076923076923,0.3076923076923077
SF-F30-1,SF-I25,18,3,18,2,0,1,1.0,0.0,0.6666666666666666,0.3333333333333333
SF-F30-1,SF-H26,7,15,6,12,1,3,0.8571428571428571,0.14285714285714285,0.8,0.2
SF-F30-1,SF-O23,2,5,0,2,2,3,0.0,1.0,0.4,0.6
SF-F30-1,SF-H27-1,14,14,5,4,9,10,0.35714285714285715,0.6428571428571429,0.2857142857142857,0.7142857142857143
SF-F30-1,SF-F28-2,11,10,9,7,2,3,0.8181818181818182,0.18181818181818182,0.7,0.3
SF-F30-1,SF-G27,32,68,28,52,4,16,0.875,0.125,0.7647058823529411,0.23529411764705882
SF-F30-1,SF-M22-2,2,5,0,0,2,5,0.0,1.0,0.0,1.0
SF-F30-1,SF-L22,3,2,2,1,1,1,0.6666666666666666,0.3333333333333333,0.5,0.5
SF-F30-1,SF-F27,22,6,18,5,4,1,0.8181818181818182,0.18181818181818182,0.8333333333333334,0.16666666666666666
SF-F30-1,SF-N22-2,7,3,1,2,6,1,0.14285714285714285,0.8571428571428571,0.6666666666666666,0.3333333333333333
SF-F30-1,SF-G28-2,5,8,3,4,2,4,0.6,0.4,0.5,0.5
SF-F30-1,SF-G28-1,2,5,2,3,0,2,1.0,0.0,0.6,0.4
SF-F30-1,SF-O25-1,1,1,0,0,1,1,0.0,1.0,0.0,1.0
SF-F30-1,SF-K22-2,7,3,4,3,3,0,0.5714285714285714,0.42857142857142855,1.0,0.0
SF-F30-1,SF-K24,5,3,5,2,0,1,1.0,0.0,0.6666666666666666,0.3333333333333333
SF-F30-1,SF-G24,1,2,0,0,1,2,0.0,1.0,0.0,1.0
SF-F30-1,SF-G25,10,9,3,0,7,9,0.3,0.7,0.0,1.0
SF-F30-1,SF-F23,4,6,0,0,4,6,0.0,1.0,0.0,1.0
SF-F30-1,SF-E23,5,5,2,2,3,3,0.4,0.6,0.4,0.6
SF-F30-1,SF-D24,39,2,32,0,7,2,0.8205128205128205,0.1794871794871795,0.0,1.0
SF-F30-1,SF-C22,3,7,1,0,2,7,0.3333333333333333,0.6666666666666666,0.0,1.0
SF-F30-1,SF-B22,5,18,1,15,4,3,0.2,0.8,0.8333333333333334,0.16666666666666666
SF-F30-1,SF-J17,3,2,1,0,2,2,0.3333333333333333,0.6666666666666666,0.0,1.0
SF-F30-1,SF-I19,1,2,0,0,1,2,0.0,1.0,0.0,1.0
SF-F30-1,SF-I20,2,2,1,0,1,2,0.5,0.5,0.0,1.0
SF-F30-1,SF-H20,3,1,0,0,3,1,0.0,1.0,0.0,1.0
SF-F30-1,SF-H18,1,1,1,1,0,0,1.0,0.0,1.0,0.0
SF-F30-1,SF-H17,1,10,0,0,1,10,0.0,1.0,0.0,1.0
SF-F30-1,SF-G18,1,1,0,0,1,1,0.0,1.0,0.0,1.0
SF-F30-1,SF-H30,41,17,33,13,8,4,0.8048780487804879,0.1951219512195122,0.7647058823529411,0.23529411764705882
SF-F30-1,SF-G30-2,84,159,49,106,35,53,0.5833333333333334,0.4166666666666667,0.6666666666666666,0.3333333333333333
SF-F30-1,SF-E29-2,19,17,15,12,4,5,0.7894736842105263,0.21052631578947367,0.7058823529411765,0.29411764705882354
SF-F30-1,SF-E29-1,21,17,18,13,3,4,0.8571428571428571,0.14285714285714285,0.7647058823529411,0.23529411764705882
SF-F30-1,SF-D29,21,39,20,32,1,7,0.9523809523809523,0.047619047619047616,0.8205128205128205,0.1794871794871795
SF-F30-1,SF-D28,170,176,156,166,14,10,0.9176470588235294,0.08235294117647059,0.9431818181818182,0.056818181818181816
SF-F30-1,SF-A27,31,90,23,84,8,6,0.7419354838709677,0.25806451612903225,0.9333333333333333,0.06666666666666667
SF-F30-1,SF-G29-2,37,18,30,10,7,8,0.8108108108108109,0.1891891891891892,0.5555555555555556,0.4444444444444444
SF-F30-1,SF-G29-1,6,1,5,1,1,0,0.8333333333333334,0.16666666666666666,1.0,0.0
SF-F30-1,SF-G30-1,14,6,13,6,1,0,0.9285714285714286,0.07142857142857142,1.0,0.0
SF-F30-1,SF-G29-3,25,11,17,5,8,6,0.68,0.32,0.45454545454545453,0.5454545454545454
SF-F30-1,SF-F30-2,24,17,17,12,7,5,0.7083333333333334,0.2916666666666667,0.7058823529411765,0.29411764705882354
SF-F30-1,SF-F29,7,11,5,8,2,3,0.7142857142857143,0.2857142857142857,0.7272727272727273,0.2727272727272727
SF-F30-1,SF-E29-3,3,4,3,4,0,0,1.0,0.0,1.0,0.0
SF-F30-1,SF-F28-1,12,5,9,2,3,3,0.75,0.25,0.4,0.6
SF-F30-1,SF-E28,5,3,4,2,1,1,0.8,0.2,0.6666666666666666,0.3333333333333333
SF-F30-1,SF-J12,1,2,0,0,1,2,0.0,1.0,0.0,1.0
SF-F30-1,SF-H12,2,1,0,0,2,1,0.0,1.0,0.0,1.0
SF-F30-1,SF-C20,5,3,3,2,2,1,0.6,0.4,0.6666666666666666,0.3333333333333333
SF-F30-1,SF-B21,4,4,3,3,1,1,0.75,0.25,0.75,0.25
SF-F30-1,SF-B19,14,16,1,6,13,10,0.07142857142857142,0.9285714285714286,0.375,0.625
SF-F30-1,SF-A20,27,36,10,15,17,21,0.37037037037037035,0.6296296296296297,0.4166666666666667,0.5833333333333334
SF-F30-1,SF-A19,8,4,0,1,8,3,0.0,1.0,0.25,0.75
SF-F30-1,SF-C26,21,13,11,3,10,10,0.5238095238095238,0.47619047619047616,0.23076923076923078,0.7692307692307693
SF-F30-1,SF-C25,6,15,1,6,5,9,0.16666666666666666,0.8333333333333334,0.4,0.6
SF-F30-1,SF-B25,25,20,13,14,12,6,0.52,0.48,0.7,0.3
SF-F30-1,SF-E27,4,1,3,1,1,0,0.75,0.25,1.0,0.0
SF-F30-1,SF-B28-2,4,1,2,0,2,1,0.5,0.5,0.0,1.0
SF-F30-1,SF-D27,7,8,4,5,3,3,0.5714285714285714,0.42857142857142855,0.625,0.375
SF-F30-1,SF-C28-2,10,6,6,4,4,2,0.6,0.4,0.6666666666666666,0.3333333333333333
SF-F30-1,SF-C28-1,20,14,18,14,2,0,0.9,0.1,1.0,0.0
SF-F30-1,SF-B28,88,89,87,82,1,7,0.9886363636363636,0.011363636363636364,0.9213483146067416,0.07865168539325842
SF-F30-1,SF-H25,1,2,1,1,0,1,1.0,0.0,0.5,0.5
SF-F30-1,SF-G26,4,5,4,4,0,1,1.0,0.0,0.8,0.2
SF-F30-1,SF-K21,7,1,2,0,5,1,0.2857142857142857,0.7142857142857143,0.0,1.0
SF-F30-1,SF-K22-1,5,8,4,6,1,2,0.8,0.2,0.75,0.25
SF-F30-1,SF-J23-1,20,3,7,1,13,2,0.35,0.65,0.3333333333333333,0.6666666666666666
SF-F30-1,SF-J22-1,1,2,0,0,1,2,0.0,1.0,0.0,1.0
SF-F30-1,SF-J22-2,5,2,1,0,4,2,0.2,0.8,0.0,1.0
SF-F30-1,SF-J21,4,5,2,0,2,5,0.5,0.5,0.0,1.0
SF-F30-1,SF-I23-2,4,2,4,1,0,1,1.0,0.0,0.5,0.5
SF-F30-1,SF-F26,78,56,69,35,9,21,0.8846153846153846,0.11538461538461539,0.625,0.375
SF-F30-1,SF-L19,5,1,3,0,2,1,0.6,0.4,0.0,1.0
SF-F30-1,SF-N20-1,3,4,0,0,3,4,0.0,1.0,0.0,1.0
SF-F30-1,SF-M20,6,6,1,1,5,5,0.16666666666666666,0.8333333333333334,0.16666666666666666,0.8333333333333334
SF-F30-1,SF-K20,3,2,2,0,1,2,0.6666666666666666,0.3333333333333333,0.0,1.0
SF-F30-1,SF-K15-,4,1,0,0,4,1,0.0,1.0,0.0,1.0
SF-F30-1,SF-K19,3,3,1,1,2,2,0.3333333333333333,0.6666666666666666,0.3333333333333333,0.6666666666666666
SF-F30-1,SF-K18,2,1,1,1,1,0,0.5,0.5,1.0,0.0
SF-F30-1,SF-K17,7,7,2,0,5,7,0.2857142857142857,0.7142857142857143,0.0,1.0
SF-F30-1,SF-J18,4,2,2,0,2,2,0.5,0.5,0.0,1.0
SF-F30-1,SF-J20,1,1,0,0,1,1,0.0,1.0,0.0,1.0
SF-F30-1,SF-J19,5,2,1,0,4,2,0.2,0.8,0.0,1.0
SF-F30-1,SF-R19,4,3,0,0,4,3,0.0,1.0,0.0,1.0
SF-F30-1,SF-Q21-1,1,1,0,0,1,1,0.0,1.0,0.0,1.0
SF-F30-1,SF-P21,4,1,0,0,4,1,0.0,1.0,0.0,1.0
SF-F30-1,SF-O21,1,3,0,1,1,2,0.0,1.0,0.3333333333333333,0.6666666666666666
SF-F30-1,SF-O22,3,5,0,1,3,4,0.0,1.0,0.2,0.8
SF-F30-1,SF-M21,4,2,0,0,4,2,0.0,1.0,0.0,1.0
SF-F30-1,SF-L21,21,15,2,0,19,15,0.09523809523809523,0.9047619047619048,0.0,1.0
SF-F30-1,SF-Q30,108,111,49,54,59,57,0.4537037037037037,0.5462962962962963,0.4864864864864865,0.5135135135135135
SF-F30-1,SF-P30,4,21,2,10,2,11,0.5,0.5,0.47619047619047616,0.5238095238095238
SF-F30-1,SF-O30-2,3,12,2,8,1,4,0.6666666666666666,0.3333333333333333,0.6666666666666666,0.3333333333333333
SF-F30-1,SF-O30,17,31,12,17,5,14,0.7058823529411765,0.29411764705882354,0.5483870967741935,0.45161290322580644
SF-F30-1,SF-N27,27,29,8,6,19,23,0.2962962962962963,0.7037037037037037,0.20689655172413793,0.7931034482758621
SF-F30-1,SF-N29,3,6,1,4,2,2,0.3333333333333333,0.6666666666666666,0.6666666666666666,0.3333333333333333
SF-F30-1,SF-N28,11,16,4,11,7,5,0.36363636363636365,0.6363636363636364,0.6875,0.3125
SF-F30-1,SF-L30-1,65,25,9,13,56,12,0.13846153846153847,0.8615384615384616,0.52,0.48
SF-F30-1,SF-L31-1,22,22,11,15,11,7,0.5,0.5,0.6818181818181818,0.3181818181818182
SF-F30-1,SF-K30-2,12,30,7,22,5,8,0.5833333333333334,0.4166666666666667,0.7333333333333333,0.26666666666666666
SF-F30-1,SF-L29,39,36,28,27,11,9,0.717948717948718,0.28205128205128205,0.75,0.25
SF-F30-1,SF-J29-1,15,32,8,16,7,16,0.5333333333333333,0.4666666666666667,0.5,0.5
SF-F30-1,SF-I30,25,41,16,30,9,11,0.64,0.36,0.7317073170731707,0.2682926829268293
SF-F30-1,SF-I29-2,4,2,4,0,0,2,1.0,0.0,0.0,1.0
SF-F30-1,SF-I27,36,26,6,4,30,22,0.16666666666666666,0.8333333333333334,0.15384615384615385,0.8461538461538461
SF-F30-1,SF-I28,20,9,11,6,9,3,0.55,0.45,0.6666666666666666,0.3333333333333333
SF-F30-1,SF-I30-2,8,8,4,6,4,2,0.5,0.5,0.75,0.25
SF-F30-1,SF I29-1,16,13,2,0,14,13,0.125,0.875,0.0,1.0
SF-F30-1,SF-H28,20,10,12,6,8,4,0.6,0.4,0.6,0.4
SF-F30-1,SF-H29,3,2,2,1,1,1,0.6666666666666666,0.3333333333333333,0.5,0.5
SF-F30-1,SF-R24,4,8,1,1,3,7,0.25,0.75,0.125,0.875
SF-F30-1,SF-R26,1,1,0,1,1,0,0.0,1.0,1.0,0.0
SF-F30-1,SF-N26,6,2,3,0,3,2,0.5,0.5,0.0,1.0
SF-F30-1,SF-T22,1,1,0,0,1,1,0.0,1.0,0.0,1.0
SF-F30-1,SF-Q23-3,2,2,2,0,0,2,1.0,0.0,0.0,1.0
SF-F30-1,SF-Q22-1,3,1,2,0,1,1,0.6666666666666666,0.3333333333333333,0.0,1.0
SF-F30-1,SF-Q22-2,2,2,1,0,1,2,0.5,0.5,0.0,1.0
SF-F30-1,SF-P22,2,3,2,1,0,2,1.0,0.0,0.3333333333333333,0.6666666666666666
SF-E29-2,SF-M25,2,3,0,0,2,3,0.0,1.0,0.0,1.0
SF-E29-2,SF-M26-2,42,51,40,47,2,4,0.9523809523809523,0.047619047619047616,0.9215686274509803,0.0784313725490196
SF-E29-2,SF-L27,2,5,2,2,0,3,1.0,0.0,0.4,0.6
SF-E29-2,SF-K26,3,11,1,5,2,6,0.3333333333333333,0.6666666666666666,0.45454545454545453,0.5454545454545454
SF-E29-2,SF-J27,6,4,6,4,0,0,1.0,0.0,1.0,0.0
SF-E29-2,SF-M30,327,297,227,205,100,92,0.6941896024464832,0.3058103975535168,0.6902356902356902,0.30976430976430974
SF-E29-2,SF-J29-3,7,33,4,23,3,10,0.5714285714285714,0.42857142857142855,0.696969696969697,0.30303030303030304
SF-E29-2,SF-J29,17,13,8,8,9,5,0.47058823529411764,0.5294117647058824,0.6153846153846154,0.38461538461538464
SF-E29-2,SF-L26,1,2,0,2,1,0,0.0,1.0,1.0,0.0
SF-E29-2,SF-M28,8,7,3,3,5,4,0.375,0.625,0.42857142857142855,0.5714285714285714
SF-E29-2,SF-L25,5,8,4,1,1,7,0.8,0.2,0.125,0.875
SF-E29-2,SF-M24,4,6,3,1,1,5,0.75,0.25,0.16666666666666666,0.8333333333333334
SF-E29-2,SF-L24,3,4,1,2,2,2,0.3333333333333333,0.6666666666666666,0.5,0.5
SF-E29-2,SF-N23,22,3,17,3,5,0,0.7727272727272727,0.22727272727272727,1.0,0.0
SF-E29-2,SF-N24-2,2,2,2,2,0,0,1.0,0.0,1.0,0.0
SF-E29-2,SF-K27-2,12,7,9,6,3,1,0.75,0.25,0.8571428571428571,0.14285714285714285
SF-E29-2,SF-J26-2,18,9,11,5,7,4,0.6111111111111112,0.3888888888888889,0.5555555555555556,0.4444444444444444
SF-E29-2,SF-L28,130,110,34,65,96,45,0.26153846153846155,0.7384615384615385,0.5909090909090909,0.4090909090909091
SF-E29-2,SF-K29-1,118,180,50,59,68,121,0.423728813559322,0.576271186440678,0.3277777777777778,0.6722222222222223
SF-E29-2,SF-J28-2,77,23,68,12,9,11,0.8831168831168831,0.11688311688311688,0.5217391304347826,0.4782608695652174
SF-E29-2,SF-K27,3,9,2,8,1,1,0.6666666666666666,0.3333333333333333,0.8888888888888888,0.1111111111111111
SF-E29-2,SF-K25,6,7,1,1,5,6,0.16666666666666666,0.8333333333333334,0.14285714285714285,0.8571428571428571
SF-E29-2,SF-J25,29,33,25,22,4,11,0.8620689655172413,0.13793103448275862,0.6666666666666666,0.3333333333333333
SF-E29-2,SF-H26-2,17,16,9,8,8,8,0.5294117647058824,0.47058823529411764,0.5,0.5
SF-E29-2,SF-P24,1,4,0,1,1,3,0.0,1.0,0.25,0.75
SF-E29-2,SF-J24,12,9,8,1,4,8,0.6666666666666666,0.3333333333333333,0.1111111111111111,0.8888888888888888
SF-E29-2,SF-O24,3,5,2,0,1,5,0.6666666666666666,0.3333333333333333,0.0,1.0
SF-E29-2,SF-J26,3,4,1,3,2,1,0.3333333333333333,0.6666666666666666,0.75,0.25
SF-E29-2,SF-I26-,2,2,1,1,1,1,0.5,0.5,0.5,0.5
SF-E29-2,SF-I25,100,81,72,55,28,26,0.72,0.28,0.6790123456790124,0.32098765432098764
SF-E29-2,SF-K23,8,1,1,0,7,1,0.125,0.875,0.0,1.0
SF-E29-2,SF-H26,117,106,98,64,19,42,0.8376068376068376,0.1623931623931624,0.6037735849056604,0.39622641509433965
SF-E29-2,SF-O23,7,11,4,4,3,7,0.5714285714285714,0.42857142857142855,0.36363636363636365,0.6363636363636364
SF-E29-2,SF-H27-1,13,9,8,5,5,4,0.6153846153846154,0.38461538461538464,0.5555555555555556,0.4444444444444444
SF-E29-2,SF-F28-2,97,64,79,49,18,15,0.8144329896907216,0.18556701030927836,0.765625,0.234375
SF-E29-2,SF-G27,134,165,96,89,38,76,0.7164179104477612,0.2835820895522388,0.5393939393939394,0.46060606060606063
SF-E29-2,SF-M22-2,23,20,8,5,15,15,0.34782608695652173,0.6521739130434783,0.25,0.75
SF-E29-2,SF-L22,18,14,8,6,10,8,0.4444444444444444,0.5555555555555556,0.42857142857142855,0.5714285714285714
SF-E29-2,SF-F27,56,30,35,19,21,11,0.625,0.375,0.6333333333333333,0.36666666666666664
SF-E29-2,SF-N22-2,25,23,14,13,11,10,0.56,0.44,0.5652173913043478,0.43478260869565216
SF-E29-2,SF-G28-2,8,1,5,0,3,1,0.625,0.375,0.0,1.0
SF-E29-2,SF-G28-1,9,8,6,4,3,4,0.6666666666666666,0.3333333333333333,0.5,0.5
SF-E29-2,SF-M22-1,10,3,1,1,9,2,0.1,0.9,0.3333333333333333,0.6666666666666666
SF-E29-2,SF-K22-2,41,28,22,9,19,19,0.5365853658536586,0.4634146341463415,0.32142857142857145,0.6785714285714286
SF-E29-2,SF-K24,13,13,8,5,5,8,0.6153846153846154,0.38461538461538464,0.38461538461538464,0.6153846153846154
SF-E29-2,SF-J23-2,35,15,24,13,11,2,0.6857142857142857,0.3142857142857143,0.8666666666666667,0.13333333333333333
SF-E29-2,SF-G23,21,4,10,1,11,3,0.47619047619047616,0.5238095238095238,0.25,0.75
SF-E29-2,SF-G24,88,91,31,7,57,84,0.3522727272727273,0.6477272727272727,0.07692307692307693,0.9230769230769231
SF-E29-2,SF-G25,75,67,36,17,39,50,0.48,0.52,0.2537313432835821,0.746268656716418
SF-E29-2,SF-F23,66,48,12,4,54,44,0.18181818181818182,0.8181818181818182,0.08333333333333333,0.9166666666666666
SF-E29-2,SF-E23,34,20,15,2,19,18,0.4411764705882353,0.5588235294117647,0.1,0.9
SF-E29-2,SF-D24,23,9,13,2,10,7,0.5652173913043478,0.43478260869565216,0.2222222222222222,0.7777777777777778
SF-E29-2,SF-C22,98,16,11,6,87,10,0.11224489795918367,0.8877551020408163,0.375,0.625
SF-E29-2,SF-B22,25,52,6,29,19,23,0.24,0.76,0.5576923076923077,0.4423076923076923
SF-E29-2,SF-J17,24,8,12,0,12,8,0.5,0.5,0.0,1.0
SF-E29-2,SF-I19,9,5,3,1,6,4,0.3333333333333333,0.6666666666666666,0.2,0.8
SF-E29-2,SF-I20,9,7,5,1,4,6,0.5555555555555556,0.4444444444444444,0.14285714285714285,0.8571428571428571
SF-E29-2,SF-H20,13,15,10,8,3,7,0.7692307692307693,0.23076923076923078,0.5333333333333333,0.4666666666666667
SF-E29-2,SF-H18,1,2,0,0,1,2,0.0,1.0,0.0,1.0
SF-E29-2,SF-G19,5,3,2,1,3,2,0.4,0.6,0.3333333333333333,0.6666666666666666
SF-E29-2,SF-G17,9,3,2,1,7,2,0.2222222222222222,0.7777777777777778,0.3333333333333333,0.6666666666666666
SF-E29-2,SF-G18,5,25,0,17,5,8,0.0,1.0,0.68,0.32
SF-E29-2,SF-G20,10,8,2,0,8,8,0.2,0.8,0.0,1.0
SF-E29-2,SF-F19,2,3,0,0,2,3,0.0,1.0,0.0,1.0
SF-E29-2,SF-E18,4,1,0,0,4,1,0.0,1.0,0.0,1.0
SF-E29-2,SF-E20,43,35,1,0,42,35,0.023255813953488372,0.9767441860465116,0.0,1.0
SF-E29-2,SF-H30,68,57,43,39,25,18,0.6323529411764706,0.36764705882352944,0.6842105263157895,0.3157894736842105
SF-E29-2,SF-G30-2,52,69,32,49,20,20,0.6153846153846154,0.38461538461538464,0.7101449275362319,0.2898550724637681
SF-E29-2,SF-F30-1,17,19,12,15,5,4,0.7058823529411765,0.29411764705882354,0.7894736842105263,0.21052631578947367
SF-E29-2,SF-E29-1,39,46,29,40,10,6,0.7435897435897436,0.2564102564102564,0.8695652173913043,0.13043478260869565
SF-E29-2,SF-D29,30,39,19,24,11,15,0.6333333333333333,0.36666666666666664,0.6153846153846154,0.38461538461538464
SF-E29-2,SF-D28,13,23,11,17,2,6,0.8461538461538461,0.15384615384615385,0.7391304347826086,0.2608695652173913
SF-E29-2,SF-A27,258,246,163,186,95,60,0.6317829457364341,0.3682170542635659,0.7560975609756098,0.24390243902439024
SF-E29-2,SF-G29-2,20,15,11,7,9,8,0.55,0.45,0.4666666666666667,0.5333333333333333
SF-E29-2,SF-G29-1,21,3,18,2,3,1,0.8571428571428571,0.14285714285714285,0.6666666666666666,0.3333333333333333
SF-E29-2,SF-G30-1,29,21,26,17,3,4,0.896551724137931,0.10344827586206896,0.8095238095238095,0.19047619047619047
SF-E29-2,SF-G29-3,13,8,12,3,1,5,0.9230769230769231,0.07692307692307693,0.375,0.625
SF-E29-2,SF-F30-2,10,21,9,19,1,2,0.9,0.1,0.9047619047619048,0.09523809523809523
SF-E29-2,SF-F29,18,9,11,6,7,3,0.6111111111111112,0.3888888888888889,0.6666666666666666,0.3333333333333333
SF-E29-2,SF-E29-3,20,29,12,23,8,6,0.6,0.4,0.7931034482758621,0.20689655172413793
SF-E29-2,SF-F28-1,39,80,37,61,2,19,0.9487179487179487,0.05128205128205128,0.7625,0.2375
SF-E29-2,SF-E28-2,16,16,11,11,5,5,0.6875,0.3125,0.6875,0.3125
SF-E29-2,SF-E28,20,9,14,6,6,3,0.7,0.3,0.6666666666666666,0.3333333333333333
SF-E29-2,SF-J12,17,29,1,1,16,28,0.058823529411764705,0.9411764705882353,0.034482758620689655,0.9655172413793104
SF-E29-2,SF-J13,3,2,1,0,2,2,0.3333333333333333,0.6666666666666666,0.0,1.0
SF-E29-2,SF-J15,1,1,1,0,0,1,1.0,0.0,0.0,1.0
SF-E29-2,SF-I16,7,3,2,0,5,3,0.2857142857142857,0.7142857142857143,0.0,1.0
SF-E29-2,SF-G9,2,3,0,0,2,3,0.0,1.0,0.0,1.0
SF-E29-2,SF-G13,1,1,0,0,1,1,0.0,1.0,0.0,1.0
SF-E29-2,SF-G11,1,1,0,0,1,1,0.0,1.0,0.0,1.0
SF-E29-2,SF-G12,2,3,0,0,2,3,0.0,1.0,0.0,1.0
SF-E29-2,SF-F16,1,1,0,0,1,1,0.0,1.0,0.0,1.0
SF-E29-2,SF-C21,3,2,0,0,3,2,0.0,1.0,0.0,1.0
SF-E29-2,SF-C20,8,14,3,4,5,10,0.375,0.625,0.2857142857142857,0.7142857142857143
SF-E29-2,SF-B21,3,6,1,0,2,6,0.3333333333333333,0.6666666666666666,0.0,1.0
SF-E29-2,SF-B19,19,24,10,13,9,11,0.5263157894736842,0.47368421052631576,0.5416666666666666,0.4583333333333333
SF-E29-2,SF-A20,42,56,26,40,16,16,0.6190476190476191,0.38095238095238093,0.7142857142857143,0.2857142857142857
SF-E29-2,SF-A19,11,15,6,9,5,6,0.5454545454545454,0.45454545454545453,0.6,0.4
SF-E29-2,SF-C26,29,25,14,12,15,13,0.4827586206896552,0.5172413793103449,0.48,0.52
SF-E29-2,SF-C25,36,50,16,22,20,28,0.4444444444444444,0.5555555555555556,0.44,0.56
SF-E29-2,SF-B25,45,88,13,50,32,38,0.28888888888888886,0.7111111111111111,0.5681818181818182,0.4318181818181818
SF-E29-2,SF-E27,23,12,10,9,13,3,0.43478260869565216,0.5652173913043478,0.75,0.25
SF-E29-2,SF-B28-2,48,60,16,15,32,45,0.3333333333333333,0.6666666666666666,0.25,0.75
SF-E29-2,SF-D27,20,25,15,19,5,6,0.75,0.25,0.76,0.24
SF-E29-2,SF-C28-2,5,2,4,2,1,0,0.8,0.2,1.0,0.0
SF-E29-2,SF-C28-1,26,15,23,13,3,2,0.8846153846153846,0.11538461538461539,0.8666666666666667,0.13333333333333333
SF-E29-2,SF-B28,89,116,62,78,27,38,0.6966292134831461,0.30337078651685395,0.6724137931034483,0.3275862068965517
SF-E29-2,SF-J1,5,5,1,2,4,3,0.2,0.8,0.4,0.6
SF-E29-2,SF-H0,2,2,1,0,1,2,0.5,0.5,0.0,1.0
SF-E29-2,SF-J3,2,3,1,0,1,3,0.5,0.5,0.0,1.0
SF-E29-2,SF-G8,1,2,0,0,1,2,0.0,1.0,0.0,1.0
SF-E29-2,SF-G5,2,3,0,0,2,3,0.0,1.0,0.0,1.0
SF-E29-2,SF-F9,2,1,1,0,1,1,0.5,0.5,0.0,1.0
SF-E29-2,SF-H25,14,11,11,6,3,5,0.7857142857142857,0.21428571428571427,0.5454545454545454,0.45454545454545453
SF-E29-2,SF-G26,28,28,20,12,8,16,0.7142857142857143,0.2857142857142857,0.42857142857142855,0.5714285714285714
SF-E29-2,SF-K21,31,12,8,2,23,10,0.25806451612903225,0.7419354838709677,0.16666666666666666,0.8333333333333334
SF-E29-2,SF-K22-1,53,106,37,73,16,33,0.6981132075471698,0.3018867924528302,0.6886792452830188,0.3113207547169811
SF-E29-2,SF-J23-1,215,172,144,71,71,101,0.6697674418604651,0.3302325581395349,0.4127906976744186,0.5872093023255814
SF-E29-2,SF-J22-1,52,24,29,9,23,15,0.5576923076923077,0.4423076923076923,0.375,0.625
SF-E29-2,SF-J22-2,39,39,20,15,19,24,0.5128205128205128,0.48717948717948717,0.38461538461538464,0.6153846153846154
SF-E29-2,SF-J21,68,58,20,11,48,47,0.29411764705882354,0.7058823529411765,0.1896551724137931,0.8103448275862069
SF-E29-2,SF-I21,17,8,5,0,12,8,0.29411764705882354,0.7058823529411765,0.0,1.0
SF-E29-2,SF-I22,9,6,5,4,4,2,0.5555555555555556,0.4444444444444444,0.6666666666666666,0.3333333333333333
SF-E29-2,SF-I23-2,22,21,14,12,8,9,0.6363636363636364,0.36363636363636365,0.5714285714285714,0.42857142857142855
SF-E29-2,SF-I24,13,16,7,14,6,2,0.5384615384615384,0.46153846153846156,0.875,0.125
SF-E29-2,SF-I23-1,15,15,10,9,5,6,0.6666666666666666,0.3333333333333333,0.6,0.4
SF-E29-2,SF-F26,52,53,31,26,21,27,0.5961538461538461,0.40384615384615385,0.49056603773584906,0.5094339622641509
SF-E29-2,SF-M13,12,5,0,0,12,5,0.0,1.0,0.0,1.0
SF-E29-2,SF-M15,16,8,6,1,10,7,0.375,0.625,0.125,0.875
SF-E29-2,SF-L19,19,9,9,0,10,9,0.47368421052631576,0.5263157894736842,0.0,1.0
SF-E29-2,SF-L20,25,17,14,6,11,11,0.56,0.44,0.35294117647058826,0.6470588235294118
SF-E29-2,SF-N20-1,26,7,16,5,10,2,0.6153846153846154,0.38461538461538464,0.7142857142857143,0.2857142857142857
SF-E29-2,SF-M20,62,40,22,2,40,38,0.3548387096774194,0.6451612903225806,0.05,0.95
SF-E29-2,SF-K17-2,6,2,2,0,4,2,0.3333333333333333,0.6666666666666666,0.0,1.0
SF-E29-2,SF-K20,21,13,14,3,7,10,0.6666666666666666,0.3333333333333333,0.23076923076923078,0.7692307692307693
SF-E29-2,SF-K15-,8,14,3,0,5,14,0.375,0.625,0.0,1.0
SF-E29-2,SF-K19,20,7,8,1,12,6,0.4,0.6,0.14285714285714285,0.8571428571428571
SF-E29-2,SF-K18,17,11,6,4,11,7,0.35294117647058826,0.6470588235294118,0.36363636363636365,0.6363636363636364
SF-E29-2,SF-K17,7,7,4,3,3,4,0.5714285714285714,0.42857142857142855,0.42857142857142855,0.5714285714285714
SF-E29-2,SF-J16,3,3,3,1,0,2,1.0,0.0,0.3333333333333333,0.6666666666666666
SF-E29-2,SF-J18,17,12,2,1,15,11,0.11764705882352941,0.8823529411764706,0.08333333333333333,0.9166666666666666
SF-E29-2,SF-J20,25,14,8,3,17,11,0.32,0.68,0.21428571428571427,0.7857142857142857
SF-E29-2,SF-J19,17,13,6,5,11,8,0.35294117647058826,0.6470588235294118,0.38461538461538464,0.6153846153846154
SF-E29-2,SF-M12,6,6,4,3,2,3,0.6666666666666666,0.3333333333333333,0.5,0.5
SF-E29-2,SF-M10,6,1,4,0,2,1,0.6666666666666666,0.3333333333333333,0.0,1.0
SF-E29-2,SF-M11,11,3,2,0,9,3,0.18181818181818182,0.8181818181818182,0.0,1.0
SF-E29-2,SF-R19,13,2,4,1,9,1,0.3076923076923077,0.6923076923076923,0.5,0.5
SF-E29-2,SF-R20,6,1,4,0,2,1,0.6666666666666666,0.3333333333333333,0.0,1.0
SF-E29-2,SF-Q21-2,6,9,0,1,6,8,0.0,1.0,0.1111111111111111,0.8888888888888888
SF-E29-2,SF-Q21-1,9,11,1,7,8,4,0.1111111111111111,0.8888888888888888,0.6363636363636364,0.36363636363636365
SF-E29-2,SF-P21,5,5,5,1,0,4,1.0,0.0,0.2,0.8
SF-E29-2,SF-O18,22,20,4,6,18,14,0.18181818181818182,0.8181818181818182,0.3,0.7
SF-E29-2,SF-O19,18,11,6,6,12,5,0.3333333333333333,0.6666666666666666,0.5454545454545454,0.45454545454545453
SF-E29-2,SF-O21,39,7,14,1,25,6,0.358974358974359,0.6410256410256411,0.14285714285714285,0.8571428571428571
SF-E29-2,SF-O22,12,22,1,5,11,17,0.08333333333333333,0.9166666666666666,0.22727272727272727,0.7727272727272727
SF-E29-2,SF-N21,11,5,2,3,9,2,0.18181818181818182,0.8181818181818182,0.6,0.4
SF-E29-2,SF-N20-2,7,3,5,1,2,2,0.7142857142857143,0.2857142857142857,0.3333333333333333,0.6666666666666666
SF-E29-2,SF-M21,20,7,7,0,13,7,0.35,0.65,0.0,1.0
SF-E29-2,SF-L21,66,84,20,16,46,68,0.30303030303030304,0.696969696969697,0.19047619047619047,0.8095238095238095
SF-E29-2,SF-S29,27,13,16,5,11,8,0.5925925925925926,0.4074074074074074,0.38461538461538464,0.6153846153846154
SF-E29-2,SF-S30,7,4,4,2,3,2,0.5714285714285714,0.42857142857142855,0.5,0.5
SF-E29-2,SF-Q30,60,95,5,7,55,88,0.08333333333333333,0.9166666666666666,0.07368421052631578,0.9263157894736842
SF-E29-2,SF-P30,21,12,6,5,15,7,0.2857142857142857,0.7142857142857143,0.4166666666666667,0.5833333333333334
SF-E29-2,SF-O30-2,86,120,56,80,30,40,0.6511627906976745,0.3488372093023256,0.6666666666666666,0.3333333333333333
SF-E29-2,SF-O30,37,30,14,9,23,21,0.3783783783783784,0.6216216216216216,0.3,0.7
SF-E29-2,SF-N27,10,20,2,6,8,14,0.2,0.8,0.3,0.7
SF-E29-2,SF-N29,9,3,3,0,6,3,0.3333333333333333,0.6666666666666666,0.0,1.0
SF-E29-2,SF-N28,12,31,6,17,6,14,0.5,0.5,0.5483870967741935,0.45161290322580644
SF-E29-2,SF-L30-1,342,273,211,174,131,99,0.6169590643274854,0.3830409356725146,0.6373626373626373,0.3626373626373626
SF-E29-2,SF-L31-1,112,77,106,38,6,39,0.9464285714285714,0.05357142857142857,0.4935064935064935,0.5064935064935064
SF-E29-2,SF-K30-2,111,54,64,22,47,32,0.5765765765765766,0.42342342342342343,0.4074074074074074,0.5925925925925926
SF-E29-2,SF-L29,55,62,28,33,27,29,0.509090909090909,0.4909090909090909,0.532258064516129,0.46774193548387094
SF-E29-2,SF-J29-1,102,121,94,115,8,6,0.9215686274509803,0.0784313725490196,0.9504132231404959,0.049586776859504134
SF-E29-2,SF-I30,48,21,43,14,5,7,0.8958333333333334,0.10416666666666667,0.6666666666666666,0.3333333333333333
SF-E29-2,SF-I29-2,3,3,1,3,2,0,0.3333333333333333,0.6666666666666666,1.0,0.0
SF-E29-2,SF-I27,7,16,4,8,3,8,0.5714285714285714,0.42857142857142855,0.5,0.5
SF-E29-2,SF-I28,4,5,2,5,2,0,0.5,0.5,1.0,0.0
SF-E29-2,SF-I30-2,20,8,16,4,4,4,0.8,0.2,0.5,0.5
SF-E29-2,SF I29-1,9,16,5,4,4,12,0.5555555555555556,0.4444444444444444,0.25,0.75
SF-E29-2,SF-H28,24,33,21,19,3,14,0.875,0.125,0.5757575757575758,0.42424242424242425
SF-E29-2,SF-H29,5,4,3,3,2,1,0.6,0.4,0.75,0.25
SF-E29-2,SF-S24,4,9,3,4,1,5,0.75,0.25,0.4444444444444444,0.5555555555555556
SF-E29-2,SF-R24,6,5,4,2,2,3,0.6666666666666666,0.3333333333333333,0.4,0.6
SF-E29-2,SF-R26,5,3,0,0,5,3,0.0,1.0,0.0,1.0
SF-E29-2,SF-Q26,8,6,0,0,8,6,0.0,1.0,0.0,1.0
SF-E29-2,SF-P26,1,2,0,1,1,1,0.0,1.0,0.5,0.5
SF-E29-2,SF-O25-2,5,4,3,2,2,2,0.6,0.4,0.5,0.5
SF-E29-2,SF-N22-1B,5,2,0,0,5,2,0.0,1.0,0.0,1.0
SF-E29-2,SF-N25,1,1,1,0,0,1,1.0,0.0,0.0,1.0
SF-E29-2,SF-T22,12,6,2,1,10,5,0.16666666666666666,0.8333333333333334,0.16666666666666666,0.8333333333333334
SF-E29-2,SF-S22-2,5,3,3,1,2,2,0.6,0.4,0.3333333333333333,0.6666666666666666
SF-E29-2,SF-S22-1,4,2,0,1,4,1,0.0,1.0,0.5,0.5
SF-E29-2,SF-Q23-3,13,11,6,6,7,5,0.46153846153846156,0.5384615384615384,0.5454545454545454,0.45454545454545453
SF-E29-2,SF-Q22-1,15,13,6,5,9,8,0.4,0.6,0.38461538461538464,0.6153846153846154
SF-E29-2,SF-Q22-2,48,21,32,15,16,6,0.6666666666666666,0.3333333333333333,0.7142857142857143,0.2857142857142857
SF-E29-2,SF-P22,22,12,9,3,13,9,0.4090909090909091,0.5909090909090909,0.25,0.75
SF-E29-2,SF-W19,3,5,0,1,3,4,0.0,1.0,0.2,0.8
SF-E29-2,SF-T20,4,7,1,1,3,6,0.25,0.75,0.14285714285714285,0.8571428571428571
SF-E29-2,SF-Y29,1,1,0,0,1,1,0.0,1.0,0.0,1.0
SF-E29-2,SF-V30,10,1,4,0,6,1,0.4,0.6,0.0,1.0
SF-E29-2,SF-V31,2,1,0,1,2,0,0.0,1.0,1.0,0.0
SF-E29-2,SF-V32,1,2,1,0,0,2,1.0,0.0,0.0,1.0
SF-E29-2,SF-U30,1,2,1,1,0,1,1.0,0.0,0.5,0.5
SF-E29-2,SF-W14,2,1,0,0,2,1,0.0,1.0,0.0,1.0
SF-E29-2,SF-Y25,1,1,0,1,1,0,0.0,1.0,1.0,0.0
SF-E29-1,SF-M26-2,19,27,13,15,6,12,0.6842105263157895,0.3157894736842105,0.5555555555555556,0.4444444444444444
SF-E29-1,SF-L27,6,9,4,3,2,6,0.6666666666666666,0.3333333333333333,0.3333333333333333,0.6666666666666666
SF-E29-1,SF-K26,11,5,6,3,5,2,0.5454545454545454,0.45454545454545453,0.6,0.4
SF-E29-1,SF-J27,7,4,7,2,0,2,1.0,0.0,0.5,0.5
SF-E29-1,SF-M30,143,76,74,49,69,27,0.5174825174825175,0.4825174825174825,0.6447368421052632,0.35526315789473684
SF-E29-1,SF-L27-2,5,6,4,5,1,1,0.8,0.2,0.8333333333333334,0.16666666666666666
SF-E29-1,SF-J29-3,20,22,16,17,4,5,0.8,0.2,0.7727272727272727,0.22727272727272727
SF-E29-1,SF-J29,24,14,8,8,16,6,0.3333333333333333,0.6666666666666666,0.5714285714285714,0.42857142857142855
SF-E29-1,SF-M28,27,27,19,17,8,10,0.7037037037037037,0.2962962962962963,0.6296296296296297,0.37037037037037035
SF-E29-1,SF-L25,5,4,0,4,5,0,0.0,1.0,1.0,0.0
SF-E29-1,SF-M24,4,11,3,0,1,11,0.75,0.25,0.0,1.0
SF-E29-1,SF-L24,9,10,5,7,4,3,0.5555555555555556,0.4444444444444444,0.7,0.3
SF-E29-1,SF-N23,6,2,6,1,0,1,1.0,0.0,0.5,0.5
SF-E29-1,SF-N24-2,5,2,1,0,4,2,0.2,0.8,0.0,1.0
SF-E29-1,SF-K27-2,28,14,21,14,7,0,0.75,0.25,1.0,0.0
SF-E29-1,SF-J26-2,43,15,18,7,25,8,0.4186046511627907,0.5813953488372093,0.4666666666666667,0.5333333333333333
SF-E29-1,SF-K28-3,2,1,2,1,0,0,1.0,0.0,1.0,0.0
SF-E29-1,SF-L28,66,44,43,30,23,14,0.6515151515151515,0.3484848484848485,0.6818181818181818,0.3181818181818182
SF-E29-1,SF-K28,9,4,7,3,2,1,0.7777777777777778,0.2222222222222222,0.75,0.25
SF-E29-1,SF-K29-1,158,124,114,74,44,50,0.7215189873417721,0.27848101265822783,0.5967741935483871,0.4032258064516129
SF-E29-1,SF-J28-2,68,30,55,11,13,19,0.8088235294117647,0.19117647058823528,0.36666666666666664,0.6333333333333333
SF-E29-1,SF-K27,2,2,2,1,0,1,1.0,0.0,0.5,0.5
SF-E29-1,SF-K25,17,7,13,4,4,3,0.7647058823529411,0.23529411764705882,0.5714285714285714,0.42857142857142855
SF-E29-1,SF-J25,40,42,21,18,19,24,0.525,0.475,0.42857142857142855,0.5714285714285714
SF-E29-1,SF-H26-2,4,3,4,2,0,1,1.0,0.0,0.6666666666666666,0.3333333333333333
SF-E29-1,SF-P24,12,4,5,2,7,2,0.4166666666666667,0.5833333333333334,0.5,0.5
SF-E29-1,SF-J24,18,8,9,2,9,6,0.5,0.5,0.25,0.75
SF-E29-1,SF-O24,9,5,5,2,4,3,0.5555555555555556,0.4444444444444444,0.4,0.6
SF-E29-1,SF-J26,11,10,3,1,8,9,0.2727272727272727,0.7272727272727273,0.1,0.9
SF-E29-1,SF-I26-,5,5,4,4,1,1,0.8,0.2,0.8,0.2
SF-E29-1,SF-I25,51,43,40,19,11,24,0.7843137254901961,0.21568627450980393,0.4418604651162791,0.5581395348837209
SF-E29-1,SF-H26,61,42,51,27,10,15,0.8360655737704918,0.16393442622950818,0.6428571428571429,0.35714285714285715
SF-E29-1,SF-O23,6,3,4,1,2,2,0.6666666666666666,0.3333333333333333,0.3333333333333333,0.6666666666666666
SF-E29-1,SF-H27-1,20,10,15,6,5,4,0.75,0.25,0.6,0.4
SF-E29-1,SF-F28-2,41,50,29,27,12,23,0.7073170731707317,0.2926829268292683,0.54,0.46
SF-E29-1,SF-G27,80,98,53,57,27,41,0.6625,0.3375,0.5816326530612245,0.41836734693877553
SF-E29-1,SF-M22-2,11,15,3,6,8,9,0.2727272727272727,0.7272727272727273,0.4,0.6
SF-E29-1,SF-L22,18,14,10,3,8,11,0.5555555555555556,0.4444444444444444,0.21428571428571427,0.7857142857142857
SF-E29-1,SF-F27,38,46,28,32,10,14,0.7368421052631579,0.2631578947368421,0.6956521739130435,0.30434782608695654
SF-E29-1,SF-N22-2,13,13,7,4,6,9,0.5384615384615384,0.46153846153846156,0.3076923076923077,0.6923076923076923
SF-E29-1,SF-G28-2,12,7,4,6,8,1,0.3333333333333333,0.6666666666666666,0.8571428571428571,0.14285714285714285
SF-E29-1,SF-G28-1,8,8,6,7,2,1,0.75,0.25,0.875,0.125
SF-E29-1,SF-M22-1,7,6,3,1,4,5,0.42857142857142855,0.5714285714285714,0.16666666666666666,0.8333333333333334
SF-E29-1,SF-O25-1,3,2,1,1,2,1,0.3333333333333333,0.6666666666666666,0.5,0.5
SF-E29-1,SF-K22-2,27,23,15,5,12,18,0.5555555555555556,0.4444444444444444,0.21739130434782608,0.782608695652174
SF-E29-1,SF-K24,31,23,25,18,6,5,0.8064516129032258,0.1935483870967742,0.782608695652174,0.21739130434782608
SF-E29-1,SF-J23-2,14,4,5,2,9,2,0.35714285714285715,0.6428571428571429,0.5,0.5
SF-E29-1,SF-G23,4,7,3,0,1,7,0.75,0.25,0.0,1.0
SF-E29-1,SF-G24,163,50,67,2,96,48,0.4110429447852761,0.588957055214724,0.04,0.96
SF-E29-1,SF-G25,35,21,17,5,18,16,0.4857142857142857,0.5142857142857142,0.23809523809523808,0.7619047619047619
SF-E29-1,SF-F23,13,9,6,1,7,8,0.46153846153846156,0.5384615384615384,0.1111111111111111,0.8888888888888888
SF-E29-1,SF-E23,17,18,9,3,8,15,0.5294117647058824,0.47058823529411764,0.16666666666666666,0.8333333333333334
SF-E29-1,SF-D24,42,4,32,2,10,2,0.7619047619047619,0.23809523809523808,0.5,0.5
SF-E29-1,SF-C22,14,16,5,4,9,12,0.35714285714285715,0.6428571428571429,0.25,0.75
SF-E29-1,SF-B22,70,87,45,61,25,26,0.6428571428571429,0.35714285714285715,0.7011494252873564,0.2988505747126437
SF-E29-1,SF-J17,3,6,1,0,2,6,0.3333333333333333,0.6666666666666666,0.0,1.0
SF-E29-1,SF-I19,2,1,0,0,2,1,0.0,1.0,0.0,1.0
SF-E29-1,SF-I20,4,2,4,0,0,2,1.0,0.0,0.0,1.0
SF-E29-1,SF-H20,6,4,4,4,2,0,0.6666666666666666,0.3333333333333333,1.0,0.0
SF-E29-1,SF-G19,5,3,2,3,3,0,0.4,0.6,1.0,0.0
SF-E29-1,SF-G17,3,3,1,1,2,2,0.3333333333333333,0.6666666666666666,0.3333333333333333,0.6666666666666666
SF-E29-1,SF-G20,12,7,2,4,10,3,0.16666666666666666,0.8333333333333334,0.5714285714285714,0.42857142857142855
SF-E29-1,SF-E20,1,2,1,0,0,2,1.0,0.0,0.0,1.0
SF-E29-1,SF-H30,140,54,120,44,20,10,0.8571428571428571,0.14285714285714285,0.8148148148148148,0.18518518518518517
SF-E29-1,SF-G30-2,115,69,93,54,22,15,0.808695652173913,0.19130434782608696,0.782608695652174,0.21739130434782608
SF-E29-1,SF-F30-1,17,21,13,18,4,3,0.7647058823529411,0.23529411764705882,0.8571428571428571,0.14285714285714285
SF-E29-1,SF-E29-2,46,39,40,29,6,10,0.8695652173913043,0.13043478260869565,0.7435897435897436,0.2564102564102564
SF-E29-1,SF-D29,28,61,19,42,9,19,0.6785714285714286,0.32142857142857145,0.6885245901639344,0.3114754098360656
SF-E29-1,SF-D28,11,30,9,25,2,5,0.8181818181818182,0.18181818181818182,0.8333333333333334,0.16666666666666666
SF-E29-1,SF-A27,78,224,55,189,23,35,0.7051282051282052,0.2948717948717949,0.84375,0.15625
SF-E29-1,SF-G29-2,93,30,75,18,18,12,0.8064516129032258,0.1935483870967742,0.6,0.4
SF-E29-1,SF-G29-1,17,10,15,8,2,2,0.8823529411764706,0.11764705882352941,0.8,0.2
SF-E29-1,SF-G30-1,34,15,26,12,8,3,0.7647058823529411,0.23529411764705882,0.8,0.2
SF-E29-1,SF-G29-3,22,14,19,9,3,5,0.8636363636363636,0.13636363636363635,0.6428571428571429,0.35714285714285715
SF-E29-1,SF-F30-2,11,10,10,7,1,3,0.9090909090909091,0.09090909090909091,0.7,0.3
SF-E29-1,SF-F29,14,8,13,6,1,2,0.9285714285714286,0.07142857142857142,0.75,0.25
SF-E29-1,SF-E29-3,16,9,13,7,3,2,0.8125,0.1875,0.7777777777777778,0.2222222222222222
SF-E29-1,SF-F28-1,52,43,39,31,13,12,0.75,0.25,0.7209302325581395,0.27906976744186046
SF-E29-1,SF-E28-2,6,4,5,3,1,1,0.8333333333333334,0.16666666666666666,0.75,0.25
SF-E29-1,SF-E28,10,3,8,1,2,2,0.8,0.2,0.3333333333333333,0.6666666666666666
SF-E29-1,SF-J10,4,4,1,4,3,0,0.25,0.75,1.0,0.0
SF-E29-1,SF-H12,3,1,0,0,3,1,0.0,1.0,0.0,1.0
SF-E29-1,SF-G10-2,3,1,0,0,3,1,0.0,1.0,0.0,1.0
SF-E29-1,SF-H14,1,1,0,0,1,1,0.0,1.0,0.0,1.0
SF-E29-1,SF-G12,2,3,0,0,2,3,0.0,1.0,0.0,1.0
SF-E29-1,SF-F15,1,2,0,0,1,2,0.0,1.0,0.0,1.0
SF-E29-1,SF-C21,7,2,1,0,6,2,0.14285714285714285,0.8571428571428571,0.0,1.0
SF-E29-1,SF-C20,9,17,1,6,8,11,0.1111111111111111,0.8888888888888888,0.35294117647058826,0.6470588235294118
SF-E29-1,SF-B21,12,8,3,7,9,1,0.25,0.75,0.875,0.125
SF-E29-1,SF-B19,15,41,8,27,7,14,0.5333333333333333,0.4666666666666667,0.6585365853658537,0.34146341463414637
SF-E29-1,SF-A20,57,112,18,83,39,29,0.3157894736842105,0.6842105263157895,0.7410714285714286,0.25892857142857145
SF-E29-1,SF-A19,3,18,3,17,0,1,1.0,0.0,0.9444444444444444,0.05555555555555555
SF-E29-1,SF-C26,10,31,6,14,4,17,0.6,0.4,0.45161290322580644,0.5483870967741935
SF-E29-1,SF-C25,59,60,25,22,34,38,0.423728813559322,0.576271186440678,0.36666666666666664,0.6333333333333333
SF-E29-1,SF-B25,47,148,29,108,18,40,0.6170212765957447,0.3829787234042553,0.7297297297297297,0.2702702702702703
SF-E29-1,SF-E27,5,7,3,6,2,1,0.6,0.4,0.8571428571428571,0.14285714285714285
SF-E29-1,SF-B28-2,33,32,23,23,10,9,0.696969696969697,0.30303030303030304,0.71875,0.28125
SF-E29-1,SF-D27,16,50,16,41,0,9,1.0,0.0,0.82,0.18
SF-E29-1,SF-C28-2,12,5,6,4,6,1,0.5,0.5,0.8,0.2
SF-E29-1,SF-C28-1,23,34,21,27,2,7,0.9130434782608695,0.08695652173913043,0.7941176470588235,0.20588235294117646
SF-E29-1,SF-B28,69,162,56,137,13,25,0.8115942028985508,0.18840579710144928,0.845679012345679,0.15432098765432098
SF-E29-1,SF-J5,1,1,0,0,1,1,0.0,1.0,0.0,1.0
SF-E29-1,SF-G7,3,3,0,0,3,3,0.0,1.0,0.0,1.0
SF-E29-1,SF-F9,2,3,0,3,2,0,0.0,1.0,1.0,0.0
SF-E29-1,SF-H25,13,9,5,6,8,3,0.38461538461538464,0.6153846153846154,0.6666666666666666,0.3333333333333333
SF-E29-1,SF-G26,12,20,11,12,1,8,0.9166666666666666,0.08333333333333333,0.6,0.4
SF-E29-1,SF-K21,30,19,6,1,24,18,0.2,0.8,0.05263157894736842,0.9473684210526315
SF-E29-1,SF-K22-1,88,71,76,51,12,20,0.8636363636363636,0.13636363636363635,0.7183098591549296,0.28169014084507044
SF-E29-1,SF-J23-1,126,81,79,35,47,46,0.626984126984127,0.373015873015873,0.43209876543209874,0.5679012345679012
SF-E29-1,SF-J22-1,32,31,19,22,13,9,0.59375,0.40625,0.7096774193548387,0.2903225806451613
SF-E29-1,SF-J22-2,10,16,7,7,3,9,0.7,0.3,0.4375,0.5625
SF-E29-1,SF-J21,12,23,7,16,5,7,0.5833333333333334,0.4166666666666667,0.6956521739130435,0.30434782608695654
SF-E29-1,SF-I21,5,5,1,3,4,2,0.2,0.8,0.6,0.4
SF-E29-1,SF-I22,9,5,9,3,0,2,1.0,0.0,0.6,0.4
SF-E29-1,SF-I23-2,18,16,15,13,3,3,0.8333333333333334,0.16666666666666666,0.8125,0.1875
SF-E29-1,SF-I24,5,26,3,16,2,10,0.6,0.4,0.6153846153846154,0.38461538461538464
SF-E29-1,SF-I23-1,12,8,8,7,4,1,0.6666666666666666,0.3333333333333333,0.875,0.125
SF-E29-1,SF-F26,32,28,17,15,15,13,0.53125,0.46875,0.5357142857142857,0.4642857142857143
SF-E29-1,SF-M15,6,2,2,0,4,2,0.3333333333333333,0.6666666666666666,0.0,1.0
SF-E29-1,SF-L19,7,1,1,1,6,0,0.14285714285714285,0.8571428571428571,1.0,0.0
SF-E29-1,SF-L20,9,11,8,2,1,9,0.8888888888888888,0.1111111111111111,0.18181818181818182,0.8181818181818182
SF-E29-1,SF-N20-1,5,11,0,6,5,5,0.0,1.0,0.5454545454545454,0.45454545454545453
SF-E29-1,SF-M20,29,23,9,5,20,18,0.3103448275862069,0.6896551724137931,0.21739130434782608,0.782608695652174
SF-E29-1,SF-K17-2,11,2,3,0,8,2,0.2727272727272727,0.7272727272727273,0.0,1.0
SF-E29-1,SF-K20,6,6,4,2,2,4,0.6666666666666666,0.3333333333333333,0.3333333333333333,0.6666666666666666
SF-E29-1,SF-K15-,10,6,3,2,7,4,0.3,0.7,0.3333333333333333,0.6666666666666666
SF-E29-1,SF-K19,15,3,5,1,10,2,0.3333333333333333,0.6666666666666666,0.3333333333333333,0.6666666666666666
SF-E29-1,SF-K18,5,4,3,1,2,3,0.6,0.4,0.25,0.75
SF-E29-1,SF-K17,7,6,6,2,1,4,0.8571428571428571,0.14285714285714285,0.3333333333333333,0.6666666666666666
SF-E29-1,SF-J18,7,5,0,2,7,3,0.0,1.0,0.4,0.6
SF-E29-1,SF-J20,7,4,4,2,3,2,0.5714285714285714,0.42857142857142855,0.5,0.5
SF-E29-1,SF-J19,6,13,1,4,5,9,0.16666666666666666,0.8333333333333334,0.3076923076923077,0.6923076923076923
SF-E29-1,SF-M12,4,1,2,0,2,1,0.5,0.5,0.0,1.0
SF-E29-1,SF-R19,4,2,2,0,2,2,0.5,0.5,0.0,1.0
SF-E29-1,SF-Q21-1,5,6,5,2,0,4,1.0,0.0,0.3333333333333333,0.6666666666666666
SF-E29-1,SF-P21,4,2,0,2,4,0,0.0,1.0,1.0,0.0
SF-E29-1,SF-O18,2,7,2,3,0,4,1.0,0.0,0.42857142857142855,0.5714285714285714
SF-E29-1,SF-O19,10,13,2,5,8,8,0.2,0.8,0.38461538461538464,0.6153846153846154
SF-E29-1,SF-O21,15,10,3,1,12,9,0.2,0.8,0.1,0.9
SF-E29-1,SF-O22,3,15,2,10,1,5,0.6666666666666666,0.3333333333333333,0.6666666666666666,0.3333333333333333
SF-E29-1,SF-N21,7,5,6,1,1,4,0.8571428571428571,0.14285714285714285,0.2,0.8
SF-E29-1,SF-N20-2,5,4,2,0,3,4,0.4,0.6,0.0,1.0
SF-E29-1,SF-M21,6,12,1,5,5,7,0.16666666666666666,0.8333333333333334,0.4166666666666667,0.5833333333333334
SF-E29-1,SF-L21,17,25,9,4,8,21,0.5294117647058824,0.47058823529411764,0.16,0.84
SF-E29-1,SF-S29,10,7,3,2,7,5,0.3,0.7,0.2857142857142857,0.7142857142857143
SF-E29-1,SF-S30,12,3,3,1,9,2,0.25,0.75,0.3333333333333333,0.6666666666666666
SF-E29-1,SF-Q30,27,58,11,14,16,44,0.4074074074074074,0.5925925925925926,0.2413793103448276,0.7586206896551724
SF-E29-1,SF-P30,53,27,36,20,17,7,0.6792452830188679,0.32075471698113206,0.7407407407407407,0.25925925925925924
SF-E29-1,SF-O30-2,79,53,55,39,24,14,0.6962025316455697,0.3037974683544304,0.7358490566037735,0.2641509433962264
SF-E29-1,SF-O30,100,87,56,31,44,56,0.56,0.44,0.3563218390804598,0.6436781609195402
SF-E29-1,SF-N27,26,27,14,7,12,20,0.5384615384615384,0.46153846153846156,0.25925925925925924,0.7407407407407407
SF-E29-1,SF-N29,21,11,12,5,9,6,0.5714285714285714,0.42857142857142855,0.45454545454545453,0.5454545454545454
SF-E29-1,SF-N28,38,32,24,13,14,19,0.631578947368421,0.3684210526315789,0.40625,0.59375
SF-E29-1,SF-L30-1,127,104,96,63,31,41,0.7559055118110236,0.2440944881889764,0.6057692307692307,0.3942307692307692
SF-E29-1,SF-L31-1,83,52,66,40,17,12,0.7951807228915663,0.20481927710843373,0.7692307692307693,0.23076923076923078
SF-E29-1,SF-K30-2,41,39,24,24,17,15,0.5853658536585366,0.4146341463414634,0.6153846153846154,0.38461538461538464
SF-E29-1,SF-L29,87,57,49,29,38,28,0.5632183908045977,0.4367816091954023,0.5087719298245614,0.49122807017543857
SF-E29-1,SF-J29-1,53,101,43,59,10,42,0.8113207547169812,0.18867924528301888,0.5841584158415841,0.4158415841584158
SF-E29-1,SF-I30,45,28,37,20,8,8,0.8222222222222222,0.17777777777777778,0.7142857142857143,0.2857142857142857
SF-E29-1,SF-I29-2,17,5,7,4,10,1,0.4117647058823529,0.5882352941176471,0.8,0.2
SF-E29-1,SF-I27,24,16,12,7,12,9,0.5,0.5,0.4375,0.5625
SF-E29-1,SF-I28,8,9,5,5,3,4,0.625,0.375,0.5555555555555556,0.4444444444444444
SF-E29-1,SF-I30-2,27,32,25,27,2,5,0.9259259259259259,0.07407407407407407,0.84375,0.15625
SF-E29-1,SF I29-1,55,38,23,6,32,32,0.41818181818181815,0.5818181818181818,0.15789473684210525,0.8421052631578947
SF-E29-1,SF-H28,151,89,61,24,90,65,0.40397350993377484,0.5960264900662252,0.2696629213483146,0.7303370786516854
SF-E29-1,SF-H29,39,1,17,0,22,1,0.4358974358974359,0.5641025641025641,0.0,1.0
SF-E29-1,SF-S24,5,6,2,3,3,3,0.4,0.6,0.5,0.5
SF-E29-1,SF-R24,22,6,9,1,13,5,0.4090909090909091,0.5909090909090909,0.16666666666666666,0.8333333333333334
SF-E29-1,SF-R26,4,1,2,1,2,0,0.5,0.5,1.0,0.0
SF-E29-1,SF-Q26,12,6,3,1,9,5,0.25,0.75,0.16666666666666666,0.8333333333333334
SF-E29-1,SF-P26,18,3,8,1,10,2,0.4444444444444444,0.5555555555555556,0.3333333333333333,0.6666666666666666
SF-E29-1,SF-O25-2,4,6,0,0,4,6,0.0,1.0,0.0,1.0
SF-E29-1,SF-N22-1B,2,3,0,1,2,2,0.0,1.0,0.3333333333333333,0.6666666666666666
SF-E29-1,SF-N26,3,3,2,0,1,3,0.6666666666666666,0.3333333333333333,0.0,1.0
SF-E29-1,SF-T22,5,3,5,0,0,3,1.0,0.0,0.0,1.0
SF-E29-1,SF-S22-2,3,2,1,1,2,1,0.3333333333333333,0.6666666666666666,0.5,0.5
SF-E29-1,SF-S22-1,8,6,5,5,3,1,0.625,0.375,0.8333333333333334,0.16666666666666666
SF-E29-1,SF-Q23-3,4,5,3,2,1,3,0.75,0.25,0.4,0.6
SF-E29-1,SF-Q22-1,2,4,1,1,1,3,0.5,0.5,0.25,0.75
SF-E29-1,SF-Q22-2,5,8,2,2,3,6,0.4,0.6,0.25,0.75
SF-E29-1,SF-P22,8,9,7,3,1,6,0.875,0.125,0.3333333333333333,0.6666666666666666
SF-E29-1,SF-W19,2,2,2,0,0,2,1.0,0.0,0.0,1.0
SF-E29-1,SF-U21,1,1,0,0,1,1,0.0,1.0,0.0,1.0
SF-E29-1,SF-T20,2,2,1,1,1,1,0.5,0.5,0.5,0.5
SF-E29-1,SF-S21,3,1,0,0,3,1,0.0,1.0,0.0,1.0
SF-E29-1,SF-V29,3,2,2,0,1,2,0.6666666666666666,0.3333333333333333,0.0,1.0
SF-E29-1,SF-V30,8,7,3,3,5,4,0.375,0.625,0.42857142857142855,0.5714285714285714
SF-E29-1,SF-V31,2,1,0,0,2,1,0.0,1.0,0.0,1.0
SF-E29-1,SF-V32,2,1,1,1,1,0,0.5,0.5,1.0,0.0
SF-E29-1,SF-W14,2,2,0,0,2,2,0.0,1.0,0.0,1.0
SF-D29,SF-M25,1,1,0,0,1,1,0.0,1.0,0.0,1.0
SF-D29,SF-M26-2,16,22,2,6,14,16,0.125,0.875,0.2727272727272727,0.7272727272727273
SF-D29,SF-L27,12,2,9,2,3,0,0.75,0.25,1.0,0.0
SF-D29,SF-K26,8,8,3,3,5,5,0.375,0.625,0.375,0.625
SF-D29,SF-M30,68,45,36,39,32,6,0.5294117647058824,0.47058823529411764,0.8666666666666667,0.13333333333333333
SF-D29,SF-L27-2,2,2,2,1,0,1,1.0,0.0,0.5,0.5
SF-D29,SF-J29-3,44,55,37,54,7,1,0.8409090909090909,0.1590909090909091,0.9818181818181818,0.01818181818181818
SF-D29,SF-J29,18,11,6,7,12,4,0.3333333333333333,0.6666666666666666,0.6363636363636364,0.36363636363636365
SF-D29,SF-M28,20,13,12,5,8,8,0.6,0.4,0.38461538461538464,0.6153846153846154
SF-D29,SF-M27,1,5,0,3,1,2,0.0,1.0,0.6,0.4
SF-D29,SF-L25,2,1,0,0,2,1,0.0,1.0,0.0,1.0
SF-D29,SF-M24,48,41,4,3,44,38,0.08333333333333333,0.9166666666666666,0.07317073170731707,0.926829268292683
SF-D29,SF-L24,9,2,0,1,9,1,0.0,1.0,0.5,0.5
SF-D29,SF-N23,3,3,1,0,2,3,0.3333333333333333,0.6666666666666666,0.0,1.0
SF-D29,SF-K27-2,26,10,22,9,4,1,0.8461538461538461,0.15384615384615385,0.9,0.1
SF-D29,SF-J26-2,25,43,14,42,11,1,0.56,0.44,0.9767441860465116,0.023255813953488372
SF-D29,SF-K28-3,1,2,1,2,0,0,1.0,0.0,1.0,0.0
SF-D29,SF-L28,41,22,25,6,16,16,0.6097560975609756,0.3902439024390244,0.2727272727272727,0.7272727272727273
SF-D29,SF-K28,4,2,4,1,0,1,1.0,0.0,0.5,0.5
SF-D29,SF-K29-1,150,105,74,45,76,60,0.49333333333333335,0.5066666666666667,0.42857142857142855,0.5714285714285714
SF-D29,SF-J28-2,51,41,17,4,34,37,0.3333333333333333,0.6666666666666666,0.0975609756097561,0.9024390243902439
SF-D29,SF-K27,3,2,2,2,1,0,0.6666666666666666,0.3333333333333333,1.0,0.0
SF-D29,SF-K25,18,2,13,2,5,0,0.7222222222222222,0.2777777777777778,1.0,0.0
SF-D29,SF-J25,14,20,11,12,3,8,0.7857142857142857,0.21428571428571427,0.6,0.4
SF-D29,SF-H26-2,10,3,4,1,6,2,0.4,0.6,0.3333333333333333,0.6666666666666666
SF-D29,SF-P24,9,5,6,1,3,4,0.6666666666666666,0.3333333333333333,0.2,0.8
SF-D29,SF-J24,7,4,5,0,2,4,0.7142857142857143,0.2857142857142857,0.0,1.0
SF-D29,SF-O24,6,5,3,3,3,2,0.5,0.5,0.6,0.4
SF-D29,SF-J26,5,9,3,3,2,6,0.6,0.4,0.3333333333333333,0.6666666666666666
SF-D29,SF-I26-,4,4,3,2,1,2,0.75,0.25,0.5,0.5
SF-D29,SF-I25,14,24,6,20,8,4,0.42857142857142855,0.5714285714285714,0.8333333333333334,0.16666666666666666
SF-D29,SF-H26,29,40,23,29,6,11,0.7931034482758621,0.20689655172413793,0.725,0.275
SF-D29,SF-O23,1,1,1,0,0,1,1.0,0.0,0.0,1.0
SF-D29,SF-H27-1,8,4,6,3,2,1,0.75,0.25,0.75,0.25
SF-D29,SF-F28-2,28,44,16,37,12,7,0.5714285714285714,0.42857142857142855,0.8409090909090909,0.1590909090909091
SF-D29,SF-G27,49,40,33,28,16,12,0.673469387755102,0.32653061224489793,0.7,0.3
SF-D29,SF-M22-2,3,7,3,4,0,3,1.0,0.0,0.5714285714285714,0.42857142857142855
SF-D29,SF-L22,6,5,4,1,2,4,0.6666666666666666,0.3333333333333333,0.2,0.8
SF-D29,SF-F27,23,18,14,12,9,6,0.6086956521739131,0.391304347826087,0.6666666666666666,0.3333333333333333
SF-D29,SF-N22-2,13,6,10,1,3,5,0.7692307692307693,0.23076923076923078,0.16666666666666666,0.8333333333333334
SF-D29,SF-G28-2,11,1,8,0,3,1,0.7272727272727273,0.2727272727272727,0.0,1.0
SF-D29,SF-G28-1,1,1,0,1,1,0,0.0,1.0,1.0,0.0
SF-D29,SF-O25-1,5,3,1,0,4,3,0.2,0.8,0.0,1.0
SF-D29,SF-K24,2,4,1,1,1,3,0.5,0.5,0.25,0.75
SF-D29,SF-G23,11,6,11,0,0,6,1.0,0.0,0.0,1.0
SF-D29,SF-G24,17,15,5,1,12,14,0.29411764705882354,0.7058823529411765,0.06666666666666667,0.9333333333333333
SF-D29,SF-G25,32,19,26,8,6,11,0.8125,0.1875,0.42105263157894735,0.5789473684210527
SF-D29,SF-F23,10,16,2,2,8,14,0.2,0.8,0.125,0.875
SF-D29,SF-E23,15,22,6,1,9,21,0.4,0.6,0.045454545454545456,0.9545454545454546
SF-D29,SF-D24,15,7,7,0,8,7,0.4666666666666667,0.5333333333333333,0.0,1.0
SF-D29,SF-C22,14,13,7,0,7,13,0.5,0.5,0.0,1.0
SF-D29,SF-B22,42,151,19,125,23,26,0.4523809523809524,0.5476190476190477,0.8278145695364238,0.17218543046357615
SF-D29,SF-J17,2,1,0,0,2,1,0.0,1.0,0.0,1.0
SF-D29,SF-I20,1,2,1,0,0,2,1.0,0.0,0.0,1.0
SF-D29,SF-G20,2,4,0,4,2,0,0.0,1.0,1.0,0.0
SF-D29,SF-E18,3,3,0,0,3,3,0.0,1.0,0.0,1.0
SF-D29,SF-E20,3,1,0,0,3,1,0.0,1.0,0.0,1.0
SF-D29,SF-H30,199,91,157,71,42,20,0.7889447236180904,0.21105527638190955,0.7802197802197802,0.21978021978021978
SF-D29,SF-G30-2,114,89,84,68,30,21,0.7368421052631579,0.2631578947368421,0.7640449438202247,0.23595505617977527
SF-D29,SF-F30-1,39,21,32,20,7,1,0.8205128205128205,0.1794871794871795,0.9523809523809523,0.047619047619047616
SF-D29,SF-E29-2,39,30,24,19,15,11,0.6153846153846154,0.38461538461538464,0.6333333333333333,0.36666666666666664
SF-D29,SF-E29-1,61,28,42,19,19,9,0.6885245901639344,0.3114754098360656,0.6785714285714286,0.32142857142857145
SF-D29,SF-D28,42,42,28,29,14,13,0.6666666666666666,0.3333333333333333,0.6904761904761905,0.30952380952380953
SF-D29,SF-A27,108,199,87,156,21,43,0.8055555555555556,0.19444444444444445,0.7839195979899497,0.21608040201005024
SF-D29,SF-G29-2,67,45,46,27,21,18,0.6865671641791045,0.31343283582089554,0.6,0.4
SF-D29,SF-G29-1,4,5,3,4,1,1,0.75,0.25,0.8,0.2
SF-D29,SF-G30-1,52,27,44,21,8,6,0.8461538461538461,0.15384615384615385,0.7777777777777778,0.2222222222222222
SF-D29,SF-G29-3,34,17,31,8,3,9,0.9117647058823529,0.08823529411764706,0.47058823529411764,0.5294117647058824
SF-D29,SF-F30-2,46,18,36,15,10,3,0.782608695652174,0.21739130434782608,0.8333333333333334,0.16666666666666666
SF-D29,SF-F29,14,1,10,1,4,0,0.7142857142857143,0.2857142857142857,1.0,0.0
SF-D29,SF-E29-3,21,8,14,7,7,1,0.6666666666666666,0.3333333333333333,0.875,0.125
SF-D29,SF-F28-1,9,16,4,13,5,3,0.4444444444444444,0.5555555555555556,0.8125,0.1875
SF-D29,SF-E28-2,1,2,0,0,1,2,0.0,1.0,0.0,1.0
SF-D29,SF-E28,11,8,6,5,5,3,0.5454545454545454,0.45454545454545453,0.625,0.375
SF-D29,SF-J14,2,2,0,0,2,2,0.0,1.0,0.0,1.0
SF-D29,SF-G9,1,2,1,2,0,0,1.0,0.0,1.0,0.0
SF-D29,SF-G11,7,4,0,0,7,4,0.0,1.0,0.0,1.0
SF-D29,SF-G10-1,7,6,0,2,7,4,0.0,1.0,0.3333333333333333,0.6666666666666666
SF-D29,SF-F15,5,1,0,0,5,1,0.0,1.0,0.0,1.0
SF-D29,SF-C21,6,5,2,1,4,4,0.3333333333333333,0.6666666666666666,0.2,0.8
SF-D29,SF-C20,11,17,3,5,8,12,0.2727272727272727,0.7272727272727273,0.29411764705882354,0.7058823529411765
SF-D29,SF-B21,8,11,4,6,4,5,0.5,0.5,0.5454545454545454,0.45454545454545453
SF-D29,SF-B19,40,56,15,30,25,26,0.375,0.625,0.5357142857142857,0.4642857142857143
SF-D29,SF-A20,56,116,30,72,26,44,0.5357142857142857,0.4642857142857143,0.6206896551724138,0.3793103448275862
SF-D29,SF-A19,14,32,8,19,6,13,0.5714285714285714,0.42857142857142855,0.59375,0.40625
SF-D29,SF-C26,36,32,21,10,15,22,0.5833333333333334,0.4166666666666667,0.3125,0.6875
SF-D29,SF-C25,27,62,15,29,12,33,0.5555555555555556,0.4444444444444444,0.46774193548387094,0.532258064516129
SF-D29,SF-B25,47,198,35,170,12,28,0.7446808510638298,0.2553191489361702,0.8585858585858586,0.1414141414141414
SF-D29,SF-E27,4,3,2,3,2,0,0.5,0.5,1.0,0.0
SF-D29,SF-B28-2,35,43,27,36,8,7,0.7714285714285715,0.22857142857142856,0.8372093023255814,0.16279069767441862
SF-D29,SF-D27,36,25,28,19,8,6,0.7777777777777778,0.2222222222222222,0.76,0.24
SF-D29,SF-C28-2,18,15,14,13,4,2,0.7777777777777778,0.2222222222222222,0.8666666666666667,0.13333333333333333
SF-D29,SF-C28-1,59,53,48,45,11,8,0.8135593220338984,0.1864406779661017,0.8490566037735849,0.1509433962264151
SF-D29,SF-B28,255,348,224,267,31,81,0.8784313725490196,0.12156862745098039,0.7672413793103449,0.23275862068965517
SF-D29,SF-J1,1,4,0,2,1,2,0.0,1.0,0.5,0.5
SF-D29,SF-H0,1,2,0,0,1,2,0.0,1.0,0.0,1.0
SF-D29,SF-H25,4,2,2,1,2,1,0.5,0.5,0.5,0.5
SF-D29,SF-G26,10,6,8,4,2,2,0.8,0.2,0.6666666666666666,0.3333333333333333
SF-D29,SF-K21,2,4,2,0,0,4,1.0,0.0,0.0,1.0
SF-D29,SF-K22-1,7,6,5,2,2,4,0.7142857142857143,0.2857142857142857,0.3333333333333333,0.6666666666666666
SF-D29,SF-J23-1,25,25,15,12,10,13,0.6,0.4,0.48,0.52
SF-D29,SF-J22-2,3,3,0,2,3,1,0.0,1.0,0.6666666666666666,0.3333333333333333
SF-D29,SF-J21,14,13,0,1,14,12,0.0,1.0,0.07692307692307693,0.9230769230769231
SF-D29,SF-I21,1,2,1,1,0,1,1.0,0.0,0.5,0.5
SF-D29,SF-I23-2,6,5,5,5,1,0,0.8333333333333334,0.16666666666666666,1.0,0.0
SF-D29,SF-I24,6,1,4,0,2,1,0.6666666666666666,0.3333333333333333,0.0,1.0
SF-D29,SF-I23-1,3,2,3,1,0,1,1.0,0.0,0.5,0.5
SF-D29,SF-F26,25,17,8,5,17,12,0.32,0.68,0.29411764705882354,0.7058823529411765
SF-D29,SF-M15,4,2,3,0,1,2,0.75,0.25,0.0,1.0
SF-D29,SF-L19,1,4,0,0,1,4,0.0,1.0,0.0,1.0
SF-D29,SF-L20,10,2,0,0,10,2,0.0,1.0,0.0,1.0
SF-D29,SF-M20,4,6,1,3,3,3,0.25,0.75,0.5,0.5
SF-D29,SF-K20,5,3,2,0,3,3,0.4,0.6,0.0,1.0
SF-D29,SF-K18,1,5,0,3,1,2,0.0,1.0,0.6,0.4
SF-D29,SF-K17,1,7,0,1,1,6,0.0,1.0,0.14285714285714285,0.8571428571428571
SF-D29,SF-J18,2,2,1,1,1,1,0.5,0.5,0.5,0.5
SF-D29,SF-J20,8,3,5,1,3,2,0.625,0.375,0.3333333333333333,0.6666666666666666
SF-D29,SF-J19,7,2,4,2,3,0,0.5714285714285714,0.42857142857142855,1.0,0.0
SF-D29,SF-M11,1,2,1,0,0,2,1.0,0.0,0.0,1.0
SF-D29,SF-P21,3,1,2,0,1,1,0.6666666666666666,0.3333333333333333,0.0,1.0
SF-D29,SF-O18,5,4,2,0,3,4,0.4,0.6,0.0,1.0
SF-D29,SF-O19,1,2,0,2,1,0,0.0,1.0,1.0,0.0
SF-D29,SF-O21,6,1,0,0,6,1,0.0,1.0,0.0,1.0
SF-D29,SF-O22,11,15,1,3,10,12,0.09090909090909091,0.9090909090909091,0.2,0.8
SF-D29,SF-N21,6,1,0,0,6,1,0.0,1.0,0.0,1.0
SF-D29,SF-M21,2,2,0,0,2,2,0.0,1.0,0.0,1.0
SF-D29,SF-L21,2,12,0,2,2,10,0.0,1.0,0.16666666666666666,0.8333333333333334
SF-D29,SF-S29,1,2,1,2,0,0,1.0,0.0,1.0,0.0
SF-D29,SF-S30,5,1,2,1,3,0,0.4,0.6,1.0,0.0
SF-D29,SF-Q30,37,41,22,16,15,25,0.5945945945945946,0.40540540540540543,0.3902439024390244,0.6097560975609756
SF-D29,SF-P30,37,25,29,17,8,8,0.7837837837837838,0.21621621621621623,0.68,0.32
SF-D29,SF-O30-2,48,67,37,46,11,21,0.7708333333333334,0.22916666666666666,0.6865671641791045,0.31343283582089554
SF-D29,SF-O30,93,63,48,29,45,34,0.5161290322580645,0.4838709677419355,0.4603174603174603,0.5396825396825397
SF-D29,SF-N27,113,32,48,10,65,22,0.4247787610619469,0.5752212389380531,0.3125,0.6875
SF-D29,SF-N29,32,14,24,5,8,9,0.75,0.25,0.35714285714285715,0.6428571428571429
SF-D29,SF-N28,38,37,15,4,23,33,0.39473684210526316,0.6052631578947368,0.10810810810810811,0.8918918918918919
SF-D29,SF-L30-1,42,36,24,20,18,16,0.5714285714285714,0.42857142857142855,0.5555555555555556,0.4444444444444444
SF-D29,SF-L31-1,73,54,56,43,17,11,0.7671232876712328,0.2328767123287671,0.7962962962962963,0.2037037037037037
SF-D29,SF-K30-2,32,24,29,15,3,9,0.90625,0.09375,0.625,0.375
SF-D29,SF-L29,59,47,41,28,18,19,0.6949152542372882,0.3050847457627119,0.5957446808510638,0.40425531914893614
SF-D29,SF-J29-1,36,22,24,17,12,5,0.6666666666666666,0.3333333333333333,0.7727272727272727,0.22727272727272727
SF-D29,SF-I30,27,22,13,10,14,12,0.48148148148148145,0.5185185185185185,0.45454545454545453,0.5454545454545454
SF-D29,SF-I29-2,13,10,7,7,6,3,0.5384615384615384,0.46153846153846156,0.7,0.3
SF-D29,SF-I27,25,4,8,1,17,3,0.32,0.68,0.25,0.75
SF-D29,SF-I28,7,11,6,6,1,5,0.8571428571428571,0.14285714285714285,0.5454545454545454,0.45454545454545453
SF-D29,SF-I30-2,20,17,8,12,12,5,0.4,0.6,0.7058823529411765,0.29411764705882354
SF-D29,SF I29-1,7,1,3,0,4,1,0.42857142857142855,0.5714285714285714,0.0,1.0
SF-D29,SF-H28,46,20,39,17,7,3,0.8478260869565217,0.15217391304347827,0.85,0.15
SF-D29,SF-H29,8,4,4,2,4,2,0.5,0.5,0.5,0.5
SF-D29,SF-S24,5,4,1,0,4,4,0.2,0.8,0.0,1.0
SF-D29,SF-R24,3,3,0,1,3,2,0.0,1.0,0.3333333333333333,0.6666666666666666
SF-D29,SF-Q26,5,4,1,2,4,2,0.2,0.8,0.5,0.5
SF-D29,SF-P26,3,6,1,3,2,3,0.3333333333333333,0.6666666666666666,0.5,0.5
SF-D29,SF-O25-2,2,1,0,0,2,1,0.0,1.0,0.0,1.0
SF-D29,SF-N22-1B,4,1,4,1,0,0,1.0,0.0,1.0,0.0
SF-D29,SF-N26,4,1,2,0,2,1,0.5,0.5,0.0,1.0
SF-D29,SF-T22,2,3,0,0,2,3,0.0,1.0,0.0,1.0
SF-D29,SF-Q23-3,3,2,2,0,1,2,0.6666666666666666,0.3333333333333333,0.0,1.0
SF-D29,SF-Q22-1,5,4,1,2,4,2,0.2,0.8,0.5,0.5
SF-D29,SF-Q22-2,2,5,2,0,0,5,1.0,0.0,0.0,1.0
SF-D29,SF-P22,5,4,0,0,5,4,0.0,1.0,0.0,1.0
SF-D29,SF-U21,1,1,1,1,0,0,1.0,0.0,1.0,0.0
SF-D29,SF-X29,4,1,0,0,4,1,0.0,1.0,0.0,1.0
SF-D29,SF-V30,1,1,0,0,1,1,0.0,1.0,0.0,1.0
SF-D29,SF-V32,1,1,1,1,0,0,1.0,0.0,1.0,0.0
SF-D28,SF-M25,4,1,2,0,2,1,0.5,0.5,0.0,1.0
SF-D28,SF-M26-2,2,4,0,0,2,4,0.0,1.0,0.0,1.0
SF-D28,SF-L27,2,1,0,0,2,1,0.0,1.0,0.0,1.0
SF-D28,SF-K26,3,1,3,1,0,0,1.0,0.0,1.0,0.0
SF-D28,SF-J27,2,1,1,1,1,0,0.5,0.5,1.0,0.0
SF-D28,SF-M30,16,10,11,6,5,4,0.6875,0.3125,0.6,0.4
SF-D28,SF-J29-3,25,14,16,12,9,2,0.64,0.36,0.8571428571428571,0.14285714285714285
SF-D28,SF-J29,64,44,42,11,22,33,0.65625,0.34375,0.25,0.75
SF-D28,SF-M28,3,4,1,0,2,4,0.3333333333333333,0.6666666666666666,0.0,1.0
SF-D28,SF-L25,23,9,22,4,1,5,0.9565217391304348,0.043478260869565216,0.4444444444444444,0.5555555555555556
SF-D28,SF-M24,1,2,0,2,1,0,0.0,1.0,1.0,0.0
SF-D28,SF-L24,2,4,2,2,0,2,1.0,0.0,0.5,0.5
SF-D28,SF-N23,3,4,1,0,2,4,0.3333333333333333,0.6666666666666666,0.0,1.0
SF-D28,SF-K27-2,5,3,1,2,4,1,0.2,0.8,0.6666666666666666,0.3333333333333333
SF-D28,SF-J26-2,8,5,6,4,2,1,0.75,0.25,0.8,0.2
SF-D28,SF-L28,7,16,4,6,3,10,0.5714285714285714,0.42857142857142855,0.375,0.625
SF-D28,SF-K28,6,2,3,1,3,1,0.5,0.5,0.5,0.5
SF-D28,SF-K29-1,40,33,25,20,15,13,0.625,0.375,0.6060606060606061,0.3939393939393939
SF-D28,SF-J28-2,32,35,12,11,20,24,0.375,0.625,0.3142857142857143,0.6857142857142857
SF-D28,SF-K27,3,1,3,1,0,0,1.0,0.0,1.0,0.0
SF-D28,SF-K25,13,8,6,5,7,3,0.46153846153846156,0.5384615384615384,0.625,0.375
SF-D28,SF-J25,4,8,1,3,3,5,0.25,0.75,0.375,0.625
SF-D28,SF-H26-2,24,19,22,9,2,10,0.9166666666666666,0.08333333333333333,0.47368421052631576,0.5263157894736842
SF-D28,SF-J26,1,2,0,2,1,0,0.0,1.0,1.0,0.0
SF-D28,SF-I26-,1,9,0,4,1,5,0.0,1.0,0.4444444444444444,0.5555555555555556
SF-D28,SF-I25,9,10,3,8,6,2,0.3333333333333333,0.6666666666666666,0.8,0.2
SF-D28,SF-K23,2,1,0,0,2,1,0.0,1.0,0.0,1.0
SF-D28,SF-H26,54,62,45,54,9,8,0.8333333333333334,0.16666666666666666,0.8709677419354839,0.12903225806451613
SF-D28,SF-O23,2,2,0,1,2,1,0.0,1.0,0.5,0.5
SF-D28,SF-H27-1,6,5,4,3,2,2,0.6666666666666666,0.3333333333333333,0.6,0.4
SF-D28,SF-F28-2,30,33,16,25,14,8,0.5333333333333333,0.4666666666666667,0.7575757575757576,0.24242424242424243
SF-D28,SF-G27,92,71,56,57,36,14,0.6086956521739131,0.391304347826087,0.8028169014084507,0.19718309859154928
SF-D28,SF-M22-2,9,8,0,3,9,5,0.0,1.0,0.375,0.625
SF-D28,SF-L22,2,4,1,2,1,2,0.5,0.5,0.5,0.5
SF-D28,SF-F27,82,65,70,59,12,6,0.8536585365853658,0.14634146341463414,0.9076923076923077,0.09230769230769231
SF-D28,SF-N22-2,4,3,0,0,4,3,0.0,1.0,0.0,1.0
SF-D28,SF-G28-2,39,32,31,32,8,0,0.7948717948717948,0.20512820512820512,1.0,0.0
SF-D28,SF-G28-1,1,5,1,3,0,2,1.0,0.0,0.6,0.4
SF-D28,SF-K22-2,4,3,1,2,3,1,0.25,0.75,0.6666666666666666,0.3333333333333333
SF-D28,SF-K24,4,1,2,1,2,0,0.5,0.5,1.0,0.0
SF-D28,SF-J23-2,7,1,6,0,1,1,0.8571428571428571,0.14285714285714285,0.0,1.0
SF-D28,SF-G23,1,1,1,0,0,1,1.0,0.0,0.0,1.0
SF-D28,SF-G24,14,5,10,0,4,5,0.7142857142857143,0.2857142857142857,0.0,1.0
SF-D28,SF-G25,43,27,12,4,31,23,0.27906976744186046,0.7209302325581395,0.14814814814814814,0.8518518518518519
SF-D28,SF-F23,14,4,5,1,9,3,0.35714285714285715,0.6428571428571429,0.25,0.75
SF-D28,SF-E23,8,7,4,2,4,5,0.5,0.5,0.2857142857142857,0.7142857142857143
SF-D28,SF-D24,20,3,14,0,6,3,0.7,0.3,0.0,1.0
SF-D28,SF-C22,12,14,3,1,9,13,0.25,0.75,0.07142857142857142,0.9285714285714286
SF-D28,SF-B22,27,30,18,24,9,6,0.6666666666666666,0.3333333333333333,0.8,0.2
SF-D28,SF-J17,5,3,2,0,3,3,0.4,0.6,0.0,1.0
SF-D28,SF-I20,29,13,26,3,3,10,0.896551724137931,0.10344827586206896,0.23076923076923078,0.7692307692307693
SF-D28,SF-H20,4,1,2,0,2,1,0.5,0.5,0.0,1.0
SF-D28,SF-H18,2,1,0,0,2,1,0.0,1.0,0.0,1.0
SF-D28,SF-G19,1,1,0,0,1,1,0.0,1.0,0.0,1.0
SF-D28,SF-G18,11,6,0,0,11,6,0.0,1.0,0.0,1.0
SF-D28,SF-G20,4,3,4,0,0,3,1.0,0.0,0.0,1.0
SF-D28,SF-F19,2,1,0,0,2,1,0.0,1.0,0.0,1.0
SF-D28,SF-E18,7,1,2,0,5,1,0.2857142857142857,0.7142857142857143,0.0,1.0
SF-D28,SF-E20,5,7,2,2,3,5,0.4,0.6,0.2857142857142857,0.7142857142857143
SF-D28,SF-H30,54,40,22,25,32,15,0.4074074074074074,0.5925925925925926,0.625,0.375
SF-D28,SF-G30-2,43,58,25,36,18,22,0.5813953488372093,0.4186046511627907,0.6206896551724138,0.3793103448275862
SF-D28,SF-F30-1,176,170,166,156,10,14,0.9431818181818182,0.056818181818181816,0.9176470588235294,0.08235294117647059
SF-D28,SF-E29-2,23,13,17,11,6,2,0.7391304347826086,0.2608695652173913,0.8461538461538461,0.15384615384615385
SF-D28,SF-E29-1,30,11,25,9,5,2,0.8333333333333334,0.16666666666666666,0.8181818181818182,0.18181818181818182
SF-D28,SF-D29,42,42,29,28,13,14,0.6904761904761905,0.30952380952380953,0.6666666666666666,0.3333333333333333
SF-D28,SF-A27,134,201,109,160,25,41,0.8134328358208955,0.1865671641791045,0.7960199004975125,0.20398009950248755
SF-D28,SF-G29-2,41,43,25,29,16,14,0.6097560975609756,0.3902439024390244,0.6744186046511628,0.32558139534883723
SF-D28,SF-G29-1,11,5,2,3,9,2,0.18181818181818182,0.8181818181818182,0.6,0.4
SF-D28,SF-G30-1,66,99,28,47,38,52,0.42424242424242425,0.5757575757575758,0.47474747474747475,0.5252525252525253
SF-D28,SF-G29-3,23,21,11,7,12,14,0.4782608695652174,0.5217391304347826,0.3333333333333333,0.6666666666666666
SF-D28,SF-F30-2,32,25,29,13,3,12,0.90625,0.09375,0.52,0.48
SF-D28,SF-F29,15,21,13,12,2,9,0.8666666666666667,0.13333333333333333,0.5714285714285714,0.42857142857142855
SF-D28,SF-E29-3,20,53,16,12,4,41,0.8,0.2,0.22641509433962265,0.7735849056603774
SF-D28,SF-F28-1,29,35,10,26,19,9,0.3448275862068966,0.6551724137931034,0.7428571428571429,0.2571428571428571
SF-D28,SF-E28-2,9,12,6,7,3,5,0.6666666666666666,0.3333333333333333,0.5833333333333334,0.4166666666666667
SF-D28,SF-E28,22,16,17,13,5,3,0.7727272727272727,0.22727272727272727,0.8125,0.1875
SF-D28,SF-J12,2,1,2,0,0,1,1.0,0.0,0.0,1.0
SF-D28,SF-I16,1,2,0,0,1,2,0.0,1.0,0.0,1.0
SF-D28,SF-G13,2,1,0,0,2,1,0.0,1.0,0.0,1.0
SF-D28,SF-G11,1,1,0,0,1,1,0.0,1.0,0.0,1.0
SF-D28,SF-F15,1,1,1,0,0,1,1.0,0.0,0.0,1.0
SF-D28,SF-C21,2,1,2,1,0,0,1.0,0.0,1.0,0.0
SF-D28,SF-C20,8,8,1,3,7,5,0.125,0.875,0.375,0.625
SF-D28,SF-B19,10,26,6,20,4,6,0.6,0.4,0.7692307692307693,0.23076923076923078
SF-D28,SF-A20,31,43,20,29,11,14,0.6451612903225806,0.3548387096774194,0.6744186046511628,0.32558139534883723
SF-D28,SF-A19,5,9,4,7,1,2,0.8,0.2,0.7777777777777778,0.2222222222222222
SF-D28,SF-C26,37,36,20,11,17,25,0.5405405405405406,0.4594594594594595,0.3055555555555556,0.6944444444444444
SF-D28,SF-C25,20,45,9,24,11,21,0.45,0.55,0.5333333333333333,0.4666666666666667
SF-D28,SF-B25,83,134,64,105,19,29,0.7710843373493976,0.2289156626506024,0.7835820895522388,0.21641791044776118
SF-D28,SF-E27,46,48,34,41,12,7,0.7391304347826086,0.2608695652173913,0.8541666666666666,0.14583333333333334
SF-D28,SF-B28-2,74,77,47,53,27,24,0.6351351351351351,0.36486486486486486,0.6883116883116883,0.3116883116883117
SF-D28,SF-D27,47,53,36,35,11,18,0.7659574468085106,0.23404255319148937,0.660377358490566,0.33962264150943394
SF-D28,SF-C28-2,23,12,19,10,4,2,0.8260869565217391,0.17391304347826086,0.8333333333333334,0.16666666666666666
SF-D28,SF-C28-1,9,15,6,11,3,4,0.6666666666666666,0.3333333333333333,0.7333333333333333,0.26666666666666666
SF-D28,SF-B28,51,73,37,66,14,7,0.7254901960784313,0.27450980392156865,0.9041095890410958,0.0958904109589041
SF-D28,SF-J1,9,3,0,0,9,3,0.0,1.0,0.0,1.0
SF-D28,SF-J3,1,1,0,0,1,1,0.0,1.0,0.0,1.0
SF-D28,SF-J5,1,1,0,1,1,0,0.0,1.0,1.0,0.0
SF-D28,SF-G7,4,4,0,2,4,2,0.0,1.0,0.5,0.5
SF-D28,SF-H25,5,4,4,1,1,3,0.8,0.2,0.25,0.75
SF-D28,SF-G26,27,29,18,15,9,14,0.6666666666666666,0.3333333333333333,0.5172413793103449,0.4827586206896552
SF-D28,SF-K21,12,2,1,0,11,2,0.08333333333333333,0.9166666666666666,0.0,1.0
SF-D28,SF-K22-1,8,22,5,11,3,11,0.625,0.375,0.5,0.5
SF-D28,SF-J23-1,23,21,12,10,11,11,0.5217391304347826,0.4782608695652174,0.47619047619047616,0.5238095238095238
SF-D28,SF-J22-1,14,1,1,0,13,1,0.07142857142857142,0.9285714285714286,0.0,1.0
SF-D28,SF-J22-2,9,10,2,2,7,8,0.2222222222222222,0.7777777777777778,0.2,0.8
SF-D28,SF-J21,38,22,14,14,24,8,0.3684210526315789,0.631578947368421,0.6363636363636364,0.36363636363636365
SF-D28,SF-I21,6,1,3,1,3,0,0.5,0.5,1.0,0.0
SF-D28,SF-I23-2,5,5,5,4,0,1,1.0,0.0,0.8,0.2
SF-D28,SF-I24,4,10,4,7,0,3,1.0,0.0,0.7,0.3
SF-D28,SF-I23-1,3,3,2,2,1,1,0.6666666666666666,0.3333333333333333,0.6666666666666666,0.3333333333333333
SF-D28,SF-F26,60,50,40,26,20,24,0.6666666666666666,0.3333333333333333,0.52,0.48
SF-D28,SF-L19,2,10,0,1,2,9,0.0,1.0,0.1,0.9
SF-D28,SF-L20,1,2,1,1,0,1,1.0,0.0,0.5,0.5
SF-D28,SF-N20-1,5,2,1,1,4,1,0.2,0.8,0.5,0.5
SF-D28,SF-M20,13,10,6,0,7,10,0.46153846153846156,0.5384615384615384,0.0,1.0
SF-D28,SF-K17-2,1,2,0,0,1,2,0.0,1.0,0.0,1.0
SF-D28,SF-K20,5,27,0,2,5,25,0.0,1.0,0.07407407407407407,0.9259259259259259
SF-D28,SF-K15-,2,5,0,1,2,4,0.0,1.0,0.2,0.8
SF-D28,SF-K19,3,2,1,0,2,2,0.3333333333333333,0.6666666666666666,0.0,1.0
SF-D28,SF-K18,5,2,4,1,1,1,0.8,0.2,0.5,0.5
SF-D28,SF-K17,9,4,3,0,6,4,0.3333333333333333,0.6666666666666666,0.0,1.0
SF-D28,SF-J18,5,3,1,0,4,3,0.2,0.8,0.0,1.0
SF-D28,SF-J20,24,21,12,13,12,8,0.5,0.5,0.6190476190476191,0.38095238095238093
SF-D28,SF-J19,32,16,15,4,17,12,0.46875,0.53125,0.25,0.75
SF-D28,SF-M11,1,2,0,1,1,1,0.0,1.0,0.5,0.5
SF-D28,SF-Q21-2,1,3,0,0,1,3,0.0,1.0,0.0,1.0
SF-D28,SF-Q21-1,17,9,0,0,17,9,0.0,1.0,0.0,1.0
SF-D28,SF-P21,7,2,0,0,7,2,0.0,1.0,0.0,1.0
SF-D28,SF-O18,2,6,1,1,1,5,0.5,0.5,0.16666666666666666,0.8333333333333334
SF-D28,SF-O19,4,2,2,0,2,2,0.5,0.5,0.0,1.0
SF-D28,SF-O21,12,7,8,3,4,4,0.6666666666666666,0.3333333333333333,0.42857142857142855,0.5714285714285714
SF-D28,SF-O22,3,4,0,2,3,2,0.0,1.0,0.5,0.5
SF-D28,SF-N21,3,3,0,2,3,1,0.0,1.0,0.6666666666666666,0.3333333333333333
SF-D28,SF-L21,21,28,2,2,19,26,0.09523809523809523,0.9047619047619048,0.07142857142857142,0.9285714285714286
SF-D28,SF-Q30,44,41,40,28,4,13,0.9090909090909091,0.09090909090909091,0.6829268292682927,0.3170731707317073
SF-D28,SF-P30,3,8,3,4,0,4,1.0,0.0,0.5,0.5
SF-D28,SF-O30-2,10,7,7,2,3,5,0.7,0.3,0.2857142857142857,0.7142857142857143
SF-D28,SF-O30,21,35,4,8,17,27,0.19047619047619047,0.8095238095238095,0.22857142857142856,0.7714285714285715
SF-D28,SF-N27,3,2,2,2,1,0,0.6666666666666666,0.3333333333333333,1.0,0.0
SF-D28,SF-N29,8,1,3,0,5,1,0.375,0.625,0.0,1.0
SF-D28,SF-N28,52,15,37,9,15,6,0.7115384615384616,0.28846153846153844,0.6,0.4
SF-D28,SF-L30-1,24,30,12,15,12,15,0.5,0.5,0.5,0.5
SF-D28,SF-L31-1,40,22,29,13,11,9,0.725,0.275,0.5909090909090909,0.4090909090909091
SF-D28,SF-K30-2,9,15,3,9,6,6,0.3333333333333333,0.6666666666666666,0.6,0.4
SF-D28,SF-L29,5,4,2,1,3,3,0.4,0.6,0.25,0.75
SF-D28,SF-J29-1,7,13,1,6,6,7,0.14285714285714285,0.8571428571428571,0.46153846153846156,0.5384615384615384
SF-D28,SF-I30,9,31,5,14,4,17,0.5555555555555556,0.4444444444444444,0.45161290322580644,0.5483870967741935
SF-D28,SF-I29-2,5,1,4,0,1,1,0.8,0.2,0.0,1.0
SF-D28,SF-I27,15,5,5,2,10,3,0.3333333333333333,0.6666666666666666,0.4,0.6
SF-D28,SF-I28,5,4,2,4,3,0,0.4,0.6,1.0,0.0
SF-D28,SF-I30-2,22,22,8,8,14,14,0.36363636363636365,0.6363636363636364,0.36363636363636365,0.6363636363636364
SF-D28,SF I29-1,14,7,11,4,3,3,0.7857142857142857,0.21428571428571427,0.5714285714285714,0.42857142857142855
SF-D28,SF-H28,53,64,48,54,5,10,0.9056603773584906,0.09433962264150944,0.84375,0.15625
SF-D28,SF-H29,1,2,0,2,1,0,0.0,1.0,1.0,0.0
SF-D28,SF-S24,3,6,0,1,3,5,0.0,1.0,0.16666666666666666,0.8333333333333334
SF-D28,SF-R24,4,3,2,0,2,3,0.5,0.5,0.0,1.0
SF-D28,SF-P26,3,2,2,0,1,2,0.6666666666666666,0.3333333333333333,0.0,1.0
SF-D28,SF-N26,4,2,2,2,2,0,0.5,0.5,1.0,0.0
SF-D28,SF-N25,1,1,0,1,1,0,0.0,1.0,1.0,0.0
SF-D28,SF-T22,1,2,1,1,0,1,1.0,0.0,0.5,0.5
SF-D28,SF-S22-1,2,4,0,3,2,1,0.0,1.0,0.75,0.25
SF-D28,SF-P22,17,14,6,3,11,11,0.35294117647058826,0.6470588235294118,0.21428571428571427,0.7857142857142857
SF-A27,SF-M26-2,18,17,18,13,0,4,1.0,0.0,0.7647058823529411,0.23529411764705882
SF-A27,SF-L27,1,6,0,6,1,0,0.0,1.0,1.0,0.0
SF-A27,SF-K26,4,3,2,2,2,1,0.5,0.5,0.6666666666666666,0.3333333333333333
SF-A27,SF-M30,57,21,42,6,15,15,0.7368421052631579,0.2631578947368421,0.2857142857142857,0.7142857142857143
SF-A27,SF-L27-2,2,4,2,3,0,1,1.0,0.0,0.75,0.25
SF-A27,SF-J29-3,21,38,16,20,5,18,0.7619047619047619,0.23809523809523808,0.5263157894736842,0.47368421052631576
SF-A27,SF-J29,11,10,8,3,3,7,0.7272727272727273,0.2727272727272727,0.3,0.7
SF-A27,SF-M28,5,8,5,3,0,5,1.0,0.0,0.375,0.625
SF-A27,SF-M27,1,3,1,3,0,0,1.0,0.0,1.0,0.0
SF-A27,SF-L25,3,1,2,1,1,0,0.6666666666666666,0.3333333333333333,1.0,0.0
SF-A27,SF-M24,2,1,1,1,1,0,0.5,0.5,1.0,0.0
SF-A27,SF-L24,2,4,2,3,0,1,1.0,0.0,0.75,0.25
SF-A27,SF-N23,1,1,1,1,0,0,1.0,0.0,1.0,0.0
SF-A27,SF-K27-2,5,6,2,4,3,2,0.4,0.6,0.6666666666666666,0.3333333333333333
SF-A27,SF-J26-2,18,7,9,4,9,3,0.5,0.5,0.5714285714285714,0.42857142857142855
SF-A27,SF-K28-3,2,1,1,1,1,0,0.5,0.5,1.0,0.0
SF-A27,SF-L28,8,2,5,2,3,0,0.625,0.375,1.0,0.0
SF-A27,SF-K28,8,6,4,4,4,2,0.5,0.5,0.6666666666666666,0.3333333333333333
SF-A27,SF-K29-1,54,28,39,18,15,10,0.7222222222222222,0.2777777777777778,0.6428571428571429,0.35714285714285715
SF-A27,SF-J28-2,1,1,0,1,1,0,0.0,1.0,1.0,0.0
SF-A27,SF-K25,4,3,2,1,2,2,0.5,0.5,0.3333333333333333,0.6666666666666666
SF-A27,SF-J25,44,47,40,44,4,3,0.9090909090909091,0.09090909090909091,0.9361702127659575,0.06382978723404255
SF-A27,SF-H26-2,4,13,2,4,2,9,0.5,0.5,0.3076923076923077,0.6923076923076923
SF-A27,SF-J24,8,5,4,4,4,1,0.5,0.5,0.8,0.2
SF-A27,SF-J26,8,77,1,1,7,76,0.125,0.875,0.012987012987012988,0.987012987012987
SF-A27,SF-I26-,1,2,1,1,0,1,1.0,0.0,0.5,0.5
SF-A27,SF-I25,10,19,6,16,4,3,0.6,0.4,0.8421052631578947,0.15789473684210525
SF-A27,SF-H26,17,47,11,33,6,14,0.6470588235294118,0.35294117647058826,0.7021276595744681,0.2978723404255319
SF-A27,SF-H27-1,14,18,12,14,2,4,0.8571428571428571,0.14285714285714285,0.7777777777777778,0.2222222222222222
SF-A27,SF-F28-2,31,48,22,35,9,13,0.7096774193548387,0.2903225806451613,0.7291666666666666,0.2708333333333333
SF-A27,SF-G27,69,64,50,54,19,10,0.7246376811594203,0.2753623188405797,0.84375,0.15625
SF-A27,SF-M22-2,6,5,4,3,2,2,0.6666666666666666,0.3333333333333333,0.6,0.4
SF-A27,SF-L22,5,4,4,1,1,3,0.8,0.2,0.25,0.75
SF-A27,SF-F27,31,16,22,11,9,5,0.7096774193548387,0.2903225806451613,0.6875,0.3125
SF-A27,SF-G28-2,10,2,7,2,3,0,0.7,0.3,1.0,0.0
SF-A27,SF-G28-1,8,7,7,6,1,1,0.875,0.125,0.8571428571428571,0.14285714285714285
SF-A27,SF-O25-1,2,2,2,1,0,1,1.0,0.0,0.5,0.5
SF-A27,SF-K22-2,3,2,2,1,1,1,0.6666666666666666,0.3333333333333333,0.5,0.5
SF-A27,SF-K24,3,43,1,42,2,1,0.3333333333333333,0.6666666666666666,0.9767441860465116,0.023255813953488372
SF-A27,SF-J23-2,73,20,72,20,1,0,0.9863013698630136,0.0136986301369863,1.0,0.0
SF-A27,SF-G24,7,4,3,0,4,4,0.42857142857142855,0.5714285714285714,0.0,1.0
SF-A27,SF-G25,9,9,5,2,4,7,0.5555555555555556,0.4444444444444444,0.2222222222222222,0.7777777777777778
SF-A27,SF-F23,27,22,1,3,26,19,0.037037037037037035,0.9629629629629629,0.13636363636363635,0.8636363636363636
SF-A27,SF-E23,20,7,11,0,9,7,0.55,0.45,0.0,1.0
SF-A27,SF-C22,33,11,11,2,22,9,0.3333333333333333,0.6666666666666666,0.18181818181818182,0.8181818181818182
SF-A27,SF-B22,131,108,86,54,45,54,0.6564885496183206,0.3435114503816794,0.5,0.5
SF-A27,SF-J17,4,1,2,0,2,1,0.5,0.5,0.0,1.0
SF-A27,SF-I19,1,1,0,0,1,1,0.0,1.0,0.0,1.0
SF-A27,SF-H20,1,1,0,1,1,0,0.0,1.0,1.0,0.0
SF-A27,SF-H17,1,1,1,0,0,1,1.0,0.0,0.0,1.0
SF-A27,SF-G19,6,1,2,0,4,1,0.3333333333333333,0.6666666666666666,0.0,1.0
SF-A27,SF-G20,7,5,4,1,3,4,0.5714285714285714,0.42857142857142855,0.2,0.8
SF-A27,SF-H30,87,32,75,24,12,8,0.8620689655172413,0.13793103448275862,0.75,0.25
SF-A27,SF-G30-2,55,58,40,33,15,25,0.7272727272727273,0.2727272727272727,0.5689655172413793,0.43103448275862066
SF-A27,SF-F30-1,90,31,84,23,6,8,0.9333333333333333,0.06666666666666667,0.7419354838709677,0.25806451612903225
SF-A27,SF-E29-2,246,258,186,163,60,95,0.7560975609756098,0.24390243902439024,0.6317829457364341,0.3682170542635659
SF-A27,SF-E29-1,224,78,189,55,35,23,0.84375,0.15625,0.7051282051282052,0.2948717948717949
SF-A27,SF-D29,199,108,156,87,43,21,0.7839195979899497,0.21608040201005024,0.8055555555555556,0.19444444444444445
SF-A27,SF-D28,201,134,160,109,41,25,0.7960199004975125,0.20398009950248755,0.8134328358208955,0.1865671641791045
SF-A27,SF-G29-2,17,31,10,20,7,11,0.5882352941176471,0.4117647058823529,0.6451612903225806,0.3548387096774194
SF-A27,SF-G29-1,8,6,7,4,1,2,0.875,0.125,0.6666666666666666,0.3333333333333333
SF-A27,SF-G30-1,19,19,15,12,4,7,0.7894736842105263,0.21052631578947367,0.631578947368421,0.3684210526315789
SF-A27,SF-G29-3,10,8,5,3,5,5,0.5,0.5,0.375,0.625
SF-A27,SF-F30-2,45,10,42,5,3,5,0.9333333333333333,0.06666666666666667,0.5,0.5
SF-A27,SF-F29,25,34,16,30,9,4,0.64,0.36,0.8823529411764706,0.11764705882352941
SF-A27,SF-E29-3,161,154,150,151,11,3,0.9316770186335404,0.06832298136645963,0.9805194805194806,0.01948051948051948
SF-A27,SF-F28-1,30,33,19,25,11,8,0.6333333333333333,0.36666666666666664,0.7575757575757576,0.24242424242424243
SF-A27,SF-E28-2,17,12,9,10,8,2,0.5294117647058824,0.47058823529411764,0.8333333333333334,0.16666666666666666
SF-A27,SF-E28,28,39,13,27,15,12,0.4642857142857143,0.5357142857142857,0.6923076923076923,0.3076923076923077
SF-A27,SF-C21,2,1,2,1,0,0,1.0,0.0,1.0,0.0
SF-A27,SF-C20,18,8,7,4,11,4,0.3888888888888889,0.6111111111111112,0.5,0.5
SF-A27,SF-B21,7,13,5,11,2,2,0.7142857142857143,0.2857142857142857,0.8461538461538461,0.15384615384615385
SF-A27,SF-B19,41,34,31,20,10,14,0.7560975609756098,0.24390243902439024,0.5882352941176471,0.4117647058823529
SF-A27,SF-A20,35,30,20,13,15,17,0.5714285714285714,0.42857142857142855,0.43333333333333335,0.5666666666666667
SF-A27,SF-A19,17,6,13,3,4,3,0.7647058823529411,0.23529411764705882,0.5,0.5
SF-A27,SF-C26,25,25,13,18,12,7,0.52,0.48,0.72,0.28
SF-A27,SF-C25,33,34,18,27,15,7,0.5454545454545454,0.45454545454545453,0.7941176470588235,0.20588235294117646
SF-A27,SF-B25,70,70,50,59,20,11,0.7142857142857143,0.2857142857142857,0.8428571428571429,0.15714285714285714
SF-A27,SF-E27,11,6,8,2,3,4,0.7272727272727273,0.2727272727272727,0.3333333333333333,0.6666666666666666
SF-A27,SF-B28-2,17,20,11,17,6,3,0.6470588235294118,0.35294117647058826,0.85,0.15
SF-A27,SF-D27,69,28,48,18,21,10,0.6956521739130435,0.30434782608695654,0.6428571428571429,0.35714285714285715
SF-A27,SF-C28-2,18,17,16,12,2,5,0.8888888888888888,0.1111111111111111,0.7058823529411765,0.29411764705882354
SF-A27,SF-C28-1,57,33,52,24,5,9,0.9122807017543859,0.08771929824561403,0.7272727272727273,0.2727272727272727
SF-A27,SF-B28,70,48,56,43,14,5,0.8,0.2,0.8958333333333334,0.10416666666666667
SF-A27,SF-G5,5,1,0,0,5,1,0.0,1.0,0.0,1.0
SF-A27,SF-G7,1,1,0,0,1,1,0.0,1.0,0.0,1.0
SF-A27,SF-H25,2,6,0,6,2,0,0.0,1.0,1.0,0.0
SF-A27,SF-G26,13,22,8,20,5,2,0.6153846153846154,0.38461538461538464,0.9090909090909091,0.09090909090909091
SF-A27,SF-K21,4,6,0,0,4,6,0.0,1.0,0.0,1.0
SF-A27,SF-K22-1,8,14,8,10,0,4,1.0,0.0,0.7142857142857143,0.2857142857142857
SF-A27,SF-J23-1,19,15,14,10,5,5,0.7368421052631579,0.2631578947368421,0.6666666666666666,0.3333333333333333
SF-A27,SF-J22-1,5,4,2,3,3,1,0.4,0.6,0.75,0.25
SF-A27,SF-J22-2,6,3,6,3,0,0,1.0,0.0,1.0,0.0
SF-A27,SF-I21,1,3,1,2,0,1,1.0,0.0,0.6666666666666666,0.3333333333333333
SF-A27,SF-I23-2,3,2,3,2,0,0,1.0,0.0,1.0,0.0
SF-A27,SF-I24,5,6,4,4,1,2,0.8,0.2,0.6666666666666666,0.3333333333333333
SF-A27,SF-F26,23,25,16,15,7,10,0.6956521739130435,0.30434782608695654,0.6,0.4
SF-A27,SF-L19,2,3,0,1,2,2,0.0,1.0,0.3333333333333333,0.6666666666666666
SF-A27,SF-M20,10,6,6,1,4,5,0.6,0.4,0.16666666666666666,0.8333333333333334
SF-A27,SF-K17-2,4,1,4,0,0,1,1.0,0.0,0.0,1.0
SF-A27,SF-K20,3,1,1,0,2,1,0.3333333333333333,0.6666666666666666,0.0,1.0
SF-A27,SF-K19,5,2,1,1,4,1,0.2,0.8,0.5,0.5
SF-A27,SF-K18,4,2,0,1,4,1,0.0,1.0,0.5,0.5
SF-A27,SF-K17,8,3,2,2,6,1,0.25,0.75,0.6666666666666666,0.3333333333333333
SF-A27,SF-J20,4,3,3,3,1,0,0.75,0.25,1.0,0.0
SF-A27,SF-J19,19,21,14,5,5,16,0.7368421052631579,0.2631578947368421,0.23809523809523808,0.7619047619047619
SF-A27,SF-M12,3,1,0,1,3,0,0.0,1.0,1.0,0.0
SF-A27,SF-O18,1,2,0,0,1,2,0.0,1.0,0.0,1.0
SF-A27,SF-O19,2,3,0,2,2,1,0.0,1.0,0.6666666666666666,0.3333333333333333
SF-A27,SF-O21,6,5,0,3,6,2,0.0,1.0,0.6,0.4
SF-A27,SF-O22,1,7,0,5,1,2,0.0,1.0,0.7142857142857143,0.2857142857142857
SF-A27,SF-L21,14,33,1,3,13,30,0.07142857142857142,0.9285714285714286,0.09090909090909091,0.9090909090909091
SF-A27,SF-Q30,6,2,2,2,4,0,0.3333333333333333,0.6666666666666666,1.0,0.0
SF-A27,SF-P30,14,7,8,6,6,1,0.5714285714285714,0.42857142857142855,0.8571428571428571,0.14285714285714285
SF-A27,SF-O30-2,3,15,0,9,3,6,0.0,1.0,0.6,0.4
SF-A27,SF-O30,26,26,13,14,13,12,0.5,0.5,0.5384615384615384,0.46153846153846156
SF-A27,SF-N27,8,2,7,1,1,1,0.875,0.125,0.5,0.5
SF-A27,SF-N29,4,8,1,4,3,4,0.25,0.75,0.5,0.5
SF-A27,SF-N28,1,3,0,1,1,2,0.0,1.0,0.3333333333333333,0.6666666666666666
SF-A27,SF-L30-1,24,17,11,5,13,12,0.4583333333333333,0.5416666666666666,0.29411764705882354,0.7058823529411765
SF-A27,SF-L31-1,12,13,10,12,2,1,0.8333333333333334,0.16666666666666666,0.9230769230769231,0.07692307692307693
SF-A27,SF-K30-2,11,22,9,18,2,4,0.8181818181818182,0.18181818181818182,0.8181818181818182,0.18181818181818182
SF-A27,SF-L29,17,26,9,11,8,15,0.5294117647058824,0.47058823529411764,0.4230769230769231,0.5769230769230769
SF-A27,SF-J29-1,46,55,35,23,11,32,0.7608695652173914,0.2391304347826087,0.41818181818181815,0.5818181818181818
SF-A27,SF-I30,49,30,23,11,26,19,0.46938775510204084,0.5306122448979592,0.36666666666666664,0.6333333333333333
SF-A27,SF-I29-2,2,3,2,3,0,0,1.0,0.0,1.0,0.0
SF-A27,SF-I27,23,17,9,8,14,9,0.391304347826087,0.6086956521739131,0.47058823529411764,0.5294117647058824
SF-A27,SF-I28,5,4,3,3,2,1,0.6,0.4,0.75,0.25
SF-A27,SF-I30-2,16,11,8,7,8,4,0.5,0.5,0.6363636363636364,0.36363636363636365
SF-A27,SF I29-1,16,3,2,2,14,1,0.125,0.875,0.6666666666666666,0.3333333333333333
SF-A27,SF-H28,19,18,13,10,6,8,0.6842105263157895,0.3157894736842105,0.5555555555555556,0.4444444444444444
SF-A27,SF-H29,4,1,3,0,1,1,0.75,0.25,0.0,1.0
SF-A27,SF-S24,3,6,0,4,3,2,0.0,1.0,0.6666666666666666,0.3333333333333333
SF-A27,SF-R24,11,1,0,1,11,0,0.0,1.0,1.0,0.0
SF-A27,SF-Q26,3,3,3,1,0,2,1.0,0.0,0.3333333333333333,0.6666666666666666
SF-A27,SF-N26,1,1,1,0,0,1,1.0,0.0,0.0,1.0
SF-A27,SF-Q22-1,6,3,4,3,2,0,0.6666666666666666,0.3333333333333333,1.0,0.0
SF-A27,SF-P22,2,1,1,0,1,1,0.5,0.5,0.0,1.0
SF-A27,SF-S21,1,6,1,0,0,6,1.0,0.0,0.0,1.0
SF-A27,SF-V29,2,3,1,1,1,2,0.5,0.5,0.3333333333333333,0.6666666666666666
SF-G29-2,SF-M26,3,2,2,1,1,1,0.6666666666666666,0.3333333333333333,0.5,0.5
SF-G29-2,SF-M25,12,10,3,5,9,5,0.25,0.75,0.5,0.5
SF-G29-2,SF-M26-2,30,32,6,10,24,22,0.2,0.8,0.3125,0.6875
SF-G29-2,SF-L27,13,5,4,3,9,2,0.3076923076923077,0.6923076923076923,0.6,0.4
SF-G29-2,SF-K26,13,15,6,3,7,12,0.46153846153846156,0.5384615384615384,0.2,0.8
SF-G29-2,SF-J27,26,8,8,1,18,7,0.3076923076923077,0.6923076923076923,0.125,0.875
SF-G29-2,SF-M30,24,31,18,19,6,12,0.75,0.25,0.6129032258064516,0.3870967741935484
SF-G29-2,SF-L27-2,4,4,3,3,1,1,0.75,0.25,0.75,0.25
SF-G29-2,SF-J29-3,48,47,23,19,25,28,0.4791666666666667,0.5208333333333334,0.40425531914893614,0.5957446808510638
SF-G29-2,SF-J29,21,26,10,9,11,17,0.47619047619047616,0.5238095238095238,0.34615384615384615,0.6538461538461539
SF-G29-2,SF-L26,2,6,0,2,2,4,0.0,1.0,0.3333333333333333,0.6666666666666666
SF-G29-2,SF-M28,6,13,1,8,5,5,0.16666666666666666,0.8333333333333334,0.6153846153846154,0.38461538461538464
SF-G29-2,SF-L25,19,19,9,9,10,10,0.47368421052631576,0.5263157894736842,0.47368421052631576,0.5263157894736842
SF-G29-2,SF-M24,13,19,5,5,8,14,0.38461538461538464,0.6153846153846154,0.2631578947368421,0.7368421052631579
SF-G29-2,SF-L24,30,42,17,26,13,16,0.5666666666666667,0.43333333333333335,0.6190476190476191,0.38095238095238093
SF-G29-2,SF-N23,13,16,1,7,12,9,0.07692307692307693,0.9230769230769231,0.4375,0.5625
SF-G29-2,SF-N24-2,8,11,1,2,7,9,0.125,0.875,0.18181818181818182,0.8181818181818182
SF-G29-2,SF-K27-2,12,12,7,6,5,6,0.5833333333333334,0.4166666666666667,0.5,0.5
SF-G29-2,SF-J26-2,51,25,23,11,28,14,0.45098039215686275,0.5490196078431373,0.44,0.56
SF-G29-2,SF-K28-3,3,4,2,4,1,0,0.6666666666666666,0.3333333333333333,1.0,0.0
SF-G29-2,SF-L28,14,18,11,11,3,7,0.7857142857142857,0.21428571428571427,0.6111111111111112,0.3888888888888889
SF-G29-2,SF-K28,3,10,1,5,2,5,0.3333333333333333,0.6666666666666666,0.5,0.5
SF-G29-2,SF-K29-1,31,48,21,16,10,32,0.6774193548387096,0.3225806451612903,0.3333333333333333,0.6666666666666666
SF-G29-2,SF-J28-2,14,23,4,7,10,16,0.2857142857142857,0.7142857142857143,0.30434782608695654,0.6956521739130435
SF-G29-2,SF-K27,7,5,4,3,3,2,0.5714285714285714,0.42857142857142855,0.6,0.4
SF-G29-2,SF-K25,22,10,7,4,15,6,0.3181818181818182,0.6818181818181818,0.4,0.6
SF-G29-2,SF-J25,40,66,21,25,19,41,0.525,0.475,0.3787878787878788,0.6212121212121212
SF-G29-2,SF-H26-2,11,5,8,4,3,1,0.7272727272727273,0.2727272727272727,0.8,0.2
SF-G29-2,SF-P24,6,8,2,4,4,4,0.3333333333333333,0.6666666666666666,0.5,0.5
SF-G29-2,SF-J24,22,23,9,12,13,11,0.4090909090909091,0.5909090909090909,0.5217391304347826,0.4782608695652174
SF-G29-2,SF-O24,7,2,0,0,7,2,0.0,1.0,0.0,1.0
SF-G29-2,SF-J26,17,24,6,11,11,13,0.35294117647058826,0.6470588235294118,0.4583333333333333,0.5416666666666666
SF-G29-2,SF-I26-,14,27,4,11,10,16,0.2857142857142857,0.7142857142857143,0.4074074074074074,0.5925925925925926
SF-G29-2,SF-I25,10,28,4,9,6,19,0.4,0.6,0.32142857142857145,0.6785714285714286
SF-G29-2,SF-K23,2,4,2,2,0,2,1.0,0.0,0.5,0.5
SF-G29-2,SF-H26,10,30,1,14,9,16,0.1,0.9,0.4666666666666667,0.5333333333333333
SF-G29-2,SF-O23,103,85,4,1,99,84,0.038834951456310676,0.9611650485436893,0.011764705882352941,0.9882352941176471
SF-G29-2,SF-H27-1,42,39,28,32,14,7,0.6666666666666666,0.3333333333333333,0.8205128205128205,0.1794871794871795
SF-G29-2,SF-F28-2,41,72,29,42,12,30,0.7073170731707317,0.2926829268292683,0.5833333333333334,0.4166666666666667
SF-G29-2,SF-G27,119,119,57,71,62,48,0.4789915966386555,0.5210084033613446,0.5966386554621849,0.40336134453781514
SF-G29-2,SF-M22-2,37,74,5,10,32,64,0.13513513513513514,0.8648648648648649,0.13513513513513514,0.8648648648648649
SF-G29-2,SF-L22,17,10,2,2,15,8,0.11764705882352941,0.8823529411764706,0.2,0.8
SF-G29-2,SF-F27,43,53,18,40,25,13,0.4186046511627907,0.5813953488372093,0.7547169811320755,0.24528301886792453
SF-G29-2,SF-N22-2,46,8,2,3,44,5,0.043478260869565216,0.9565217391304348,0.375,0.625
SF-G29-2,SF-G28-2,5,13,4,5,1,8,0.8,0.2,0.38461538461538464,0.6153846153846154
SF-G29-2,SF-G28-1,9,21,6,16,3,5,0.6666666666666666,0.3333333333333333,0.7619047619047619,0.23809523809523808
SF-G29-2,SF-M22-1,9,8,0,1,9,7,0.0,1.0,0.125,0.875
SF-G29-2,SF-O25-1,3,1,0,0,3,1,0.0,1.0,0.0,1.0
SF-G29-2,SF-K22-2,16,22,6,6,10,16,0.375,0.625,0.2727272727272727,0.7272727272727273
SF-G29-2,SF-K24,15,15,10,9,5,6,0.6666666666666666,0.3333333333333333,0.6,0.4
SF-G29-2,SF-J23-2,7,7,3,1,4,6,0.42857142857142855,0.5714285714285714,0.14285714285714285,0.8571428571428571
SF-G29-2,SF-G23,4,5,1,0,3,5,0.25,0.75,0.0,1.0
SF-G29-2,SF-G24,10,4,4,0,6,4,0.4,0.6,0.0,1.0
SF-G29-2,SF-G25,35,18,6,9,29,9,0.17142857142857143,0.8285714285714286,0.5,0.5
SF-G29-2,SF-F23,12,24,2,4,10,20,0.16666666666666666,0.8333333333333334,0.16666666666666666,0.8333333333333334
SF-G29-2,SF-E23,15,36,2,1,13,35,0.13333333333333333,0.8666666666666667,0.027777777777777776,0.9722222222222222
SF-G29-2,SF-D24,3,2,3,1,0,1,1.0,0.0,0.5,0.5
SF-G29-2,SF-C22,5,3,1,0,4,3,0.2,0.8,0.0,1.0
SF-G29-2,SF-B22,2,30,1,17,1,13,0.5,0.5,0.5666666666666667,0.43333333333333335
SF-G29-2,SF-J17,7,10,2,1,5,9,0.2857142857142857,0.7142857142857143,0.1,0.9
SF-G29-2,SF-I19,5,6,2,2,3,4,0.4,0.6,0.3333333333333333,0.6666666666666666
SF-G29-2,SF-I20,6,3,1,0,5,3,0.16666666666666666,0.8333333333333334,0.0,1.0
SF-G29-2,SF-H16,2,1,1,0,1,1,0.5,0.5,0.0,1.0
SF-G29-2,SF-H20,6,4,4,2,2,2,0.6666666666666666,0.3333333333333333,0.5,0.5
SF-G29-2,SF-H18,3,1,0,0,3,1,0.0,1.0,0.0,1.0
SF-G29-2,SF-G17,2,3,0,0,2,3,0.0,1.0,0.0,1.0
SF-G29-2,SF-G18,60,25,3,1,57,24,0.05,0.95,0.04,0.96
SF-G29-2,SF-G20,17,11,3,3,14,8,0.17647058823529413,0.8235294117647058,0.2727272727272727,0.7272727272727273
SF-G29-2,SF-F19,1,2,1,1,0,1,1.0,0.0,0.5,0.5
SF-G29-2,SF-E18,6,1,0,1,6,0,0.0,1.0,1.0,0.0
SF-G29-2,SF-H30,26,6,22,5,4,1,0.8461538461538461,0.15384615384615385,0.8333333333333334,0.16666666666666666
SF-G29-2,SF-G30-2,25,24,13,18,12,6,0.52,0.48,0.75,0.25
SF-G29-2,SF-F30-1,18,37,10,30,8,7,0.5555555555555556,0.4444444444444444,0.8108108108108109,0.1891891891891892
SF-G29-2,SF-E29-2,15,20,7,11,8,9,0.4666666666666667,0.5333333333333333,0.55,0.45
SF-G29-2,SF-E29-1,30,93,18,75,12,18,0.6,0.4,0.8064516129032258,0.1935483870967742
SF-G29-2,SF-D29,45,67,27,46,18,21,0.6,0.4,0.6865671641791045,0.31343283582089554
SF-G29-2,SF-D28,43,41,29,25,14,16,0.6744186046511628,0.32558139534883723,0.6097560975609756,0.3902439024390244
SF-G29-2,SF-A27,31,17,20,10,11,7,0.6451612903225806,0.3548387096774194,0.5882352941176471,0.4117647058823529
SF-G29-2,SF-G29-1,22,21,12,16,10,5,0.5454545454545454,0.45454545454545453,0.7619047619047619,0.23809523809523808
SF-G29-2,SF-G30-1,21,34,10,21,11,13,0.47619047619047616,0.5238095238095238,0.6176470588235294,0.38235294117647056
SF-G29-2,SF-G29-3,37,35,23,20,14,15,0.6216216216216216,0.3783783783783784,0.5714285714285714,0.42857142857142855
SF-G29-2,SF-F30-2,3,15,2,10,1,5,0.6666666666666666,0.3333333333333333,0.6666666666666666,0.3333333333333333
SF-G29-2,SF-F29,17,26,8,15,9,11,0.47058823529411764,0.5294117647058824,0.5769230769230769,0.4230769230769231
SF-G29-2,SF-E29-3,49,84,15,30,34,54,0.30612244897959184,0.6938775510204082,0.35714285714285715,0.6428571428571429
SF-G29-2,SF-F28-1,33,35,12,24,21,11,0.36363636363636365,0.6363636363636364,0.6857142857142857,0.3142857142857143
SF-G29-2,SF-E28-2,15,16,7,11,8,5,0.4666666666666667,0.5333333333333333,0.6875,0.3125
SF-G29-2,SF-E28,13,22,10,15,3,7,0.7692307692307693,0.23076923076923078,0.6818181818181818,0.3181818181818182
SF-G29-2,SF-J10,1,1,0,0,1,1,0.0,1.0,0.0,1.0
SF-G29-2,SF-J12,4,1,0,0,4,1,0.0,1.0,0.0,1.0
SF-G29-2,SF-J13,9,5,2,0,7,5,0.2222222222222222,0.7777777777777778,0.0,1.0
SF-G29-2,SF-G13,1,1,0,1,1,0,0.0,1.0,1.0,0.0
SF-G29-2,SF-G12,2,1,0,0,2,1,0.0,1.0,0.0,1.0
SF-G29-2,SF-F16,3,1,0,0,3,1,0.0,1.0,0.0,1.0
SF-G29-2,SF-C21,2,2,1,2,1,0,0.5,0.5,1.0,0.0
SF-G29-2,SF-C20,12,10,4,5,8,5,0.3333333333333333,0.6666666666666666,0.5,0.5
SF-G29-2,SF-B21,1,6,0,5,1,1,0.0,1.0,0.8333333333333334,0.16666666666666666
SF-G29-2,SF-B19,12,19,5,10,7,9,0.4166666666666667,0.5833333333333334,0.5263157894736842,0.47368421052631576
SF-G29-2,SF-A20,17,23,6,12,11,11,0.35294117647058826,0.6470588235294118,0.5217391304347826,0.4782608695652174
SF-G29-2,SF-A19,5,9,1,5,4,4,0.2,0.8,0.5555555555555556,0.4444444444444444
SF-G29-2,SF-C26,23,31,6,10,17,21,0.2608695652173913,0.7391304347826086,0.3225806451612903,0.6774193548387096
SF-G29-2,SF-C25,17,30,2,6,15,24,0.11764705882352941,0.8823529411764706,0.2,0.8
SF-G29-2,SF-B25,16,37,5,17,11,20,0.3125,0.6875,0.4594594594594595,0.5405405405405406
SF-G29-2,SF-E27,16,19,4,5,12,14,0.25,0.75,0.2631578947368421,0.7368421052631579
SF-G29-2,SF-B28-2,67,87,58,84,9,3,0.8656716417910447,0.13432835820895522,0.9655172413793104,0.034482758620689655
SF-G29-2,SF-D27,26,37,20,26,6,11,0.7692307692307693,0.23076923076923078,0.7027027027027027,0.2972972972972973
SF-G29-2,SF-C28-2,8,17,7,9,1,8,0.875,0.125,0.5294117647058824,0.47058823529411764
SF-G29-2,SF-C28-1,7,10,4,7,3,3,0.5714285714285714,0.42857142857142855,0.7,0.3
SF-G29-2,SF-B28,62,46,43,26,19,20,0.6935483870967742,0.3064516129032258,0.5652173913043478,0.43478260869565216
SF-G29-2,SF-J1,3,3,0,2,3,1,0.0,1.0,0.6666666666666666,0.3333333333333333
SF-G29-2,SF-H25,6,2,0,0,6,2,0.0,1.0,0.0,1.0
SF-G29-2,SF-G26,20,24,12,14,8,10,0.6,0.4,0.5833333333333334,0.4166666666666667
SF-G29-2,SF-K21,5,6,2,1,3,5,0.4,0.6,0.16666666666666666,0.8333333333333334
SF-G29-2,SF-K22-1,5,17,2,8,3,9,0.4,0.6,0.47058823529411764,0.5294117647058824
SF-G29-2,SF-J23-1,60,62,25,25,35,37,0.4166666666666667,0.5833333333333334,0.4032258064516129,0.5967741935483871
SF-G29-2,SF-J22-1,12,9,8,6,4,3,0.6666666666666666,0.3333333333333333,0.6666666666666666,0.3333333333333333
SF-G29-2,SF-J22-2,7,19,4,6,3,13,0.5714285714285714,0.42857142857142855,0.3157894736842105,0.6842105263157895
SF-G29-2,SF-J21,12,17,4,6,8,11,0.3333333333333333,0.6666666666666666,0.35294117647058826,0.6470588235294118
SF-G29-2,SF-I21,17,19,14,14,3,5,0.8235294117647058,0.17647058823529413,0.7368421052631579,0.2631578947368421
SF-G29-2,SF-I22,8,8,3,1,5,7,0.375,0.625,0.125,0.875
SF-G29-2,SF-I23-2,7,2,3,0,4,2,0.42857142857142855,0.5714285714285714,0.0,1.0
SF-G29-2,SF-I24,1,7,1,3,0,4,1.0,0.0,0.42857142857142855,0.5714285714285714
SF-G29-2,SF-I23-1,4,8,1,4,3,4,0.25,0.75,0.5,0.5
SF-G29-2,SF-F26,53,51,14,22,39,29,0.2641509433962264,0.7358490566037735,0.43137254901960786,0.5686274509803921
SF-G29-2,SF-M13,8,12,3,1,5,11,0.375,0.625,0.08333333333333333,0.9166666666666666
SF-G29-2,SF-M15,3,3,0,0,3,3,0.0,1.0,0.0,1.0
SF-G29-2,SF-L19,14,11,2,3,12,8,0.14285714285714285,0.8571428571428571,0.2727272727272727,0.7272727272727273
SF-G29-2,SF-L20,2,6,0,2,2,4,0.0,1.0,0.3333333333333333,0.6666666666666666
SF-G29-2,SF-N20-1,23,2,1,1,22,1,0.043478260869565216,0.9565217391304348,0.5,0.5
SF-G29-2,SF-M20,16,42,4,0,12,42,0.25,0.75,0.0,1.0
SF-G29-2,SF-K20,18,11,8,3,10,8,0.4444444444444444,0.5555555555555556,0.2727272727272727,0.7272727272727273
SF-G29-2,SF-K15-,14,13,5,5,9,8,0.35714285714285715,0.6428571428571429,0.38461538461538464,0.6153846153846154
SF-G29-2,SF-K19,8,7,1,2,7,5,0.125,0.875,0.2857142857142857,0.7142857142857143
SF-G29-2,SF-K18,9,7,4,1,5,6,0.4444444444444444,0.5555555555555556,0.14285714285714285,0.8571428571428571
SF-G29-2,SF-K17,5,6,1,1,4,5,0.2,0.8,0.16666666666666666,0.8333333333333334
SF-G29-2,SF-J16,7,1,0,0,7,1,0.0,1.0,0.0,1.0
SF-G29-2,SF-J18,3,9,0,0,3,9,0.0,1.0,0.0,1.0
SF-G29-2,SF-J20,4,1,0,0,4,1,0.0,1.0,0.0,1.0
SF-G29-2,SF-J19,7,10,4,5,3,5,0.5714285714285714,0.42857142857142855,0.5,0.5
SF-G29-2,SF-Q21-2,2,2,2,1,0,1,1.0,0.0,0.5,0.5
SF-G29-2,SF-Q21-1,2,1,0,0,2,1,0.0,1.0,0.0,1.0
SF-G29-2,SF-P21,6,4,2,2,4,2,0.3333333333333333,0.6666666666666666,0.5,0.5
SF-G29-2,SF-O18,9,16,4,5,5,11,0.4444444444444444,0.5555555555555556,0.3125,0.6875
SF-G29-2,SF-O19,4,4,0,2,4,2,0.0,1.0,0.5,0.5
SF-G29-2,SF-O21,23,15,9,8,14,7,0.391304347826087,0.6086956521739131,0.5333333333333333,0.4666666666666667
SF-G29-2,SF-O22,17,21,2,11,15,10,0.11764705882352941,0.8823529411764706,0.5238095238095238,0.47619047619047616
SF-G29-2,SF-N21,4,1,1,1,3,0,0.25,0.75,1.0,0.0
SF-G29-2,SF-N20-2,2,1,1,0,1,1,0.5,0.5,0.0,1.0
SF-G29-2,SF-M21,9,11,2,2,7,9,0.2222222222222222,0.7777777777777778,0.18181818181818182,0.8181818181818182
SF-G29-2,SF-L21,31,37,9,4,22,33,0.2903225806451613,0.7096774193548387,0.10810810810810811,0.8918918918918919
SF-G29-2,SF-S30,21,21,0,1,21,20,0.0,1.0,0.047619047619047616,0.9523809523809523
SF-G29-2,SF-Q30,6,4,5,1,1,3,0.8333333333333334,0.16666666666666666,0.25,0.75
SF-G29-2,SF-P30,4,6,3,5,1,1,0.75,0.25,0.8333333333333334,0.16666666666666666
SF-G29-2,SF-O30-2,11,9,3,5,8,4,0.2727272727272727,0.7272727272727273,0.5555555555555556,0.4444444444444444
SF-G29-2,SF-O30,8,15,2,5,6,10,0.25,0.75,0.3333333333333333,0.6666666666666666
SF-G29-2,SF-N27,13,21,6,4,7,17,0.46153846153846156,0.5384615384615384,0.19047619047619047,0.8095238095238095
SF-G29-2,SF-N29,6,2,0,2,6,0,0.0,1.0,1.0,0.0
SF-G29-2,SF-N28,3,14,2,6,1,8,0.6666666666666666,0.3333333333333333,0.42857142857142855,0.5714285714285714
SF-G29-2,SF-L30-1,31,29,18,16,13,13,0.5806451612903226,0.41935483870967744,0.5517241379310345,0.4482758620689655
SF-G29-2,SF-L31-1,22,34,14,16,8,18,0.6363636363636364,0.36363636363636365,0.47058823529411764,0.5294117647058824
SF-G29-2,SF-K30-2,13,12,9,8,4,4,0.6923076923076923,0.3076923076923077,0.6666666666666666,0.3333333333333333
SF-G29-2,SF-L29,21,35,13,21,8,14,0.6190476190476191,0.38095238095238093,0.6,0.4
SF-G29-2,SF-J29-1,22,29,13,15,9,14,0.5909090909090909,0.4090909090909091,0.5172413793103449,0.4827586206896552
SF-G29-2,SF-I30,22,22,14,14,8,8,0.6363636363636364,0.36363636363636365,0.6363636363636364,0.36363636363636365
SF-G29-2,SF-I29-2,27,21,20,19,7,2,0.7407407407407407,0.25925925925925924,0.9047619047619048,0.09523809523809523
SF-G29-2,SF-I27,75,29,38,17,37,12,0.5066666666666667,0.49333333333333335,0.5862068965517241,0.41379310344827586
SF-G29-2,SF-I28,28,33,9,8,19,25,0.32142857142857145,0.6785714285714286,0.24242424242424243,0.7575757575757576
SF-G29-2,SF-I30-2,12,10,6,7,6,3,0.5,0.5,0.7,0.3
SF-G29-2,SF I29-1,7,4,1,2,6,2,0.14285714285714285,0.8571428571428571,0.5,0.5
SF-G29-2,SF-H28,50,38,25,28,25,10,0.5,0.5,0.7368421052631579,0.2631578947368421
SF-G29-2,SF-H29,7,20,5,12,2,8,0.7142857142857143,0.2857142857142857,0.6,0.4
SF-G29-2,SF-S24,16,4,2,0,14,4,0.125,0.875,0.0,1.0
SF-G29-2,SF-R24,94,15,1,1,93,14,0.010638297872340425,0.9893617021276596,0.06666666666666667,0.9333333333333333
SF-G29-2,SF-R26,1,1,0,0,1,1,0.0,1.0,0.0,1.0
SF-G29-2,SF-P26,2,2,0,0,2,2,0.0,1.0,0.0,1.0
SF-G29-2,SF-N22-1B,4,2,2,0,2,2,0.5,0.5,0.0,1.0
SF-G29-2,SF-N25,4,2,0,1,4,1,0.0,1.0,0.5,0.5
SF-G29-2,SF-T22,2,4,0,0,2,4,0.0,1.0,0.0,1.0
SF-G29-2,SF-S22-2,2,1,0,1,2,0,0.0,1.0,1.0,0.0
SF-G29-2,SF-S22-1,6,3,1,0,5,3,0.16666666666666666,0.8333333333333334,0.0,1.0
SF-G29-2,SF-Q23-3,3,4,1,1,2,3,0.3333333333333333,0.6666666666666666,0.25,0.75
SF-G29-2,SF-Q22-1,4,6,1,2,3,4,0.25,0.75,0.3333333333333333,0.6666666666666666
SF-G29-2,SF-Q22-2,5,3,2,2,3,1,0.4,0.6,0.6666666666666666,0.3333333333333333
SF-G29-2,SF-P22,6,14,1,5,5,9,0.16666666666666666,0.8333333333333334,0.35714285714285715,0.6428571428571429
SF-G29-2,SF-T20,2,1,1,0,1,1,0.5,0.5,0.0,1.0
SF-G29-2,SF-S21,5,4,0,1,5,3,0.0,1.0,0.25,0.75
SF-G29-2,SF-V32,2,7,2,7,0,0,1.0,0.0,1.0,0.0
SF-G29-1,SF-M25,19,19,17,16,2,3,0.8947368421052632,0.10526315789473684,0.8421052631578947,0.15789473684210525
SF-G29-1,SF-M26-2,72,30,1,7,71,23,0.013888888888888888,0.9861111111111112,0.23333333333333334,0.7666666666666667
SF-G29-1,SF-L27,8,4,0,2,8,2,0.0,1.0,0.5,0.5
SF-G29-1,SF-K26,12,15,2,9,10,6,0.16666666666666666,0.8333333333333334,0.6,0.4
SF-G29-1,SF-J27,8,8,2,3,6,5,0.25,0.75,0.375,0.625
SF-G29-1,SF-M30,15,4,13,3,2,1,0.8666666666666667,0.13333333333333333,0.75,0.25
SF-G29-1,SF-J29-3,3,10,2,4,1,6,0.6666666666666666,0.3333333333333333,0.4,0.6
SF-G29-1,SF-J29,15,16,3,4,12,12,0.2,0.8,0.25,0.75
SF-G29-1,SF-L26,13,1,2,1,11,0,0.15384615384615385,0.8461538461538461,1.0,0.0
SF-G29-1,SF-M28,5,10,1,1,4,9,0.2,0.8,0.1,0.9
SF-G29-1,SF-L25,6,12,4,10,2,2,0.6666666666666666,0.3333333333333333,0.8333333333333334,0.16666666666666666
SF-G29-1,SF-M24,1,2,0,1,1,1,0.0,1.0,0.5,0.5
SF-G29-1,SF-L24,2,7,1,3,1,4,0.5,0.5,0.42857142857142855,0.5714285714285714
SF-G29-1,SF-N23,2,11,1,8,1,3,0.5,0.5,0.7272727272727273,0.2727272727272727
SF-G29-1,SF-N24-2,1,4,0,1,1,3,0.0,1.0,0.25,0.75
SF-G29-1,SF-K27-2,18,9,12,3,6,6,0.6666666666666666,0.3333333333333333,0.3333333333333333,0.6666666666666666
SF-G29-1,SF-J26-2,38,27,12,5,26,22,0.3157894736842105,0.6842105263157895,0.18518518518518517,0.8148148148148148
SF-G29-1,SF-L28,15,16,2,7,13,9,0.13333333333333333,0.8666666666666667,0.4375,0.5625
SF-G29-1,SF-K28,1,1,0,0,1,1,0.0,1.0,0.0,1.0
SF-G29-1,SF-K29-1,87,100,62,70,25,30,0.7126436781609196,0.28735632183908044,0.7,0.3
SF-G29-1,SF-J28-2,8,3,3,2,5,1,0.375,0.625,0.6666666666666666,0.3333333333333333
SF-G29-1,SF-K27,1,5,0,2,1,3,0.0,1.0,0.4,0.6
SF-G29-1,SF-K25,21,14,16,13,5,1,0.7619047619047619,0.23809523809523808,0.9285714285714286,0.07142857142857142
SF-G29-1,SF-J25,17,43,12,25,5,18,0.7058823529411765,0.29411764705882354,0.5813953488372093,0.4186046511627907
SF-G29-1,SF-H26-2,1,5,1,5,0,0,1.0,0.0,1.0,0.0
SF-G29-1,SF-P24,5,10,2,2,3,8,0.4,0.6,0.2,0.8
SF-G29-1,SF-J24,39,37,36,36,3,1,0.9230769230769231,0.07692307692307693,0.972972972972973,0.02702702702702703
SF-G29-1,SF-O24,1,1,0,0,1,1,0.0,1.0,0.0,1.0
SF-G29-1,SF-J26,12,19,7,9,5,10,0.5833333333333334,0.4166666666666667,0.47368421052631576,0.5263157894736842
SF-G29-1,SF-I26-,2,7,0,6,2,1,0.0,1.0,0.8571428571428571,0.14285714285714285
SF-G29-1,SF-I25,56,15,22,8,34,7,0.39285714285714285,0.6071428571428571,0.5333333333333333,0.4666666666666667
SF-G29-1,SF-K23,2,4,2,1,0,3,1.0,0.0,0.25,0.75
SF-G29-1,SF-H26,61,41,49,30,12,11,0.8032786885245902,0.19672131147540983,0.7317073170731707,0.2682926829268293
SF-G29-1,SF-H27-1,10,15,7,12,3,3,0.7,0.3,0.8,0.2
SF-G29-1,SF-F28-2,38,40,32,30,6,10,0.8421052631578947,0.15789473684210525,0.75,0.25
SF-G29-1,SF-G27,43,77,30,64,13,13,0.6976744186046512,0.3023255813953488,0.8311688311688312,0.16883116883116883
SF-G29-1,SF-M22-2,49,32,2,13,47,19,0.04081632653061224,0.9591836734693877,0.40625,0.59375
SF-G29-1,SF-L22,9,5,3,0,6,5,0.3333333333333333,0.6666666666666666,0.0,1.0
SF-G29-1,SF-F27,34,27,22,23,12,4,0.6470588235294118,0.35294117647058826,0.8518518518518519,0.14814814814814814
SF-G29-1,SF-N22-2,8,11,3,5,5,6,0.375,0.625,0.45454545454545453,0.5454545454545454
SF-G29-1,SF-G28-2,7,12,4,5,3,7,0.5714285714285714,0.42857142857142855,0.4166666666666667,0.5833333333333334
SF-G29-1,SF-G28-1,7,10,5,8,2,2,0.7142857142857143,0.2857142857142857,0.8,0.2
SF-G29-1,SF-M22-1,12,6,0,1,12,5,0.0,1.0,0.16666666666666666,0.8333333333333334
SF-G29-1,SF-K22-2,4,2,0,1,4,1,0.0,1.0,0.5,0.5
SF-G29-1,SF-K24,4,13,3,5,1,8,0.75,0.25,0.38461538461538464,0.6153846153846154
SF-G29-1,SF-J23-2,12,12,1,0,11,12,0.08333333333333333,0.9166666666666666,0.0,1.0
SF-G29-1,SF-G24,42,27,8,0,34,27,0.19047619047619047,0.8095238095238095,0.0,1.0
SF-G29-1,SF-G25,20,11,13,2,7,9,0.65,0.35,0.18181818181818182,0.8181818181818182
SF-G29-1,SF-F23,7,9,2,0,5,9,0.2857142857142857,0.7142857142857143,0.0,1.0
SF-G29-1,SF-E23,5,13,0,1,5,12,0.0,1.0,0.07692307692307693,0.9230769230769231
SF-G29-1,SF-D24,4,3,0,0,4,3,0.0,1.0,0.0,1.0
SF-G29-1,SF-C22,20,20,2,1,18,19,0.1,0.9,0.05,0.95
SF-G29-1,SF-B22,7,6,0,1,7,5,0.0,1.0,0.16666666666666666,0.8333333333333334
SF-G29-1,SF-J17,5,3,2,0,3,3,0.4,0.6,0.0,1.0
SF-G29-1,SF-I19,4,3,0,0,4,3,0.0,1.0,0.0,1.0
SF-G29-1,SF-G17,5,1,0,0,5,1,0.0,1.0,0.0,1.0
SF-G29-1,SF-G18,32,14,27,3,5,11,0.84375,0.15625,0.21428571428571427,0.7857142857142857
SF-G29-1,SF-G20,4,1,1,0,3,1,0.25,0.75,0.0,1.0
SF-G29-1,SF-F19,2,2,0,0,2,2,0.0,1.0,0.0,1.0
SF-G29-1,SF-E20,3,2,1,0,2,2,0.3333333333333333,0.6666666666666666,0.0,1.0
SF-G29-1,SF-H30,9,7,4,5,5,2,0.4444444444444444,0.5555555555555556,0.7142857142857143,0.2857142857142857
SF-G29-1,SF-G30-2,128,101,36,22,92,79,0.28125,0.71875,0.21782178217821782,0.7821782178217822
SF-G29-1,SF-F30-1,1,6,1,5,0,1,1.0,0.0,0.8333333333333334,0.16666666666666666
SF-G29-1,SF-E29-2,3,21,2,18,1,3,0.6666666666666666,0.3333333333333333,0.8571428571428571,0.14285714285714285
SF-G29-1,SF-E29-1,10,17,8,15,2,2,0.8,0.2,0.8823529411764706,0.11764705882352941
SF-G29-1,SF-D29,5,4,4,3,1,1,0.8,0.2,0.75,0.25
SF-G29-1,SF-D28,5,11,3,2,2,9,0.6,0.4,0.18181818181818182,0.8181818181818182
SF-G29-1,SF-A27,6,8,4,7,2,1,0.6666666666666666,0.3333333333333333,0.875,0.125
SF-G29-1,SF-G29-2,21,22,16,12,5,10,0.7619047619047619,0.23809523809523808,0.5454545454545454,0.45454545454545453
SF-G29-1,SF-G30-1,35,27,15,11,20,16,0.42857142857142855,0.5714285714285714,0.4074074074074074,0.5925925925925926
SF-G29-1,SF-G29-3,9,12,8,5,1,7,0.8888888888888888,0.1111111111111111,0.4166666666666667,0.5833333333333334
SF-G29-1,SF-F30-2,2,4,0,0,2,4,0.0,1.0,0.0,1.0
SF-G29-1,SF-F29,13,19,9,12,4,7,0.6923076923076923,0.3076923076923077,0.631578947368421,0.3684210526315789
SF-G29-1,SF-E29-3,4,3,2,2,2,1,0.5,0.5,0.6666666666666666,0.3333333333333333
SF-G29-1,SF-F28-1,3,16,2,8,1,8,0.6666666666666666,0.3333333333333333,0.5,0.5
SF-G29-1,SF-E28-2,1,4,0,3,1,1,0.0,1.0,0.75,0.25
SF-G29-1,SF-J12,4,3,3,0,1,3,0.75,0.25,0.0,1.0
SF-G29-1,SF-I16,1,1,1,0,0,1,1.0,0.0,0.0,1.0
SF-G29-1,SF-H12,10,3,2,1,8,2,0.2,0.8,0.3333333333333333,0.6666666666666666
SF-G29-1,SF-G13,3,1,1,1,2,0,0.3333333333333333,0.6666666666666666,1.0,0.0
SF-G29-1,SF-F16,2,2,1,1,1,1,0.5,0.5,0.5,0.5
SF-G29-1,SF-C20,3,4,1,1,2,3,0.3333333333333333,0.6666666666666666,0.25,0.75
SF-G29-1,SF-B19,2,5,1,2,1,3,0.5,0.5,0.4,0.6
SF-G29-1,SF-A20,9,13,4,0,5,13,0.4444444444444444,0.5555555555555556,0.0,1.0
SF-G29-1,SF-C26,37,39,10,5,27,34,0.2702702702702703,0.7297297297297297,0.1282051282051282,0.8717948717948718
SF-G29-1,SF-C25,12,16,6,1,6,15,0.5,0.5,0.0625,0.9375
SF-G29-1,SF-B25,5,4,2,0,3,4,0.4,0.6,0.0,1.0
SF-G29-1,SF-E27,3,16,3,11,0,5,1.0,0.0,0.6875,0.3125
SF-G29-1,SF-B28-2,32,16,31,15,1,1,0.96875,0.03125,0.9375,0.0625
SF-G29-1,SF-D27,38,26,33,15,5,11,0.868421052631579,0.13157894736842105,0.5769230769230769,0.4230769230769231
SF-G29-1,SF-B28,6,14,5,12,1,2,0.8333333333333334,0.16666666666666666,0.8571428571428571,0.14285714285714285
SF-G29-1,SF-H25,2,5,1,0,1,5,0.5,0.5,0.0,1.0
SF-G29-1,SF-G26,8,11,4,6,4,5,0.5,0.5,0.5454545454545454,0.45454545454545453
SF-G29-1,SF-K21,9,8,1,0,8,8,0.1111111111111111,0.8888888888888888,0.0,1.0
SF-G29-1,SF-K22-1,16,22,13,16,3,6,0.8125,0.1875,0.7272727272727273,0.2727272727272727
SF-G29-1,SF-J23-1,44,42,13,9,31,33,0.29545454545454547,0.7045454545454546,0.21428571428571427,0.7857142857142857
SF-G29-1,SF-J22-1,3,6,1,3,2,3,0.3333333333333333,0.6666666666666666,0.5,0.5
SF-G29-1,SF-J22-2,4,6,1,2,3,4,0.25,0.75,0.3333333333333333,0.6666666666666666
SF-G29-1,SF-J21,75,67,61,44,14,23,0.8133333333333334,0.18666666666666668,0.6567164179104478,0.34328358208955223
SF-G29-1,SF-I21,5,6,4,1,1,5,0.8,0.2,0.16666666666666666,0.8333333333333334
SF-G29-1,SF-I22,24,11,18,4,6,7,0.75,0.25,0.36363636363636365,0.6363636363636364
SF-G29-1,SF-I23-2,2,5,0,2,2,3,0.0,1.0,0.4,0.6
SF-G29-1,SF-I24,5,6,2,2,3,4,0.4,0.6,0.3333333333333333,0.6666666666666666
SF-G29-1,SF-I23-1,3,5,3,3,0,2,1.0,0.0,0.6,0.4
SF-G29-1,SF-F26,139,54,131,44,8,10,0.9424460431654677,0.05755395683453238,0.8148148148148148,0.18518518518518517
SF-G29-1,SF-M13,1,2,0,0,1,2,0.0,1.0,0.0,1.0
SF-G29-1,SF-M15,2,1,1,0,1,1,0.5,0.5,0.0,1.0
SF-G29-1,SF-L19,1,6,0,0,1,6,0.0,1.0,0.0,1.0
SF-G29-1,SF-L20,11,6,1,0,10,6,0.09090909090909091,0.9090909090909091,0.0,1.0
SF-G29-1,SF-M20,11,28,2,4,9,24,0.18181818181818182,0.8181818181818182,0.14285714285714285,0.8571428571428571
SF-G29-1,SF-K17-2,3,2,0,0,3,2,0.0,1.0,0.0,1.0
SF-G29-1,SF-K20,1,2,0,2,1,0,0.0,1.0,1.0,0.0
SF-G29-1,SF-K15-,3,4,1,0,2,4,0.3333333333333333,0.6666666666666666,0.0,1.0
SF-G29-1,SF-K19,14,8,6,1,8,7,0.42857142857142855,0.5714285714285714,0.125,0.875
SF-G29-1,SF-K18,15,11,3,2,12,9,0.2,0.8,0.18181818181818182,0.8181818181818182
SF-G29-1,SF-K17,3,8,0,1,3,7,0.0,1.0,0.125,0.875
SF-G29-1,SF-J16,6,4,0,0,6,4,0.0,1.0,0.0,1.0
SF-G29-1,SF-J18,10,3,1,0,9,3,0.1,0.9,0.0,1.0
SF-G29-1,SF-J20,5,5,3,2,2,3,0.6,0.4,0.4,0.6
SF-G29-1,SF-J19,2,4,1,2,1,2,0.5,0.5,0.5,0.5
SF-G29-1,SF-Q21-2,7,1,2,0,5,1,0.2857142857142857,0.7142857142857143,0.0,1.0
SF-G29-1,SF-Q21-1,2,2,0,1,2,1,0.0,1.0,0.5,0.5
SF-G29-1,SF-P21,1,7,1,1,0,6,1.0,0.0,0.14285714285714285,0.8571428571428571
SF-G29-1,SF-O18,2,2,1,0,1,2,0.5,0.5,0.0,1.0
SF-G29-1,SF-O21,4,8,2,1,2,7,0.5,0.5,0.125,0.875
SF-G29-1,SF-O22,15,10,6,5,9,5,0.4,0.6,0.5,0.5
SF-G29-1,SF-M21,2,2,1,1,1,1,0.5,0.5,0.5,0.5
SF-G29-1,SF-L21,27,24,6,7,21,17,0.2222222222222222,0.7777777777777778,0.2916666666666667,0.7083333333333334
SF-G29-1,SF-Q30,19,16,0,0,19,16,0.0,1.0,0.0,1.0
SF-G29-1,SF-P30,3,10,1,8,2,2,0.3333333333333333,0.6666666666666666,0.8,0.2
SF-G29-1,SF-O30-2,1,4,0,1,1,3,0.0,1.0,0.25,0.75
SF-G29-1,SF-O30,9,5,3,0,6,5,0.3333333333333333,0.6666666666666666,0.0,1.0
SF-G29-1,SF-N27,9,18,6,8,3,10,0.6666666666666666,0.3333333333333333,0.4444444444444444,0.5555555555555556
SF-G29-1,SF-N28,5,8,0,2,5,6,0.0,1.0,0.25,0.75
SF-G29-1,SF-L30-1,16,13,12,6,4,7,0.75,0.25,0.46153846153846156,0.5384615384615384
SF-G29-1,SF-L31-1,3,3,2,2,1,1,0.6666666666666666,0.3333333333333333,0.6666666666666666,0.3333333333333333
SF-G29-1,SF-K30-2,4,4,4,2,0,2,1.0,0.0,0.5,0.5
SF-G29-1,SF-L29,4,16,1,1,3,15,0.25,0.75,0.0625,0.9375
SF-G29-1,SF-J29-1,30,32,12,15,18,17,0.4,0.6,0.46875,0.53125
SF-G29-1,SF-I30,21,20,15,12,6,8,0.7142857142857143,0.2857142857142857,0.6,0.4
SF-G29-1,SF-I29-2,4,3,2,3,2,0,0.5,0.5,1.0,0.0
SF-G29-1,SF-I27,29,27,17,11,12,16,0.5862068965517241,0.41379310344827586,0.4074074074074074,0.5925925925925926
SF-G29-1,SF-I28,1,16,1,10,0,6,1.0,0.0,0.625,0.375
SF-G29-1,SF-I30-2,30,23,23,22,7,1,0.7666666666666667,0.23333333333333334,0.9565217391304348,0.043478260869565216
SF-G29-1,SF I29-1,85,55,25,7,60,48,0.29411764705882354,0.7058823529411765,0.12727272727272726,0.8727272727272727
SF-G29-1,SF-H28,38,32,32,15,6,17,0.8421052631578947,0.15789473684210525,0.46875,0.53125
SF-G29-1,SF-H29,12,18,11,9,1,9,0.9166666666666666,0.08333333333333333,0.5,0.5
SF-G29-1,SF-S24,16,15,1,3,15,12,0.0625,0.9375,0.2,0.8
SF-G29-1,SF-R24,18,19,2,3,16,16,0.1111111111111111,0.8888888888888888,0.15789473684210525,0.8421052631578947
SF-G29-1,SF-R26,4,1,0,0,4,1,0.0,1.0,0.0,1.0
SF-G29-1,SF-P26,4,1,1,0,3,1,0.25,0.75,0.0,1.0
SF-G29-1,SF-N22-1B,5,6,1,1,4,5,0.2,0.8,0.16666666666666666,0.8333333333333334
SF-G29-1,SF-N26,4,4,0,0,4,4,0.0,1.0,0.0,1.0
SF-G29-1,SF-T22,1,4,0,2,1,2,0.0,1.0,0.5,0.5
SF-G29-1,SF-S22-1,2,2,0,2,2,0,0.0,1.0,1.0,0.0
SF-G29-1,SF-Q23-3,5,1,0,0,5,1,0.0,1.0,0.0,1.0
SF-G29-1,SF-Q22-1,4,5,2,1,2,4,0.5,0.5,0.2,0.8
SF-G29-1,SF-Q22-2,1,1,0,0,1,1,0.0,1.0,0.0,1.0
SF-G29-1,SF-P22,7,7,3,5,4,2,0.42857142857142855,0.5714285714285714,0.7142857142857143,0.2857142857142857
SF-G29-1,SF-W19,1,1,1,0,0,1,1.0,0.0,0.0,1.0
SF-G29-1,SF-S21,2,3,0,0,2,3,0.0,1.0,0.0,1.0
SF-G30-1,SF-M26,29,33,27,24,2,9,0.9310344827586207,0.06896551724137931,0.7272727272727273,0.2727272727272727
SF-G30-1,SF-M25,4,4,1,2,3,2,0.25,0.75,0.5,0.5
SF-G30-1,SF-M26-2,9,14,5,4,4,10,0.5555555555555556,0.4444444444444444,0.2857142857142857,0.7142857142857143
SF-G30-1,SF-L27,23,14,7,7,16,7,0.30434782608695654,0.6956521739130435,0.5,0.5
SF-G30-1,SF-K26,34,19,8,5,26,14,0.23529411764705882,0.7647058823529411,0.2631578947368421,0.7368421052631579
SF-G30-1,SF-J27,11,4,1,4,10,0,0.09090909090909091,0.9090909090909091,1.0,0.0
SF-G30-1,SF-M30,44,66,33,55,11,11,0.75,0.25,0.8333333333333334,0.16666666666666666
SF-G30-1,SF-J29-3,37,71,23,38,14,33,0.6216216216216216,0.3783783783783784,0.5352112676056338,0.4647887323943662
SF-G30-1,SF-J29,46,29,33,19,13,10,0.717391304347826,0.2826086956521739,0.6551724137931034,0.3448275862068966
SF-G30-1,SF-L26,4,22,0,2,4,20,0.0,1.0,0.09090909090909091,0.9090909090909091
SF-G30-1,SF-M28,8,16,5,7,3,9,0.625,0.375,0.4375,0.5625
SF-G30-1,SF-L25,10,16,6,8,4,8,0.6,0.4,0.5,0.5
SF-G30-1,SF-M24,18,17,4,1,14,16,0.2222222222222222,0.7777777777777778,0.058823529411764705,0.9411764705882353
SF-G30-1,SF-L24,13,10,6,7,7,3,0.46153846153846156,0.5384615384615384,0.7,0.3
SF-G30-1,SF-N23,8,8,2,5,6,3,0.25,0.75,0.625,0.375
SF-G30-1,SF-N24-2,5,2,0,0,5,2,0.0,1.0,0.0,1.0
SF-G30-1,SF-K27-2,18,19,13,11,5,8,0.7222222222222222,0.2777777777777778,0.5789473684210527,0.42105263157894735
SF-G30-1,SF-J26-2,10,4,4,1,6,3,0.4,0.6,0.25,0.75
SF-G30-1,SF-L28,6,9,4,4,2,5,0.6666666666666666,0.3333333333333333,0.4444444444444444,0.5555555555555556
SF-G30-1,SF-K28,34,42,16,25,18,17,0.47058823529411764,0.5294117647058824,0.5952380952380952,0.40476190476190477
SF-G30-1,SF-K29-1,81,47,39,31,42,16,0.48148148148148145,0.5185185185185185,0.6595744680851063,0.3404255319148936
SF-G30-1,SF-J28-2,11,14,3,5,8,9,0.2727272727272727,0.7272727272727273,0.35714285714285715,0.6428571428571429
SF-G30-1,SF-K27,7,4,4,4,3,0,0.5714285714285714,0.42857142857142855,1.0,0.0
SF-G30-1,SF-K25,16,8,8,0,8,8,0.5,0.5,0.0,1.0
SF-G30-1,SF-J25,22,19,11,7,11,12,0.5,0.5,0.3684210526315789,0.631578947368421
SF-G30-1,SF-H26-2,7,10,3,5,4,5,0.42857142857142855,0.5714285714285714,0.5,0.5
SF-G30-1,SF-P24,3,2,0,0,3,2,0.0,1.0,0.0,1.0
SF-G30-1,SF-J24,10,4,4,0,6,4,0.4,0.6,0.0,1.0
SF-G30-1,SF-J26,15,5,7,1,8,4,0.4666666666666667,0.5333333333333333,0.2,0.8
SF-G30-1,SF-I26-,4,13,1,10,3,3,0.25,0.75,0.7692307692307693,0.23076923076923078
SF-G30-1,SF-I25,18,20,9,13,9,7,0.5,0.5,0.65,0.35
SF-G30-1,SF-H26,10,33,3,21,7,12,0.3,0.7,0.6363636363636364,0.36363636363636365
SF-G30-1,SF-O23,4,4,1,1,3,3,0.25,0.75,0.25,0.75
SF-G30-1,SF-H27-1,27,50,18,38,9,12,0.6666666666666666,0.3333333333333333,0.76,0.24
SF-G30-1,SF-F28-2,40,50,25,29,15,21,0.625,0.375,0.58,0.42
SF-G30-1,SF-G27,149,99,88,59,61,40,0.5906040268456376,0.40939597315436244,0.5959595959595959,0.40404040404040403
SF-G30-1,SF-M22-2,5,6,0,1,5,5,0.0,1.0,0.16666666666666666,0.8333333333333334
SF-G30-1,SF-L22,5,8,0,3,5,5,0.0,1.0,0.375,0.625
SF-G30-1,SF-F27,36,39,23,32,13,7,0.6388888888888888,0.3611111111111111,0.8205128205128205,0.1794871794871795
SF-G30-1,SF-N22-2,3,16,0,12,3,4,0.0,1.0,0.75,0.25
SF-G30-1,SF-G28-2,19,22,15,18,4,4,0.7894736842105263,0.21052631578947367,0.8181818181818182,0.18181818181818182
SF-G30-1,SF-G28-1,8,19,6,16,2,3,0.75,0.25,0.8421052631578947,0.15789473684210525
SF-G30-1,SF-M22-1,3,4,1,1,2,3,0.3333333333333333,0.6666666666666666,0.25,0.75
SF-G30-1,SF-O25-1,4,6,0,0,4,6,0.0,1.0,0.0,1.0
SF-G30-1,SF-K22-2,1,4,0,0,1,4,0.0,1.0,0.0,1.0
SF-G30-1,SF-K24,5,5,2,2,3,3,0.4,0.6,0.4,0.6
SF-G30-1,SF-J23-2,6,2,1,0,5,2,0.16666666666666666,0.8333333333333334,0.0,1.0
SF-G30-1,SF-G23,1,4,0,0,1,4,0.0,1.0,0.0,1.0
SF-G30-1,SF-G24,20,19,13,2,7,17,0.65,0.35,0.10526315789473684,0.8947368421052632
SF-G30-1,SF-G25,26,18,11,5,15,13,0.4230769230769231,0.5769230769230769,0.2777777777777778,0.7222222222222222
SF-G30-1,SF-F23,4,12,2,4,2,8,0.5,0.5,0.3333333333333333,0.6666666666666666
SF-G30-1,SF-E23,11,7,3,1,8,6,0.2727272727272727,0.7272727272727273,0.14285714285714285,0.8571428571428571
SF-G30-1,SF-D24,8,2,4,0,4,2,0.5,0.5,0.0,1.0
SF-G30-1,SF-C22,9,8,7,2,2,6,0.7777777777777778,0.2222222222222222,0.25,0.75
SF-G30-1,SF-B22,9,30,3,23,6,7,0.3333333333333333,0.6666666666666666,0.7666666666666667,0.23333333333333334
SF-G30-1,SF-J17,2,6,0,0,2,6,0.0,1.0,0.0,1.0
SF-G30-1,SF-I20,15,4,4,1,11,3,0.26666666666666666,0.7333333333333333,0.25,0.75
SF-G30-1,SF-H20,6,2,2,1,4,1,0.3333333333333333,0.6666666666666666,0.5,0.5
SF-G30-1,SF-H18,1,2,1,1,0,1,1.0,0.0,0.5,0.5
SF-G30-1,SF-H17,3,8,1,0,2,8,0.3333333333333333,0.6666666666666666,0.0,1.0
SF-G30-1,SF-G19,2,5,2,5,0,0,1.0,0.0,1.0,0.0
SF-G30-1,SF-G17,2,1,2,0,0,1,1.0,0.0,0.0,1.0
SF-G30-1,SF-G18,5,13,5,11,0,2,1.0,0.0,0.8461538461538461,0.15384615384615385
SF-G30-1,SF-G20,7,11,3,0,4,11,0.42857142857142855,0.5714285714285714,0.0,1.0
SF-G30-1,SF-E18,3,2,1,0,2,2,0.3333333333333333,0.6666666666666666,0.0,1.0
SF-G30-1,SF-E20,4,1,1,0,3,1,0.25,0.75,0.0,1.0
SF-G30-1,SF-H30,23,30,14,21,9,9,0.6086956521739131,0.391304347826087,0.7,0.3
SF-G30-1,SF-G30-2,27,59,16,53,11,6,0.5925925925925926,0.4074074074074074,0.8983050847457628,0.1016949152542373
SF-G30-1,SF-F30-1,6,14,6,13,0,1,1.0,0.0,0.9285714285714286,0.07142857142857142
SF-G30-1,SF-E29-2,21,29,17,26,4,3,0.8095238095238095,0.19047619047619047,0.896551724137931,0.10344827586206896
SF-G30-1,SF-E29-1,15,34,12,26,3,8,0.8,0.2,0.7647058823529411,0.23529411764705882
SF-G30-1,SF-D29,27,52,21,44,6,8,0.7777777777777778,0.2222222222222222,0.8461538461538461,0.15384615384615385
SF-G30-1,SF-D28,99,66,47,28,52,38,0.47474747474747475,0.5252525252525253,0.42424242424242425,0.5757575757575758
SF-G30-1,SF-A27,19,19,12,15,7,4,0.631578947368421,0.3684210526315789,0.7894736842105263,0.21052631578947367
SF-G30-1,SF-G29-2,34,21,21,10,13,11,0.6176470588235294,0.38235294117647056,0.47619047619047616,0.5238095238095238
SF-G30-1,SF-G29-1,27,35,11,15,16,20,0.4074074074074074,0.5925925925925926,0.42857142857142855,0.5714285714285714
SF-G30-1,SF-G29-3,13,11,4,5,9,6,0.3076923076923077,0.6923076923076923,0.45454545454545453,0.5454545454545454
SF-G30-1,SF-F30-2,24,43,18,39,6,4,0.75,0.25,0.9069767441860465,0.09302325581395349
SF-G30-1,SF-F29,18,27,9,22,9,5,0.5,0.5,0.8148148148148148,0.18518518518518517
SF-G30-1,SF-E29-3,85,52,47,40,38,12,0.5529411764705883,0.4470588235294118,0.7692307692307693,0.23076923076923078
SF-G30-1,SF-F28-1,28,46,16,32,12,14,0.5714285714285714,0.42857142857142855,0.6956521739130435,0.30434782608695654
SF-G30-1,SF-E28-2,37,20,15,12,22,8,0.40540540540540543,0.5945945945945946,0.6,0.4
SF-G30-1,SF-E28,15,10,11,8,4,2,0.7333333333333333,0.26666666666666666,0.8,0.2
SF-G30-1,SF-J10,1,1,1,0,0,1,1.0,0.0,0.0,1.0
SF-G30-1,SF-J12,8,4,1,0,7,4,0.125,0.875,0.0,1.0
SF-G30-1,SF-H12,4,1,0,0,4,1,0.0,1.0,0.0,1.0
SF-G30-1,SF-F15,2,3,0,1,2,2,0.0,1.0,0.3333333333333333,0.6666666666666666
SF-G30-1,SF-C21,14,1,14,1,0,0,1.0,0.0,1.0,0.0
SF-G30-1,SF-C20,5,9,1,7,4,2,0.2,0.8,0.7777777777777778,0.2222222222222222
SF-G30-1,SF-B19,8,16,4,7,4,9,0.5,0.5,0.4375,0.5625
SF-G30-1,SF-A20,28,28,14,16,14,12,0.5,0.5,0.5714285714285714,0.42857142857142855
SF-G30-1,SF-A19,7,11,4,6,3,5,0.5714285714285714,0.42857142857142855,0.5454545454545454,0.45454545454545453
SF-G30-1,SF-C26,15,14,9,2,6,12,0.6,0.4,0.14285714285714285,0.8571428571428571
SF-G30-1,SF-C25,11,14,6,6,5,8,0.5454545454545454,0.45454545454545453,0.42857142857142855,0.5714285714285714
SF-G30-1,SF-B25,31,47,14,32,17,15,0.45161290322580644,0.5483870967741935,0.6808510638297872,0.3191489361702128
SF-G30-1,SF-E27,14,39,6,7,8,32,0.42857142857142855,0.5714285714285714,0.1794871794871795,0.8205128205128205
SF-G30-1,SF-B28-2,21,15,13,14,8,1,0.6190476190476191,0.38095238095238093,0.9333333333333333,0.06666666666666667
SF-G30-1,SF-D27,29,39,23,27,6,12,0.7931034482758621,0.20689655172413793,0.6923076923076923,0.3076923076923077
SF-G30-1,SF-C28-2,3,8,1,6,2,2,0.3333333333333333,0.6666666666666666,0.75,0.25
SF-G30-1,SF-C28-1,45,75,43,72,2,3,0.9555555555555556,0.044444444444444446,0.96,0.04
SF-G30-1,SF-B28,30,42,24,32,6,10,0.8,0.2,0.7619047619047619,0.23809523809523808
SF-G30-1,SF-G8,1,1,0,1,1,0,0.0,1.0,1.0,0.0
SF-G30-1,SF-H25,54,40,47,17,7,23,0.8703703703703703,0.12962962962962962,0.425,0.575
SF-G30-1,SF-G26,17,18,6,6,11,12,0.35294117647058826,0.6470588235294118,0.3333333333333333,0.6666666666666666
SF-G30-1,SF-K21,3,3,0,0,3,3,0.0,1.0,0.0,1.0
SF-G30-1,SF-K22-1,5,6,3,2,2,4,0.6,0.4,0.3333333333333333,0.6666666666666666
SF-G30-1,SF-J23-1,30,18,8,5,22,13,0.26666666666666666,0.7333333333333333,0.2777777777777778,0.7222222222222222
SF-G30-1,SF-J22-1,4,7,1,4,3,3,0.25,0.75,0.5714285714285714,0.42857142857142855
SF-G30-1,SF-J22-2,3,6,2,4,1,2,0.6666666666666666,0.3333333333333333,0.6666666666666666,0.3333333333333333
SF-G30-1,SF-J21,15,16,7,7,8,9,0.4666666666666667,0.5333333333333333,0.4375,0.5625
SF-G30-1,SF-I22,2,4,2,3,0,1,1.0,0.0,0.75,0.25
SF-G30-1,SF-I23-2,1,3,1,1,0,2,1.0,0.0,0.3333333333333333,0.6666666666666666
SF-G30-1,SF-I24,7,2,2,2,5,0,0.2857142857142857,0.7142857142857143,1.0,0.0
SF-G30-1,SF-I23-1,12,4,12,4,0,0,1.0,0.0,1.0,0.0
SF-G30-1,SF-F26,38,43,21,17,17,26,0.5526315789473685,0.4473684210526316,0.3953488372093023,0.6046511627906976
SF-G30-1,SF-M13,45,16,38,0,7,16,0.8444444444444444,0.15555555555555556,0.0,1.0
SF-G30-1,SF-L19,8,4,2,1,6,3,0.25,0.75,0.25,0.75
SF-G30-1,SF-L20,6,4,4,1,2,3,0.6666666666666666,0.3333333333333333,0.25,0.75
SF-G30-1,SF-N20-1,7,2,1,1,6,1,0.14285714285714285,0.8571428571428571,0.5,0.5
SF-G30-1,SF-M20,8,2,0,0,8,2,0.0,1.0,0.0,1.0
SF-G30-1,SF-K17-2,2,1,0,0,2,1,0.0,1.0,0.0,1.0
SF-G30-1,SF-K20,6,2,2,1,4,1,0.3333333333333333,0.6666666666666666,0.5,0.5
SF-G30-1,SF-K15-,7,9,0,1,7,8,0.0,1.0,0.1111111111111111,0.8888888888888888
SF-G30-1,SF-K18,7,2,0,1,7,1,0.0,1.0,0.5,0.5
SF-G30-1,SF-K17,5,2,2,0,3,2,0.4,0.6,0.0,1.0
SF-G30-1,SF-J18,4,5,3,1,1,4,0.75,0.25,0.2,0.8
SF-G30-1,SF-J19,8,7,2,4,6,3,0.25,0.75,0.5714285714285714,0.42857142857142855
SF-G30-1,SF-O12,3,1,0,0,3,1,0.0,1.0,0.0,1.0
SF-G30-1,SF-M10,1,1,0,1,1,0,0.0,1.0,1.0,0.0
SF-G30-1,SF-M11,2,1,0,0,2,1,0.0,1.0,0.0,1.0
SF-G30-1,SF-P21,2,1,0,0,2,1,0.0,1.0,0.0,1.0
SF-G30-1,SF-O18,4,2,2,0,2,2,0.5,0.5,0.0,1.0
SF-G30-1,SF-O19,7,5,2,1,5,4,0.2857142857142857,0.7142857142857143,0.2,0.8
SF-G30-1,SF-O21,18,10,6,2,12,8,0.3333333333333333,0.6666666666666666,0.2,0.8
SF-G30-1,SF-O22,9,7,1,2,8,5,0.1111111111111111,0.8888888888888888,0.2857142857142857,0.7142857142857143
SF-G30-1,SF-N21,1,2,0,0,1,2,0.0,1.0,0.0,1.0
SF-G30-1,SF-N20-2,1,2,0,0,1,2,0.0,1.0,0.0,1.0
SF-G30-1,SF-M21,2,2,0,0,2,2,0.0,1.0,0.0,1.0
SF-G30-1,SF-L21,16,13,5,3,11,10,0.3125,0.6875,0.23076923076923078,0.7692307692307693
SF-G30-1,SF-S30,10,17,2,3,8,14,0.2,0.8,0.17647058823529413,0.8235294117647058
SF-G30-1,SF-Q30,3,13,0,2,3,11,0.0,1.0,0.15384615384615385,0.8461538461538461
SF-G30-1,SF-P30,4,8,3,4,1,4,0.75,0.25,0.5,0.5
SF-G30-1,SF-O30-2,10,16,3,7,7,9,0.3,0.7,0.4375,0.5625
SF-G30-1,SF-O30,7,9,5,5,2,4,0.7142857142857143,0.2857142857142857,0.5555555555555556,0.4444444444444444
SF-G30-1,SF-N27,16,15,2,4,14,11,0.125,0.875,0.26666666666666666,0.7333333333333333
SF-G30-1,SF-N29,1,7,0,2,1,5,0.0,1.0,0.2857142857142857,0.7142857142857143
SF-G30-1,SF-N28,7,8,0,0,7,8,0.0,1.0,0.0,1.0
SF-G30-1,SF-L30-1,26,41,21,30,5,11,0.8076923076923077,0.19230769230769232,0.7317073170731707,0.2682926829268293
SF-G30-1,SF-L31-1,27,37,24,27,3,10,0.8888888888888888,0.1111111111111111,0.7297297297297297,0.2702702702702703
SF-G30-1,SF-K30-2,12,22,7,13,5,9,0.5833333333333334,0.4166666666666667,0.5909090909090909,0.4090909090909091
SF-G30-1,SF-L29,36,34,23,26,13,8,0.6388888888888888,0.3611111111111111,0.7647058823529411,0.23529411764705882
SF-G30-1,SF-J29-1,41,40,35,33,6,7,0.8536585365853658,0.14634146341463414,0.825,0.175
SF-G30-1,SF-I30,14,13,10,9,4,4,0.7142857142857143,0.2857142857142857,0.6923076923076923,0.3076923076923077
SF-G30-1,SF-I29-2,7,11,5,7,2,4,0.7142857142857143,0.2857142857142857,0.6363636363636364,0.36363636363636365
SF-G30-1,SF-I27,22,18,7,3,15,15,0.3181818181818182,0.6818181818181818,0.16666666666666666,0.8333333333333334
SF-G30-1,SF-I28,4,11,3,7,1,4,0.75,0.25,0.6363636363636364,0.36363636363636365
SF-G30-1,SF-I30-2,20,18,18,10,2,8,0.9,0.1,0.5555555555555556,0.4444444444444444
SF-G30-1,SF I29-1,41,40,13,4,28,36,0.3170731707317073,0.6829268292682927,0.1,0.9
SF-G30-1,SF-H28,50,11,27,6,23,5,0.54,0.46,0.5454545454545454,0.45454545454545453
SF-G30-1,SF-H29,5,2,2,1,3,1,0.4,0.6,0.5,0.5
SF-G30-1,SF-S24,9,3,0,0,9,3,0.0,1.0,0.0,1.0
SF-G30-1,SF-R24,6,27,2,1,4,26,0.3333333333333333,0.6666666666666666,0.037037037037037035,0.9629629629629629
SF-G30-1,SF-P26,1,4,0,0,1,4,0.0,1.0,0.0,1.0
SF-G30-1,SF-N22-1B,1,1,0,0,1,1,0.0,1.0,0.0,1.0
SF-G30-1,SF-N26,3,9,0,0,3,9,0.0,1.0,0.0,1.0
SF-G30-1,SF-N25,4,1,0,0,4,1,0.0,1.0,0.0,1.0
SF-G30-1,SF-T22,1,2,1,0,0,2,1.0,0.0,0.0,1.0
SF-G30-1,SF-Q23-3,4,2,2,2,2,0,0.5,0.5,1.0,0.0
SF-G30-1,SF-Q22-1,2,3,0,1,2,2,0.0,1.0,0.3333333333333333,0.6666666666666666
SF-G30-1,SF-Q22-2,2,1,2,1,0,0,1.0,0.0,1.0,0.0
SF-G30-1,SF-P22,3,3,2,0,1,3,0.6666666666666666,0.3333333333333333,0.0,1.0
SF-G30-1,SF-V30,43,44,43,41,0,3,1.0,0.0,0.9318181818181818,0.06818181818181818
SF-G30-1,SF-V31,2,1,2,1,0,0,1.0,0.0,1.0,0.0
SF-G30-1,SF-V32,4,1,2,0,2,1,0.5,0.5,0.0,1.0
SF-G30-1,SF-Y14,4,1,0,0,4,1,0.0,1.0,0.0,1.0
SF-G29-3,SF-M25,2,3,1,2,1,1,0.5,0.5,0.6666666666666666,0.3333333333333333
SF-G29-3,SF-M26-2,16,18,2,0,14,18,0.125,0.875,0.0,1.0
SF-G29-3,SF-L27,1,4,0,2,1,2,0.0,1.0,0.5,0.5
SF-G29-3,SF-K26,7,7,4,3,3,4,0.5714285714285714,0.42857142857142855,0.42857142857142855,0.5714285714285714
SF-G29-3,SF-J27,5,6,2,2,3,4,0.4,0.6,0.3333333333333333,0.6666666666666666
SF-G29-3,SF-M30,6,8,4,5,2,3,0.6666666666666666,0.3333333333333333,0.625,0.375
SF-G29-3,SF-J29-3,21,19,7,12,14,7,0.3333333333333333,0.6666666666666666,0.631578947368421,0.3684210526315789
SF-G29-3,SF-J29,27,13,2,7,25,6,0.07407407407407407,0.9259259259259259,0.5384615384615384,0.46153846153846156
SF-G29-3,SF-L26,4,5,0,4,4,1,0.0,1.0,0.8,0.2
SF-G29-3,SF-L25,10,15,4,8,6,7,0.4,0.6,0.5333333333333333,0.4666666666666667
SF-G29-3,SF-M24,2,10,2,1,0,9,1.0,0.0,0.1,0.9
SF-G29-3,SF-L24,7,16,4,13,3,3,0.5714285714285714,0.42857142857142855,0.8125,0.1875
SF-G29-3,SF-N23,1,7,0,4,1,3,0.0,1.0,0.5714285714285714,0.42857142857142855
SF-G29-3,SF-K27-2,3,8,1,6,2,2,0.3333333333333333,0.6666666666666666,0.75,0.25
SF-G29-3,SF-J26-2,21,9,1,4,20,5,0.047619047619047616,0.9523809523809523,0.4444444444444444,0.5555555555555556
SF-G29-3,SF-L28,1,5,0,5,1,0,0.0,1.0,1.0,0.0
SF-G29-3,SF-K28,2,4,2,1,0,3,1.0,0.0,0.25,0.75
SF-G29-3,SF-K29-1,59,68,42,41,17,27,0.711864406779661,0.288135593220339,0.6029411764705882,0.39705882352941174
SF-G29-3,SF-J28-2,4,6,0,0,4,6,0.0,1.0,0.0,1.0
SF-G29-3,SF-K27,5,6,0,4,5,2,0.0,1.0,0.6666666666666666,0.3333333333333333
SF-G29-3,SF-K25,6,14,3,5,3,9,0.5,0.5,0.35714285714285715,0.6428571428571429
SF-G29-3,SF-J25,35,73,12,26,23,47,0.34285714285714286,0.6571428571428571,0.3561643835616438,0.6438356164383562
SF-G29-3,SF-H26-2,1,2,1,1,0,1,1.0,0.0,0.5,0.5
SF-G29-3,SF-J24,42,20,5,7,37,13,0.11904761904761904,0.8809523809523809,0.35,0.65
SF-G29-3,SF-O24,3,3,2,3,1,0,0.6666666666666666,0.3333333333333333,1.0,0.0
SF-G29-3,SF-J26,9,8,2,3,7,5,0.2222222222222222,0.7777777777777778,0.375,0.625
SF-G29-3,SF-I26-,2,10,1,8,1,2,0.5,0.5,0.8,0.2
SF-G29-3,SF-I25,15,8,8,7,7,1,0.5333333333333333,0.4666666666666667,0.875,0.125
SF-G29-3,SF-K23,5,1,3,0,2,1,0.6,0.4,0.0,1.0
SF-G29-3,SF-H26,16,26,9,22,7,4,0.5625,0.4375,0.8461538461538461,0.15384615384615385
SF-G29-3,SF-O23,2,23,1,1,1,22,0.5,0.5,0.043478260869565216,0.9565217391304348
SF-G29-3,SF-H27-1,6,12,4,9,2,3,0.6666666666666666,0.3333333333333333,0.75,0.25
SF-G29-3,SF-F28-2,38,47,27,24,11,23,0.7105263157894737,0.2894736842105263,0.5106382978723404,0.48936170212765956
SF-G29-3,SF-G27,102,92,64,66,38,26,0.6274509803921569,0.37254901960784315,0.717391304347826,0.2826086956521739
SF-G29-3,SF-M22-2,25,24,14,1,11,23,0.56,0.44,0.041666666666666664,0.9583333333333334
SF-G29-3,SF-L22,11,9,1,5,10,4,0.09090909090909091,0.9090909090909091,0.5555555555555556,0.4444444444444444
SF-G29-3,SF-F27,27,46,14,39,13,7,0.5185185185185185,0.48148148148148145,0.8478260869565217,0.15217391304347827
SF-G29-3,SF-N22-2,10,7,0,2,10,5,0.0,1.0,0.2857142857142857,0.7142857142857143
SF-G29-3,SF-G28-2,4,5,2,4,2,1,0.5,0.5,0.8,0.2
SF-G29-3,SF-G28-1,1,11,1,10,0,1,1.0,0.0,0.9090909090909091,0.09090909090909091
SF-G29-3,SF-M22-1,9,8,4,3,5,5,0.4444444444444444,0.5555555555555556,0.375,0.625
SF-G29-3,SF-O25-1,1,4,0,4,1,0,0.0,1.0,1.0,0.0
SF-G29-3,SF-K22-2,9,2,3,1,6,1,0.3333333333333333,0.6666666666666666,0.5,0.5
SF-G29-3,SF-J23-2,5,3,2,1,3,2,0.4,0.6,0.3333333333333333,0.6666666666666666
SF-G29-3,SF-G23,11,2,9,0,2,2,0.8181818181818182,0.18181818181818182,0.0,1.0
SF-G29-3,SF-G24,29,8,18,4,11,4,0.6206896551724138,0.3793103448275862,0.5,0.5
SF-G29-3,SF-G25,10,9,6,3,4,6,0.6,0.4,0.3333333333333333,0.6666666666666666
SF-G29-3,SF-F23,8,7,3,1,5,6,0.375,0.625,0.14285714285714285,0.8571428571428571
SF-G29-3,SF-E23,16,24,6,3,10,21,0.375,0.625,0.125,0.875
SF-G29-3,SF-C22,6,3,2,0,4,3,0.3333333333333333,0.6666666666666666,0.0,1.0
SF-G29-3,SF-B22,4,9,1,6,3,3,0.25,0.75,0.6666666666666666,0.3333333333333333
SF-G29-3,SF-J17,3,3,1,0,2,3,0.3333333333333333,0.6666666666666666,0.0,1.0
SF-G29-3,SF-I19,1,1,0,0,1,1,0.0,1.0,0.0,1.0
SF-G29-3,SF-G18,3,8,0,0,3,8,0.0,1.0,0.0,1.0
SF-G29-3,SF-G20,48,49,23,2,25,47,0.4791666666666667,0.5208333333333334,0.04081632653061224,0.9591836734693877
SF-G29-3,SF-F19,1,1,0,0,1,1,0.0,1.0,0.0,1.0
SF-G29-3,SF-E20,1,1,1,1,0,0,1.0,0.0,1.0,0.0
SF-G29-3,SF-H30,12,21,9,13,3,8,0.75,0.25,0.6190476190476191,0.38095238095238093
SF-G29-3,SF-G30-2,20,30,17,20,3,10,0.85,0.15,0.6666666666666666,0.3333333333333333
SF-G29-3,SF-F30-1,11,25,5,17,6,8,0.45454545454545453,0.5454545454545454,0.68,0.32
SF-G29-3,SF-E29-2,8,13,3,12,5,1,0.375,0.625,0.9230769230769231,0.07692307692307693
SF-G29-3,SF-E29-1,14,22,9,19,5,3,0.6428571428571429,0.35714285714285715,0.8636363636363636,0.13636363636363635
SF-G29-3,SF-D29,17,34,8,31,9,3,0.47058823529411764,0.5294117647058824,0.9117647058823529,0.08823529411764706
SF-G29-3,SF-D28,21,23,7,11,14,12,0.3333333333333333,0.6666666666666666,0.4782608695652174,0.5217391304347826
SF-G29-3,SF-A27,8,10,3,5,5,5,0.375,0.625,0.5,0.5
SF-G29-3,SF-G29-2,35,37,20,23,15,14,0.5714285714285714,0.42857142857142855,0.6216216216216216,0.3783783783783784
SF-G29-3,SF-G29-1,12,9,5,8,7,1,0.4166666666666667,0.5833333333333334,0.8888888888888888,0.1111111111111111
SF-G29-3,SF-G30-1,11,13,5,4,6,9,0.45454545454545453,0.5454545454545454,0.3076923076923077,0.6923076923076923
SF-G29-3,SF-F30-2,5,3,4,2,1,1,0.8,0.2,0.6666666666666666,0.3333333333333333
SF-G29-3,SF-F29,15,16,5,11,10,5,0.3333333333333333,0.6666666666666666,0.6875,0.3125
SF-G29-3,SF-E29-3,14,16,11,10,3,6,0.7857142857142857,0.21428571428571427,0.625,0.375
SF-G29-3,SF-F28-1,14,11,8,2,6,9,0.5714285714285714,0.42857142857142855,0.18181818181818182,0.8181818181818182
SF-G29-3,SF-E28-2,6,8,2,4,4,4,0.3333333333333333,0.6666666666666666,0.5,0.5
SF-G29-3,SF-E28,6,26,4,3,2,23,0.6666666666666666,0.3333333333333333,0.11538461538461539,0.8846153846153846
SF-G29-3,SF-J12,2,2,0,0,2,2,0.0,1.0,0.0,1.0
SF-G29-3,SF-G13,1,1,0,0,1,1,0.0,1.0,0.0,1.0
SF-G29-3,SF-C20,1,3,0,1,1,2,0.0,1.0,0.3333333333333333,0.6666666666666666
SF-G29-3,SF-B19,3,7,0,7,3,0,0.0,1.0,1.0,0.0
SF-G29-3,SF-A20,7,20,1,18,6,2,0.14285714285714285,0.8571428571428571,0.9,0.1
SF-G29-3,SF-A19,1,1,1,1,0,0,1.0,0.0,1.0,0.0
SF-G29-3,SF-C26,13,20,6,7,7,13,0.46153846153846156,0.5384615384615384,0.35,0.65
SF-G29-3,SF-C25,62,9,42,2,20,7,0.6774193548387096,0.3225806451612903,0.2222222222222222,0.7777777777777778
SF-G29-3,SF-B25,20,17,7,7,13,10,0.35,0.65,0.4117647058823529,0.5882352941176471
SF-G29-3,SF-E27,18,22,8,18,10,4,0.4444444444444444,0.5555555555555556,0.8181818181818182,0.18181818181818182
SF-G29-3,SF-B28-2,22,11,5,7,17,4,0.22727272727272727,0.7727272727272727,0.6363636363636364,0.36363636363636365
SF-G29-3,SF-D27,21,13,13,8,8,5,0.6190476190476191,0.38095238095238093,0.6153846153846154,0.38461538461538464
SF-G29-3,SF-C28-2,11,9,4,7,7,2,0.36363636363636365,0.6363636363636364,0.7777777777777778,0.2222222222222222
SF-G29-3,SF-B28,16,7,13,6,3,1,0.8125,0.1875,0.8571428571428571,0.14285714285714285
SF-G29-3,SF-J5,1,1,0,0,1,1,0.0,1.0,0.0,1.0
SF-G29-3,SF-G26,12,19,8,17,4,2,0.6666666666666666,0.3333333333333333,0.8947368421052632,0.10526315789473684
SF-G29-3,SF-K21,3,2,1,0,2,2,0.3333333333333333,0.6666666666666666,0.0,1.0
SF-G29-3,SF-K22-1,2,9,2,7,0,2,1.0,0.0,0.7777777777777778,0.2222222222222222
SF-G29-3,SF-J23-1,48,33,23,11,25,22,0.4791666666666667,0.5208333333333334,0.3333333333333333,0.6666666666666666
SF-G29-3,SF-J22-1,4,9,1,7,3,2,0.25,0.75,0.7777777777777778,0.2222222222222222
SF-G29-3,SF-J22-2,12,13,6,7,6,6,0.5,0.5,0.5384615384615384,0.46153846153846156
SF-G29-3,SF-J21,11,6,6,2,5,4,0.5454545454545454,0.45454545454545453,0.3333333333333333,0.6666666666666666
SF-G29-3,SF-I21,3,4,2,1,1,3,0.6666666666666666,0.3333333333333333,0.25,0.75
SF-G29-3,SF-I22,1,1,1,1,0,0,1.0,0.0,1.0,0.0
SF-G29-3,SF-I24,3,14,2,3,1,11,0.6666666666666666,0.3333333333333333,0.21428571428571427,0.7857142857142857
SF-G29-3,SF-I23-1,9,9,3,5,6,4,0.3333333333333333,0.6666666666666666,0.5555555555555556,0.4444444444444444
SF-G29-3,SF-F26,16,30,12,19,4,11,0.75,0.25,0.6333333333333333,0.36666666666666664
SF-G29-3,SF-M13,2,1,0,0,2,1,0.0,1.0,0.0,1.0
SF-G29-3,SF-L19,4,1,0,0,4,1,0.0,1.0,0.0,1.0
SF-G29-3,SF-L20,8,5,5,1,3,4,0.625,0.375,0.2,0.8
SF-G29-3,SF-N20-1,1,3,1,1,0,2,1.0,0.0,0.3333333333333333,0.6666666666666666
SF-G29-3,SF-M20,11,27,5,3,6,24,0.45454545454545453,0.5454545454545454,0.1111111111111111,0.8888888888888888
SF-G29-3,SF-K17-2,2,2,0,0,2,2,0.0,1.0,0.0,1.0
SF-G29-3,SF-K20,4,1,0,0,4,1,0.0,1.0,0.0,1.0
SF-G29-3,SF-K15-,4,4,0,0,4,4,0.0,1.0,0.0,1.0
SF-G29-3,SF-K19,4,5,0,0,4,5,0.0,1.0,0.0,1.0
SF-G29-3,SF-K18,3,7,1,2,2,5,0.3333333333333333,0.6666666666666666,0.2857142857142857,0.7142857142857143
SF-G29-3,SF-K17,4,1,0,0,4,1,0.0,1.0,0.0,1.0
SF-G29-3,SF-J18,5,4,0,1,5,3,0.0,1.0,0.25,0.75
SF-G29-3,SF-J20,5,4,2,0,3,4,0.4,0.6,0.0,1.0
SF-G29-3,SF-J19,7,8,5,4,2,4,0.7142857142857143,0.2857142857142857,0.5,0.5
SF-G29-3,SF-O12,1,1,1,1,0,0,1.0,0.0,1.0,0.0
SF-G29-3,SF-R20,1,1,0,1,1,0,0.0,1.0,1.0,0.0
SF-G29-3,SF-O18,3,3,0,0,3,3,0.0,1.0,0.0,1.0
SF-G29-3,SF-O19,11,7,0,4,11,3,0.0,1.0,0.5714285714285714,0.42857142857142855
SF-G29-3,SF-O21,11,16,1,5,10,11,0.09090909090909091,0.9090909090909091,0.3125,0.6875
SF-G29-3,SF-O22,6,6,1,2,5,4,0.16666666666666666,0.8333333333333334,0.3333333333333333,0.6666666666666666
SF-G29-3,SF-N21,2,2,0,0,2,2,0.0,1.0,0.0,1.0
SF-G29-3,SF-N20-2,1,1,0,0,1,1,0.0,1.0,0.0,1.0
SF-G29-3,SF-M21,3,6,1,2,2,4,0.3333333333333333,0.6666666666666666,0.3333333333333333,0.6666666666666666
SF-G29-3,SF-L21,17,27,3,5,14,22,0.17647058823529413,0.8235294117647058,0.18518518518518517,0.8148148148148148
SF-G29-3,SF-S30,1,6,0,0,1,6,0.0,1.0,0.0,1.0
SF-G29-3,SF-Q30,1,2,1,1,0,1,1.0,0.0,0.5,0.5
SF-G29-3,SF-P30,3,1,2,1,1,0,0.6666666666666666,0.3333333333333333,1.0,0.0
SF-G29-3,SF-O30-2,6,12,2,9,4,3,0.3333333333333333,0.6666666666666666,0.75,0.25
SF-G29-3,SF-O30,14,4,7,2,7,2,0.5,0.5,0.5,0.5
SF-G29-3,SF-N27,2,22,1,3,1,19,0.5,0.5,0.13636363636363635,0.8636363636363636
SF-G29-3,SF-N29,6,2,4,1,2,1,0.6666666666666666,0.3333333333333333,0.5,0.5
SF-G29-3,SF-N28,7,5,2,5,5,0,0.2857142857142857,0.7142857142857143,1.0,0.0
SF-G29-3,SF-L30-1,6,18,1,13,5,5,0.16666666666666666,0.8333333333333334,0.7222222222222222,0.2777777777777778
SF-G29-3,SF-L31-1,6,4,2,2,4,2,0.3333333333333333,0.6666666666666666,0.5,0.5
SF-G29-3,SF-K30-2,1,4,1,3,0,1,1.0,0.0,0.75,0.25
SF-G29-3,SF-L29,16,26,13,19,3,7,0.8125,0.1875,0.7307692307692307,0.2692307692307692
SF-G29-3,SF-J29-1,33,22,14,10,19,12,0.42424242424242425,0.5757575757575758,0.45454545454545453,0.5454545454545454
SF-G29-3,SF-I30,13,17,8,8,5,9,0.6153846153846154,0.38461538461538464,0.47058823529411764,0.5294117647058824
SF-G29-3,SF-I29-2,4,1,3,0,1,1,0.75,0.25,0.0,1.0
SF-G29-3,SF-I27,18,17,10,6,8,11,0.5555555555555556,0.4444444444444444,0.35294117647058826,0.6470588235294118
SF-G29-3,SF-I28,17,13,1,4,16,9,0.058823529411764705,0.9411764705882353,0.3076923076923077,0.6923076923076923
SF-G29-3,SF-I30-2,60,41,51,38,9,3,0.85,0.15,0.926829268292683,0.07317073170731707
SF-G29-3,SF I29-1,7,11,5,2,2,9,0.7142857142857143,0.2857142857142857,0.18181818181818182,0.8181818181818182
SF-G29-3,SF-H28,30,6,26,3,4,3,0.8666666666666667,0.13333333333333333,0.5,0.5
SF-G29-3,SF-H29,13,8,10,6,3,2,0.7692307692307693,0.23076923076923078,0.75,0.25
SF-G29-3,SF-S24,1,2,0,1,1,1,0.0,1.0,0.5,0.5
SF-G29-3,SF-R24,4,2,2,1,2,1,0.5,0.5,0.5,0.5
SF-G29-3,SF-R26,2,1,0,0,2,1,0.0,1.0,0.0,1.0
SF-G29-3,SF-Q26,1,1,1,1,0,0,1.0,0.0,1.0,0.0
SF-G29-3,SF-P26,15,1,6,0,9,1,0.4,0.6,0.0,1.0
SF-G29-3,SF-Q22-1,1,5,1,1,0,4,1.0,0.0,0.2,0.8
SF-G29-3,SF-T20,6,4,2,3,4,1,0.3333333333333333,0.6666666666666666,0.75,0.25
SF-F30-2,SF-M25,7,12,5,9,2,3,0.7142857142857143,0.2857142857142857,0.75,0.25
SF-F30-2,SF-J27,2,2,2,0,0,2,1.0,0.0,0.0,1.0
SF-F30-2,SF-M30,2,10,2,1,0,9,1.0,0.0,0.1,0.9
SF-F30-2,SF-J29-3,13,10,11,8,2,2,0.8461538461538461,0.15384615384615385,0.8,0.2
SF-F30-2,SF-J29,7,6,4,3,3,3,0.5714285714285714,0.42857142857142855,0.5,0.5
SF-F30-2,SF-L26,3,2,0,1,3,1,0.0,1.0,0.5,0.5
SF-F30-2,SF-M28,7,5,3,4,4,1,0.42857142857142855,0.5714285714285714,0.8,0.2
SF-F30-2,SF-L25,10,8,9,8,1,0,0.9,0.1,1.0,0.0
SF-F30-2,SF-L24,2,1,1,1,1,0,0.5,0.5,1.0,0.0
SF-F30-2,SF-N23,3,1,0,0,3,1,0.0,1.0,0.0,1.0
SF-F30-2,SF-K27-2,10,10,4,5,6,5,0.4,0.6,0.5,0.5
SF-F30-2,SF-J26-2,15,3,9,3,6,0,0.6,0.4,1.0,0.0
SF-F30-2,SF-L28,18,14,5,6,13,8,0.2777777777777778,0.7222222222222222,0.42857142857142855,0.5714285714285714
SF-F30-2,SF-K29-1,25,18,12,14,13,4,0.48,0.52,0.7777777777777778,0.2222222222222222
SF-F30-2,SF-J28-2,5,4,3,1,2,3,0.6,0.4,0.25,0.75
SF-F30-2,SF-K27,3,1,3,0,0,1,1.0,0.0,0.0,1.0
SF-F30-2,SF-K25,58,40,41,32,17,8,0.7068965517241379,0.29310344827586204,0.8,0.2
SF-F30-2,SF-J25,20,26,4,20,16,6,0.2,0.8,0.7692307692307693,0.23076923076923078
SF-F30-2,SF-H26-2,1,1,0,1,1,0,0.0,1.0,1.0,0.0
SF-F30-2,SF-P24,5,3,2,2,3,1,0.4,0.6,0.6666666666666666,0.3333333333333333
SF-F30-2,SF-J24,7,8,3,1,4,7,0.42857142857142855,0.5714285714285714,0.125,0.875
SF-F30-2,SF-O24,10,9,1,2,9,7,0.1,0.9,0.2222222222222222,0.7777777777777778
SF-F30-2,SF-J26,3,1,2,1,1,0,0.6666666666666666,0.3333333333333333,1.0,0.0
SF-F30-2,SF-I26-,10,9,5,6,5,3,0.5,0.5,0.6666666666666666,0.3333333333333333
SF-F30-2,SF-I25,8,4,5,4,3,0,0.625,0.375,1.0,0.0
SF-F30-2,SF-H26,7,9,4,6,3,3,0.5714285714285714,0.42857142857142855,0.6666666666666666,0.3333333333333333
SF-F30-2,SF-O23,12,5,0,0,12,5,0.0,1.0,0.0,1.0
SF-F30-2,SF-H27-1,5,5,3,3,2,2,0.6,0.4,0.6,0.4
SF-F30-2,SF-F28-2,14,26,11,20,3,6,0.7857142857142857,0.21428571428571427,0.7692307692307693,0.23076923076923078
SF-F30-2,SF-G27,43,40,19,19,24,21,0.4418604651162791,0.5581395348837209,0.475,0.525
SF-F30-2,SF-M22-2,3,5,1,1,2,4,0.3333333333333333,0.6666666666666666,0.2,0.8
SF-F30-2,SF-L22,2,4,0,0,2,4,0.0,1.0,0.0,1.0
SF-F30-2,SF-F27,8,17,8,11,0,6,1.0,0.0,0.6470588235294118,0.35294117647058826
SF-F30-2,SF-N22-2,4,4,0,0,4,4,0.0,1.0,0.0,1.0
SF-F30-2,SF-G28-2,1,1,0,0,1,1,0.0,1.0,0.0,1.0
SF-F30-2,SF-G28-1,1,3,1,2,0,1,1.0,0.0,0.6666666666666666,0.3333333333333333
SF-F30-2,SF-O25-1,1,1,1,0,0,1,1.0,0.0,0.0,1.0
SF-F30-2,SF-K22-2,4,3,3,0,1,3,0.75,0.25,0.0,1.0
SF-F30-2,SF-K24,3,4,3,2,0,2,1.0,0.0,0.5,0.5
SF-F30-2,SF-J23-2,1,1,0,0,1,1,0.0,1.0,0.0,1.0
SF-F30-2,SF-G23,6,5,5,5,1,0,0.8333333333333334,0.16666666666666666,1.0,0.0
SF-F30-2,SF-G24,19,8,7,4,12,4,0.3684210526315789,0.631578947368421,0.5,0.5
SF-F30-2,SF-G25,3,7,1,1,2,6,0.3333333333333333,0.6666666666666666,0.14285714285714285,0.8571428571428571
SF-F30-2,SF-F23,3,7,2,5,1,2,0.6666666666666666,0.3333333333333333,0.7142857142857143,0.2857142857142857
SF-F30-2,SF-E23,8,5,5,1,3,4,0.625,0.375,0.2,0.8
SF-F30-2,SF-D24,2,3,0,0,2,3,0.0,1.0,0.0,1.0
SF-F30-2,SF-C22,4,7,1,3,3,4,0.25,0.75,0.42857142857142855,0.5714285714285714
SF-F30-2,SF-B22,6,37,1,24,5,13,0.16666666666666666,0.8333333333333334,0.6486486486486487,0.35135135135135137
SF-F30-2,SF-J17,1,2,0,0,1,2,0.0,1.0,0.0,1.0
SF-F30-2,SF-I20,2,1,1,0,1,1,0.5,0.5,0.0,1.0
SF-F30-2,SF-H19,22,1,6,0,16,1,0.2727272727272727,0.7272727272727273,0.0,1.0
SF-F30-2,SF-H20,4,5,1,2,3,3,0.25,0.75,0.4,0.6
SF-F30-2,SF-G19,7,1,1,0,6,1,0.14285714285714285,0.8571428571428571,0.0,1.0
SF-F30-2,SF-E20,26,7,1,1,25,6,0.038461538461538464,0.9615384615384616,0.14285714285714285,0.8571428571428571
SF-F30-2,SF-H30,13,14,8,13,5,1,0.6153846153846154,0.38461538461538464,0.9285714285714286,0.07142857142857142
SF-F30-2,SF-G30-2,40,34,36,30,4,4,0.9,0.1,0.8823529411764706,0.11764705882352941
SF-F30-2,SF-F30-1,17,24,12,17,5,7,0.7058823529411765,0.29411764705882354,0.7083333333333334,0.2916666666666667
SF-F30-2,SF-E29-2,21,10,19,9,2,1,0.9047619047619048,0.09523809523809523,0.9,0.1
SF-F30-2,SF-E29-1,10,11,7,10,3,1,0.7,0.3,0.9090909090909091,0.09090909090909091
SF-F30-2,SF-D29,18,46,15,36,3,10,0.8333333333333334,0.16666666666666666,0.782608695652174,0.21739130434782608
SF-F30-2,SF-D28,25,32,13,29,12,3,0.52,0.48,0.90625,0.09375
SF-F30-2,SF-A27,10,45,5,42,5,3,0.5,0.5,0.9333333333333333,0.06666666666666667
SF-F30-2,SF-G29-2,15,3,10,2,5,1,0.6666666666666666,0.3333333333333333,0.6666666666666666,0.3333333333333333
SF-F30-2,SF-G29-1,4,2,0,0,4,2,0.0,1.0,0.0,1.0
SF-F30-2,SF-G30-1,43,24,39,18,4,6,0.9069767441860465,0.09302325581395349,0.75,0.25
SF-F30-2,SF-G29-3,3,5,2,4,1,1,0.6666666666666666,0.3333333333333333,0.8,0.2
SF-F30-2,SF-F29,5,11,4,9,1,2,0.8,0.2,0.8181818181818182,0.18181818181818182
SF-F30-2,SF-E29-3,5,10,4,10,1,0,0.8,0.2,1.0,0.0
SF-F30-2,SF-F28-1,8,32,6,30,2,2,0.75,0.25,0.9375,0.0625
SF-F30-2,SF-E28-2,16,7,15,5,1,2,0.9375,0.0625,0.7142857142857143,0.2857142857142857
SF-F30-2,SF-E28,4,1,3,0,1,1,0.75,0.25,0.0,1.0
SF-F30-2,SF-G13,1,2,0,2,1,0,0.0,1.0,1.0,0.0
SF-F30-2,SF-F15,2,1,0,1,2,0,0.0,1.0,1.0,0.0
SF-F30-2,SF-C21,1,2,0,2,1,0,0.0,1.0,1.0,0.0
SF-F30-2,SF-C20,3,5,2,3,1,2,0.6666666666666666,0.3333333333333333,0.6,0.4
SF-F30-2,SF-B21,4,9,1,7,3,2,0.25,0.75,0.7777777777777778,0.2222222222222222
SF-F30-2,SF-B19,9,17,4,8,5,9,0.4444444444444444,0.5555555555555556,0.47058823529411764,0.5294117647058824
SF-F30-2,SF-A20,22,29,7,15,15,14,0.3181818181818182,0.6818181818181818,0.5172413793103449,0.4827586206896552
SF-F30-2,SF-A19,1,8,0,8,1,0,0.0,1.0,1.0,0.0
SF-F30-2,SF-C26,14,9,8,4,6,5,0.5714285714285714,0.42857142857142855,0.4444444444444444,0.5555555555555556
SF-F30-2,SF-C25,8,14,5,8,3,6,0.625,0.375,0.5714285714285714,0.42857142857142855
SF-F30-2,SF-B25,4,11,1,6,3,5,0.25,0.75,0.5454545454545454,0.45454545454545453
SF-F30-2,SF-E27,7,8,6,4,1,4,0.8571428571428571,0.14285714285714285,0.5,0.5
SF-F30-2,SF-B28-2,9,3,6,3,3,0,0.6666666666666666,0.3333333333333333,1.0,0.0
SF-F30-2,SF-D27,8,8,6,5,2,3,0.75,0.25,0.625,0.375
SF-F30-2,SF-C28-2,4,2,1,0,3,2,0.25,0.75,0.0,1.0
SF-F30-2,SF-C28-1,15,25,13,25,2,0,0.8666666666666667,0.13333333333333333,1.0,0.0
SF-F30-2,SF-B28,41,22,37,17,4,5,0.9024390243902439,0.0975609756097561,0.7727272727272727,0.22727272727272727
SF-F30-2,SF-H25,1,1,1,1,0,0,1.0,0.0,1.0,0.0
SF-F30-2,SF-G26,18,20,16,12,2,8,0.8888888888888888,0.1111111111111111,0.6,0.4
SF-F30-2,SF-K21,8,2,1,0,7,2,0.125,0.875,0.0,1.0
SF-F30-2,SF-K22-1,5,3,3,0,2,3,0.6,0.4,0.0,1.0
SF-F30-2,SF-J23-1,28,8,10,1,18,7,0.35714285714285715,0.6428571428571429,0.125,0.875
SF-F30-2,SF-J22-1,2,2,0,0,2,2,0.0,1.0,0.0,1.0
SF-F30-2,SF-J22-2,1,2,1,1,0,1,1.0,0.0,0.5,0.5
SF-F30-2,SF-J21,8,3,4,2,4,1,0.5,0.5,0.6666666666666666,0.3333333333333333
SF-F30-2,SF-I22,3,2,1,0,2,2,0.3333333333333333,0.6666666666666666,0.0,1.0
SF-F30-2,SF-I23-2,4,3,1,3,3,0,0.25,0.75,1.0,0.0
SF-F30-2,SF-I23-1,26,2,1,2,25,0,0.038461538461538464,0.9615384615384616,1.0,0.0
SF-F30-2,SF-F26,41,39,29,14,12,25,0.7073170731707317,0.2926829268292683,0.358974358974359,0.6410256410256411
SF-F30-2,SF-M15,5,2,3,1,2,1,0.6,0.4,0.5,0.5
SF-F30-2,SF-L19,1,1,0,0,1,1,0.0,1.0,0.0,1.0
SF-F30-2,SF-L20,1,2,1,2,0,0,1.0,0.0,1.0,0.0
SF-F30-2,SF-M20,6,3,1,2,5,1,0.16666666666666666,0.8333333333333334,0.6666666666666666,0.3333333333333333
SF-F30-2,SF-K20,2,2,1,0,1,2,0.5,0.5,0.0,1.0
SF-F30-2,SF-K15-,2,3,1,0,1,3,0.5,0.5,0.0,1.0
SF-F30-2,SF-K19,4,3,1,0,3,3,0.25,0.75,0.0,1.0
SF-F30-2,SF-K18,6,5,3,1,3,4,0.5,0.5,0.2,0.8
SF-F30-2,SF-K17,9,6,6,0,3,6,0.6666666666666666,0.3333333333333333,0.0,1.0
SF-F30-2,SF-J16,2,1,1,0,1,1,0.5,0.5,0.0,1.0
SF-F30-2,SF-J18,3,1,1,0,2,1,0.3333333333333333,0.6666666666666666,0.0,1.0
SF-F30-2,SF-J20,3,1,1,0,2,1,0.3333333333333333,0.6666666666666666,0.0,1.0
SF-F30-2,SF-J19,1,6,1,0,0,6,1.0,0.0,0.0,1.0
SF-F30-2,SF-M11,1,2,0,0,1,2,0.0,1.0,0.0,1.0
SF-F30-2,SF-O18,3,2,0,0,3,2,0.0,1.0,0.0,1.0
SF-F30-2,SF-O21,6,5,2,0,4,5,0.3333333333333333,0.6666666666666666,0.0,1.0
SF-F30-2,SF-N21,3,2,1,1,2,1,0.3333333333333333,0.6666666666666666,0.5,0.5
SF-F30-2,SF-M21,19,21,19,19,0,2,1.0,0.0,0.9047619047619048,0.09523809523809523
SF-F30-2,SF-L21,7,8,2,3,5,5,0.2857142857142857,0.7142857142857143,0.375,0.625
SF-F30-2,SF-Q30,6,12,3,4,3,8,0.5,0.5,0.3333333333333333,0.6666666666666666
SF-F30-2,SF-P30,2,1,1,1,1,0,0.5,0.5,1.0,0.0
SF-F30-2,SF-O30-2,4,6,4,1,0,5,1.0,0.0,0.16666666666666666,0.8333333333333334
SF-F30-2,SF-O30,3,7,2,2,1,5,0.6666666666666666,0.3333333333333333,0.2857142857142857,0.7142857142857143
SF-F30-2,SF-N27,5,8,3,0,2,8,0.6,0.4,0.0,1.0
SF-F30-2,SF-N29,3,1,1,1,2,0,0.3333333333333333,0.6666666666666666,1.0,0.0
SF-F30-2,SF-N28,1,4,0,1,1,3,0.0,1.0,0.25,0.75
SF-F30-2,SF-L30-1,16,12,9,7,7,5,0.5625,0.4375,0.5833333333333334,0.4166666666666667
SF-F30-2,SF-L31-1,13,6,7,3,6,3,0.5384615384615384,0.46153846153846156,0.5,0.5
SF-F30-2,SF-K30-2,42,50,41,46,1,4,0.9761904761904762,0.023809523809523808,0.92,0.08
SF-F30-2,SF-L29,50,47,37,38,13,9,0.74,0.26,0.8085106382978723,0.19148936170212766
SF-F30-2,SF-J29-1,24,5,21,2,3,3,0.875,0.125,0.4,0.6
SF-F30-2,SF-I30,7,8,4,7,3,1,0.5714285714285714,0.42857142857142855,0.875,0.125
SF-F30-2,SF-I29-2,6,2,3,2,3,0,0.5,0.5,1.0,0.0
SF-F30-2,SF-I27,21,8,13,5,8,3,0.6190476190476191,0.38095238095238093,0.625,0.375
SF-F30-2,SF-I28,21,9,14,5,7,4,0.6666666666666666,0.3333333333333333,0.5555555555555556,0.4444444444444444
SF-F30-2,SF-I30-2,12,3,9,0,3,3,0.75,0.25,0.0,1.0
SF-F30-2,SF I29-1,4,4,2,0,2,4,0.5,0.5,0.0,1.0
SF-F30-2,SF-H28,20,10,11,4,9,6,0.55,0.45,0.4,0.6
SF-F30-2,SF-H29,5,3,5,2,0,1,1.0,0.0,0.6666666666666666,0.3333333333333333
SF-F30-2,SF-S24,2,3,2,1,0,2,1.0,0.0,0.3333333333333333,0.6666666666666666
SF-F30-2,SF-R24,3,7,2,2,1,5,0.6666666666666666,0.3333333333333333,0.2857142857142857,0.7142857142857143
SF-F30-2,SF-P26,1,1,1,1,0,0,1.0,0.0,1.0,0.0
SF-F30-2,SF-Q23-3,1,2,0,0,1,2,0.0,1.0,0.0,1.0
SF-F30-2,SF-P22,1,1,0,0,1,1,0.0,1.0,0.0,1.0
SF-F30-2,SF-W19,1,1,0,0,1,1,0.0,1.0,0.0,1.0
SF-F30-2,SF-U21,3,3,0,1,3,2,0.0,1.0,0.3333333333333333,0.6666666666666666
SF-F30-2,SF-S21,1,3,0,0,1,3,0.0,1.0,0.0,1.0
SF-F30-2,SF-Y14,5,4,0,0,5,4,0.0,1.0,0.0,1.0
SF-F29,SF-M25,1,4,1,2,0,2,1.0,0.0,0.5,0.5
SF-F29,SF-M26-2,45,18,1,2,44,16,0.022222222222222223,0.9777777777777777,0.1111111111111111,0.8888888888888888
SF-F29,SF-L27,1,2,0,0,1,2,0.0,1.0,0.0,1.0
SF-F29,SF-K26,2,3,0,0,2,3,0.0,1.0,0.0,1.0
SF-F29,SF-J27,4,3,1,1,3,2,0.25,0.75,0.3333333333333333,0.6666666666666666
SF-F29,SF-M30,61,39,28,26,33,13,0.45901639344262296,0.5409836065573771,0.6666666666666666,0.3333333333333333
SF-F29,SF-J29-3,7,10,4,7,3,3,0.5714285714285714,0.42857142857142855,0.7,0.3
SF-F29,SF-J29,20,8,8,7,12,1,0.4,0.6,0.875,0.125
SF-F29,SF-L26,1,2,0,2,1,0,0.0,1.0,1.0,0.0
SF-F29,SF-M28,2,5,0,2,2,3,0.0,1.0,0.4,0.6
SF-F29,SF-L25,1,3,1,3,0,0,1.0,0.0,1.0,0.0
SF-F29,SF-M24,1,6,1,4,0,2,1.0,0.0,0.6666666666666666,0.3333333333333333
SF-F29,SF-N23,2,8,1,6,1,2,0.5,0.5,0.75,0.25
SF-F29,SF-K27-2,2,3,1,3,1,0,0.5,0.5,1.0,0.0
SF-F29,SF-J26-2,22,12,7,5,15,7,0.3181818181818182,0.6818181818181818,0.4166666666666667,0.5833333333333334
SF-F29,SF-L28,4,4,2,1,2,3,0.5,0.5,0.25,0.75
SF-F29,SF-K29-1,47,49,38,43,9,6,0.8085106382978723,0.19148936170212766,0.8775510204081632,0.12244897959183673
SF-F29,SF-J28-2,5,2,1,1,4,1,0.2,0.8,0.5,0.5
SF-F29,SF-K25,2,23,2,5,0,18,1.0,0.0,0.21739130434782608,0.782608695652174
SF-F29,SF-J25,19,118,11,98,8,20,0.5789473684210527,0.42105263157894735,0.8305084745762712,0.1694915254237288
SF-F29,SF-H26-2,4,10,1,7,3,3,0.25,0.75,0.7,0.3
SF-F29,SF-J24,4,8,4,3,0,5,1.0,0.0,0.375,0.625
SF-F29,SF-O24,1,2,0,0,1,2,0.0,1.0,0.0,1.0
SF-F29,SF-J26,3,13,2,10,1,3,0.6666666666666666,0.3333333333333333,0.7692307692307693,0.23076923076923078
SF-F29,SF-I26-,12,31,12,26,0,5,1.0,0.0,0.8387096774193549,0.16129032258064516
SF-F29,SF-I25,53,8,47,7,6,1,0.8867924528301887,0.11320754716981132,0.875,0.125
SF-F29,SF-H26,7,10,5,6,2,4,0.7142857142857143,0.2857142857142857,0.6,0.4
SF-F29,SF-O23,3,2,0,0,3,2,0.0,1.0,0.0,1.0
SF-F29,SF-H27-1,20,38,12,30,8,8,0.6,0.4,0.7894736842105263,0.21052631578947367
SF-F29,SF-F28-2,19,40,9,15,10,25,0.47368421052631576,0.5263157894736842,0.375,0.625
SF-F29,SF-G27,48,28,26,23,22,5,0.5416666666666666,0.4583333333333333,0.8214285714285714,0.17857142857142858
SF-F29,SF-M22-2,2,5,1,1,1,4,0.5,0.5,0.2,0.8
SF-F29,SF-L22,2,3,0,1,2,2,0.0,1.0,0.3333333333333333,0.6666666666666666
SF-F29,SF-F27,22,24,9,18,13,6,0.4090909090909091,0.5909090909090909,0.75,0.25
SF-F29,SF-G28-2,16,2,7,1,9,1,0.4375,0.5625,0.5,0.5
SF-F29,SF-G28-1,12,37,7,31,5,6,0.5833333333333334,0.4166666666666667,0.8378378378378378,0.16216216216216217
SF-F29,SF-M22-1,3,1,2,1,1,0,0.6666666666666666,0.3333333333333333,1.0,0.0
SF-F29,SF-K22-2,4,8,3,4,1,4,0.75,0.25,0.5,0.5
SF-F29,SF-K24,4,9,2,7,2,2,0.5,0.5,0.7777777777777778,0.2222222222222222
SF-F29,SF-J23-2,2,1,1,1,1,0,0.5,0.5,1.0,0.0
SF-F29,SF-G23,7,2,1,0,6,2,0.14285714285714285,0.8571428571428571,0.0,1.0
SF-F29,SF-G24,22,5,15,2,7,3,0.6818181818181818,0.3181818181818182,0.4,0.6
SF-F29,SF-G25,8,6,1,1,7,5,0.125,0.875,0.16666666666666666,0.8333333333333334
SF-F29,SF-F23,11,4,1,0,10,4,0.09090909090909091,0.9090909090909091,0.0,1.0
SF-F29,SF-E23,5,1,2,0,3,1,0.4,0.6,0.0,1.0
SF-F29,SF-C22,1,8,1,1,0,7,1.0,0.0,0.125,0.875
SF-F29,SF-B22,5,13,1,11,4,2,0.2,0.8,0.8461538461538461,0.15384615384615385
SF-F29,SF-I19,10,3,6,0,4,3,0.6,0.4,0.0,1.0
SF-F29,SF-G19,2,1,1,0,1,1,0.5,0.5,0.0,1.0
SF-F29,SF-G18,1,2,1,0,0,2,1.0,0.0,0.0,1.0
SF-F29,SF-G20,12,8,7,2,5,6,0.5833333333333334,0.4166666666666667,0.25,0.75
SF-F29,SF-E18,2,1,1,1,1,0,0.5,0.5,1.0,0.0
SF-F29,SF-E20,3,1,2,0,1,1,0.6666666666666666,0.3333333333333333,0.0,1.0
SF-F29,SF-H30,5,6,3,6,2,0,0.6,0.4,1.0,0.0
SF-F29,SF-G30-2,11,15,5,8,6,7,0.45454545454545453,0.5454545454545454,0.5333333333333333,0.4666666666666667
SF-F29,SF-F30-1,11,7,8,5,3,2,0.7272727272727273,0.2727272727272727,0.7142857142857143,0.2857142857142857
SF-F29,SF-E29-2,9,18,6,11,3,7,0.6666666666666666,0.3333333333333333,0.6111111111111112,0.3888888888888889
SF-F29,SF-E29-1,8,14,6,13,2,1,0.75,0.25,0.9285714285714286,0.07142857142857142
SF-F29,SF-D29,1,14,1,10,0,4,1.0,0.0,0.7142857142857143,0.2857142857142857
SF-F29,SF-D28,21,15,12,13,9,2,0.5714285714285714,0.42857142857142855,0.8666666666666667,0.13333333333333333
SF-F29,SF-A27,34,25,30,16,4,9,0.8823529411764706,0.11764705882352941,0.64,0.36
SF-F29,SF-G29-2,26,17,15,8,11,9,0.5769230769230769,0.4230769230769231,0.47058823529411764,0.5294117647058824
SF-F29,SF-G29-1,19,13,12,9,7,4,0.631578947368421,0.3684210526315789,0.6923076923076923,0.3076923076923077
SF-F29,SF-G30-1,27,18,22,9,5,9,0.8148148148148148,0.18518518518518517,0.5,0.5
SF-F29,SF-G29-3,16,15,11,5,5,10,0.6875,0.3125,0.3333333333333333,0.6666666666666666
SF-F29,SF-F30-2,11,5,9,4,2,1,0.8181818181818182,0.18181818181818182,0.8,0.2
SF-F29,SF-E29-3,23,10,20,7,3,3,0.8695652173913043,0.13043478260869565,0.7,0.3
SF-F29,SF-F28-1,38,28,19,17,19,11,0.5,0.5,0.6071428571428571,0.39285714285714285
SF-F29,SF-E28-2,2,5,1,3,1,2,0.5,0.5,0.6,0.4
SF-F29,SF-E28,14,33,11,6,3,27,0.7857142857142857,0.21428571428571427,0.18181818181818182,0.8181818181818182
SF-F29,SF-J12,9,2,0,0,9,2,0.0,1.0,0.0,1.0
SF-F29,SF-I16,2,1,0,0,2,1,0.0,1.0,0.0,1.0
SF-F29,SF-H12,11,10,0,0,11,10,0.0,1.0,0.0,1.0
SF-F29,SF-C21,1,3,1,0,0,3,1.0,0.0,0.0,1.0
SF-F29,SF-C20,3,2,2,2,1,0,0.6666666666666666,0.3333333333333333,1.0,0.0
SF-F29,SF-B19,13,13,4,7,9,6,0.3076923076923077,0.6923076923076923,0.5384615384615384,0.46153846153846156
SF-F29,SF-A20,13,17,12,15,1,2,0.9230769230769231,0.07692307692307693,0.8823529411764706,0.11764705882352941
SF-F29,SF-A19,5,2,5,0,0,2,1.0,0.0,0.0,1.0
SF-F29,SF-C26,11,8,4,5,7,3,0.36363636363636365,0.6363636363636364,0.625,0.375
SF-F29,SF-C25,9,2,4,0,5,2,0.4444444444444444,0.5555555555555556,0.0,1.0
SF-F29,SF-B25,11,24,6,15,5,9,0.5454545454545454,0.45454545454545453,0.625,0.375
SF-F29,SF-E27,1,5,1,3,0,2,1.0,0.0,0.6,0.4
SF-F29,SF-B28-2,12,6,11,6,1,0,0.9166666666666666,0.08333333333333333,1.0,0.0
SF-F29,SF-D27,29,13,12,11,17,2,0.41379310344827586,0.5862068965517241,0.8461538461538461,0.15384615384615385
SF-F29,SF-C28-1,3,4,3,4,0,0,1.0,0.0,1.0,0.0
SF-F29,SF-B28,13,21,10,17,3,4,0.7692307692307693,0.23076923076923078,0.8095238095238095,0.19047619047619047
SF-F29,SF-G26,8,2,5,0,3,2,0.625,0.375,0.0,1.0
SF-F29,SF-K21,9,2,3,0,6,2,0.3333333333333333,0.6666666666666666,0.0,1.0
SF-F29,SF-K22-1,1,1,0,0,1,1,0.0,1.0,0.0,1.0
SF-F29,SF-J23-1,16,7,9,5,7,2,0.5625,0.4375,0.7142857142857143,0.2857142857142857
SF-F29,SF-J22-1,3,3,1,0,2,3,0.3333333333333333,0.6666666666666666,0.0,1.0
SF-F29,SF-J22-2,6,3,4,1,2,2,0.6666666666666666,0.3333333333333333,0.3333333333333333,0.6666666666666666
SF-F29,SF-J21,7,4,5,4,2,0,0.7142857142857143,0.2857142857142857,1.0,0.0
SF-F29,SF-I21,1,1,1,1,0,0,1.0,0.0,1.0,0.0
SF-F29,SF-I23-2,4,2,3,1,1,1,0.75,0.25,0.5,0.5
SF-F29,SF-I24,2,5,2,3,0,2,1.0,0.0,0.6,0.4
SF-F29,SF-I23-1,4,5,4,5,0,0,1.0,0.0,1.0,0.0
SF-F29,SF-F26,22,16,6,9,16,7,0.2727272727272727,0.7272727272727273,0.5625,0.4375
SF-F29,SF-M13,5,12,3,0,2,12,0.6,0.4,0.0,1.0
SF-F29,SF-M15,5,4,3,1,2,3,0.6,0.4,0.25,0.75
SF-F29,SF-L20,1,2,1,0,0,2,1.0,0.0,0.0,1.0
SF-F29,SF-M20,9,4,3,0,6,4,0.3333333333333333,0.6666666666666666,0.0,1.0
SF-F29,SF-K20,2,4,2,0,0,4,1.0,0.0,0.0,1.0
SF-F29,SF-K18,9,3,2,0,7,3,0.2222222222222222,0.7777777777777778,0.0,1.0
SF-F29,SF-K17,2,1,1,0,1,1,0.5,0.5,0.0,1.0
SF-F29,SF-J16,3,1,1,0,2,1,0.3333333333333333,0.6666666666666666,0.0,1.0
SF-F29,SF-J18,8,4,1,1,7,3,0.125,0.875,0.25,0.75
SF-F29,SF-M12,1,4,0,0,1,4,0.0,1.0,0.0,1.0
SF-F29,SF-R19,1,2,0,1,1,1,0.0,1.0,0.5,0.5
SF-F29,SF-P21,1,2,0,2,1,0,0.0,1.0,1.0,0.0
SF-F29,SF-O18,5,3,1,1,4,2,0.2,0.8,0.3333333333333333,0.6666666666666666
SF-F29,SF-O19,1,4,0,0,1,4,0.0,1.0,0.0,1.0
SF-F29,SF-O21,4,7,2,6,2,1,0.5,0.5,0.8571428571428571,0.14285714285714285
SF-F29,SF-O22,2,4,0,2,2,2,0.0,1.0,0.5,0.5
SF-F29,SF-N20-2,2,1,2,0,0,1,1.0,0.0,0.0,1.0
SF-F29,SF-L21,12,7,3,1,9,6,0.25,0.75,0.14285714285714285,0.8571428571428571
SF-F29,SF-S30,1,1,1,1,0,0,1.0,0.0,1.0,0.0
SF-F29,SF-Q30,6,3,0,1,6,2,0.0,1.0,0.3333333333333333,0.6666666666666666
SF-F29,SF-P30,6,3,5,3,1,0,0.8333333333333334,0.16666666666666666,1.0,0.0
SF-F29,SF-O30-2,1,2,1,2,0,0,1.0,0.0,1.0,0.0
SF-F29,SF-O30,34,23,24,11,10,12,0.7058823529411765,0.29411764705882354,0.4782608695652174,0.5217391304347826
SF-F29,SF-N27,2,17,2,2,0,15,1.0,0.0,0.11764705882352941,0.8823529411764706
SF-F29,SF-N29,1,2,1,0,0,2,1.0,0.0,0.0,1.0
SF-F29,SF-N28,2,2,0,0,2,2,0.0,1.0,0.0,1.0
SF-F29,SF-L30-1,12,39,6,32,6,7,0.5,0.5,0.8205128205128205,0.1794871794871795
SF-F29,SF-L31-1,16,19,9,15,7,4,0.5625,0.4375,0.7894736842105263,0.21052631578947367
SF-F29,SF-L29,24,23,5,11,19,12,0.20833333333333334,0.7916666666666666,0.4782608695652174,0.5217391304347826
SF-F29,SF-J29-1,5,9,5,6,0,3,1.0,0.0,0.6666666666666666,0.3333333333333333
SF-F29,SF-I30,7,2,7,2,0,0,1.0,0.0,1.0,0.0
SF-F29,SF-I29-2,1,3,1,0,0,3,1.0,0.0,0.0,1.0
SF-F29,SF-I27,14,8,7,4,7,4,0.5,0.5,0.5,0.5
SF-F29,SF-I28,8,23,4,17,4,6,0.5,0.5,0.7391304347826086,0.2608695652173913
SF-F29,SF-I30-2,12,1,8,1,4,0,0.6666666666666666,0.3333333333333333,1.0,0.0
SF-F29,SF I29-1,7,2,3,0,4,2,0.42857142857142855,0.5714285714285714,0.0,1.0
SF-F29,SF-H28,28,14,9,5,19,9,0.32142857142857145,0.6785714285714286,0.35714285714285715,0.6428571428571429
SF-F29,SF-H29,2,2,1,2,1,0,0.5,0.5,1.0,0.0
SF-F29,SF-R24,1,18,0,2,1,16,0.0,1.0,0.1111111111111111,0.8888888888888888
SF-F29,SF-N22-1B,1,1,0,0,1,1,0.0,1.0,0.0,1.0
SF-F29,SF-Q23-3,3,1,0,1,3,0,0.0,1.0,1.0,0.0
SF-F29,SF-Q22-1,2,2,2,1,0,1,1.0,0.0,0.5,0.5
SF-F29,SF-P22,1,1,1,1,0,0,1.0,0.0,1.0,0.0
SF-F29,SF-Y25,3,4,0,0,3,4,0.0,1.0,0.0,1.0
SF-E29-3,SF-M26-2,2,2,0,0,2,2,0.0,1.0,0.0,1.0
SF-E29-3,SF-J27,3,2,0,0,3,2,0.0,1.0,0.0,1.0
SF-E29-3,SF-M30,11,51,4,6,7,45,0.36363636363636365,0.6363636363636364,0.11764705882352941,0.8823529411764706
SF-E29-3,SF-L27-2,1,1,0,0,1,1,0.0,1.0,0.0,1.0
SF-E29-3,SF-J29-3,1,8,1,3,0,5,1.0,0.0,0.375,0.625
SF-E29-3,SF-J29,4,6,0,2,4,4,0.0,1.0,0.3333333333333333,0.6666666666666666
SF-E29-3,SF-M28,2,4,0,1,2,3,0.0,1.0,0.25,0.75
SF-E29-3,SF-M24,3,1,1,1,2,0,0.3333333333333333,0.6666666666666666,1.0,0.0
SF-E29-3,SF-N23,3,3,2,0,1,3,0.6666666666666666,0.3333333333333333,0.0,1.0
SF-E29-3,SF-N24-2,3,19,1,0,2,19,0.3333333333333333,0.6666666666666666,0.0,1.0
SF-E29-3,SF-K29-1,16,48,9,12,7,36,0.5625,0.4375,0.25,0.75
SF-E29-3,SF-J25,1,10,0,3,1,7,0.0,1.0,0.3,0.7
SF-E29-3,SF-H26-2,6,2,4,1,2,1,0.6666666666666666,0.3333333333333333,0.5,0.5
SF-E29-3,SF-P24,55,65,2,1,53,64,0.03636363636363636,0.9636363636363636,0.015384615384615385,0.9846153846153847
SF-E29-3,SF-J24,3,3,1,2,2,1,0.3333333333333333,0.6666666666666666,0.6666666666666666,0.3333333333333333
SF-E29-3,SF-O24,43,19,0,0,43,19,0.0,1.0,0.0,1.0
SF-E29-3,SF-J26,3,1,2,0,1,1,0.6666666666666666,0.3333333333333333,0.0,1.0
SF-E29-3,SF-I26-,3,3,2,1,1,2,0.6666666666666666,0.3333333333333333,0.3333333333333333,0.6666666666666666
SF-E29-3,SF-I25,46,31,28,23,18,8,0.6086956521739131,0.391304347826087,0.7419354838709677,0.25806451612903225
SF-E29-3,SF-H26,16,24,10,14,6,10,0.625,0.375,0.5833333333333334,0.4166666666666667
SF-E29-3,SF-O23,16,3,0,0,16,3,0.0,1.0,0.0,1.0
SF-E29-3,SF-H27-1,7,5,7,3,0,2,1.0,0.0,0.6,0.4
SF-E29-3,SF-F28-2,29,40,18,23,11,17,0.6206896551724138,0.3793103448275862,0.575,0.425
SF-E29-3,SF-G27,63,35,28,19,35,16,0.4444444444444444,0.5555555555555556,0.5428571428571428,0.45714285714285713
SF-E29-3,SF-M22-2,4,4,4,0,0,4,1.0,0.0,0.0,1.0
SF-E29-3,SF-L22,10,4,4,0,6,4,0.4,0.6,0.0,1.0
SF-E29-3,SF-F27,18,16,5,2,13,14,0.2777777777777778,0.7222222222222222,0.125,0.875
SF-E29-3,SF-N22-2,3,3,1,0,2,3,0.3333333333333333,0.6666666666666666,0.0,1.0
SF-E29-3,SF-M22-1,3,2,0,0,3,2,0.0,1.0,0.0,1.0
SF-E29-3,SF-K22-2,6,3,6,2,0,1,1.0,0.0,0.6666666666666666,0.3333333333333333
SF-E29-3,SF-J23-2,14,8,12,4,2,4,0.8571428571428571,0.14285714285714285,0.5,0.5
SF-E29-3,SF-G23,2,1,1,0,1,1,0.5,0.5,0.0,1.0
SF-E29-3,SF-G24,11,18,4,0,7,18,0.36363636363636365,0.6363636363636364,0.0,1.0
SF-E29-3,SF-G25,6,10,2,1,4,9,0.3333333333333333,0.6666666666666666,0.1,0.9
SF-E29-3,SF-F23,6,3,3,0,3,3,0.5,0.5,0.0,1.0
SF-E29-3,SF-E23,7,3,2,1,5,2,0.2857142857142857,0.7142857142857143,0.3333333333333333,0.6666666666666666
SF-E29-3,SF-D24,10,3,4,0,6,3,0.4,0.6,0.0,1.0
SF-E29-3,SF-C22,9,7,3,1,6,6,0.3333333333333333,0.6666666666666666,0.14285714285714285,0.8571428571428571
SF-E29-3,SF-B22,5,16,3,12,2,4,0.6,0.4,0.75,0.25
SF-E29-3,SF-J17,68,2,4,0,64,2,0.058823529411764705,0.9411764705882353,0.0,1.0
SF-E29-3,SF-H20,1,1,0,0,1,1,0.0,1.0,0.0,1.0
SF-E29-3,SF-H18,7,3,0,0,7,3,0.0,1.0,0.0,1.0
SF-E29-3,SF-G19,4,2,4,0,0,2,1.0,0.0,0.0,1.0
SF-E29-3,SF-G18,17,28,1,0,16,28,0.058823529411764705,0.9411764705882353,0.0,1.0
SF-E29-3,SF-G20,9,3,0,2,9,1,0.0,1.0,0.6666666666666666,0.3333333333333333
SF-E29-3,SF-E20,2,5,0,0,2,5,0.0,1.0,0.0,1.0
SF-E29-3,SF-H30,7,7,5,5,2,2,0.7142857142857143,0.2857142857142857,0.7142857142857143,0.2857142857142857
SF-E29-3,SF-G30-2,16,32,10,8,6,24,0.625,0.375,0.25,0.75
SF-E29-3,SF-F30-1,4,3,4,3,0,0,1.0,0.0,1.0,0.0
SF-E29-3,SF-E29-2,29,20,23,12,6,8,0.7931034482758621,0.20689655172413793,0.6,0.4
SF-E29-3,SF-E29-1,9,16,7,13,2,3,0.7777777777777778,0.2222222222222222,0.8125,0.1875
SF-E29-3,SF-D29,8,21,7,14,1,7,0.875,0.125,0.6666666666666666,0.3333333333333333
SF-E29-3,SF-D28,53,20,12,16,41,4,0.22641509433962265,0.7735849056603774,0.8,0.2
SF-E29-3,SF-A27,154,161,151,150,3,11,0.9805194805194806,0.01948051948051948,0.9316770186335404,0.06832298136645963
SF-E29-3,SF-G29-2,84,49,30,15,54,34,0.35714285714285715,0.6428571428571429,0.30612244897959184,0.6938775510204082
SF-E29-3,SF-G29-1,3,4,2,2,1,2,0.6666666666666666,0.3333333333333333,0.5,0.5
SF-E29-3,SF-G30-1,52,85,40,47,12,38,0.7692307692307693,0.23076923076923078,0.5529411764705883,0.4470588235294118
SF-E29-3,SF-G29-3,16,14,10,11,6,3,0.625,0.375,0.7857142857142857,0.21428571428571427
SF-E29-3,SF-F30-2,10,5,10,4,0,1,1.0,0.0,0.8,0.2
SF-E29-3,SF-F29,10,23,7,20,3,3,0.7,0.3,0.8695652173913043,0.13043478260869565
SF-E29-3,SF-F28-1,32,19,28,6,4,13,0.875,0.125,0.3157894736842105,0.6842105263157895
SF-E29-3,SF-E28-2,23,24,21,7,2,17,0.9130434782608695,0.08695652173913043,0.2916666666666667,0.7083333333333334
SF-E29-3,SF-E28,34,14,2,8,32,6,0.058823529411764705,0.9411764705882353,0.5714285714285714,0.42857142857142855
SF-E29-3,SF-J13,1,1,0,0,1,1,0.0,1.0,0.0,1.0
SF-E29-3,SF-J15,1,5,0,0,1,5,0.0,1.0,0.0,1.0
SF-E29-3,SF-I16,10,5,0,0,10,5,0.0,1.0,0.0,1.0
SF-E29-3,SF-H12,1,1,0,0,1,1,0.0,1.0,0.0,1.0
SF-E29-3,SF-F15,1,1,0,0,1,1,0.0,1.0,0.0,1.0
SF-E29-3,SF-C20,2,4,0,2,2,2,0.0,1.0,0.5,0.5
SF-E29-3,SF-B19,11,10,6,4,5,6,0.5454545454545454,0.45454545454545453,0.4,0.6
SF-E29-3,SF-A20,27,79,26,68,1,11,0.9629629629629629,0.037037037037037035,0.8607594936708861,0.13924050632911392
SF-E29-3,SF-A19,6,4,4,2,2,2,0.6666666666666666,0.3333333333333333,0.5,0.5
SF-E29-3,SF-C26,10,15,6,7,4,8,0.6,0.4,0.4666666666666667,0.5333333333333333
SF-E29-3,SF-C25,13,22,8,8,5,14,0.6153846153846154,0.38461538461538464,0.36363636363636365,0.6363636363636364
SF-E29-3,SF-B25,33,36,5,9,28,27,0.15151515151515152,0.8484848484848485,0.25,0.75
SF-E29-3,SF-E27,6,3,3,3,3,0,0.5,0.5,1.0,0.0
SF-E29-3,SF-B28-2,9,23,5,8,4,15,0.5555555555555556,0.4444444444444444,0.34782608695652173,0.6521739130434783
SF-E29-3,SF-D27,6,12,6,10,0,2,1.0,0.0,0.8333333333333334,0.16666666666666666
SF-E29-3,SF-C28-1,5,3,3,3,2,0,0.6,0.4,1.0,0.0
SF-E29-3,SF-B28,30,26,19,16,11,10,0.6333333333333333,0.36666666666666664,0.6153846153846154,0.38461538461538464
SF-E29-3,SF-J3,2,4,0,0,2,4,0.0,1.0,0.0,1.0
SF-E29-3,SF-H25,1,4,1,3,0,1,1.0,0.0,0.75,0.25
SF-E29-3,SF-G26,3,8,0,1,3,7,0.0,1.0,0.125,0.875
SF-E29-3,SF-K21,6,5,2,2,4,3,0.3333333333333333,0.6666666666666666,0.4,0.6
SF-E29-3,SF-K22-1,6,8,4,6,2,2,0.6666666666666666,0.3333333333333333,0.75,0.25
SF-E29-3,SF-J23-1,52,42,27,15,25,27,0.5192307692307693,0.4807692307692308,0.35714285714285715,0.6428571428571429
SF-E29-3,SF-J22-1,3,8,0,2,3,6,0.0,1.0,0.25,0.75
SF-E29-3,SF-J22-2,2,25,1,4,1,21,0.5,0.5,0.16,0.84
SF-E29-3,SF-J21,3,6,2,4,1,2,0.6666666666666666,0.3333333333333333,0.6666666666666666,0.3333333333333333
SF-E29-3,SF-I23-2,9,10,7,2,2,8,0.7777777777777778,0.2222222222222222,0.2,0.8
SF-E29-3,SF-I24,2,1,2,1,0,0,1.0,0.0,1.0,0.0
SF-E29-3,SF-I23-1,20,7,6,3,14,4,0.3,0.7,0.42857142857142855,0.5714285714285714
SF-E29-3,SF-F26,8,8,5,0,3,8,0.625,0.375,0.0,1.0
SF-E29-3,SF-M13,25,32,21,0,4,32,0.84,0.16,0.0,1.0
SF-E29-3,SF-M15,6,5,2,1,4,4,0.3333333333333333,0.6666666666666666,0.2,0.8
SF-E29-3,SF-L19,32,5,1,0,31,5,0.03125,0.96875,0.0,1.0
SF-E29-3,SF-L20,10,3,4,2,6,1,0.4,0.6,0.6666666666666666,0.3333333333333333
SF-E29-3,SF-N20-1,3,3,0,1,3,2,0.0,1.0,0.3333333333333333,0.6666666666666666
SF-E29-3,SF-M20,72,31,9,3,63,28,0.125,0.875,0.0967741935483871,0.9032258064516129
SF-E29-3,SF-K20,13,8,4,1,9,7,0.3076923076923077,0.6923076923076923,0.125,0.875
SF-E29-3,SF-K15-,4,3,1,0,3,3,0.25,0.75,0.0,1.0
SF-E29-3,SF-K19,11,12,3,3,8,9,0.2727272727272727,0.7272727272727273,0.25,0.75
SF-E29-3,SF-K17,2,4,1,0,1,4,0.5,0.5,0.0,1.0
SF-E29-3,SF-J18,34,30,3,0,31,30,0.08823529411764706,0.9117647058823529,0.0,1.0
SF-E29-3,SF-J20,4,6,2,3,2,3,0.5,0.5,0.5,0.5
SF-E29-3,SF-J19,21,6,4,0,17,6,0.19047619047619047,0.8095238095238095,0.0,1.0
SF-E29-3,SF-M12,1,1,0,0,1,1,0.0,1.0,0.0,1.0
SF-E29-3,SF-R19,3,2,1,1,2,1,0.3333333333333333,0.6666666666666666,0.5,0.5
SF-E29-3,SF-Q21-1,5,3,2,1,3,2,0.4,0.6,0.3333333333333333,0.6666666666666666
SF-E29-3,SF-P21,1,2,1,0,0,2,1.0,0.0,0.0,1.0
SF-E29-3,SF-O18,11,6,0,2,11,4,0.0,1.0,0.3333333333333333,0.6666666666666666
SF-E29-3,SF-O19,3,3,3,0,0,3,1.0,0.0,0.0,1.0
SF-E29-3,SF-O21,3,11,0,5,3,6,0.0,1.0,0.45454545454545453,0.5454545454545454
SF-E29-3,SF-O22,7,11,2,7,5,4,0.2857142857142857,0.7142857142857143,0.6363636363636364,0.36363636363636365
SF-E29-3,SF-N21,1,1,0,0,1,1,0.0,1.0,0.0,1.0
SF-E29-3,SF-M21,15,8,7,3,8,5,0.4666666666666667,0.5333333333333333,0.375,0.625
SF-E29-3,SF-L21,73,63,36,7,37,56,0.4931506849315068,0.5068493150684932,0.1111111111111111,0.8888888888888888
SF-E29-3,SF-Q30,9,7,9,2,0,5,1.0,0.0,0.2857142857142857,0.7142857142857143
SF-E29-3,SF-P30,1,3,0,2,1,1,0.0,1.0,0.6666666666666666,0.3333333333333333
SF-E29-3,SF-O30,3,10,1,5,2,5,0.3333333333333333,0.6666666666666666,0.5,0.5
SF-E29-3,SF-N27,6,6,1,1,5,5,0.16666666666666666,0.8333333333333334,0.16666666666666666,0.8333333333333334
SF-E29-3,SF-N29,2,3,1,2,1,1,0.5,0.5,0.6666666666666666,0.3333333333333333
SF-E29-3,SF-N28,1,1,0,0,1,1,0.0,1.0,0.0,1.0
SF-E29-3,SF-L30-1,71,123,39,103,32,20,0.5492957746478874,0.4507042253521127,0.8373983739837398,0.16260162601626016
SF-E29-3,SF-K30-2,30,79,29,77,1,2,0.9666666666666667,0.03333333333333333,0.9746835443037974,0.02531645569620253
SF-E29-3,SF-L29,2,5,1,1,1,4,0.5,0.5,0.2,0.8
SF-E29-3,SF-J29-1,3,5,1,3,2,2,0.3333333333333333,0.6666666666666666,0.6,0.4
SF-E29-3,SF-I30,1,6,1,3,0,3,1.0,0.0,0.5,0.5
SF-E29-3,SF-I27,2,1,1,1,1,0,0.5,0.5,1.0,0.0
SF-E29-3,SF-I28,5,4,3,1,2,3,0.6,0.4,0.25,0.75
SF-E29-3,SF-I30-2,3,7,2,3,1,4,0.6666666666666666,0.3333333333333333,0.42857142857142855,0.5714285714285714
SF-E29-3,SF I29-1,4,3,1,1,3,2,0.25,0.75,0.3333333333333333,0.6666666666666666
SF-E29-3,SF-H28,9,6,7,3,2,3,0.7777777777777778,0.2222222222222222,0.5,0.5
SF-E29-3,SF-N22-1B,2,2,2,2,0,0,1.0,0.0,1.0,0.0
SF-E29-3,SF-T22,2,2,0,1,2,1,0.0,1.0,0.5,0.5
SF-E29-3,SF-Q23-3,4,2,2,2,2,0,0.5,0.5,1.0,0.0
SF-E29-3,SF-Q22-1,22,17,21,16,1,1,0.9545454545454546,0.045454545454545456,0.9411764705882353,0.058823529411764705
SF-E29-3,SF-Q22-2,9,12,7,2,2,10,0.7777777777777778,0.2222222222222222,0.16666666666666666,0.8333333333333334
SF-E29-3,SF-P22,4,3,2,0,2,3,0.5,0.5,0.0,1.0
SF-E29-3,SF-T20,3,2,0,1,3,1,0.0,1.0,0.5,0.5
SF-E29-3,SF-S21,2,1,0,0,2,1,0.0,1.0,0.0,1.0
SF-E29-3,SF-V30,6,7,2,0,4,7,0.3333333333333333,0.6666666666666666,0.0,1.0
SF-E29-3,SF-BB17,1,1,1,1,0,0,1.0,0.0,1.0,0.0
SF-E29-3,SF-Y14,2,2,0,0,2,2,0.0,1.0,0.0,1.0
SF-F28-1,SF-M26-2,8,2,6,2,2,0,0.75,0.25,1.0,0.0
SF-F28-1,SF-K26,3,2,1,0,2,2,0.3333333333333333,0.6666666666666666,0.0,1.0
SF-F28-1,SF-J27,7,4,0,0,7,4,0.0,1.0,0.0,1.0
SF-F28-1,SF-M30,7,5,4,2,3,3,0.5714285714285714,0.42857142857142855,0.4,0.6
SF-F28-1,SF-L27-2,1,1,0,0,1,1,0.0,1.0,0.0,1.0
SF-F28-1,SF-J29-3,5,4,4,1,1,3,0.8,0.2,0.25,0.75
SF-F28-1,SF-J29,1,8,1,4,0,4,1.0,0.0,0.5,0.5
SF-F28-1,SF-M28,5,4,4,2,1,2,0.8,0.2,0.5,0.5
SF-F28-1,SF-M24,4,4,3,3,1,1,0.75,0.25,0.75,0.25
SF-F28-1,SF-L24,3,2,2,0,1,2,0.6666666666666666,0.3333333333333333,0.0,1.0
SF-F28-1,SF-K27-2,3,1,0,0,3,1,0.0,1.0,0.0,1.0
SF-F28-1,SF-J26-2,7,2,1,1,6,1,0.14285714285714285,0.8571428571428571,0.5,0.5
SF-F28-1,SF-L28,3,1,3,1,0,0,1.0,0.0,1.0,0.0
SF-F28-1,SF-K29-1,10,14,8,5,2,9,0.8,0.2,0.35714285714285715,0.6428571428571429
SF-F28-1,SF-J28-2,7,7,0,0,7,7,0.0,1.0,0.0,1.0
SF-F28-1,SF-K27,2,2,1,0,1,2,0.5,0.5,0.0,1.0
SF-F28-1,SF-K25,6,5,4,3,2,2,0.6666666666666666,0.3333333333333333,0.6,0.4
SF-F28-1,SF-J25,42,11,2,3,40,8,0.047619047619047616,0.9523809523809523,0.2727272727272727,0.7272727272727273
SF-F28-1,SF-H26-2,7,6,2,4,5,2,0.2857142857142857,0.7142857142857143,0.6666666666666666,0.3333333333333333
SF-F28-1,SF-P24,2,4,1,1,1,3,0.5,0.5,0.25,0.75
SF-F28-1,SF-N22-1A,1,1,1,1,0,0,1.0,0.0,1.0,0.0
SF-F28-1,SF-J24,4,7,4,6,0,1,1.0,0.0,0.8571428571428571,0.14285714285714285
SF-F28-1,SF-J26,2,1,0,1,2,0,0.0,1.0,1.0,0.0
SF-F28-1,SF-I26-,3,2,0,0,3,2,0.0,1.0,0.0,1.0
SF-F28-1,SF-I25,61,30,32,16,29,14,0.5245901639344263,0.47540983606557374,0.5333333333333333,0.4666666666666667
SF-F28-1,SF-H26,59,80,32,48,27,32,0.5423728813559322,0.4576271186440678,0.6,0.4
SF-F28-1,SF-O23,13,3,0,1,13,2,0.0,1.0,0.3333333333333333,0.6666666666666666
SF-F28-1,SF-H27-1,3,8,1,5,2,3,0.3333333333333333,0.6666666666666666,0.625,0.375
SF-F28-1,SF-F28-2,54,83,29,61,25,22,0.5370370370370371,0.46296296296296297,0.7349397590361446,0.26506024096385544
SF-F28-1,SF-G27,62,98,41,73,21,25,0.6612903225806451,0.3387096774193548,0.7448979591836735,0.25510204081632654
SF-F28-1,SF-M22-2,5,9,3,7,2,2,0.6,0.4,0.7777777777777778,0.2222222222222222
SF-F28-1,SF-L22,17,8,11,2,6,6,0.6470588235294118,0.35294117647058826,0.25,0.75
SF-F28-1,SF-F27,23,35,17,26,6,9,0.7391304347826086,0.2608695652173913,0.7428571428571429,0.2571428571428571
SF-F28-1,SF-N22-2,6,8,2,2,4,6,0.3333333333333333,0.6666666666666666,0.25,0.75
SF-F28-1,SF-G28-2,12,3,2,3,10,0,0.16666666666666666,0.8333333333333334,1.0,0.0
SF-F28-1,SF-G28-1,1,5,0,4,1,1,0.0,1.0,0.8,0.2
SF-F28-1,SF-K22-2,4,6,0,2,4,4,0.0,1.0,0.3333333333333333,0.6666666666666666
SF-F28-1,SF-K24,2,11,1,5,1,6,0.5,0.5,0.45454545454545453,0.5454545454545454
SF-F28-1,SF-J23-2,11,6,6,6,5,0,0.5454545454545454,0.45454545454545453,1.0,0.0
SF-F28-1,SF-G23,9,6,5,3,4,3,0.5555555555555556,0.4444444444444444,0.5,0.5
SF-F28-1,SF-G24,29,19,10,2,19,17,0.3448275862068966,0.6551724137931034,0.10526315789473684,0.8947368421052632
SF-F28-1,SF-G25,79,29,68,11,11,18,0.8607594936708861,0.13924050632911392,0.3793103448275862,0.6206896551724138
SF-F28-1,SF-F23,11,12,3,2,8,10,0.2727272727272727,0.7272727272727273,0.16666666666666666,0.8333333333333334
SF-F28-1,SF-E23,14,9,10,0,4,9,0.7142857142857143,0.2857142857142857,0.0,1.0
SF-F28-1,SF-D24,10,4,5,0,5,4,0.5,0.5,0.0,1.0
SF-F28-1,SF-C22,4,3,2,2,2,1,0.5,0.5,0.6666666666666666,0.3333333333333333
SF-F28-1,SF-B22,14,15,6,12,8,3,0.42857142857142855,0.5714285714285714,0.8,0.2
SF-F28-1,SF-J17,41,10,22,0,19,10,0.5365853658536586,0.4634146341463415,0.0,1.0
SF-F28-1,SF-I19,14,6,9,2,5,4,0.6428571428571429,0.35714285714285715,0.3333333333333333,0.6666666666666666
SF-F28-1,SF-I20,3,5,0,0,3,5,0.0,1.0,0.0,1.0
SF-F28-1,SF-H19,3,4,3,4,0,0,1.0,0.0,1.0,0.0
SF-F28-1,SF-H20,8,2,5,0,3,2,0.625,0.375,0.0,1.0
SF-F28-1,SF-G19,2,1,0,0,2,1,0.0,1.0,0.0,1.0
SF-F28-1,SF-G17,2,1,0,0,2,1,0.0,1.0,0.0,1.0
SF-F28-1,SF-G18,5,6,0,1,5,5,0.0,1.0,0.16666666666666666,0.8333333333333334
SF-F28-1,SF-G20,21,1,0,0,21,1,0.0,1.0,0.0,1.0
SF-F28-1,SF-F19,31,25,3,1,28,24,0.0967741935483871,0.9032258064516129,0.04,0.96
SF-F28-1,SF-E18,1,4,0,0,1,4,0.0,1.0,0.0,1.0
SF-F28-1,SF-E20,13,5,0,0,13,5,0.0,1.0,0.0,1.0
SF-F28-1,SF-H30,22,7,19,5,3,2,0.8636363636363636,0.13636363636363635,0.7142857142857143,0.2857142857142857
SF-F28-1,SF-G30-2,41,24,25,11,16,13,0.6097560975609756,0.3902439024390244,0.4583333333333333,0.5416666666666666
SF-F28-1,SF-F30-1,5,12,2,9,3,3,0.4,0.6,0.75,0.25
SF-F28-1,SF-E29-2,80,39,61,37,19,2,0.7625,0.2375,0.9487179487179487,0.05128205128205128
SF-F28-1,SF-E29-1,43,52,31,39,12,13,0.7209302325581395,0.27906976744186046,0.75,0.25
SF-F28-1,SF-D29,16,9,13,4,3,5,0.8125,0.1875,0.4444444444444444,0.5555555555555556
SF-F28-1,SF-D28,35,29,26,10,9,19,0.7428571428571429,0.2571428571428571,0.3448275862068966,0.6551724137931034
SF-F28-1,SF-A27,33,30,25,19,8,11,0.7575757575757576,0.24242424242424243,0.6333333333333333,0.36666666666666664
SF-F28-1,SF-G29-2,35,33,24,12,11,21,0.6857142857142857,0.3142857142857143,0.36363636363636365,0.6363636363636364
SF-F28-1,SF-G29-1,16,3,8,2,8,1,0.5,0.5,0.6666666666666666,0.3333333333333333
SF-F28-1,SF-G30-1,46,28,32,16,14,12,0.6956521739130435,0.30434782608695654,0.5714285714285714,0.42857142857142855
SF-F28-1,SF-G29-3,11,14,2,8,9,6,0.18181818181818182,0.8181818181818182,0.5714285714285714,0.42857142857142855
SF-F28-1,SF-F30-2,32,8,30,6,2,2,0.9375,0.0625,0.75,0.25
SF-F28-1,SF-F29,28,38,17,19,11,19,0.6071428571428571,0.39285714285714285,0.5,0.5
SF-F28-1,SF-E29-3,19,32,6,28,13,4,0.3157894736842105,0.6842105263157895,0.875,0.125
SF-F28-1,SF-E28-2,25,36,18,18,7,18,0.72,0.28,0.5,0.5
SF-F28-1,SF-E28,12,20,8,10,4,10,0.6666666666666666,0.3333333333333333,0.5,0.5
SF-F28-1,SF-J15,1,1,1,0,0,1,1.0,0.0,0.0,1.0
SF-F28-1,SF-H13,1,2,0,0,1,2,0.0,1.0,0.0,1.0
SF-F28-1,SF-I16,1,1,0,1,1,0,0.0,1.0,1.0,0.0
SF-F28-1,SF-H14,4,1,0,0,4,1,0.0,1.0,0.0,1.0
SF-F28-1,SF-G13,2,1,1,0,1,1,0.5,0.5,0.0,1.0
SF-F28-1,SF-F15,2,2,0,2,2,0,0.0,1.0,1.0,0.0
SF-F28-1,SF-C21,2,1,1,1,1,0,0.5,0.5,1.0,0.0
SF-F28-1,SF-C20,11,7,1,2,10,5,0.09090909090909091,0.9090909090909091,0.2857142857142857,0.7142857142857143
SF-F28-1,SF-B19,2,11,0,0,2,11,0.0,1.0,0.0,1.0
SF-F28-1,SF-A20,10,2,7,0,3,2,0.7,0.3,0.0,1.0
SF-F28-1,SF-A19,3,2,1,1,2,1,0.3333333333333333,0.6666666666666666,0.5,0.5
SF-F28-1,SF-C26,12,13,7,3,5,10,0.5833333333333334,0.4166666666666667,0.23076923076923078,0.7692307692307693
SF-F28-1,SF-C25,34,26,21,11,13,15,0.6176470588235294,0.38235294117647056,0.4230769230769231,0.5769230769230769
SF-F28-1,SF-B25,4,27,2,13,2,14,0.5,0.5,0.48148148148148145,0.5185185185185185
SF-F28-1,SF-E27,140,62,120,39,20,23,0.8571428571428571,0.14285714285714285,0.6290322580645161,0.3709677419354839
SF-F28-1,SF-B28-2,24,8,11,5,13,3,0.4583333333333333,0.5416666666666666,0.625,0.375
SF-F28-1,SF-D27,13,115,7,109,6,6,0.5384615384615384,0.46153846153846156,0.9478260869565217,0.05217391304347826
SF-F28-1,SF-C28-2,64,7,61,3,3,4,0.953125,0.046875,0.42857142857142855,0.5714285714285714
SF-F28-1,SF-C28-1,2,12,2,12,0,0,1.0,0.0,1.0,0.0
SF-F28-1,SF-B28,36,23,34,16,2,7,0.9444444444444444,0.05555555555555555,0.6956521739130435,0.30434782608695654
SF-F28-1,SF-J1,1,1,0,0,1,1,0.0,1.0,0.0,1.0
SF-F28-1,SF-J3,2,9,0,0,2,9,0.0,1.0,0.0,1.0
SF-F28-1,SF-J5,66,58,0,0,66,58,0.0,1.0,0.0,1.0
SF-F28-1,SF-G8,2,1,2,1,0,0,1.0,0.0,1.0,0.0
SF-F28-1,SF-H25,19,4,1,0,18,4,0.05263157894736842,0.9473684210526315,0.0,1.0
SF-F28-1,SF-G26,5,18,4,14,1,4,0.8,0.2,0.7777777777777778,0.2222222222222222
SF-F28-1,SF-K21,9,6,2,0,7,6,0.2222222222222222,0.7777777777777778,0.0,1.0
SF-F28-1,SF-K22-1,27,40,23,33,4,7,0.8518518518518519,0.14814814814814814,0.825,0.175
SF-F28-1,SF-J23-1,60,114,36,51,24,63,0.6,0.4,0.4473684210526316,0.5526315789473685
SF-F28-1,SF-J22-1,10,21,4,9,6,12,0.4,0.6,0.42857142857142855,0.5714285714285714
SF-F28-1,SF-J22-2,34,41,2,1,32,40,0.058823529411764705,0.9411764705882353,0.024390243902439025,0.975609756097561
SF-F28-1,SF-J21,15,21,9,12,6,9,0.6,0.4,0.5714285714285714,0.42857142857142855
SF-F28-1,SF-I21,2,1,0,0,2,1,0.0,1.0,0.0,1.0
SF-F28-1,SF-I23-2,4,7,4,7,0,0,1.0,0.0,1.0,0.0
SF-F28-1,SF-I24,8,6,3,3,5,3,0.375,0.625,0.5,0.5
SF-F28-1,SF-I23-1,5,11,1,9,4,2,0.2,0.8,0.8181818181818182,0.18181818181818182
SF-F28-1,SF-F26,16,27,10,15,6,12,0.625,0.375,0.5555555555555556,0.4444444444444444
SF-F28-1,SF-M13,2,26,1,0,1,26,0.5,0.5,0.0,1.0
SF-F28-1,SF-M15,56,25,8,0,48,25,0.14285714285714285,0.8571428571428571,0.0,1.0
SF-F28-1,SF-L19,3,6,0,1,3,5,0.0,1.0,0.16666666666666666,0.8333333333333334
SF-F28-1,SF-L20,10,21,4,5,6,16,0.4,0.6,0.23809523809523808,0.7619047619047619
SF-F28-1,SF-N20-1,2,2,1,0,1,2,0.5,0.5,0.0,1.0
SF-F28-1,SF-M20,17,19,6,4,11,15,0.35294117647058826,0.6470588235294118,0.21052631578947367,0.7894736842105263
SF-F28-1,SF-K17-2,3,2,1,0,2,2,0.3333333333333333,0.6666666666666666,0.0,1.0
SF-F28-1,SF-K20,8,12,2,2,6,10,0.25,0.75,0.16666666666666666,0.8333333333333334
SF-F28-1,SF-K15-,5,4,2,3,3,1,0.4,0.6,0.75,0.25
SF-F28-1,SF-K19,3,2,1,0,2,2,0.3333333333333333,0.6666666666666666,0.0,1.0
SF-F28-1,SF-K18,9,9,1,0,8,9,0.1111111111111111,0.8888888888888888,0.0,1.0
SF-F28-1,SF-K17,5,5,1,1,4,4,0.2,0.8,0.2,0.8
SF-F28-1,SF-J16,7,3,3,0,4,3,0.42857142857142855,0.5714285714285714,0.0,1.0
SF-F28-1,SF-J18,9,11,4,2,5,9,0.4444444444444444,0.5555555555555556,0.18181818181818182,0.8181818181818182
SF-F28-1,SF-J20,7,14,4,11,3,3,0.5714285714285714,0.42857142857142855,0.7857142857142857,0.21428571428571427
SF-F28-1,SF-J19,17,10,14,9,3,1,0.8235294117647058,0.17647058823529413,0.9,0.1
SF-F28-1,SF-M12,1,2,0,0,1,2,0.0,1.0,0.0,1.0
SF-F28-1,SF-M10,6,2,4,1,2,1,0.6666666666666666,0.3333333333333333,0.5,0.5
SF-F28-1,SF-M11,3,2,0,0,3,2,0.0,1.0,0.0,1.0
SF-F28-1,SF-R19,6,1,2,0,4,1,0.3333333333333333,0.6666666666666666,0.0,1.0
SF-F28-1,SF-Q21-2,1,5,1,2,0,3,1.0,0.0,0.4,0.6
SF-F28-1,SF-Q21-1,3,1,0,0,3,1,0.0,1.0,0.0,1.0
SF-F28-1,SF-P21,2,2,0,0,2,2,0.0,1.0,0.0,1.0
SF-F28-1,SF-O18,9,20,1,4,8,16,0.1111111111111111,0.8888888888888888,0.2,0.8
SF-F28-1,SF-O19,7,4,3,1,4,3,0.42857142857142855,0.5714285714285714,0.25,0.75
SF-F28-1,SF-O21,4,10,2,2,2,8,0.5,0.5,0.2,0.8
SF-F28-1,SF-O22,7,16,2,7,5,9,0.2857142857142857,0.7142857142857143,0.4375,0.5625
SF-F28-1,SF-N21,1,4,0,0,1,4,0.0,1.0,0.0,1.0
SF-F28-1,SF-N20-2,3,2,2,1,1,1,0.6666666666666666,0.3333333333333333,0.5,0.5
SF-F28-1,SF-M21,67,48,59,33,8,15,0.8805970149253731,0.11940298507462686,0.6875,0.3125
SF-F28-1,SF-L21,17,40,10,14,7,26,0.5882352941176471,0.4117647058823529,0.35,0.65
SF-F28-1,SF-Q30,6,6,1,1,5,5,0.16666666666666666,0.8333333333333334,0.16666666666666666,0.8333333333333334
SF-F28-1,SF-P30,9,6,1,1,8,5,0.1111111111111111,0.8888888888888888,0.16666666666666666,0.8333333333333334
SF-F28-1,SF-O30-2,2,2,2,1,0,1,1.0,0.0,0.5,0.5
SF-F28-1,SF-O30,16,12,5,4,11,8,0.3125,0.6875,0.3333333333333333,0.6666666666666666
SF-F28-1,SF-N27,3,7,1,5,2,2,0.3333333333333333,0.6666666666666666,0.7142857142857143,0.2857142857142857
SF-F28-1,SF-N29,3,2,3,2,0,0,1.0,0.0,1.0,0.0
SF-F28-1,SF-N28,4,1,0,0,4,1,0.0,1.0,0.0,1.0
SF-F28-1,SF-L30-1,16,37,5,28,11,9,0.3125,0.6875,0.7567567567567568,0.24324324324324326
SF-F28-1,SF-L31-1,8,3,7,1,1,2,0.875,0.125,0.3333333333333333,0.6666666666666666
SF-F28-1,SF-K30-2,5,2,2,1,3,1,0.4,0.6,0.5,0.5
SF-F28-1,SF-L29,6,6,0,3,6,3,0.0,1.0,0.5,0.5
SF-F28-1,SF-J29-1,3,1,2,1,1,0,0.6666666666666666,0.3333333333333333,1.0,0.0
SF-F28-1,SF-I30,8,5,4,4,4,1,0.5,0.5,0.8,0.2
SF-F28-1,SF-I29-2,5,1,3,0,2,1,0.6,0.4,0.0,1.0
SF-F28-1,SF-I27,10,8,8,5,2,3,0.8,0.2,0.625,0.375
SF-F28-1,SF-I28,3,4,1,0,2,4,0.3333333333333333,0.6666666666666666,0.0,1.0
SF-F28-1,SF-I30-2,11,5,10,3,1,2,0.9090909090909091,0.09090909090909091,0.6,0.4
SF-F28-1,SF I29-1,4,9,2,1,2,8,0.5,0.5,0.1111111111111111,0.8888888888888888
SF-F28-1,SF-H28,9,7,6,3,3,4,0.6666666666666666,0.3333333333333333,0.42857142857142855,0.5714285714285714
SF-F28-1,SF-R24,2,3,0,0,2,3,0.0,1.0,0.0,1.0
SF-F28-1,SF-O25-2,3,1,0,0,3,1,0.0,1.0,0.0,1.0
SF-F28-1,SF-N22-1B,1,1,1,1,0,0,1.0,0.0,1.0,0.0
SF-F28-1,SF-T22,7,2,1,0,6,2,0.14285714285714285,0.8571428571428571,0.0,1.0
SF-F28-1,SF-S22-1,10,13,6,8,4,5,0.6,0.4,0.6153846153846154,0.38461538461538464
SF-F28-1,SF-Q23-3,2,3,1,1,1,2,0.5,0.5,0.3333333333333333,0.6666666666666666
SF-F28-1,SF-Q22-1,6,9,1,3,5,6,0.16666666666666666,0.8333333333333334,0.3333333333333333,0.6666666666666666
SF-F28-1,SF-Q22-2,7,6,5,4,2,2,0.7142857142857143,0.2857142857142857,0.6666666666666666,0.3333333333333333
SF-F28-1,SF-P22,2,3,1,2,1,1,0.5,0.5,0.6666666666666666,0.3333333333333333
SF-F28-1,SF-W19-2,1,1,0,0,1,1,0.0,1.0,0.0,1.0
SF-F28-1,SF-T20,3,1,1,1,2,0,0.3333333333333333,0.6666666666666666,1.0,0.0
SF-F28-1,SF-S21,4,2,2,0,2,2,0.5,0.5,0.0,1.0
SF-F28-1,SF-V30,8,1,5,0,3,1,0.625,0.375,0.0,1.0
SF-F28-1,SF-W14,3,4,1,2,2,2,0.3333333333333333,0.6666666666666666,0.5,0.5
SF-E28-2,SF-M25,1,1,0,0,1,1,0.0,1.0,0.0,1.0
SF-E28-2,SF-M26-2,1,1,1,0,0,1,1.0,0.0,0.0,1.0
SF-E28-2,SF-K26,1,2,0,0,1,2,0.0,1.0,0.0,1.0
SF-E28-2,SF-J27,2,2,0,0,2,2,0.0,1.0,0.0,1.0
SF-E28-2,SF-M30,2,3,0,1,2,2,0.0,1.0,0.3333333333333333,0.6666666666666666
SF-E28-2,SF-L27-2,1,1,0,0,1,1,0.0,1.0,0.0,1.0
SF-E28-2,SF-J29-3,1,3,0,1,1,2,0.0,1.0,0.3333333333333333,0.6666666666666666
SF-E28-2,SF-M28,4,2,1,1,3,1,0.25,0.75,0.5,0.5
SF-E28-2,SF-M24,2,4,0,3,2,1,0.0,1.0,0.75,0.25
SF-E28-2,SF-K27-2,2,1,2,1,0,0,1.0,0.0,1.0,0.0
SF-E28-2,SF-L28,5,7,2,5,3,2,0.4,0.6,0.7142857142857143,0.2857142857142857
SF-E28-2,SF-K29-1,4,5,3,2,1,3,0.75,0.25,0.4,0.6
SF-E28-2,SF-J28-2,1,2,0,1,1,1,0.0,1.0,0.5,0.5
SF-E28-2,SF-H26-2,1,3,0,2,1,1,0.0,1.0,0.6666666666666666,0.3333333333333333
SF-E28-2,SF-P24,2,4,0,1,2,3,0.0,1.0,0.25,0.75
SF-E28-2,SF-J24,6,1,3,1,3,0,0.5,0.5,1.0,0.0
SF-E28-2,SF-O24,1,2,0,0,1,2,0.0,1.0,0.0,1.0
SF-E28-2,SF-J26,1,3,1,3,0,0,1.0,0.0,1.0,0.0
SF-E28-2,SF-I26-,4,5,0,1,4,4,0.0,1.0,0.2,0.8
SF-E28-2,SF-H26,63,32,58,26,5,6,0.9206349206349206,0.07936507936507936,0.8125,0.1875
SF-E28-2,SF-O23,2,1,1,0,1,1,0.5,0.5,0.0,1.0
SF-E28-2,SF-H27-1,1,3,1,3,0,0,1.0,0.0,1.0,0.0
SF-E28-2,SF-F28-2,14,18,9,16,5,2,0.6428571428571429,0.35714285714285715,0.8888888888888888,0.1111111111111111
SF-E28-2,SF-G27,24,30,11,10,13,20,0.4583333333333333,0.5416666666666666,0.3333333333333333,0.6666666666666666
SF-E28-2,SF-L22,1,5,1,4,0,1,1.0,0.0,0.8,0.2
SF-E28-2,SF-F27,11,11,5,5,6,6,0.45454545454545453,0.5454545454545454,0.45454545454545453,0.5454545454545454
SF-E28-2,SF-K24,2,2,0,0,2,2,0.0,1.0,0.0,1.0
SF-E28-2,SF-J23-2,2,3,1,2,1,1,0.5,0.5,0.6666666666666666,0.3333333333333333
SF-E28-2,SF-G24,94,54,4,2,90,52,0.0425531914893617,0.9574468085106383,0.037037037037037035,0.9629629629629629
SF-E28-2,SF-G25,36,4,20,1,16,3,0.5555555555555556,0.4444444444444444,0.25,0.75
SF-E28-2,SF-F23,15,8,2,1,13,7,0.13333333333333333,0.8666666666666667,0.125,0.875
SF-E28-2,SF-E23,1,5,0,0,1,5,0.0,1.0,0.0,1.0
SF-E28-2,SF-D24,8,11,4,0,4,11,0.5,0.5,0.0,1.0
SF-E28-2,SF-C22,1,8,0,6,1,2,0.0,1.0,0.75,0.25
SF-E28-2,SF-B22,16,14,4,9,12,5,0.25,0.75,0.6428571428571429,0.35714285714285715
SF-E28-2,SF-J17,1,3,1,0,0,3,1.0,0.0,0.0,1.0
SF-E28-2,SF-G19,1,1,1,1,0,0,1.0,0.0,1.0,0.0
SF-E28-2,SF-G20,1,1,0,0,1,1,0.0,1.0,0.0,1.0
SF-E28-2,SF-F19,4,2,2,0,2,2,0.5,0.5,0.0,1.0
SF-E28-2,SF-E18,1,2,0,0,1,2,0.0,1.0,0.0,1.0
SF-E28-2,SF-E20,17,10,0,0,17,10,0.0,1.0,0.0,1.0
SF-E28-2,SF-H30,3,1,1,0,2,1,0.3333333333333333,0.6666666666666666,0.0,1.0
SF-E28-2,SF-G30-2,18,14,14,10,4,4,0.7777777777777778,0.2222222222222222,0.7142857142857143,0.2857142857142857
SF-E28-2,SF-E29-2,16,16,11,11,5,5,0.6875,0.3125,0.6875,0.3125
SF-E28-2,SF-E29-1,4,6,3,5,1,1,0.75,0.25,0.8333333333333334,0.16666666666666666
SF-E28-2,SF-D29,2,1,0,0,2,1,0.0,1.0,0.0,1.0
SF-E28-2,SF-D28,12,9,7,6,5,3,0.5833333333333334,0.4166666666666667,0.6666666666666666,0.3333333333333333
SF-E28-2,SF-A27,12,17,10,9,2,8,0.8333333333333334,0.16666666666666666,0.5294117647058824,0.47058823529411764
SF-E28-2,SF-G29-2,16,15,11,7,5,8,0.6875,0.3125,0.4666666666666667,0.5333333333333333
SF-E28-2,SF-G29-1,4,1,3,0,1,1,0.75,0.25,0.0,1.0
SF-E28-2,SF-G30-1,20,37,12,15,8,22,0.6,0.4,0.40540540540540543,0.5945945945945946
SF-E28-2,SF-G29-3,8,6,4,2,4,4,0.5,0.5,0.3333333333333333,0.6666666666666666
SF-E28-2,SF-F30-2,7,16,5,15,2,1,0.7142857142857143,0.2857142857142857,0.9375,0.0625
SF-E28-2,SF-F29,5,2,3,1,2,1,0.6,0.4,0.5,0.5
SF-E28-2,SF-E29-3,24,23,7,21,17,2,0.2916666666666667,0.7083333333333334,0.9130434782608695,0.08695652173913043
SF-E28-2,SF-F28-1,36,25,18,18,18,7,0.5,0.5,0.72,0.28
SF-E28-2,SF-E28,13,8,9,6,4,2,0.6923076923076923,0.3076923076923077,0.75,0.25
SF-E28-2,SF-J12,1,2,0,0,1,2,0.0,1.0,0.0,1.0
SF-E28-2,SF-C20,2,7,0,1,2,6,0.0,1.0,0.14285714285714285,0.8571428571428571
SF-E28-2,SF-B19,1,9,0,0,1,9,0.0,1.0,0.0,1.0
SF-E28-2,SF-A20,11,8,0,1,11,7,0.0,1.0,0.125,0.875
SF-E28-2,SF-A19,3,2,0,1,3,1,0.0,1.0,0.5,0.5
SF-E28-2,SF-C26,15,9,7,2,8,7,0.4666666666666667,0.5333333333333333,0.2222222222222222,0.7777777777777778
SF-E28-2,SF-C25,35,39,17,7,18,32,0.4857142857142857,0.5142857142857142,0.1794871794871795,0.8205128205128205
SF-E28-2,SF-B25,5,10,1,3,4,7,0.2,0.8,0.3,0.7
SF-E28-2,SF-E27,4,10,2,5,2,5,0.5,0.5,0.5,0.5
SF-E28-2,SF-B28-2,12,4,5,3,7,1,0.4166666666666667,0.5833333333333334,0.75,0.25
SF-E28-2,SF-D27,10,15,9,11,1,4,0.9,0.1,0.7333333333333333,0.26666666666666666
SF-E28-2,SF-C28-1,2,2,2,2,0,0,1.0,0.0,1.0,0.0
SF-E28-2,SF-B28,3,4,2,4,1,0,0.6666666666666666,0.3333333333333333,1.0,0.0
SF-E28-2,SF-J1,1,1,0,0,1,1,0.0,1.0,0.0,1.0
SF-E28-2,SF-H25,4,1,1,0,3,1,0.25,0.75,0.0,1.0
SF-E28-2,SF-G26,3,5,1,1,2,4,0.3333333333333333,0.6666666666666666,0.2,0.8
SF-E28-2,SF-K22-1,2,3,1,2,1,1,0.5,0.5,0.6666666666666666,0.3333333333333333
SF-E28-2,SF-J23-1,16,16,8,3,8,13,0.5,0.5,0.1875,0.8125
SF-E28-2,SF-J22-2,1,2,1,0,0,2,1.0,0.0,0.0,1.0
SF-E28-2,SF-J21,3,3,1,0,2,3,0.3333333333333333,0.6666666666666666,0.0,1.0
SF-E28-2,SF-I23-2,1,2,0,0,1,2,0.0,1.0,0.0,1.0
SF-E28-2,SF-I23-1,1,2,0,2,1,0,0.0,1.0,1.0,0.0
SF-E28-2,SF-F26,3,8,3,4,0,4,1.0,0.0,0.5,0.5
SF-E28-2,SF-M15,1,1,1,0,0,1,1.0,0.0,0.0,1.0
SF-E28-2,SF-L20,4,3,3,2,1,1,0.75,0.25,0.6666666666666666,0.3333333333333333
SF-E28-2,SF-N20-1,6,1,2,0,4,1,0.3333333333333333,0.6666666666666666,0.0,1.0
SF-E28-2,SF-M20,6,17,1,0,5,17,0.16666666666666666,0.8333333333333334,0.0,1.0
SF-E28-2,SF-K17-2,1,1,0,0,1,1,0.0,1.0,0.0,1.0
SF-E28-2,SF-K20,5,5,1,2,4,3,0.2,0.8,0.4,0.6
SF-E28-2,SF-K19,6,7,4,2,2,5,0.6666666666666666,0.3333333333333333,0.2857142857142857,0.7142857142857143
SF-E28-2,SF-K18,1,1,0,0,1,1,0.0,1.0,0.0,1.0
SF-E28-2,SF-J18,1,5,0,0,1,5,0.0,1.0,0.0,1.0
SF-E28-2,SF-J19,1,2,1,0,0,2,1.0,0.0,0.0,1.0
SF-E28-2,SF-R19,9,1,5,0,4,1,0.5555555555555556,0.4444444444444444,0.0,1.0
SF-E28-2,SF-Q21-1,4,2,2,0,2,2,0.5,0.5,0.0,1.0
SF-E28-2,SF-P21,2,1,1,1,1,0,0.5,0.5,1.0,0.0
SF-E28-2,SF-O18,6,6,1,1,5,5,0.16666666666666666,0.8333333333333334,0.16666666666666666,0.8333333333333334
SF-E28-2,SF-O19,1,2,0,2,1,0,0.0,1.0,1.0,0.0
SF-E28-2,SF-O22,1,4,0,1,1,3,0.0,1.0,0.25,0.75
SF-E28-2,SF-L21,3,20,1,0,2,20,0.3333333333333333,0.6666666666666666,0.0,1.0
SF-E28-2,SF-Q30,2,14,1,2,1,12,0.5,0.5,0.14285714285714285,0.8571428571428571
SF-E28-2,SF-P30,4,4,0,2,4,2,0.0,1.0,0.5,0.5
SF-E28-2,SF-O30-2,2,3,0,1,2,2,0.0,1.0,0.3333333333333333,0.6666666666666666
SF-E28-2,SF-O30,22,2,2,0,20,2,0.09090909090909091,0.9090909090909091,0.0,1.0
SF-E28-2,SF-N27,2,5,0,0,2,5,0.0,1.0,0.0,1.0
SF-E28-2,SF-N29,2,3,0,1,2,2,0.0,1.0,0.3333333333333333,0.6666666666666666
SF-E28-2,SF-L30-1,2,6,0,2,2,4,0.0,1.0,0.3333333333333333,0.6666666666666666
SF-E28-2,SF-L31-1,2,2,2,1,0,1,1.0,0.0,0.5,0.5
SF-E28-2,SF-K30-2,1,1,1,0,0,1,1.0,0.0,0.0,1.0
SF-E28-2,SF-L29,6,7,2,1,4,6,0.3333333333333333,0.6666666666666666,0.14285714285714285,0.8571428571428571
SF-E28-2,SF-J29-1,13,6,8,1,5,5,0.6153846153846154,0.38461538461538464,0.16666666666666666,0.8333333333333334
SF-E28-2,SF-I30,4,8,3,2,1,6,0.75,0.25,0.25,0.75
SF-E28-2,SF-I29-2,3,1,0,1,3,0,0.0,1.0,1.0,0.0
SF-E28-2,SF-I27,18,21,2,0,16,21,0.1111111111111111,0.8888888888888888,0.0,1.0
SF-E28-2,SF-I28,6,12,0,1,6,11,0.0,1.0,0.08333333333333333,0.9166666666666666
SF-E28-2,SF-I30-2,4,8,3,2,1,6,0.75,0.25,0.25,0.75
SF-E28-2,SF I29-1,1,1,0,0,1,1,0.0,1.0,0.0,1.0
SF-E28-2,SF-H28,13,7,1,1,12,6,0.07692307692307693,0.9230769230769231,0.14285714285714285,0.8571428571428571
SF-E28-2,SF-S24,1,1,0,1,1,0,0.0,1.0,1.0,0.0
SF-E28-2,SF-P26,1,1,1,0,0,1,1.0,0.0,0.0,1.0
SF-E28-2,SF-O25-2,1,2,0,0,1,2,0.0,1.0,0.0,1.0
SF-E28-2,SF-N25,2,2,1,0,1,2,0.5,0.5,0.0,1.0
SF-E28-2,SF-T22,1,1,0,0,1,1,0.0,1.0,0.0,1.0
SF-E28-2,SF-Q22-1,1,4,0,1,1,3,0.0,1.0,0.25,0.75
SF-E28-2,SF-Q22-2,5,2,2,1,3,1,0.4,0.6,0.5,0.5
SF-E28-2,SF-P22,1,2,0,0,1,2,0.0,1.0,0.0,1.0
SF-E28-2,SF-W19,15,4,15,4,0,0,1.0,0.0,1.0,0.0
SF-E28-2,SF-W14,1,3,1,0,0,3,1.0,0.0,0.0,1.0
SF-E28,SF-M26,1,2,0,2,1,0,0.0,1.0,1.0,0.0
SF-E28,SF-M26-2,2,2,1,0,1,2,0.5,0.5,0.0,1.0
SF-E28,SF-K26,3,4,0,4,3,0,0.0,1.0,1.0,0.0
SF-E28,SF-M30,2,7,2,5,0,2,1.0,0.0,0.7142857142857143,0.2857142857142857
SF-E28,SF-L27-2,1,1,0,1,1,0,0.0,1.0,1.0,0.0
SF-E28,SF-J29-3,30,46,30,44,0,2,1.0,0.0,0.9565217391304348,0.043478260869565216
SF-E28,SF-J29,111,86,101,79,10,7,0.9099099099099099,0.09009009009009009,0.9186046511627907,0.08139534883720931
SF-E28,SF-L26,4,3,4,3,0,0,1.0,0.0,1.0,0.0
SF-E28,SF-M28,4,5,0,1,4,4,0.0,1.0,0.2,0.8
SF-E28,SF-L25,2,1,1,0,1,1,0.5,0.5,0.0,1.0
SF-E28,SF-L24,1,3,1,3,0,0,1.0,0.0,1.0,0.0
SF-E28,SF-K27-2,6,5,2,2,4,3,0.3333333333333333,0.6666666666666666,0.4,0.6
SF-E28,SF-J26-2,2,3,1,1,1,2,0.5,0.5,0.3333333333333333,0.6666666666666666
SF-E28,SF-L28,6,4,3,3,3,1,0.5,0.5,0.75,0.25
SF-E28,SF-K29-1,11,15,0,12,11,3,0.0,1.0,0.8,0.2
SF-E28,SF-J28-2,1,4,0,0,1,4,0.0,1.0,0.0,1.0
SF-E28,SF-K25,3,7,3,7,0,0,1.0,0.0,1.0,0.0
SF-E28,SF-J25,6,7,0,1,6,6,0.0,1.0,0.14285714285714285,0.8571428571428571
SF-E28,SF-H26-2,5,6,4,5,1,1,0.8,0.2,0.8333333333333334,0.16666666666666666
SF-E28,SF-P24,2,3,2,2,0,1,1.0,0.0,0.6666666666666666,0.3333333333333333
SF-E28,SF-J24,3,1,1,1,2,0,0.3333333333333333,0.6666666666666666,1.0,0.0
SF-E28,SF-O24,1,1,0,1,1,0,0.0,1.0,1.0,0.0
SF-E28,SF-J26,3,7,2,5,1,2,0.6666666666666666,0.3333333333333333,0.7142857142857143,0.2857142857142857
SF-E28,SF-I26-,2,4,2,3,0,1,1.0,0.0,0.75,0.25
SF-E28,SF-I25,9,6,4,6,5,0,0.4444444444444444,0.5555555555555556,1.0,0.0
SF-E28,SF-H26,17,33,10,14,7,19,0.5882352941176471,0.4117647058823529,0.42424242424242425,0.5757575757575758
SF-E28,SF-O23,1,2,1,0,0,2,1.0,0.0,0.0,1.0
SF-E28,SF-H27-1,2,6,2,2,0,4,1.0,0.0,0.3333333333333333,0.6666666666666666
SF-E28,SF-F28-2,15,33,8,25,7,8,0.5333333333333333,0.4666666666666667,0.7575757575757576,0.24242424242424243
SF-E28,SF-G27,52,57,35,36,17,21,0.6730769230769231,0.3269230769230769,0.631578947368421,0.3684210526315789
SF-E28,SF-M22-2,2,4,0,1,2,3,0.0,1.0,0.25,0.75
SF-E28,SF-L22,2,6,0,4,2,2,0.0,1.0,0.6666666666666666,0.3333333333333333
SF-E28,SF-F27,10,8,6,6,4,2,0.6,0.4,0.75,0.25
SF-E28,SF-N22-2,7,6,2,2,5,4,0.2857142857142857,0.7142857142857143,0.3333333333333333,0.6666666666666666
SF-E28,SF-G28-2,1,5,0,2,1,3,0.0,1.0,0.4,0.6
SF-E28,SF-K22-2,6,3,6,2,0,1,1.0,0.0,0.6666666666666666,0.3333333333333333
SF-E28,SF-K24,11,9,8,8,3,1,0.7272727272727273,0.2727272727272727,0.8888888888888888,0.1111111111111111
SF-E28,SF-J23-2,2,2,1,1,1,1,0.5,0.5,0.5,0.5
SF-E28,SF-G24,53,37,32,2,21,35,0.6037735849056604,0.39622641509433965,0.05405405405405406,0.9459459459459459
SF-E28,SF-G25,61,11,54,5,7,6,0.8852459016393442,0.11475409836065574,0.45454545454545453,0.5454545454545454
SF-E28,SF-F23,8,6,0,0,8,6,0.0,1.0,0.0,1.0
SF-E28,SF-E23,6,4,0,1,6,3,0.0,1.0,0.25,0.75
SF-E28,SF-D24,23,9,20,1,3,8,0.8695652173913043,0.13043478260869565,0.1111111111111111,0.8888888888888888
SF-E28,SF-C22,5,5,0,2,5,3,0.0,1.0,0.4,0.6
SF-E28,SF-B22,9,24,3,17,6,7,0.3333333333333333,0.6666666666666666,0.7083333333333334,0.2916666666666667
SF-E28,SF-J17,11,9,0,0,11,9,0.0,1.0,0.0,1.0
SF-E28,SF-I19,3,1,0,0,3,1,0.0,1.0,0.0,1.0
SF-E28,SF-I20,4,6,0,2,4,4,0.0,1.0,0.3333333333333333,0.6666666666666666
SF-E28,SF-G19,1,1,1,0,0,1,1.0,0.0,0.0,1.0
SF-E28,SF-G18,1,1,0,0,1,1,0.0,1.0,0.0,1.0
SF-E28,SF-G20,3,2,0,0,3,2,0.0,1.0,0.0,1.0
SF-E28,SF-F19,4,3,0,0,4,3,0.0,1.0,0.0,1.0
SF-E28,SF-E18,1,2,1,0,0,2,1.0,0.0,0.0,1.0
SF-E28,SF-H30,18,18,9,8,9,10,0.5,0.5,0.4444444444444444,0.5555555555555556
SF-E28,SF-G30-2,9,14,8,7,1,7,0.8888888888888888,0.1111111111111111,0.5,0.5
SF-E28,SF-F30-1,3,5,2,4,1,1,0.6666666666666666,0.3333333333333333,0.8,0.2
SF-E28,SF-E29-2,9,20,6,14,3,6,0.6666666666666666,0.3333333333333333,0.7,0.3
SF-E28,SF-E29-1,3,10,1,8,2,2,0.3333333333333333,0.6666666666666666,0.8,0.2
SF-E28,SF-D29,8,11,5,6,3,5,0.625,0.375,0.5454545454545454,0.45454545454545453
SF-E28,SF-D28,16,22,13,17,3,5,0.8125,0.1875,0.7727272727272727,0.22727272727272727
SF-E28,SF-A27,39,28,27,13,12,15,0.6923076923076923,0.3076923076923077,0.4642857142857143,0.5357142857142857
SF-E28,SF-G29-2,22,13,15,10,7,3,0.6818181818181818,0.3181818181818182,0.7692307692307693,0.23076923076923078
SF-E28,SF-G30-1,10,15,8,11,2,4,0.8,0.2,0.7333333333333333,0.26666666666666666
SF-E28,SF-G29-3,26,6,3,4,23,2,0.11538461538461539,0.8846153846153846,0.6666666666666666,0.3333333333333333
SF-E28,SF-F30-2,1,4,0,3,1,1,0.0,1.0,0.75,0.25
SF-E28,SF-F29,33,14,6,11,27,3,0.18181818181818182,0.8181818181818182,0.7857142857142857,0.21428571428571427
SF-E28,SF-E29-3,14,34,8,2,6,32,0.5714285714285714,0.42857142857142855,0.058823529411764705,0.9411764705882353
SF-E28,SF-F28-1,20,12,10,8,10,4,0.5,0.5,0.6666666666666666,0.3333333333333333
SF-E28,SF-E28-2,8,13,6,9,2,4,0.75,0.25,0.6923076923076923,0.3076923076923077
SF-E28,SF-J12,1,1,1,0,0,1,1.0,0.0,0.0,1.0
SF-E28,SF-J13,1,1,0,0,1,1,0.0,1.0,0.0,1.0
SF-E28,SF-I16,2,7,0,0,2,7,0.0,1.0,0.0,1.0
SF-E28,SF-H12,2,1,1,0,1,1,0.5,0.5,0.0,1.0
SF-E28,SF-G12,1,3,1,0,0,3,1.0,0.0,0.0,1.0
SF-E28,SF-F15,2,2,2,0,0,2,1.0,0.0,0.0,1.0
SF-E28,SF-C20,9,15,2,1,7,14,0.2222222222222222,0.7777777777777778,0.06666666666666667,0.9333333333333333
SF-E28,SF-B21,6,3,2,0,4,3,0.3333333333333333,0.6666666666666666,0.0,1.0
SF-E28,SF-B19,4,13,2,6,2,7,0.5,0.5,0.46153846153846156,0.5384615384615384
SF-E28,SF-A20,9,28,3,16,6,12,0.3333333333333333,0.6666666666666666,0.5714285714285714,0.42857142857142855
SF-E28,SF-A19,7,5,3,4,4,1,0.42857142857142855,0.5714285714285714,0.8,0.2
SF-E28,SF-C26,22,30,7,9,15,21,0.3181818181818182,0.6818181818181818,0.3,0.7
SF-E28,SF-C25,37,38,22,6,15,32,0.5945945945945946,0.40540540540540543,0.15789473684210525,0.8421052631578947
SF-E28,SF-B25,21,25,6,13,15,12,0.2857142857142857,0.7142857142857143,0.52,0.48
SF-E28,SF-E27,11,2,4,1,7,1,0.36363636363636365,0.6363636363636364,0.5,0.5
SF-E28,SF-B28-2,22,10,17,9,5,1,0.7727272727272727,0.22727272727272727,0.9,0.1
SF-E28,SF-D27,54,18,27,16,27,2,0.5,0.5,0.8888888888888888,0.1111111111111111
SF-E28,SF-C28-2,12,4,11,4,1,0,0.9166666666666666,0.08333333333333333,1.0,0.0
SF-E28,SF-C28-1,6,10,5,7,1,3,0.8333333333333334,0.16666666666666666,0.7,0.3
SF-E28,SF-B28,8,21,2,19,6,2,0.25,0.75,0.9047619047619048,0.09523809523809523
SF-E28,SF-J5,5,1,1,1,4,0,0.2,0.8,1.0,0.0
SF-E28,SF-G6,1,2,0,2,1,0,0.0,1.0,1.0,0.0
SF-E28,SF-G7,5,9,0,0,5,9,0.0,1.0,0.0,1.0
SF-E28,SF-H25,1,2,1,1,0,1,1.0,0.0,0.5,0.5
SF-E28,SF-G26,6,5,4,4,2,1,0.6666666666666666,0.3333333333333333,0.8,0.2
SF-E28,SF-K21,6,3,2,0,4,3,0.3333333333333333,0.6666666666666666,0.0,1.0
SF-E28,SF-K22-1,9,10,6,6,3,4,0.6666666666666666,0.3333333333333333,0.6,0.4
SF-E28,SF-J23-1,39,30,21,10,18,20,0.5384615384615384,0.46153846153846156,0.3333333333333333,0.6666666666666666
SF-E28,SF-J22-1,3,2,1,1,2,1,0.3333333333333333,0.6666666666666666,0.5,0.5
SF-E28,SF-J22-2,3,5,1,1,2,4,0.3333333333333333,0.6666666666666666,0.2,0.8
SF-E28,SF-J21,4,7,2,2,2,5,0.5,0.5,0.2857142857142857,0.7142857142857143
SF-E28,SF-I22,2,2,0,0,2,2,0.0,1.0,0.0,1.0
SF-E28,SF-I23-2,3,4,0,3,3,1,0.0,1.0,0.75,0.25
SF-E28,SF-I23-1,5,16,5,15,0,1,1.0,0.0,0.9375,0.0625
SF-E28,SF-F26,25,24,14,12,11,12,0.56,0.44,0.5,0.5
SF-E28,SF-M15,5,3,0,0,5,3,0.0,1.0,0.0,1.0
SF-E28,SF-L19,1,1,0,0,1,1,0.0,1.0,0.0,1.0
SF-E28,SF-L20,6,2,6,0,0,2,1.0,0.0,0.0,1.0
SF-E28,SF-M20,5,7,1,0,4,7,0.2,0.8,0.0,1.0
SF-E28,SF-K20,3,2,1,1,2,1,0.3333333333333333,0.6666666666666666,0.5,0.5
SF-E28,SF-K15-,1,2,0,0,1,2,0.0,1.0,0.0,1.0
SF-E28,SF-K19,2,4,1,0,1,4,0.5,0.5,0.0,1.0
SF-E28,SF-K18,10,6,1,1,9,5,0.1,0.9,0.16666666666666666,0.8333333333333334
SF-E28,SF-K17,4,3,1,0,3,3,0.25,0.75,0.0,1.0
SF-E28,SF-J16,4,1,4,0,0,1,1.0,0.0,0.0,1.0
SF-E28,SF-J18,6,5,1,2,5,3,0.16666666666666666,0.8333333333333334,0.4,0.6
SF-E28,SF-J20,4,6,2,0,2,6,0.5,0.5,0.0,1.0
SF-E28,SF-J19,2,8,0,4,2,4,0.0,1.0,0.5,0.5
SF-E28,SF-O18,3,3,1,1,2,2,0.3333333333333333,0.6666666666666666,0.3333333333333333,0.6666666666666666
SF-E28,SF-O19,23,9,0,2,23,7,0.0,1.0,0.2222222222222222,0.7777777777777778
SF-E28,SF-O21,1,4,0,1,1,3,0.0,1.0,0.25,0.75
SF-E28,SF-O22,4,7,2,2,2,5,0.5,0.5,0.2857142857142857,0.7142857142857143
SF-E28,SF-N21,2,2,0,0,2,2,0.0,1.0,0.0,1.0
SF-E28,SF-N20-2,1,3,0,0,1,3,0.0,1.0,0.0,1.0
SF-E28,SF-M21,1,4,0,0,1,4,0.0,1.0,0.0,1.0
SF-E28,SF-L21,2,6,1,1,1,5,0.5,0.5,0.16666666666666666,0.8333333333333334
SF-E28,SF-Q30,1,10,0,0,1,10,0.0,1.0,0.0,1.0
SF-E28,SF-P30,6,3,2,0,4,3,0.3333333333333333,0.6666666666666666,0.0,1.0
SF-E28,SF-O30,6,11,2,4,4,7,0.3333333333333333,0.6666666666666666,0.36363636363636365,0.6363636363636364
SF-E28,SF-N27,2,4,0,2,2,2,0.0,1.0,0.5,0.5
SF-E28,SF-L30-1,4,6,0,2,4,4,0.0,1.0,0.3333333333333333,0.6666666666666666
SF-E28,SF-L31-1,2,2,1,1,1,1,0.5,0.5,0.5,0.5
SF-E28,SF-K30-2,5,4,4,1,1,3,0.8,0.2,0.25,0.75
SF-E28,SF-L29,9,8,4,6,5,2,0.4444444444444444,0.5555555555555556,0.75,0.25
SF-E28,SF-J29-1,4,3,1,1,3,2,0.25,0.75,0.3333333333333333,0.6666666666666666
SF-E28,SF-I30,7,11,6,7,1,4,0.8571428571428571,0.14285714285714285,0.6363636363636364,0.36363636363636365
SF-E28,SF-I27,15,16,3,2,12,14,0.2,0.8,0.125,0.875
SF-E28,SF-I30-2,4,4,3,3,1,1,0.75,0.25,0.75,0.25
SF-E28,SF I29-1,11,7,7,0,4,7,0.6363636363636364,0.36363636363636365,0.0,1.0
SF-E28,SF-H28,3,7,0,6,3,1,0.0,1.0,0.8571428571428571,0.14285714285714285
SF-E28,SF-S24,23,7,21,6,2,1,0.9130434782608695,0.08695652173913043,0.8571428571428571,0.14285714285714285
SF-E28,SF-R24,2,4,2,1,0,3,1.0,0.0,0.25,0.75
SF-E28,SF-R26,2,1,0,0,2,1,0.0,1.0,0.0,1.0
SF-E28,SF-Q26,3,1,0,0,3,1,0.0,1.0,0.0,1.0
SF-E28,SF-P26,1,2,1,1,0,1,1.0,0.0,0.5,0.5
SF-E28,SF-O25-2,2,1,0,0,2,1,0.0,1.0,0.0,1.0
SF-E28,SF-N25,1,1,0,0,1,1,0.0,1.0,0.0,1.0
SF-E28,SF-T21,7,1,7,0,0,1,1.0,0.0,0.0,1.0
SF-E28,SF-T22,1,6,1,5,0,1,1.0,0.0,0.8333333333333334,0.16666666666666666
SF-E28,SF-S22-1,2,1,2,1,0,0,1.0,0.0,1.0,0.0
SF-E28,SF-Q23-3,3,2,3,2,0,0,1.0,0.0,1.0,0.0
SF-E28,SF-Q22-2,1,2,1,2,0,0,1.0,0.0,1.0,0.0
SF-E28,SF-P22,3,7,1,1,2,6,0.3333333333333333,0.6666666666666666,0.14285714285714285,0.8571428571428571
SF-J10,SF-J29-3,1,1,1,0,0,1,1.0,0.0,0.0,1.0
SF-J10,SF-J29,2,1,1,1,1,0,0.5,0.5,1.0,0.0
SF-J10,SF-L25,1,1,0,0,1,1,0.0,1.0,0.0,1.0
SF-J10,SF-M24,2,1,2,0,0,1,1.0,0.0,0.0,1.0
SF-J10,SF-L24,1,3,1,2,0,1,1.0,0.0,0.6666666666666666,0.3333333333333333
SF-J10,SF-N23,1,2,0,1,1,1,0.0,1.0,0.5,0.5
SF-J10,SF-J26-2,2,4,0,1,2,3,0.0,1.0,0.25,0.75
SF-J10,SF-L28,1,1,0,0,1,1,0.0,1.0,0.0,1.0
SF-J10,SF-K25,2,1,0,1,2,0,0.0,1.0,1.0,0.0
SF-J10,SF-J25,4,6,2,5,2,1,0.5,0.5,0.8333333333333334,0.16666666666666666
SF-J10,SF-J24,2,4,0,0,2,4,0.0,1.0,0.0,1.0
SF-J10,SF-O24,2,2,1,1,1,1,0.5,0.5,0.5,0.5
SF-J10,SF-H26,6,5,6,3,0,2,1.0,0.0,0.6,0.4
SF-J10,SF-G27,4,2,0,2,4,0,0.0,1.0,1.0,0.0
SF-J10,SF-L22,3,2,1,1,2,1,0.3333333333333333,0.6666666666666666,0.5,0.5
SF-J10,SF-F27,3,1,0,1,3,0,0.0,1.0,1.0,0.0
SF-J10,SF-N22-2,9,9,1,2,8,7,0.1111111111111111,0.8888888888888888,0.2222222222222222,0.7777777777777778
SF-J10,SF-M22-1,2,1,0,1,2,0,0.0,1.0,1.0,0.0
SF-J10,SF-O25-1,1,1,0,1,1,0,0.0,1.0,1.0,0.0
SF-J10,SF-J23-2,2,5,0,1,2,4,0.0,1.0,0.2,0.8
SF-J10,SF-G23,2,4,0,4,2,0,0.0,1.0,1.0,0.0
SF-J10,SF-G24,3,9,2,1,1,8,0.6666666666666666,0.3333333333333333,0.1111111111111111,0.8888888888888888
SF-J10,SF-G25,1,3,0,0,1,3,0.0,1.0,0.0,1.0
SF-J10,SF-F23,3,1,0,0,3,1,0.0,1.0,0.0,1.0
SF-J10,SF-E23,14,7,5,3,9,4,0.35714285714285715,0.6428571428571429,0.42857142857142855,0.5714285714285714
SF-J10,SF-D24,7,3,2,2,5,1,0.2857142857142857,0.7142857142857143,0.6666666666666666,0.3333333333333333
SF-J10,SF-C22,4,6,0,1,4,5,0.0,1.0,0.16666666666666666,0.8333333333333334
SF-J10,SF-B22,13,9,0,0,13,9,0.0,1.0,0.0,1.0
SF-J10,SF-J17,20,34,7,8,13,26,0.35,0.65,0.23529411764705882,0.7647058823529411
SF-J10,SF-I20,5,5,0,3,5,2,0.0,1.0,0.6,0.4
SF-J10,SF-H16,10,11,5,4,5,7,0.5,0.5,0.36363636363636365,0.6363636363636364
SF-J10,SF-H19,2,3,0,0,2,3,0.0,1.0,0.0,1.0
SF-J10,SF-H20,6,1,1,1,5,0,0.16666666666666666,0.8333333333333334,1.0,0.0
SF-J10,SF-H18,4,2,3,1,1,1,0.75,0.25,0.5,0.5
SF-J10,SF-H17,2,1,0,0,2,1,0.0,1.0,0.0,1.0
SF-J10,SF-G19,7,6,4,2,3,4,0.5714285714285714,0.42857142857142855,0.3333333333333333,0.6666666666666666
SF-J10,SF-G17,5,4,5,0,0,4,1.0,0.0,0.0,1.0
SF-J10,SF-G18,7,7,1,0,6,7,0.14285714285714285,0.8571428571428571,0.0,1.0
SF-J10,SF-G20,5,5,1,1,4,4,0.2,0.8,0.2,0.8
SF-J10,SF-F19,3,7,0,2,3,5,0.0,1.0,0.2857142857142857,0.7142857142857143
SF-J10,SF-E18,5,9,1,5,4,4,0.2,0.8,0.5555555555555556,0.4444444444444444
SF-J10,SF-E20,2,2,0,1,2,1,0.0,1.0,0.5,0.5
SF-J10,SF-E29-1,4,4,4,1,0,3,1.0,0.0,0.25,0.75
SF-J10,SF-G29-2,1,1,0,0,1,1,0.0,1.0,0.0,1.0
SF-J10,SF-G30-1,1,1,0,1,1,0,0.0,1.0,1.0,0.0
SF-J10,SF-J12,80,92,48,60,32,32,0.6,0.4,0.6521739130434783,0.34782608695652173
SF-J10,SF-J13,27,42,18,27,9,15,0.6666666666666666,0.3333333333333333,0.6428571428571429,0.35714285714285715
SF-J10,SF-J15,4,4,3,0,1,4,0.75,0.25,0.0,1.0
SF-J10,SF-J14,2,4,2,3,0,1,1.0,0.0,0.75,0.25
SF-J10,SF-H13,7,5,5,3,2,2,0.7142857142857143,0.2857142857142857,0.6,0.4
SF-J10,SF-I16,5,3,2,1,3,2,0.4,0.6,0.3333333333333333,0.6666666666666666
SF-J10,SF-H12,4,11,3,4,1,7,0.75,0.25,0.36363636363636365,0.6363636363636364
SF-J10,SF-G10-2,33,18,21,10,12,8,0.6363636363636364,0.36363636363636365,0.5555555555555556,0.4444444444444444
SF-J10,SF-H15,8,5,5,1,3,4,0.625,0.375,0.2,0.8
SF-J10,SF-G9,15,7,7,7,8,0,0.4666666666666667,0.5333333333333333,1.0,0.0
SF-J10,SF-H14,3,7,2,4,1,3,0.6666666666666666,0.3333333333333333,0.5714285714285714,0.42857142857142855
SF-J10,SF-G13,37,39,17,12,20,27,0.4594594594594595,0.5405405405405406,0.3076923076923077,0.6923076923076923
SF-J10,SF-G11,21,17,16,7,5,10,0.7619047619047619,0.23809523809523808,0.4117647058823529,0.5882352941176471
SF-J10,SF-G12,33,48,25,38,8,10,0.7575757575757576,0.24242424242424243,0.7916666666666666,0.20833333333333334
SF-J10,SF-G10-1,20,23,14,15,6,8,0.7,0.3,0.6521739130434783,0.34782608695652173
SF-J10,SF-F15,8,20,3,9,5,11,0.375,0.625,0.45,0.55
SF-J10,SF-C20,4,3,0,3,4,0,0.0,1.0,1.0,0.0
SF-J10,SF-A20,4,10,0,6,4,4,0.0,1.0,0.6,0.4
SF-J10,SF-C25,6,1,0,0,6,1,0.0,1.0,0.0,1.0
SF-J10,SF-B25,2,5,1,1,1,4,0.5,0.5,0.2,0.8
SF-J10,SF-B28,2,1,2,0,0,1,1.0,0.0,0.0,1.0
SF-J10,SF-J1,64,139,35,101,29,38,0.546875,0.453125,0.7266187050359713,0.2733812949640288
SF-J10,SF-H0,11,28,4,12,7,16,0.36363636363636365,0.6363636363636364,0.42857142857142855,0.5714285714285714
SF-J10,SF-J3,21,36,13,32,8,4,0.6190476190476191,0.38095238095238093,0.8888888888888888,0.1111111111111111
SF-J10,SF-J5,21,33,12,14,9,19,0.5714285714285714,0.42857142857142855,0.42424242424242425,0.5757575757575758
SF-J10,SF-G6,6,6,3,2,3,4,0.5,0.5,0.3333333333333333,0.6666666666666666
SF-J10,SF-G8,20,19,8,12,12,7,0.4,0.6,0.631578947368421,0.3684210526315789
SF-J10,SF-G5,10,7,7,3,3,4,0.7,0.3,0.42857142857142855,0.5714285714285714
SF-J10,SF-G7,35,26,22,17,13,9,0.6285714285714286,0.37142857142857144,0.6538461538461539,0.34615384615384615
SF-J10,SF-F9,8,26,2,16,6,10,0.25,0.75,0.6153846153846154,0.38461538461538464
SF-J10,SF-K21,16,7,9,5,7,2,0.5625,0.4375,0.7142857142857143,0.2857142857142857
SF-J10,SF-K22-1,4,1,2,0,2,1,0.5,0.5,0.0,1.0
SF-J10,SF-J23-1,7,10,0,10,7,0,0.0,1.0,1.0,0.0
SF-J10,SF-J22-1,6,11,1,9,5,2,0.16666666666666666,0.8333333333333334,0.8181818181818182,0.18181818181818182
SF-J10,SF-J22-2,11,1,2,0,9,1,0.18181818181818182,0.8181818181818182,0.0,1.0
SF-J10,SF-J21,8,10,1,5,7,5,0.125,0.875,0.5,0.5
SF-J10,SF-I21,2,9,0,4,2,5,0.0,1.0,0.4444444444444444,0.5555555555555556
SF-J10,SF-I23-2,4,3,1,0,3,3,0.25,0.75,0.0,1.0
SF-J10,SF-I24,5,6,4,1,1,5,0.8,0.2,0.16666666666666666,0.8333333333333334
SF-J10,SF-I23-1,1,4,1,1,0,3,1.0,0.0,0.25,0.75
SF-J10,SF-F26,12,7,1,1,11,6,0.08333333333333333,0.9166666666666666,0.14285714285714285,0.8571428571428571
SF-J10,SF-M13,126,147,71,84,55,63,0.5634920634920635,0.4365079365079365,0.5714285714285714,0.42857142857142855
SF-J10,SF-M15,104,65,24,10,80,55,0.23076923076923078,0.7692307692307693,0.15384615384615385,0.8461538461538461
SF-J10,SF-L19,30,20,9,6,21,14,0.3,0.7,0.3,0.7
SF-J10,SF-L20,8,6,4,3,4,3,0.5,0.5,0.5,0.5
SF-J10,SF-N20-1,4,6,0,2,4,4,0.0,1.0,0.3333333333333333,0.6666666666666666
SF-J10,SF-M20,20,20,3,3,17,17,0.15,0.85,0.15,0.85
SF-J10,SF-K17-2,10,13,6,8,4,5,0.6,0.4,0.6153846153846154,0.38461538461538464
SF-J10,SF-K20,25,21,13,8,12,13,0.52,0.48,0.38095238095238093,0.6190476190476191
SF-J10,SF-K15-,109,70,57,50,52,20,0.5229357798165137,0.47706422018348627,0.7142857142857143,0.2857142857142857
SF-J10,SF-K19,31,27,19,14,12,13,0.6129032258064516,0.3870967741935484,0.5185185185185185,0.48148148148148145
SF-J10,SF-K18,50,45,25,22,25,23,0.5,0.5,0.4888888888888889,0.5111111111111111
SF-J10,SF-K17,83,58,36,28,47,30,0.43373493975903615,0.5662650602409639,0.4827586206896552,0.5172413793103449
SF-J10,SF-J16,26,6,13,5,13,1,0.5,0.5,0.8333333333333334,0.16666666666666666
SF-J10,SF-J18,31,31,16,11,15,20,0.5161290322580645,0.4838709677419355,0.3548387096774194,0.6451612903225806
SF-J10,SF-J19,19,8,3,0,16,8,0.15789473684210525,0.8421052631578947,0.0,1.0
SF-J10,SF-O12,1,1,1,0,0,1,1.0,0.0,0.0,1.0
SF-J10,SF-M12,37,10,27,7,10,3,0.7297297297297297,0.2702702702702703,0.7,0.3
SF-J10,SF-M10,29,24,25,18,4,6,0.8620689655172413,0.13793103448275862,0.75,0.25
SF-J10,SF-M11,42,40,37,25,5,15,0.8809523809523809,0.11904761904761904,0.625,0.375
SF-J10,SF-R19,3,4,0,0,3,4,0.0,1.0,0.0,1.0
SF-J10,SF-R20,3,1,0,0,3,1,0.0,1.0,0.0,1.0
SF-J10,SF-Q21-2,1,3,0,0,1,3,0.0,1.0,0.0,1.0
SF-J10,SF-Q21-1,3,3,1,0,2,3,0.3333333333333333,0.6666666666666666,0.0,1.0
SF-J10,SF-P21,4,5,0,2,4,3,0.0,1.0,0.4,0.6
SF-J10,SF-O18,13,7,0,0,13,7,0.0,1.0,0.0,1.0
SF-J10,SF-O19,13,12,5,4,8,8,0.38461538461538464,0.6153846153846154,0.3333333333333333,0.6666666666666666
SF-J10,SF-O21,9,21,2,8,7,13,0.2222222222222222,0.7777777777777778,0.38095238095238093,0.6190476190476191
SF-J10,SF-O22,8,8,1,3,7,5,0.125,0.875,0.375,0.625
SF-J10,SF-N21,8,5,4,1,4,4,0.5,0.5,0.2,0.8
SF-J10,SF-N20-2,6,3,4,1,2,2,0.6666666666666666,0.3333333333333333,0.3333333333333333,0.6666666666666666
SF-J10,SF-M21,2,1,2,0,0,1,1.0,0.0,0.0,1.0
SF-J10,SF-L21,18,11,8,3,10,8,0.4444444444444444,0.5555555555555556,0.2727272727272727,0.7272727272727273
SF-J10,SF-P30,2,2,1,2,1,0,0.5,0.5,1.0,0.0
SF-J10,SF-O30,3,1,1,1,2,0,0.3333333333333333,0.6666666666666666,1.0,0.0
SF-J10,SF-N29,1,2,1,0,0,2,1.0,0.0,0.0,1.0
SF-J10,SF-N28,1,3,0,0,1,3,0.0,1.0,0.0,1.0
SF-J10,SF-L30-1,2,4,2,2,0,2,1.0,0.0,0.5,0.5
SF-J10,SF-H28,4,1,2,0,2,1,0.5,0.5,0.0,1.0
SF-J10,SF-R24,5,2,2,0,3,2,0.4,0.6,0.0,1.0
SF-J10,SF-P26,2,1,0,1,2,0,0.0,1.0,1.0,0.0
SF-J10,SF-Q23-3,1,1,0,0,1,1,0.0,1.0,0.0,1.0
SF-J10,SF-Q22-1,4,3,1,1,3,2,0.25,0.75,0.3333333333333333,0.6666666666666666
SF-J10,SF-Q22-2,8,3,0,0,8,3,0.0,1.0,0.0,1.0
SF-J10,SF-P22,8,6,2,2,6,4,0.25,0.75,0.3333333333333333,0.6666666666666666
SF-J10,SF-T20,2,2,0,1,2,1,0.0,1.0,0.5,0.5
SF-J10,SF-W14,1,1,0,1,1,0,0.0,1.0,1.0,0.0
SF-J12,SF-M25,4,1,0,0,4,1,0.0,1.0,0.0,1.0
SF-J12,SF-M26-2,2,2,1,2,1,0,0.5,0.5,1.0,0.0
SF-J12,SF-J27,1,2,0,0,1,2,0.0,1.0,0.0,1.0
SF-J12,SF-M30,34,15,0,15,34,0,0.0,1.0,1.0,0.0
SF-J12,SF-J29,4,5,0,0,4,5,0.0,1.0,0.0,1.0
SF-J12,SF-M24,1,4,0,3,1,1,0.0,1.0,0.75,0.25
SF-J12,SF-N23,5,4,0,1,5,3,0.0,1.0,0.25,0.75
SF-J12,SF-N24-2,6,5,2,3,4,2,0.3333333333333333,0.6666666666666666,0.6,0.4
SF-J12,SF-K27-2,6,3,1,0,5,3,0.16666666666666666,0.8333333333333334,0.0,1.0
SF-J12,SF-J26-2,5,1,1,0,4,1,0.2,0.8,0.0,1.0
SF-J12,SF-K29-1,1,2,0,0,1,2,0.0,1.0,0.0,1.0
SF-J12,SF-J28-2,1,1,0,0,1,1,0.0,1.0,0.0,1.0
SF-J12,SF-H26-2,11,15,1,0,10,15,0.09090909090909091,0.9090909090909091,0.0,1.0
SF-J12,SF-P24,3,3,1,2,2,1,0.3333333333333333,0.6666666666666666,0.6666666666666666,0.3333333333333333
SF-J12,SF-O24,5,2,0,0,5,2,0.0,1.0,0.0,1.0
SF-J12,SF-I25,3,5,2,1,1,4,0.6666666666666666,0.3333333333333333,0.2,0.8
SF-J12,SF-H26,5,7,0,3,5,4,0.0,1.0,0.42857142857142855,0.5714285714285714
SF-J12,SF-F28-2,7,2,0,1,7,1,0.0,1.0,0.5,0.5
SF-J12,SF-G27,5,15,0,1,5,14,0.0,1.0,0.06666666666666667,0.9333333333333333
SF-J12,SF-M22-2,6,7,2,5,4,2,0.3333333333333333,0.6666666666666666,0.7142857142857143,0.2857142857142857
SF-J12,SF-L22,6,5,1,4,5,1,0.16666666666666666,0.8333333333333334,0.8,0.2
SF-J12,SF-F27,6,7,1,3,5,4,0.16666666666666666,0.8333333333333334,0.42857142857142855,0.5714285714285714
SF-J12,SF-N22-2,12,6,5,1,7,5,0.4166666666666667,0.5833333333333334,0.16666666666666666,0.8333333333333334
SF-J12,SF-G28-1,2,1,1,0,1,1,0.5,0.5,0.0,1.0
SF-J12,SF-M22-1,5,8,0,5,5,3,0.0,1.0,0.625,0.375
SF-J12,SF-O25-1,1,2,0,1,1,1,0.0,1.0,0.5,0.5
SF-J12,SF-K22-2,5,3,1,2,4,1,0.2,0.8,0.6666666666666666,0.3333333333333333
SF-J12,SF-K24,1,5,1,1,0,4,1.0,0.0,0.2,0.8
SF-J12,SF-J23-2,12,6,1,0,11,6,0.08333333333333333,0.9166666666666666,0.0,1.0
SF-J12,SF-G23,1,1,0,0,1,1,0.0,1.0,0.0,1.0
SF-J12,SF-G24,5,7,1,2,4,5,0.2,0.8,0.2857142857142857,0.7142857142857143
SF-J12,SF-G25,2,1,0,0,2,1,0.0,1.0,0.0,1.0
SF-J12,SF-F23,6,11,0,0,6,11,0.0,1.0,0.0,1.0
SF-J12,SF-E23,13,9,0,1,13,8,0.0,1.0,0.1111111111111111,0.8888888888888888
SF-J12,SF-D24,16,3,2,1,14,2,0.125,0.875,0.3333333333333333,0.6666666666666666
SF-J12,SF-C22,15,6,1,2,14,4,0.06666666666666667,0.9333333333333333,0.3333333333333333,0.6666666666666666
SF-J12,SF-B22,5,5,1,0,4,5,0.2,0.8,0.0,1.0
SF-J12,SF-J17,49,55,20,19,29,36,0.40816326530612246,0.5918367346938775,0.34545454545454546,0.6545454545454545
SF-J12,SF-I19,7,11,0,0,7,11,0.0,1.0,0.0,1.0
SF-J12,SF-I20,3,1,2,1,1,0,0.6666666666666666,0.3333333333333333,1.0,0.0
SF-J12,SF-H16,39,30,9,5,30,25,0.23076923076923078,0.7692307692307693,0.16666666666666666,0.8333333333333334
SF-J12,SF-H20,9,5,0,2,9,3,0.0,1.0,0.4,0.6
SF-J12,SF-H18,10,3,2,0,8,3,0.2,0.8,0.0,1.0
SF-J12,SF-H17,8,10,0,0,8,10,0.0,1.0,0.0,1.0
SF-J12,SF-G19,8,10,3,5,5,5,0.375,0.625,0.5,0.5
SF-J12,SF-G17,2,3,0,1,2,2,0.0,1.0,0.3333333333333333,0.6666666666666666
SF-J12,SF-G18,17,37,2,3,15,34,0.11764705882352941,0.8823529411764706,0.08108108108108109,0.918918918918919
SF-J12,SF-G20,7,7,2,1,5,6,0.2857142857142857,0.7142857142857143,0.14285714285714285,0.8571428571428571
SF-J12,SF-F19,10,13,0,2,10,11,0.0,1.0,0.15384615384615385,0.8461538461538461
SF-J12,SF-E18,13,11,4,4,9,7,0.3076923076923077,0.6923076923076923,0.36363636363636365,0.6363636363636364
SF-J12,SF-E20,13,15,4,3,9,12,0.3076923076923077,0.6923076923076923,0.2,0.8
SF-J12,SF-H30,1,2,0,0,1,2,0.0,1.0,0.0,1.0
SF-J12,SF-G30-2,4,15,0,3,4,12,0.0,1.0,0.2,0.8
SF-J12,SF-F30-1,2,1,0,0,2,1,0.0,1.0,0.0,1.0
SF-J12,SF-E29-2,29,17,1,1,28,16,0.034482758620689655,0.9655172413793104,0.058823529411764705,0.9411764705882353
SF-J12,SF-D28,1,2,0,2,1,0,0.0,1.0,1.0,0.0
SF-J12,SF-G29-2,1,4,0,0,1,4,0.0,1.0,0.0,1.0
SF-J12,SF-G29-1,3,4,0,3,3,1,0.0,1.0,0.75,0.25
SF-J12,SF-G30-1,4,8,0,1,4,7,0.0,1.0,0.125,0.875
SF-J12,SF-G29-3,2,2,0,0,2,2,0.0,1.0,0.0,1.0
SF-J12,SF-F29,2,9,0,0,2,9,0.0,1.0,0.0,1.0
SF-J12,SF-E28-2,2,1,0,0,2,1,0.0,1.0,0.0,1.0
SF-J12,SF-E28,1,1,0,1,1,0,0.0,1.0,1.0,0.0
SF-J12,SF-J10,92,80,60,48,32,32,0.6521739130434783,0.34782608695652173,0.6,0.4
SF-J12,SF-J13,137,149,81,76,56,73,0.5912408759124088,0.40875912408759124,0.5100671140939598,0.4899328859060403
SF-J12,SF-J15,25,17,7,4,18,13,0.28,0.72,0.23529411764705882,0.7647058823529411
SF-J12,SF-J14,9,6,7,1,2,5,0.7777777777777778,0.2222222222222222,0.16666666666666666,0.8333333333333334
SF-J12,SF-H13,33,42,23,23,10,19,0.696969696969697,0.30303030303030304,0.5476190476190477,0.4523809523809524
SF-J12,SF-I16,7,7,2,2,5,5,0.2857142857142857,0.7142857142857143,0.2857142857142857,0.7142857142857143
SF-J12,SF-H12,54,47,26,28,28,19,0.48148148148148145,0.5185185185185185,0.5957446808510638,0.40425531914893614
SF-J12,SF-G10-2,24,23,14,17,10,6,0.5833333333333334,0.4166666666666667,0.7391304347826086,0.2608695652173913
SF-J12,SF-H15,14,13,3,2,11,11,0.21428571428571427,0.7857142857142857,0.15384615384615385,0.8461538461538461
SF-J12,SF-G9,32,31,15,14,17,17,0.46875,0.53125,0.45161290322580644,0.5483870967741935
SF-J12,SF-H14,13,12,7,9,6,3,0.5384615384615384,0.46153846153846156,0.75,0.25
SF-J12,SF-G13,84,76,37,40,47,36,0.44047619047619047,0.5595238095238095,0.5263157894736842,0.47368421052631576
SF-J12,SF-G11,56,47,32,25,24,22,0.5714285714285714,0.42857142857142855,0.5319148936170213,0.46808510638297873
SF-J12,SF-G12,120,117,73,71,47,46,0.6083333333333333,0.39166666666666666,0.6068376068376068,0.39316239316239315
SF-J12,SF-G10-1,21,25,5,15,16,10,0.23809523809523808,0.7619047619047619,0.6,0.4
SF-J12,SF-F15,29,27,9,5,20,22,0.3103448275862069,0.6896551724137931,0.18518518518518517,0.8148148148148148
SF-J12,SF-F16,19,24,6,1,13,23,0.3157894736842105,0.6842105263157895,0.041666666666666664,0.9583333333333334
SF-J12,SF-C21,6,6,0,0,6,6,0.0,1.0,0.0,1.0
SF-J12,SF-C20,1,4,0,3,1,1,0.0,1.0,0.75,0.25
SF-J12,SF-B21,1,2,0,0,1,2,0.0,1.0,0.0,1.0
SF-J12,SF-B19,6,18,0,5,6,13,0.0,1.0,0.2777777777777778,0.7222222222222222
SF-J12,SF-A20,2,15,2,2,0,13,1.0,0.0,0.13333333333333333,0.8666666666666667
SF-J12,SF-A19,2,3,0,2,2,1,0.0,1.0,0.6666666666666666,0.3333333333333333
SF-J12,SF-C26,3,3,0,0,3,3,0.0,1.0,0.0,1.0
SF-J12,SF-C25,3,7,0,2,3,5,0.0,1.0,0.2857142857142857,0.7142857142857143
SF-J12,SF-B25,4,4,0,1,4,3,0.0,1.0,0.25,0.75
SF-J12,SF-E27,4,3,0,2,4,1,0.0,1.0,0.6666666666666666,0.3333333333333333
SF-J12,SF-J1,65,107,23,66,42,41,0.35384615384615387,0.6461538461538462,0.616822429906542,0.38317757009345793
SF-J12,SF-H0,37,36,11,18,26,18,0.2972972972972973,0.7027027027027027,0.5,0.5
SF-J12,SF-J3,29,34,11,14,18,20,0.3793103448275862,0.6206896551724138,0.4117647058823529,0.5882352941176471
SF-J12,SF-J5,25,37,13,24,12,13,0.52,0.48,0.6486486486486487,0.35135135135135137
SF-J12,SF-G6,19,34,5,10,14,24,0.2631578947368421,0.7368421052631579,0.29411764705882354,0.7058823529411765
SF-J12,SF-G8,26,33,12,20,14,13,0.46153846153846156,0.5384615384615384,0.6060606060606061,0.3939393939393939
SF-J12,SF-G5,19,25,11,4,8,21,0.5789473684210527,0.42105263157894735,0.16,0.84
SF-J12,SF-G7,37,55,10,16,27,39,0.2702702702702703,0.7297297297297297,0.2909090909090909,0.7090909090909091
SF-J12,SF-F9,43,46,9,8,34,38,0.20930232558139536,0.7906976744186046,0.17391304347826086,0.8260869565217391
SF-J12,SF-G26,4,2,0,0,4,2,0.0,1.0,0.0,1.0
SF-J12,SF-K21,34,51,4,8,30,43,0.11764705882352941,0.8823529411764706,0.1568627450980392,0.8431372549019608
SF-J12,SF-K22-1,16,35,1,12,15,23,0.0625,0.9375,0.34285714285714286,0.6571428571428571
SF-J12,SF-J23-1,15,23,6,14,9,9,0.4,0.6,0.6086956521739131,0.391304347826087
SF-J12,SF-J22-1,19,31,0,9,19,22,0.0,1.0,0.2903225806451613,0.7096774193548387
SF-J12,SF-J22-2,11,5,0,2,11,3,0.0,1.0,0.4,0.6
SF-J12,SF-J21,14,10,6,1,8,9,0.42857142857142855,0.5714285714285714,0.1,0.9
SF-J12,SF-I21,6,2,0,2,6,0,0.0,1.0,1.0,0.0
SF-J12,SF-I22,2,3,0,2,2,1,0.0,1.0,0.6666666666666666,0.3333333333333333
SF-J12,SF-I23-2,2,1,1,0,1,1,0.5,0.5,0.0,1.0
SF-J12,SF-I24,1,1,0,0,1,1,0.0,1.0,0.0,1.0
SF-J12,SF-I23-1,2,3,1,0,1,3,0.5,0.5,0.0,1.0
SF-J12,SF-F26,5,24,2,5,3,19,0.4,0.6,0.20833333333333334,0.7916666666666666
SF-J12,SF-M13,85,66,47,24,38,42,0.5529411764705883,0.4470588235294118,0.36363636363636365,0.6363636363636364
SF-J12,SF-M15,41,46,24,21,17,25,0.5853658536585366,0.4146341463414634,0.45652173913043476,0.5434782608695652
SF-J12,SF-L19,21,10,4,2,17,8,0.19047619047619047,0.8095238095238095,0.2,0.8
SF-J12,SF-L20,16,22,3,2,13,20,0.1875,0.8125,0.09090909090909091,0.9090909090909091
SF-J12,SF-N20-1,9,4,4,1,5,3,0.4444444444444444,0.5555555555555556,0.25,0.75
SF-J12,SF-M20,29,33,4,8,25,25,0.13793103448275862,0.8620689655172413,0.24242424242424243,0.7575757575757576
SF-J12,SF-K17-2,19,24,6,2,13,22,0.3157894736842105,0.6842105263157895,0.08333333333333333,0.9166666666666666
SF-J12,SF-K20,26,36,7,16,19,20,0.2692307692307692,0.7307692307692307,0.4444444444444444,0.5555555555555556
SF-J12,SF-K15-,89,71,43,37,46,34,0.48314606741573035,0.5168539325842697,0.5211267605633803,0.4788732394366197
SF-J12,SF-K19,25,34,10,14,15,20,0.4,0.6,0.4117647058823529,0.5882352941176471
SF-J12,SF-K18,51,31,19,8,32,23,0.37254901960784315,0.6274509803921569,0.25806451612903225,0.7419354838709677
SF-J12,SF-K17,57,49,34,24,23,25,0.5964912280701754,0.40350877192982454,0.4897959183673469,0.5102040816326531
SF-J12,SF-J16,11,11,4,3,7,8,0.36363636363636365,0.6363636363636364,0.2727272727272727,0.7272727272727273
SF-J12,SF-J18,37,43,13,14,24,29,0.35135135135135137,0.6486486486486487,0.32558139534883723,0.6744186046511628
SF-J12,SF-J20,4,3,0,0,4,3,0.0,1.0,0.0,1.0
SF-J12,SF-J19,18,12,2,2,16,10,0.1111111111111111,0.8888888888888888,0.16666666666666666,0.8333333333333334
SF-J12,SF-O12,1,3,1,0,0,3,1.0,0.0,0.0,1.0
SF-J12,SF-M12,61,51,42,24,19,27,0.6885245901639344,0.3114754098360656,0.47058823529411764,0.5294117647058824
SF-J12,SF-M10,20,38,5,13,15,25,0.25,0.75,0.34210526315789475,0.6578947368421053
SF-J12,SF-M11,61,65,34,41,27,24,0.5573770491803278,0.4426229508196721,0.6307692307692307,0.36923076923076925
SF-J12,SF-R19,5,2,0,0,5,2,0.0,1.0,0.0,1.0
SF-J12,SF-R20,3,2,0,0,3,2,0.0,1.0,0.0,1.0
SF-J12,SF-Q21-2,5,3,0,0,5,3,0.0,1.0,0.0,1.0
SF-J12,SF-P21,9,6,1,1,8,5,0.1111111111111111,0.8888888888888888,0.16666666666666666,0.8333333333333334
SF-J12,SF-O18,6,6,0,2,6,4,0.0,1.0,0.3333333333333333,0.6666666666666666
SF-J12,SF-O19,4,13,0,3,4,10,0.0,1.0,0.23076923076923078,0.7692307692307693
SF-J12,SF-O21,19,21,3,3,16,18,0.15789473684210525,0.8421052631578947,0.14285714285714285,0.8571428571428571
SF-J12,SF-O22,11,13,0,1,11,12,0.0,1.0,0.07692307692307693,0.9230769230769231
SF-J12,SF-N21,9,5,3,0,6,5,0.3333333333333333,0.6666666666666666,0.0,1.0
SF-J12,SF-N20-2,4,7,0,2,4,5,0.0,1.0,0.2857142857142857,0.7142857142857143
SF-J12,SF-M21,13,13,5,2,8,11,0.38461538461538464,0.6153846153846154,0.15384615384615385,0.8461538461538461
SF-J12,SF-L21,21,26,3,12,18,14,0.14285714285714285,0.8571428571428571,0.46153846153846156,0.5384615384615384
SF-J12,SF-N27,8,8,2,3,6,5,0.25,0.75,0.375,0.625
SF-J12,SF-N28,1,2,0,0,1,2,0.0,1.0,0.0,1.0
SF-J12,SF-L30-1,32,81,0,62,32,19,0.0,1.0,0.7654320987654321,0.2345679012345679
SF-J12,SF-I27,1,2,0,0,1,2,0.0,1.0,0.0,1.0
SF-J12,SF-R24,8,9,2,4,6,5,0.25,0.75,0.4444444444444444,0.5555555555555556
SF-J12,SF-Q26,1,4,0,1,1,3,0.0,1.0,0.25,0.75
SF-J12,SF-P26,2,4,0,2,2,2,0.0,1.0,0.5,0.5
SF-J12,SF-O25-2,1,1,0,0,1,1,0.0,1.0,0.0,1.0
SF-J12,SF-N26,2,1,0,0,2,1,0.0,1.0,0.0,1.0
SF-J12,SF-T21,1,1,0,0,1,1,0.0,1.0,0.0,1.0
SF-J12,SF-T22,1,1,0,0,1,1,0.0,1.0,0.0,1.0
SF-J12,SF-S22-1,26,23,7,1,19,22,0.2692307692307692,0.7307692307692307,0.043478260869565216,0.9565217391304348
SF-J12,SF-Q23-3,3,3,0,0,3,3,0.0,1.0,0.0,1.0
SF-J12,SF-Q22-1,2,1,0,0,2,1,0.0,1.0,0.0,1.0
SF-J12,SF-Q22-2,2,7,0,1,2,6,0.0,1.0,0.14285714285714285,0.8571428571428571
SF-J12,SF-P22,6,5,1,1,5,4,0.16666666666666666,0.8333333333333334,0.2,0.8
SF-J12,SF-W19,1,4,0,0,1,4,0.0,1.0,0.0,1.0
SF-J12,SF-T20,1,1,1,0,0,1,1.0,0.0,0.0,1.0
SF-J12,SF-S21,1,2,0,0,1,2,0.0,1.0,0.0,1.0
SF-J12,SF-W8,1,1,0,0,1,1,0.0,1.0,0.0,1.0
SF-J12,SF-AA15,2,1,0,0,2,1,0.0,1.0,0.0,1.0
SF-J13,SF-K26,1,4,0,0,1,4,0.0,1.0,0.0,1.0
SF-J13,SF-M30,1,2,0,1,1,1,0.0,1.0,0.5,0.5
SF-J13,SF-J29-3,1,1,1,0,0,1,1.0,0.0,0.0,1.0
SF-J13,SF-J29,4,1,3,0,1,1,0.75,0.25,0.0,1.0
SF-J13,SF-L26,1,2,0,2,1,0,0.0,1.0,1.0,0.0
SF-J13,SF-M28,2,2,0,0,2,2,0.0,1.0,0.0,1.0
SF-J13,SF-M27,1,1,0,0,1,1,0.0,1.0,0.0,1.0
SF-J13,SF-L24,5,9,1,1,4,8,0.2,0.8,0.1111111111111111,0.8888888888888888
SF-J13,SF-N23,2,3,0,0,2,3,0.0,1.0,0.0,1.0
SF-J13,SF-K25,1,5,0,0,1,5,0.0,1.0,0.0,1.0
SF-J13,SF-J25,4,5,2,0,2,5,0.5,0.5,0.0,1.0
SF-J13,SF-J24,2,1,1,0,1,1,0.5,0.5,0.0,1.0
SF-J13,SF-I25,1,2,0,0,1,2,0.0,1.0,0.0,1.0
SF-J13,SF-H26,9,10,2,0,7,10,0.2222222222222222,0.7777777777777778,0.0,1.0
SF-J13,SF-O23,1,3,0,0,1,3,0.0,1.0,0.0,1.0
SF-J13,SF-F28-2,2,2,1,0,1,2,0.5,0.5,0.0,1.0
SF-J13,SF-G27,5,4,0,0,5,4,0.0,1.0,0.0,1.0
SF-J13,SF-M22-2,3,4,0,0,3,4,0.0,1.0,0.0,1.0
SF-J13,SF-F27,2,10,0,6,2,4,0.0,1.0,0.6,0.4
SF-J13,SF-N22-2,2,6,0,3,2,3,0.0,1.0,0.5,0.5
SF-J13,SF-G28-1,1,1,0,1,1,0,0.0,1.0,1.0,0.0
SF-J13,SF-M22-1,1,2,0,0,1,2,0.0,1.0,0.0,1.0
SF-J13,SF-K24,5,7,1,4,4,3,0.2,0.8,0.5714285714285714,0.42857142857142855
SF-J13,SF-J23-2,3,2,0,0,3,2,0.0,1.0,0.0,1.0
SF-J13,SF-G23,7,2,1,0,6,2,0.14285714285714285,0.8571428571428571,0.0,1.0
SF-J13,SF-G24,11,5,0,1,11,4,0.0,1.0,0.2,0.8
SF-J13,SF-G25,6,2,2,2,4,0,0.3333333333333333,0.6666666666666666,1.0,0.0
SF-J13,SF-F23,16,1,1,0,15,1,0.0625,0.9375,0.0,1.0
SF-J13,SF-E23,12,11,2,3,10,8,0.16666666666666666,0.8333333333333334,0.2727272727272727,0.7272727272727273
SF-J13,SF-D24,6,10,0,0,6,10,0.0,1.0,0.0,1.0
SF-J13,SF-C22,4,4,0,1,4,3,0.0,1.0,0.25,0.75
SF-J13,SF-B22,10,5,6,2,4,3,0.6,0.4,0.4,0.6
SF-J13,SF-J17,16,10,4,4,12,6,0.25,0.75,0.4,0.6
SF-J13,SF-I19,3,3,1,0,2,3,0.3333333333333333,0.6666666666666666,0.0,1.0
SF-J13,SF-H16,42,32,10,3,32,29,0.23809523809523808,0.7619047619047619,0.09375,0.90625
SF-J13,SF-H20,2,2,0,0,2,2,0.0,1.0,0.0,1.0
SF-J13,SF-H18,4,4,0,1,4,3,0.0,1.0,0.25,0.75
SF-J13,SF-H17,1,2,0,0,1,2,0.0,1.0,0.0,1.0
SF-J13,SF-G19,8,4,3,3,5,1,0.375,0.625,0.75,0.25
SF-J13,SF-G17,4,4,1,1,3,3,0.25,0.75,0.25,0.75
SF-J13,SF-G18,3,7,0,2,3,5,0.0,1.0,0.2857142857142857,0.7142857142857143
SF-J13,SF-G20,6,4,1,2,5,2,0.16666666666666666,0.8333333333333334,0.5,0.5
SF-J13,SF-F19,1,2,0,0,1,2,0.0,1.0,0.0,1.0
SF-J13,SF-E18,11,7,2,4,9,3,0.18181818181818182,0.8181818181818182,0.5714285714285714,0.42857142857142855
SF-J13,SF-E20,26,49,2,0,24,49,0.07692307692307693,0.9230769230769231,0.0,1.0
SF-J13,SF-G30-2,4,2,0,0,4,2,0.0,1.0,0.0,1.0
SF-J13,SF-E29-2,2,3,0,1,2,2,0.0,1.0,0.3333333333333333,0.6666666666666666
SF-J13,SF-G29-2,5,9,0,2,5,7,0.0,1.0,0.2222222222222222,0.7777777777777778
SF-J13,SF-E29-3,1,1,0,0,1,1,0.0,1.0,0.0,1.0
SF-J13,SF-E28,1,1,0,0,1,1,0.0,1.0,0.0,1.0
SF-J13,SF-J10,42,27,27,18,15,9,0.6428571428571429,0.35714285714285715,0.6666666666666666,0.3333333333333333
SF-J13,SF-J12,149,137,76,81,73,56,0.5100671140939598,0.4899328859060403,0.5912408759124088,0.40875912408759124
SF-J13,SF-J15,22,5,10,1,12,4,0.45454545454545453,0.5454545454545454,0.2,0.8
SF-J13,SF-J14,9,5,3,3,6,2,0.3333333333333333,0.6666666666666666,0.6,0.4
SF-J13,SF-H13,58,60,27,22,31,38,0.46551724137931033,0.5344827586206896,0.36666666666666664,0.6333333333333333
SF-J13,SF-I16,10,8,5,2,5,6,0.5,0.5,0.25,0.75
SF-J13,SF-H12,79,90,39,38,40,52,0.4936708860759494,0.5063291139240507,0.4222222222222222,0.5777777777777777
SF-J13,SF-G10-2,15,16,5,3,10,13,0.3333333333333333,0.6666666666666666,0.1875,0.8125
SF-J13,SF-H15,9,12,1,3,8,9,0.1111111111111111,0.8888888888888888,0.25,0.75
SF-J13,SF-G9,10,12,2,2,8,10,0.2,0.8,0.16666666666666666,0.8333333333333334
SF-J13,SF-H14,7,14,5,13,2,1,0.7142857142857143,0.2857142857142857,0.9285714285714286,0.07142857142857142
SF-J13,SF-G13,153,113,88,59,65,54,0.5751633986928104,0.42483660130718953,0.5221238938053098,0.4778761061946903
SF-J13,SF-G11,20,35,14,31,6,4,0.7,0.3,0.8857142857142857,0.11428571428571428
SF-J13,SF-G12,42,50,15,22,27,28,0.35714285714285715,0.6428571428571429,0.44,0.56
SF-J13,SF-G10-1,24,33,8,16,16,17,0.3333333333333333,0.6666666666666666,0.48484848484848486,0.5151515151515151
SF-J13,SF-F15,22,24,8,13,14,11,0.36363636363636365,0.6363636363636364,0.5416666666666666,0.4583333333333333
SF-J13,SF-F16,9,18,1,2,8,16,0.1111111111111111,0.8888888888888888,0.1111111111111111,0.8888888888888888
SF-J13,SF-C21,4,7,0,0,4,7,0.0,1.0,0.0,1.0
SF-J13,SF-C20,6,3,0,0,6,3,0.0,1.0,0.0,1.0
SF-J13,SF-B19,9,7,2,3,7,4,0.2222222222222222,0.7777777777777778,0.42857142857142855,0.5714285714285714
SF-J13,SF-A20,6,2,2,0,4,2,0.3333333333333333,0.6666666666666666,0.0,1.0
SF-J13,SF-A19,1,4,1,3,0,1,1.0,0.0,0.75,0.25
SF-J13,SF-C26,5,1,0,1,5,0,0.0,1.0,1.0,0.0
SF-J13,SF-C25,2,2,0,1,2,1,0.0,1.0,0.5,0.5
SF-J13,SF-B25,2,2,0,0,2,2,0.0,1.0,0.0,1.0
SF-J13,SF-J1,53,100,26,57,27,43,0.49056603773584906,0.5094339622641509,0.57,0.43
SF-J13,SF-H0,12,11,3,9,9,2,0.25,0.75,0.8181818181818182,0.18181818181818182
SF-J13,SF-J3,14,15,1,7,13,8,0.07142857142857142,0.9285714285714286,0.4666666666666667,0.5333333333333333
SF-J13,SF-J5,18,18,8,7,10,11,0.4444444444444444,0.5555555555555556,0.3888888888888889,0.6111111111111112
SF-J13,SF-G6,14,24,5,8,9,16,0.35714285714285715,0.6428571428571429,0.3333333333333333,0.6666666666666666
SF-J13,SF-G8,6,16,3,13,3,3,0.5,0.5,0.8125,0.1875
SF-J13,SF-G5,35,21,23,13,12,8,0.6571428571428571,0.34285714285714286,0.6190476190476191,0.38095238095238093
SF-J13,SF-G7,30,73,11,61,19,12,0.36666666666666664,0.6333333333333333,0.8356164383561644,0.1643835616438356
SF-J13,SF-F9,16,14,14,13,2,1,0.875,0.125,0.9285714285714286,0.07142857142857142
SF-J13,SF-H25,4,1,0,1,4,0,0.0,1.0,1.0,0.0
SF-J13,SF-G26,1,2,0,2,1,0,0.0,1.0,1.0,0.0
SF-J13,SF-K21,6,12,0,2,6,10,0.0,1.0,0.16666666666666666,0.8333333333333334
SF-J13,SF-K22-1,3,2,0,1,3,1,0.0,1.0,0.5,0.5
SF-J13,SF-J23-1,8,8,1,1,7,7,0.125,0.875,0.125,0.875
SF-J13,SF-J22-1,4,3,0,1,4,2,0.0,1.0,0.3333333333333333,0.6666666666666666
SF-J13,SF-J22-2,6,3,1,0,5,3,0.16666666666666666,0.8333333333333334,0.0,1.0
SF-J13,SF-J21,8,10,0,0,8,10,0.0,1.0,0.0,1.0
SF-J13,SF-I21,2,1,0,0,2,1,0.0,1.0,0.0,1.0
SF-J13,SF-I22,7,4,0,0,7,4,0.0,1.0,0.0,1.0
SF-J13,SF-I23-2,1,1,0,0,1,1,0.0,1.0,0.0,1.0
SF-J13,SF-I24,3,1,2,0,1,1,0.6666666666666666,0.3333333333333333,0.0,1.0
SF-J13,SF-I23-1,1,2,0,0,1,2,0.0,1.0,0.0,1.0
SF-J13,SF-F26,4,3,1,1,3,2,0.25,0.75,0.3333333333333333,0.6666666666666666
SF-J13,SF-M13,30,36,6,7,24,29,0.2,0.8,0.19444444444444445,0.8055555555555556
SF-J13,SF-M15,8,20,1,5,7,15,0.125,0.875,0.25,0.75
SF-J13,SF-L19,11,7,1,2,10,5,0.09090909090909091,0.9090909090909091,0.2857142857142857,0.7142857142857143
SF-J13,SF-L20,12,9,4,2,8,7,0.3333333333333333,0.6666666666666666,0.2222222222222222,0.7777777777777778
SF-J13,SF-M20,9,17,2,4,7,13,0.2222222222222222,0.7777777777777778,0.23529411764705882,0.7647058823529411
SF-J13,SF-K17-2,15,31,2,1,13,30,0.13333333333333333,0.8666666666666667,0.03225806451612903,0.967741935483871
SF-J13,SF-K20,15,17,5,2,10,15,0.3333333333333333,0.6666666666666666,0.11764705882352941,0.8823529411764706
SF-J13,SF-K15-,41,46,17,30,24,16,0.4146341463414634,0.5853658536585366,0.6521739130434783,0.34782608695652173
SF-J13,SF-K19,20,17,2,6,18,11,0.1,0.9,0.35294117647058826,0.6470588235294118
SF-J13,SF-K18,19,30,9,4,10,26,0.47368421052631576,0.5263157894736842,0.13333333333333333,0.8666666666666667
SF-J13,SF-K17,27,21,10,6,17,15,0.37037037037037035,0.6296296296296297,0.2857142857142857,0.7142857142857143
SF-J13,SF-J16,7,7,4,3,3,4,0.5714285714285714,0.42857142857142855,0.42857142857142855,0.5714285714285714
SF-J13,SF-J18,27,38,7,7,20,31,0.25925925925925924,0.7407407407407407,0.18421052631578946,0.8157894736842105
SF-J13,SF-J20,2,1,1,1,1,0,0.5,0.5,1.0,0.0
SF-J13,SF-J19,11,7,3,1,8,6,0.2727272727272727,0.7272727272727273,0.14285714285714285,0.8571428571428571
SF-J13,SF-M12,15,21,8,12,7,9,0.5333333333333333,0.4666666666666667,0.5714285714285714,0.42857142857142855
SF-J13,SF-M10,9,19,2,15,7,4,0.2222222222222222,0.7777777777777778,0.7894736842105263,0.21052631578947367
SF-J13,SF-M11,15,28,6,11,9,17,0.4,0.6,0.39285714285714285,0.6071428571428571
SF-J13,SF-R19,1,1,0,0,1,1,0.0,1.0,0.0,1.0
SF-J13,SF-R20,2,1,0,0,2,1,0.0,1.0,0.0,1.0
SF-J13,SF-Q21-2,3,1,0,0,3,1,0.0,1.0,0.0,1.0
SF-J13,SF-Q21-1,2,1,2,1,0,0,1.0,0.0,1.0,0.0
SF-J13,SF-P21,4,2,2,0,2,2,0.5,0.5,0.0,1.0
SF-J13,SF-O18,7,4,1,0,6,4,0.14285714285714285,0.8571428571428571,0.0,1.0
SF-J13,SF-O19,9,6,1,1,8,5,0.1111111111111111,0.8888888888888888,0.16666666666666666,0.8333333333333334
SF-J13,SF-O21,14,15,0,5,14,10,0.0,1.0,0.3333333333333333,0.6666666666666666
SF-J13,SF-O22,7,12,0,1,7,11,0.0,1.0,0.08333333333333333,0.9166666666666666
SF-J13,SF-N21,4,3,0,0,4,3,0.0,1.0,0.0,1.0
SF-J13,SF-N20-2,1,5,1,2,0,3,1.0,0.0,0.4,0.6
SF-J13,SF-M21,1,5,0,0,1,5,0.0,1.0,0.0,1.0
SF-J13,SF-L21,17,9,1,0,16,9,0.058823529411764705,0.9411764705882353,0.0,1.0
SF-J13,SF-L30-1,1,1,1,1,0,0,1.0,0.0,1.0,0.0
SF-J13,SF-J29-1,2,3,0,0,2,3,0.0,1.0,0.0,1.0
SF-J13,SF-I27,1,1,1,0,0,1,1.0,0.0,0.0,1.0
SF-J13,SF-H28,3,1,0,0,3,1,0.0,1.0,0.0,1.0
SF-J13,SF-R24,3,5,0,0,3,5,0.0,1.0,0.0,1.0
SF-J13,SF-Q26,6,5,0,1,6,4,0.0,1.0,0.2,0.8
SF-J13,SF-P26,5,6,0,0,5,6,0.0,1.0,0.0,1.0
SF-J13,SF-T22,1,1,0,0,1,1,0.0,1.0,0.0,1.0
SF-J13,SF-S22-2,1,3,0,0,1,3,0.0,1.0,0.0,1.0
SF-J13,SF-Q23-3,1,1,0,1,1,0,0.0,1.0,1.0,0.0
SF-J13,SF-Q22-1,3,4,0,0,3,4,0.0,1.0,0.0,1.0
SF-J13,SF-Q22-2,5,1,2,0,3,1,0.4,0.6,0.0,1.0
SF-J13,SF-T20,1,2,0,0,1,2,0.0,1.0,0.0,1.0
SF-J13,SF-S21,3,1,2,0,1,1,0.6666666666666666,0.3333333333333333,0.0,1.0
SF-J15,SF-K26,2,6,2,3,0,3,1.0,0.0,0.5,0.5
SF-J15,SF-L26,1,2,0,0,1,2,0.0,1.0,0.0,1.0
SF-J15,SF-J26-2,2,2,2,0,0,2,1.0,0.0,0.0,1.0
SF-J15,SF-J25,1,3,0,1,1,2,0.0,1.0,0.3333333333333333,0.6666666666666666
SF-J15,SF-P24,1,5,0,1,1,4,0.0,1.0,0.2,0.8
SF-J15,SF-I26-,1,1,0,0,1,1,0.0,1.0,0.0,1.0
SF-J15,SF-I25,1,9,0,5,1,4,0.0,1.0,0.5555555555555556,0.4444444444444444
SF-J15,SF-H26,1,3,0,0,1,3,0.0,1.0,0.0,1.0
SF-J15,SF-G27,1,2,0,2,1,0,0.0,1.0,1.0,0.0
SF-J15,SF-L22,1,1,1,1,0,0,1.0,0.0,1.0,0.0
SF-J15,SF-J23-2,2,1,0,0,2,1,0.0,1.0,0.0,1.0
SF-J15,SF-G24,4,2,0,0,4,2,0.0,1.0,0.0,1.0
SF-J15,SF-F23,6,2,0,0,6,2,0.0,1.0,0.0,1.0
SF-J15,SF-E23,8,5,0,0,8,5,0.0,1.0,0.0,1.0
SF-J15,SF-B22,3,2,3,0,0,2,1.0,0.0,0.0,1.0
SF-J15,SF-J17,13,13,4,8,9,5,0.3076923076923077,0.6923076923076923,0.6153846153846154,0.38461538461538464
SF-J15,SF-H16,16,38,5,22,11,16,0.3125,0.6875,0.5789473684210527,0.42105263157894735
SF-J15,SF-H19,7,9,1,2,6,7,0.14285714285714285,0.8571428571428571,0.2222222222222222,0.7777777777777778
SF-J15,SF-H20,4,1,0,0,4,1,0.0,1.0,0.0,1.0
SF-J15,SF-H18,1,3,0,0,1,3,0.0,1.0,0.0,1.0
SF-J15,SF-H17,6,18,0,5,6,13,0.0,1.0,0.2777777777777778,0.7222222222222222
SF-J15,SF-G19,4,5,0,2,4,3,0.0,1.0,0.4,0.6
SF-J15,SF-G17,4,4,0,0,4,4,0.0,1.0,0.0,1.0
SF-J15,SF-G18,9,11,1,3,8,8,0.1111111111111111,0.8888888888888888,0.2727272727272727,0.7272727272727273
SF-J15,SF-G20,6,4,0,4,6,0,0.0,1.0,1.0,0.0
SF-J15,SF-F19,3,3,0,1,3,2,0.0,1.0,0.3333333333333333,0.6666666666666666
SF-J15,SF-E20,3,7,0,0,3,7,0.0,1.0,0.0,1.0
SF-J15,SF-E29-2,1,1,0,1,1,0,0.0,1.0,1.0,0.0
SF-J15,SF-E29-3,5,1,0,0,5,1,0.0,1.0,0.0,1.0
SF-J15,SF-F28-1,1,1,0,1,1,0,0.0,1.0,1.0,0.0
SF-J15,SF-J10,4,4,0,3,4,1,0.0,1.0,0.75,0.25
SF-J15,SF-J12,17,25,4,7,13,18,0.23529411764705882,0.7647058823529411,0.28,0.72
SF-J15,SF-J13,5,22,1,10,4,12,0.2,0.8,0.45454545454545453,0.5454545454545454
SF-J15,SF-J14,24,34,23,21,1,13,0.9583333333333334,0.041666666666666664,0.6176470588235294,0.38235294117647056
SF-J15,SF-H13,2,6,0,1,2,5,0.0,1.0,0.16666666666666666,0.8333333333333334
SF-J15,SF-I16,21,19,13,7,8,12,0.6190476190476191,0.38095238095238093,0.3684210526315789,0.631578947368421
SF-J15,SF-H12,5,4,1,3,4,1,0.2,0.8,0.75,0.25
SF-J15,SF-H15,10,9,6,6,4,3,0.6,0.4,0.6666666666666666,0.3333333333333333
SF-J15,SF-G9,1,4,0,0,1,4,0.0,1.0,0.0,1.0
SF-J15,SF-H14,9,6,1,3,8,3,0.1111111111111111,0.8888888888888888,0.5,0.5
SF-J15,SF-G13,10,28,3,24,7,4,0.3,0.7,0.8571428571428571,0.14285714285714285
SF-J15,SF-G11,1,1,1,0,0,1,1.0,0.0,0.0,1.0
SF-J15,SF-G12,3,7,1,2,2,5,0.3333333333333333,0.6666666666666666,0.2857142857142857,0.7142857142857143
SF-J15,SF-F15,2,11,1,4,1,7,0.5,0.5,0.36363636363636365,0.6363636363636364
SF-J15,SF-F16,4,4,0,2,4,2,0.0,1.0,0.5,0.5
SF-J15,SF-C21,2,7,0,0,2,7,0.0,1.0,0.0,1.0
SF-J15,SF-B19,2,10,0,4,2,6,0.0,1.0,0.4,0.6
SF-J15,SF-C26,2,3,0,0,2,3,0.0,1.0,0.0,1.0
SF-J15,SF-C25,3,6,0,1,3,5,0.0,1.0,0.16666666666666666,0.8333333333333334
SF-J15,SF-B25,1,1,0,0,1,1,0.0,1.0,0.0,1.0
SF-J15,SF-D27,1,2,0,0,1,2,0.0,1.0,0.0,1.0
SF-J15,SF-J1,26,30,0,13,26,17,0.0,1.0,0.43333333333333335,0.5666666666666667
SF-J15,SF-H0,12,7,1,6,11,1,0.08333333333333333,0.9166666666666666,0.8571428571428571,0.14285714285714285
SF-J15,SF-J3,2,10,0,3,2,7,0.0,1.0,0.3,0.7
SF-J15,SF-J5,1,6,0,5,1,1,0.0,1.0,0.8333333333333334,0.16666666666666666
SF-J15,SF-G7,17,6,0,0,17,6,0.0,1.0,0.0,1.0
SF-J15,SF-F9,33,5,0,0,33,5,0.0,1.0,0.0,1.0
SF-J15,SF-K21,4,1,0,0,4,1,0.0,1.0,0.0,1.0
SF-J15,SF-J22-2,2,1,0,1,2,0,0.0,1.0,1.0,0.0
SF-J15,SF-J21,1,5,1,5,0,0,1.0,0.0,1.0,0.0
SF-J15,SF-I21,2,2,1,1,1,1,0.5,0.5,0.5,0.5
SF-J15,SF-I23-2,2,9,1,6,1,3,0.5,0.5,0.6666666666666666,0.3333333333333333
SF-J15,SF-F26,2,7,0,1,2,6,0.0,1.0,0.14285714285714285,0.8571428571428571
SF-J15,SF-M13,6,4,0,3,6,1,0.0,1.0,0.75,0.25
SF-J15,SF-M15,7,17,1,9,6,8,0.14285714285714285,0.8571428571428571,0.5294117647058824,0.47058823529411764
SF-J15,SF-L20,1,2,0,2,1,0,0.0,1.0,1.0,0.0
SF-J15,SF-M20,2,4,0,3,2,1,0.0,1.0,0.75,0.25
SF-J15,SF-K20,1,5,1,1,0,4,1.0,0.0,0.2,0.8
SF-J15,SF-K15-,11,25,1,10,10,15,0.09090909090909091,0.9090909090909091,0.4,0.6
SF-J15,SF-K19,1,6,0,3,1,3,0.0,1.0,0.5,0.5
SF-J15,SF-K18,3,4,1,3,2,1,0.3333333333333333,0.6666666666666666,0.75,0.25
SF-J15,SF-K17,6,6,1,4,5,2,0.16666666666666666,0.8333333333333334,0.6666666666666666,0.3333333333333333
SF-J15,SF-J16,9,15,3,9,6,6,0.3333333333333333,0.6666666666666666,0.6,0.4
SF-J15,SF-J18,9,16,5,4,4,12,0.5555555555555556,0.4444444444444444,0.25,0.75
SF-J15,SF-J20,3,3,1,2,2,1,0.3333333333333333,0.6666666666666666,0.6666666666666666,0.3333333333333333
SF-J15,SF-J19,6,2,1,1,5,1,0.16666666666666666,0.8333333333333334,0.5,0.5
SF-J15,SF-M12,2,3,1,0,1,3,0.5,0.5,0.0,1.0
SF-J15,SF-M10,2,6,0,3,2,3,0.0,1.0,0.5,0.5
SF-J15,SF-M11,10,4,4,0,6,4,0.4,0.6,0.0,1.0
SF-J15,SF-R20,1,5,0,0,1,5,0.0,1.0,0.0,1.0
SF-J15,SF-Q21-2,1,1,0,0,1,1,0.0,1.0,0.0,1.0
SF-J15,SF-O18,3,7,0,1,3,6,0.0,1.0,0.14285714285714285,0.8571428571428571
SF-J15,SF-O19,3,6,1,0,2,6,0.3333333333333333,0.6666666666666666,0.0,1.0
SF-J15,SF-O21,4,6,0,1,4,5,0.0,1.0,0.16666666666666666,0.8333333333333334
SF-J15,SF-O22,4,4,1,2,3,2,0.25,0.75,0.5,0.5
SF-J15,SF-L21,4,3,3,2,1,1,0.75,0.25,0.6666666666666666,0.3333333333333333
SF-J15,SF-S29,1,1,1,0,0,1,1.0,0.0,0.0,1.0
SF-J15,SF-L30-1,1,1,1,0,0,1,1.0,0.0,0.0,1.0
SF-J15,SF-K30-2,1,1,0,0,1,1,0.0,1.0,0.0,1.0
SF-J15,SF-R24,1,3,0,0,1,3,0.0,1.0,0.0,1.0
SF-J15,SF-T22,1,1,0,1,1,0,0.0,1.0,1.0,0.0
SF-J15,SF-Q22-2,2,2,0,0,2,2,0.0,1.0,0.0,1.0
SF-J14,SF-G27,2,1,0,1,2,0,0.0,1.0,1.0,0.0
SF-J14,SF-J23-2,1,1,0,1,1,0,0.0,1.0,1.0,0.0
SF-J14,SF-G24,1,1,0,0,1,1,0.0,1.0,0.0,1.0
SF-J14,SF-J17,4,8,1,1,3,7,0.25,0.75,0.125,0.875
SF-J14,SF-I19,1,2,0,1,1,1,0.0,1.0,0.5,0.5
SF-J14,SF-H16,8,15,2,8,6,7,0.25,0.75,0.5333333333333333,0.4666666666666667
SF-J14,SF-H19,1,1,1,0,0,1,1.0,0.0,0.0,1.0
SF-J14,SF-H18,3,1,1,0,2,1,0.3333333333333333,0.6666666666666666,0.0,1.0
SF-J14,SF-F19,4,1,1,0,3,1,0.25,0.75,0.0,1.0
SF-J14,SF-D29,2,2,0,0,2,2,0.0,1.0,0.0,1.0
SF-J14,SF-J10,4,2,3,2,1,0,0.75,0.25,1.0,0.0
SF-J14,SF-J12,6,9,1,7,5,2,0.16666666666666666,0.8333333333333334,0.7777777777777778,0.2222222222222222
SF-J14,SF-J13,5,9,3,3,2,6,0.6,0.4,0.3333333333333333,0.6666666666666666
SF-J14,SF-J15,34,24,21,23,13,1,0.6176470588235294,0.38235294117647056,0.9583333333333334,0.041666666666666664
SF-J14,SF-H13,4,8,1,7,3,1,0.25,0.75,0.875,0.125
SF-J14,SF-I16,6,18,3,4,3,14,0.5,0.5,0.2222222222222222,0.7777777777777778
SF-J14,SF-H12,8,3,4,2,4,1,0.5,0.5,0.6666666666666666,0.3333333333333333
SF-J14,SF-H15,3,2,2,2,1,0,0.6666666666666666,0.3333333333333333,1.0,0.0
SF-J14,SF-H14,3,7,1,4,2,3,0.3333333333333333,0.6666666666666666,0.5714285714285714,0.42857142857142855
SF-J14,SF-G13,1,7,1,5,0,2,1.0,0.0,0.7142857142857143,0.2857142857142857
SF-J14,SF-G11,2,3,0,3,2,0,0.0,1.0,1.0,0.0
SF-J14,SF-G12,3,5,1,2,2,3,0.3333333333333333,0.6666666666666666,0.4,0.6
SF-J14,SF-G10-1,3,2,0,1,3,1,0.0,1.0,0.5,0.5
SF-J14,SF-F15,1,2,1,1,0,1,1.0,0.0,0.5,0.5
SF-J14,SF-F16,1,1,0,0,1,1,0.0,1.0,0.0,1.0
SF-J14,SF-B19,1,5,1,1,0,4,1.0,0.0,0.2,0.8
SF-J14,SF-J1,8,20,1,14,7,6,0.125,0.875,0.7,0.3
SF-J14,SF-H0,1,1,0,0,1,1,0.0,1.0,0.0,1.0
SF-J14,SF-J3,2,6,2,4,0,2,1.0,0.0,0.6666666666666666,0.3333333333333333
SF-J14,SF-G5,3,2,2,1,1,1,0.6666666666666666,0.3333333333333333,0.5,0.5
SF-J14,SF-G7,4,3,4,2,0,1,1.0,0.0,0.6666666666666666,0.3333333333333333
SF-J14,SF-F9,2,3,0,0,2,3,0.0,1.0,0.0,1.0
SF-J14,SF-K21,1,3,1,2,0,1,1.0,0.0,0.6666666666666666,0.3333333333333333
SF-J14,SF-J23-1,3,2,0,1,3,1,0.0,1.0,0.5,0.5
SF-J14,SF-J22-1,3,2,0,1,3,1,0.0,1.0,0.5,0.5
SF-J14,SF-M13,1,1,0,1,1,0,0.0,1.0,1.0,0.0
SF-J14,SF-M15,2,3,0,1,2,2,0.0,1.0,0.3333333333333333,0.6666666666666666
SF-J14,SF-L19,1,1,0,0,1,1,0.0,1.0,0.0,1.0
SF-J14,SF-K15-,3,13,0,7,3,6,0.0,1.0,0.5384615384615384,0.46153846153846156
SF-J14,SF-K19,4,6,0,1,4,5,0.0,1.0,0.16666666666666666,0.8333333333333334
SF-J14,SF-K18,3,4,0,0,3,4,0.0,1.0,0.0,1.0
SF-J14,SF-J16,8,3,0,0,8,3,0.0,1.0,0.0,1.0
SF-J14,SF-J18,4,3,1,0,3,3,0.25,0.75,0.0,1.0
SF-J14,SF-J19,1,3,0,1,1,2,0.0,1.0,0.3333333333333333,0.6666666666666666
SF-J14,SF-M10,5,2,2,0,3,2,0.4,0.6,0.0,1.0
SF-J14,SF-R20,1,2,0,0,1,2,0.0,1.0,0.0,1.0
SF-J14,SF-O19,1,1,0,0,1,1,0.0,1.0,0.0,1.0
SF-J14,SF-O21,1,1,0,0,1,1,0.0,1.0,0.0,1.0
SF-J14,SF-L21,3,3,0,1,3,2,0.0,1.0,0.3333333333333333,0.6666666666666666
SF-H13,SF-K27-2,1,1,0,0,1,1,0.0,1.0,0.0,1.0
SF-H13,SF-J25,3,11,0,0,3,11,0.0,1.0,0.0,1.0
SF-H13,SF-P24,4,1,0,0,4,1,0.0,1.0,0.0,1.0
SF-H13,SF-O24,8,13,0,0,8,13,0.0,1.0,0.0,1.0
SF-H13,SF-M22-2,2,6,0,3,2,3,0.0,1.0,0.5,0.5
SF-H13,SF-N22-2,3,2,0,0,3,2,0.0,1.0,0.0,1.0
SF-H13,SF-G24,2,1,1,0,1,1,0.5,0.5,0.0,1.0
SF-H13,SF-G25,1,6,0,0,1,6,0.0,1.0,0.0,1.0
SF-H13,SF-F23,2,2,1,0,1,2,0.5,0.5,0.0,1.0
SF-H13,SF-E23,1,3,0,1,1,2,0.0,1.0,0.3333333333333333,0.6666666666666666
SF-H13,SF-C22,1,1,0,0,1,1,0.0,1.0,0.0,1.0
SF-H13,SF-B22,3,3,1,0,2,3,0.3333333333333333,0.6666666666666666,0.0,1.0
SF-H13,SF-J17,7,6,1,1,6,5,0.14285714285714285,0.8571428571428571,0.16666666666666666,0.8333333333333334
SF-H13,SF-I20,2,2,1,0,1,2,0.5,0.5,0.0,1.0
SF-H13,SF-H16,30,20,12,4,18,16,0.4,0.6,0.2,0.8
SF-H13,SF-H18,9,2,0,0,9,2,0.0,1.0,0.0,1.0
SF-H13,SF-H17,56,70,0,0,56,70,0.0,1.0,0.0,1.0
SF-H13,SF-G19,4,3,2,2,2,1,0.5,0.5,0.6666666666666666,0.3333333333333333
SF-H13,SF-G17,19,3,0,0,19,3,0.0,1.0,0.0,1.0
SF-H13,SF-G18,10,9,1,3,9,6,0.1,0.9,0.3333333333333333,0.6666666666666666
SF-H13,SF-G20,2,6,0,1,2,5,0.0,1.0,0.16666666666666666,0.8333333333333334
SF-H13,SF-F19,3,8,0,1,3,7,0.0,1.0,0.125,0.875
SF-H13,SF-E18,6,11,1,2,5,9,0.16666666666666666,0.8333333333333334,0.18181818181818182,0.8181818181818182
SF-H13,SF-E20,10,16,4,6,6,10,0.4,0.6,0.375,0.625
SF-H13,SF-G30-2,1,1,0,0,1,1,0.0,1.0,0.0,1.0
SF-H13,SF-F28-1,2,1,0,0,2,1,0.0,1.0,0.0,1.0
SF-H13,SF-J10,5,7,3,5,2,2,0.6,0.4,0.7142857142857143,0.2857142857142857
SF-H13,SF-J12,42,33,23,23,19,10,0.5476190476190477,0.4523809523809524,0.696969696969697,0.30303030303030304
SF-H13,SF-J13,60,58,22,27,38,31,0.36666666666666664,0.6333333333333333,0.46551724137931033,0.5344827586206896
SF-H13,SF-J15,6,2,1,0,5,2,0.16666666666666666,0.8333333333333334,0.0,1.0
SF-H13,SF-J14,8,4,7,1,1,3,0.875,0.125,0.25,0.75
SF-H13,SF-I16,6,5,3,1,3,4,0.5,0.5,0.2,0.8
SF-H13,SF-H12,19,16,9,14,10,2,0.47368421052631576,0.5263157894736842,0.875,0.125
SF-H13,SF-G10-2,14,11,1,3,13,8,0.07142857142857142,0.9285714285714286,0.2727272727272727,0.7272727272727273
SF-H13,SF-H15,13,7,8,4,5,3,0.6153846153846154,0.38461538461538464,0.5714285714285714,0.42857142857142855
SF-H13,SF-G9,7,23,1,6,6,17,0.14285714285714285,0.8571428571428571,0.2608695652173913,0.7391304347826086
SF-H13,SF-H14,17,10,15,5,2,5,0.8823529411764706,0.11764705882352941,0.5,0.5
SF-H13,SF-G13,80,61,39,35,41,26,0.4875,0.5125,0.5737704918032787,0.4262295081967213
SF-H13,SF-G11,25,34,14,20,11,14,0.56,0.44,0.5882352941176471,0.4117647058823529
SF-H13,SF-G12,22,15,13,10,9,5,0.5909090909090909,0.4090909090909091,0.6666666666666666,0.3333333333333333
SF-H13,SF-G10-1,7,12,4,6,3,6,0.5714285714285714,0.42857142857142855,0.5,0.5
SF-H13,SF-F15,4,5,2,1,2,4,0.5,0.5,0.2,0.8
SF-H13,SF-F16,2,10,1,2,1,8,0.5,0.5,0.2,0.8
SF-H13,SF-C20,1,12,0,7,1,5,0.0,1.0,0.5833333333333334,0.4166666666666667
SF-H13,SF-B21,1,1,1,1,0,0,1.0,0.0,1.0,0.0
SF-H13,SF-B19,6,9,0,4,6,5,0.0,1.0,0.4444444444444444,0.5555555555555556
SF-H13,SF-A20,4,8,2,3,2,5,0.5,0.5,0.375,0.625
SF-H13,SF-A19,1,3,0,1,1,2,0.0,1.0,0.3333333333333333,0.6666666666666666
SF-H13,SF-C26,1,1,0,0,1,1,0.0,1.0,0.0,1.0
SF-H13,SF-C25,5,4,0,1,5,3,0.0,1.0,0.25,0.75
SF-H13,SF-E27,2,1,0,0,2,1,0.0,1.0,0.0,1.0
SF-H13,SF-C28-2,1,1,0,0,1,1,0.0,1.0,0.0,1.0
SF-H13,SF-J1,16,30,5,22,11,8,0.3125,0.6875,0.7333333333333333,0.26666666666666666
SF-H13,SF-H0,25,31,0,1,25,30,0.0,1.0,0.03225806451612903,0.967741935483871
SF-H13,SF-J3,6,9,1,9,5,0,0.16666666666666666,0.8333333333333334,1.0,0.0
SF-H13,SF-J5,5,6,3,5,2,1,0.6,0.4,0.8333333333333334,0.16666666666666666
SF-H13,SF-G6,3,7,1,3,2,4,0.3333333333333333,0.6666666666666666,0.42857142857142855,0.5714285714285714
SF-H13,SF-G8,6,9,3,4,3,5,0.5,0.5,0.4444444444444444,0.5555555555555556
SF-H13,SF-G5,9,12,5,5,4,7,0.5555555555555556,0.4444444444444444,0.4166666666666667,0.5833333333333334
SF-H13,SF-G7,8,19,4,10,4,9,0.5,0.5,0.5263157894736842,0.47368421052631576
SF-H13,SF-F9,5,4,2,4,3,0,0.4,0.6,1.0,0.0
SF-H13,SF-K21,3,6,1,1,2,5,0.3333333333333333,0.6666666666666666,0.16666666666666666,0.8333333333333334
SF-H13,SF-J23-1,2,4,0,0,2,4,0.0,1.0,0.0,1.0
SF-H13,SF-J22-2,4,1,0,0,4,1,0.0,1.0,0.0,1.0
SF-H13,SF-J21,6,4,3,0,3,4,0.5,0.5,0.0,1.0
SF-H13,SF-I24,1,1,0,0,1,1,0.0,1.0,0.0,1.0
SF-H13,SF-I23-1,2,2,2,0,0,2,1.0,0.0,0.0,1.0
SF-H13,SF-M13,76,88,8,11,68,77,0.10526315789473684,0.8947368421052632,0.125,0.875
SF-H13,SF-M15,7,15,0,4,7,11,0.0,1.0,0.26666666666666666,0.7333333333333333
SF-H13,SF-L19,3,2,0,1,3,1,0.0,1.0,0.5,0.5
SF-H13,SF-L20,4,10,0,0,4,10,0.0,1.0,0.0,1.0
SF-H13,SF-M20,6,6,1,1,5,5,0.16666666666666666,0.8333333333333334,0.16666666666666666,0.8333333333333334
SF-H13,SF-K17-2,10,7,0,2,10,5,0.0,1.0,0.2857142857142857,0.7142857142857143
SF-H13,SF-K20,6,11,1,2,5,9,0.16666666666666666,0.8333333333333334,0.18181818181818182,0.8181818181818182
SF-H13,SF-K15-,15,19,2,7,13,12,0.13333333333333333,0.8666666666666667,0.3684210526315789,0.631578947368421
SF-H13,SF-K19,16,10,5,4,11,6,0.3125,0.6875,0.4,0.6
SF-H13,SF-K18,7,4,2,2,5,2,0.2857142857142857,0.7142857142857143,0.5,0.5
SF-H13,SF-K17,10,10,6,5,4,5,0.6,0.4,0.5,0.5
SF-H13,SF-J16,2,1,1,0,1,1,0.5,0.5,0.0,1.0
SF-H13,SF-J18,5,18,3,1,2,17,0.6,0.4,0.05555555555555555,0.9444444444444444
SF-H13,SF-J19,8,5,1,3,7,2,0.125,0.875,0.6,0.4
SF-H13,SF-O12,1,1,0,1,1,0,0.0,1.0,1.0,0.0
SF-H13,SF-M12,18,23,1,7,17,16,0.05555555555555555,0.9444444444444444,0.30434782608695654,0.6956521739130435
SF-H13,SF-M10,1,4,1,2,0,2,1.0,0.0,0.5,0.5
SF-H13,SF-M11,9,14,1,5,8,9,0.1111111111111111,0.8888888888888888,0.35714285714285715,0.6428571428571429
SF-H13,SF-R20,1,1,0,0,1,1,0.0,1.0,0.0,1.0
SF-H13,SF-P21,1,3,0,2,1,1,0.0,1.0,0.6666666666666666,0.3333333333333333
SF-H13,SF-O19,8,3,0,0,8,3,0.0,1.0,0.0,1.0
SF-H13,SF-O21,5,6,0,3,5,3,0.0,1.0,0.5,0.5
SF-H13,SF-O22,1,1,0,0,1,1,0.0,1.0,0.0,1.0
SF-H13,SF-N21,1,2,0,0,1,2,0.0,1.0,0.0,1.0
SF-H13,SF-N20-2,3,2,0,1,3,1,0.0,1.0,0.5,0.5
SF-H13,SF-L21,45,21,0,1,45,20,0.0,1.0,0.047619047619047616,0.9523809523809523
SF-H13,SF-I27,3,1,1,0,2,1,0.3333333333333333,0.6666666666666666,0.0,1.0
SF-H13,SF-R24,2,4,0,1,2,3,0.0,1.0,0.25,0.75
SF-H13,SF-Q22-2,1,3,0,0,1,3,0.0,1.0,0.0,1.0
SF-H13,SF-P22,1,2,1,1,0,1,1.0,0.0,0.5,0.5
SF-I16,SF-M25,1,1,0,0,1,1,0.0,1.0,0.0,1.0
SF-I16,SF-J29,2,2,1,0,1,2,0.5,0.5,0.0,1.0
SF-I16,SF-O24,1,2,0,0,1,2,0.0,1.0,0.0,1.0
SF-I16,SF-I25,2,2,0,1,2,1,0.0,1.0,0.5,0.5
SF-I16,SF-K23,1,1,0,0,1,1,0.0,1.0,0.0,1.0
SF-I16,SF-H26,1,3,0,0,1,3,0.0,1.0,0.0,1.0
SF-I16,SF-O23,3,1,0,0,3,1,0.0,1.0,0.0,1.0
SF-I16,SF-M22-2,2,1,1,0,1,1,0.5,0.5,0.0,1.0
SF-I16,SF-K22-2,2,1,1,0,1,1,0.5,0.5,0.0,1.0
SF-I16,SF-G25,1,1,0,0,1,1,0.0,1.0,0.0,1.0
SF-I16,SF-F23,2,4,0,2,2,2,0.0,1.0,0.5,0.5
SF-I16,SF-E23,2,3,0,0,2,3,0.0,1.0,0.0,1.0
SF-I16,SF-D24,1,2,0,0,1,2,0.0,1.0,0.0,1.0
SF-I16,SF-C22,4,6,0,1,4,5,0.0,1.0,0.16666666666666666,0.8333333333333334
SF-I16,SF-J17,14,9,6,4,8,5,0.42857142857142855,0.5714285714285714,0.4444444444444444,0.5555555555555556
SF-I16,SF-I19,2,1,0,0,2,1,0.0,1.0,0.0,1.0
SF-I16,SF-I20,2,1,0,0,2,1,0.0,1.0,0.0,1.0
SF-I16,SF-H16,73,86,30,68,43,18,0.410958904109589,0.589041095890411,0.7906976744186046,0.20930232558139536
SF-I16,SF-H19,1,6,1,4,0,2,1.0,0.0,0.6666666666666666,0.3333333333333333
SF-I16,SF-H17,1,3,0,3,1,0,0.0,1.0,1.0,0.0
SF-I16,SF-G19,2,1,0,0,2,1,0.0,1.0,0.0,1.0
SF-I16,SF-G17,3,7,1,2,2,5,0.3333333333333333,0.6666666666666666,0.2857142857142857,0.7142857142857143
SF-I16,SF-G18,13,8,4,4,9,4,0.3076923076923077,0.6923076923076923,0.5,0.5
SF-I16,SF-G20,2,4,0,1,2,3,0.0,1.0,0.25,0.75
SF-I16,SF-F19,16,4,1,1,15,3,0.0625,0.9375,0.25,0.75
SF-I16,SF-E18,16,6,2,0,14,6,0.125,0.875,0.0,1.0
SF-I16,SF-E20,8,13,1,0,7,13,0.125,0.875,0.0,1.0
SF-I16,SF-E29-2,3,7,0,2,3,5,0.0,1.0,0.2857142857142857,0.7142857142857143
SF-I16,SF-D28,2,1,0,0,2,1,0.0,1.0,0.0,1.0
SF-I16,SF-G29-1,1,1,0,1,1,0,0.0,1.0,1.0,0.0
SF-I16,SF-F29,1,2,0,0,1,2,0.0,1.0,0.0,1.0
SF-I16,SF-E29-3,5,10,0,0,5,10,0.0,1.0,0.0,1.0
SF-I16,SF-F28-1,1,1,1,0,0,1,1.0,0.0,0.0,1.0
SF-I16,SF-E28,7,2,0,0,7,2,0.0,1.0,0.0,1.0
SF-I16,SF-J10,3,5,1,2,2,3,0.3333333333333333,0.6666666666666666,0.4,0.6
SF-I16,SF-J12,7,7,2,2,5,5,0.2857142857142857,0.7142857142857143,0.2857142857142857,0.7142857142857143
SF-I16,SF-J13,8,10,2,5,6,5,0.25,0.75,0.5,0.5
SF-I16,SF-J15,19,21,7,13,12,8,0.3684210526315789,0.631578947368421,0.6190476190476191,0.38095238095238093
SF-I16,SF-J14,18,6,4,3,14,3,0.2222222222222222,0.7777777777777778,0.5,0.5
SF-I16,SF-H13,5,6,1,3,4,3,0.2,0.8,0.5,0.5
SF-I16,SF-H12,4,9,1,6,3,3,0.25,0.75,0.6666666666666666,0.3333333333333333
SF-I16,SF-G10-2,3,5,2,2,1,3,0.6666666666666666,0.3333333333333333,0.4,0.6
SF-I16,SF-H15,23,17,7,11,16,6,0.30434782608695654,0.6956521739130435,0.6470588235294118,0.35294117647058826
SF-I16,SF-G9,3,9,0,1,3,8,0.0,1.0,0.1111111111111111,0.8888888888888888
SF-I16,SF-H14,9,8,2,3,7,5,0.2222222222222222,0.7777777777777778,0.375,0.625
SF-I16,SF-G13,10,16,4,9,6,7,0.4,0.6,0.5625,0.4375
SF-I16,SF-G12,16,14,6,5,10,9,0.375,0.625,0.35714285714285715,0.6428571428571429
SF-I16,SF-G10-1,3,4,0,2,3,2,0.0,1.0,0.5,0.5
SF-I16,SF-F15,5,11,1,5,4,6,0.2,0.8,0.45454545454545453,0.5454545454545454
SF-I16,SF-F16,14,12,1,5,13,7,0.07142857142857142,0.9285714285714286,0.4166666666666667,0.5833333333333334
SF-I16,SF-B19,1,7,0,1,1,6,0.0,1.0,0.14285714285714285,0.8571428571428571
SF-I16,SF-A20,3,3,0,1,3,2,0.0,1.0,0.3333333333333333,0.6666666666666666
SF-I16,SF-A19,1,1,0,1,1,0,0.0,1.0,1.0,0.0
SF-I16,SF-D27,2,1,0,0,2,1,0.0,1.0,0.0,1.0
SF-I16,SF-J1,7,14,2,3,5,11,0.2857142857142857,0.7142857142857143,0.21428571428571427,0.7857142857142857
SF-I16,SF-H0,2,4,0,0,2,4,0.0,1.0,0.0,1.0
SF-I16,SF-J3,1,3,0,3,1,0,0.0,1.0,1.0,0.0
SF-I16,SF-J5,6,4,0,0,6,4,0.0,1.0,0.0,1.0
SF-I16,SF-G6,3,2,0,2,3,0,0.0,1.0,1.0,0.0
SF-I16,SF-G8,2,3,0,2,2,1,0.0,1.0,0.6666666666666666,0.3333333333333333
SF-I16,SF-G5,8,6,0,2,8,4,0.0,1.0,0.3333333333333333,0.6666666666666666
SF-I16,SF-G7,4,5,0,2,4,3,0.0,1.0,0.4,0.6
SF-I16,SF-K21,3,6,0,2,3,4,0.0,1.0,0.3333333333333333,0.6666666666666666
SF-I16,SF-K22-1,1,1,0,1,1,0,0.0,1.0,1.0,0.0
SF-I16,SF-J23-1,2,2,0,1,2,1,0.0,1.0,0.5,0.5
SF-I16,SF-J22-2,5,2,2,0,3,2,0.4,0.6,0.0,1.0
SF-I16,SF-J21,3,8,1,8,2,0,0.3333333333333333,0.6666666666666666,1.0,0.0
SF-I16,SF-I21,2,3,0,2,2,1,0.0,1.0,0.6666666666666666,0.3333333333333333
SF-I16,SF-I22,2,1,1,0,1,1,0.5,0.5,0.0,1.0
SF-I16,SF-I23-2,1,4,0,1,1,3,0.0,1.0,0.25,0.75
SF-I16,SF-I24,1,7,0,6,1,1,0.0,1.0,0.8571428571428571,0.14285714285714285
SF-I16,SF-I23-1,3,4,2,1,1,3,0.6666666666666666,0.3333333333333333,0.25,0.75
SF-I16,SF-F26,3,5,2,1,1,4,0.6666666666666666,0.3333333333333333,0.2,0.8
SF-I16,SF-M13,4,7,2,2,2,5,0.5,0.5,0.2857142857142857,0.7142857142857143
SF-I16,SF-M15,2,15,1,6,1,9,0.5,0.5,0.4,0.6
SF-I16,SF-L19,5,2,0,1,5,1,0.0,1.0,0.5,0.5
SF-I16,SF-L20,3,7,0,2,3,5,0.0,1.0,0.2857142857142857,0.7142857142857143
SF-I16,SF-M20,2,5,0,3,2,2,0.0,1.0,0.6,0.4
SF-I16,SF-K17-2,10,8,1,2,9,6,0.1,0.9,0.25,0.75
SF-I16,SF-K20,12,9,1,1,11,8,0.08333333333333333,0.9166666666666666,0.1111111111111111,0.8888888888888888
SF-I16,SF-K15-,18,32,4,15,14,17,0.2222222222222222,0.7777777777777778,0.46875,0.53125
SF-I16,SF-K19,3,16,1,12,2,4,0.3333333333333333,0.6666666666666666,0.75,0.25
SF-I16,SF-K18,5,15,1,11,4,4,0.2,0.8,0.7333333333333333,0.26666666666666666
SF-I16,SF-K17,8,35,1,21,7,14,0.125,0.875,0.6,0.4
SF-I16,SF-J16,14,57,1,44,13,13,0.07142857142857142,0.9285714285714286,0.7719298245614035,0.22807017543859648
SF-I16,SF-J18,6,18,3,9,3,9,0.5,0.5,0.5,0.5
SF-I16,SF-J20,2,3,0,2,2,1,0.0,1.0,0.6666666666666666,0.3333333333333333
SF-I16,SF-J19,3,4,1,1,2,3,0.3333333333333333,0.6666666666666666,0.25,0.75
SF-I16,SF-M12,1,9,1,5,0,4,1.0,0.0,0.5555555555555556,0.4444444444444444
SF-I16,SF-M10,14,10,1,0,13,10,0.07142857142857142,0.9285714285714286,0.0,1.0
SF-I16,SF-M11,6,17,0,8,6,9,0.0,1.0,0.47058823529411764,0.5294117647058824
SF-I16,SF-P21,1,2,0,0,1,2,0.0,1.0,0.0,1.0
SF-I16,SF-O18,2,3,0,0,2,3,0.0,1.0,0.0,1.0
SF-I16,SF-O19,1,5,0,3,1,2,0.0,1.0,0.6,0.4
SF-I16,SF-O21,4,4,1,0,3,4,0.25,0.75,0.0,1.0
SF-I16,SF-O22,1,4,0,0,1,4,0.0,1.0,0.0,1.0
SF-I16,SF-M21,4,4,0,0,4,4,0.0,1.0,0.0,1.0
SF-I16,SF-L21,2,10,0,1,2,9,0.0,1.0,0.1,0.9
SF-I16,SF-O30,1,1,0,0,1,1,0.0,1.0,0.0,1.0
SF-I16,SF-H28,1,2,0,0,1,2,0.0,1.0,0.0,1.0
SF-I16,SF-O25-2,2,1,0,0,2,1,0.0,1.0,0.0,1.0
SF-I16,SF-T22,2,1,0,0,2,1,0.0,1.0,0.0,1.0
SF-I16,SF-Q23-3,9,17,3,2,6,15,0.3333333333333333,0.6666666666666666,0.11764705882352941,0.8823529411764706
SF-I16,SF-Q22-1,1,1,0,0,1,1,0.0,1.0,0.0,1.0
SF-I16,SF-Q22-2,3,1,0,0,3,1,0.0,1.0,0.0,1.0
SF-I16,SF-P22,3,1,1,0,2,1,0.3333333333333333,0.6666666666666666,0.0,1.0
SF-H12,SF-M30,5,4,0,0,5,4,0.0,1.0,0.0,1.0
SF-H12,SF-L25,2,2,0,0,2,2,0.0,1.0,0.0,1.0
SF-H12,SF-K27-2,1,1,1,0,0,1,1.0,0.0,0.0,1.0
SF-H12,SF-J25,14,13,0,0,14,13,0.0,1.0,0.0,1.0
SF-H12,SF-H26-2,25,9,0,0,25,9,0.0,1.0,0.0,1.0
SF-H12,SF-J24,1,2,0,0,1,2,0.0,1.0,0.0,1.0
SF-H12,SF-I25,7,4,0,2,7,2,0.0,1.0,0.5,0.5
SF-H12,SF-K23,2,1,0,1,2,0,0.0,1.0,1.0,0.0
SF-H12,SF-H26,11,6,0,0,11,6,0.0,1.0,0.0,1.0
SF-H12,SF-O23,1,2,0,0,1,2,0.0,1.0,0.0,1.0
SF-H12,SF-F28-2,1,1,0,0,1,1,0.0,1.0,0.0,1.0
SF-H12,SF-G27,6,12,0,1,6,11,0.0,1.0,0.08333333333333333,0.9166666666666666
SF-H12,SF-M22-2,1,4,0,1,1,3,0.0,1.0,0.25,0.75
SF-H12,SF-L22,2,1,0,1,2,0,0.0,1.0,1.0,0.0
SF-H12,SF-F27,2,1,0,0,2,1,0.0,1.0,0.0,1.0
SF-H12,SF-N22-2,5,2,0,0,5,2,0.0,1.0,0.0,1.0
SF-H12,SF-K22-2,5,4,0,2,5,2,0.0,1.0,0.5,0.5
SF-H12,SF-K24,3,1,1,0,2,1,0.3333333333333333,0.6666666666666666,0.0,1.0
SF-H12,SF-J23-2,7,15,0,0,7,15,0.0,1.0,0.0,1.0
SF-H12,SF-G24,3,6,0,0,3,6,0.0,1.0,0.0,1.0
SF-H12,SF-G25,5,2,0,0,5,2,0.0,1.0,0.0,1.0
SF-H12,SF-F23,6,1,1,1,5,0,0.16666666666666666,0.8333333333333334,1.0,0.0
SF-H12,SF-E23,6,5,1,1,5,4,0.16666666666666666,0.8333333333333334,0.2,0.8
SF-H12,SF-D24,1,1,1,0,0,1,1.0,0.0,0.0,1.0
SF-H12,SF-C22,4,6,0,0,4,6,0.0,1.0,0.0,1.0
SF-H12,SF-B22,1,4,0,0,1,4,0.0,1.0,0.0,1.0
SF-H12,SF-J17,19,11,4,1,15,10,0.21052631578947367,0.7894736842105263,0.09090909090909091,0.9090909090909091
SF-H12,SF-I20,5,2,3,0,2,2,0.6,0.4,0.0,1.0
SF-H12,SF-H16,25,22,14,3,11,19,0.56,0.44,0.13636363636363635,0.8636363636363636
SF-H12,SF-H19,7,14,2,11,5,3,0.2857142857142857,0.7142857142857143,0.7857142857142857,0.21428571428571427
SF-H12,SF-H20,3,2,0,0,3,2,0.0,1.0,0.0,1.0
SF-H12,SF-H18,2,4,1,0,1,4,0.5,0.5,0.0,1.0
SF-H12,SF-H17,3,3,0,0,3,3,0.0,1.0,0.0,1.0
SF-H12,SF-G19,6,2,0,0,6,2,0.0,1.0,0.0,1.0
SF-H12,SF-G17,5,1,0,0,5,1,0.0,1.0,0.0,1.0
SF-H12,SF-G18,32,13,0,3,32,10,0.0,1.0,0.23076923076923078,0.7692307692307693
SF-H12,SF-G20,1,5,1,2,0,3,1.0,0.0,0.4,0.6
SF-H12,SF-F19,16,15,0,0,16,15,0.0,1.0,0.0,1.0
SF-H12,SF-E18,3,6,0,1,3,5,0.0,1.0,0.16666666666666666,0.8333333333333334
SF-H12,SF-E20,6,5,0,0,6,5,0.0,1.0,0.0,1.0
SF-H12,SF-G30-2,3,7,0,4,3,3,0.0,1.0,0.5714285714285714,0.42857142857142855
SF-H12,SF-F30-1,1,2,0,0,1,2,0.0,1.0,0.0,1.0
SF-H12,SF-E29-1,1,3,0,0,1,3,0.0,1.0,0.0,1.0
SF-H12,SF-G29-1,3,10,1,2,2,8,0.3333333333333333,0.6666666666666666,0.2,0.8
SF-H12,SF-G30-1,1,4,0,0,1,4,0.0,1.0,0.0,1.0
SF-H12,SF-F29,10,11,0,0,10,11,0.0,1.0,0.0,1.0
SF-H12,SF-E29-3,1,1,0,0,1,1,0.0,1.0,0.0,1.0
SF-H12,SF-E28,1,2,0,1,1,1,0.0,1.0,0.5,0.5
SF-H12,SF-J10,11,4,4,3,7,1,0.36363636363636365,0.6363636363636364,0.75,0.25
SF-H12,SF-J12,47,54,28,26,19,28,0.5957446808510638,0.40425531914893614,0.48148148148148145,0.5185185185185185
SF-H12,SF-J13,90,79,38,39,52,40,0.4222222222222222,0.5777777777777777,0.4936708860759494,0.5063291139240507
SF-H12,SF-J15,4,5,3,1,1,4,0.75,0.25,0.2,0.8
SF-H12,SF-J14,3,8,2,4,1,4,0.6666666666666666,0.3333333333333333,0.5,0.5
SF-H12,SF-H13,16,19,14,9,2,10,0.875,0.125,0.47368421052631576,0.5263157894736842
SF-H12,SF-I16,9,4,6,1,3,3,0.6666666666666666,0.3333333333333333,0.25,0.75
SF-H12,SF-G10-2,8,5,4,2,4,3,0.5,0.5,0.4,0.6
SF-H12,SF-H15,7,10,2,7,5,3,0.2857142857142857,0.7142857142857143,0.7,0.3
SF-H12,SF-G9,9,9,5,1,4,8,0.5555555555555556,0.4444444444444444,0.1111111111111111,0.8888888888888888
SF-H12,SF-H14,4,5,4,3,0,2,1.0,0.0,0.6,0.4
SF-H12,SF-G13,22,22,20,7,2,15,0.9090909090909091,0.09090909090909091,0.3181818181818182,0.6818181818181818
SF-H12,SF-G11,5,6,3,5,2,1,0.6,0.4,0.8333333333333334,0.16666666666666666
SF-H12,SF-G12,20,9,15,7,5,2,0.75,0.25,0.7777777777777778,0.2222222222222222
SF-H12,SF-G10-1,5,4,1,0,4,4,0.2,0.8,0.0,1.0
SF-H12,SF-F15,7,13,3,5,4,8,0.42857142857142855,0.5714285714285714,0.38461538461538464,0.6153846153846154
SF-H12,SF-F16,15,24,7,2,8,22,0.4666666666666667,0.5333333333333333,0.08333333333333333,0.9166666666666666
SF-H12,SF-C21,2,3,0,0,2,3,0.0,1.0,0.0,1.0
SF-H12,SF-B21,1,1,0,0,1,1,0.0,1.0,0.0,1.0
SF-H12,SF-B19,4,10,0,1,4,9,0.0,1.0,0.1,0.9
SF-H12,SF-A20,1,6,0,1,1,5,0.0,1.0,0.16666666666666666,0.8333333333333334
SF-H12,SF-A19,2,2,0,0,2,2,0.0,1.0,0.0,1.0
SF-H12,SF-C26,2,2,0,0,2,2,0.0,1.0,0.0,1.0
SF-H12,SF-C25,1,4,0,0,1,4,0.0,1.0,0.0,1.0
SF-H12,SF-E27,4,3,1,2,3,1,0.25,0.75,0.6666666666666666,0.3333333333333333
SF-H12,SF-D27,1,1,0,0,1,1,0.0,1.0,0.0,1.0
SF-H12,SF-J1,19,27,1,10,18,17,0.05263157894736842,0.9473684210526315,0.37037037037037035,0.6296296296296297
SF-H12,SF-H0,11,11,2,4,9,7,0.18181818181818182,0.8181818181818182,0.36363636363636365,0.6363636363636364
SF-H12,SF-J3,5,11,2,4,3,7,0.4,0.6,0.36363636363636365,0.6363636363636364
SF-H12,SF-J5,3,15,1,4,2,11,0.3333333333333333,0.6666666666666666,0.26666666666666666,0.7333333333333333
SF-H12,SF-G6,12,7,5,1,7,6,0.4166666666666667,0.5833333333333334,0.14285714285714285,0.8571428571428571
SF-H12,SF-G8,34,27,21,16,13,11,0.6176470588235294,0.38235294117647056,0.5925925925925926,0.4074074074074074
SF-H12,SF-G5,14,15,4,7,10,8,0.2857142857142857,0.7142857142857143,0.4666666666666667,0.5333333333333333
SF-H12,SF-G7,14,8,8,3,6,5,0.5714285714285714,0.42857142857142855,0.375,0.625
SF-H12,SF-F9,16,11,8,1,8,10,0.5,0.5,0.09090909090909091,0.9090909090909091
SF-H12,SF-G26,1,3,0,2,1,1,0.0,1.0,0.6666666666666666,0.3333333333333333
SF-H12,SF-K21,15,18,4,9,11,9,0.26666666666666666,0.7333333333333333,0.5,0.5
SF-H12,SF-K22-1,1,4,0,0,1,4,0.0,1.0,0.0,1.0
SF-H12,SF-J23-1,19,16,3,0,16,16,0.15789473684210525,0.8421052631578947,0.0,1.0
SF-H12,SF-J22-1,5,9,0,1,5,8,0.0,1.0,0.1111111111111111,0.8888888888888888
SF-H12,SF-J22-2,6,4,0,0,6,4,0.0,1.0,0.0,1.0
SF-H12,SF-J21,26,20,1,2,25,18,0.038461538461538464,0.9615384615384616,0.1,0.9
SF-H12,SF-I22,2,5,0,1,2,4,0.0,1.0,0.2,0.8
SF-H12,SF-I23-1,4,8,0,0,4,8,0.0,1.0,0.0,1.0
SF-H12,SF-M13,19,13,5,4,14,9,0.2631578947368421,0.7368421052631579,0.3076923076923077,0.6923076923076923
SF-H12,SF-M15,15,14,6,4,9,10,0.4,0.6,0.2857142857142857,0.7142857142857143
SF-H12,SF-L19,4,3,0,0,4,3,0.0,1.0,0.0,1.0
SF-H12,SF-L20,3,18,2,0,1,18,0.6666666666666666,0.3333333333333333,0.0,1.0
SF-H12,SF-N20-1,1,1,0,1,1,0,0.0,1.0,1.0,0.0
SF-H12,SF-M20,9,4,1,1,8,3,0.1111111111111111,0.8888888888888888,0.25,0.75
SF-H12,SF-K17-2,8,7,0,2,8,5,0.0,1.0,0.2857142857142857,0.7142857142857143
SF-H12,SF-K20,7,3,1,0,6,3,0.14285714285714285,0.8571428571428571,0.0,1.0
SF-H12,SF-K15-,19,33,4,12,15,21,0.21052631578947367,0.7894736842105263,0.36363636363636365,0.6363636363636364
SF-H12,SF-K19,7,9,2,3,5,6,0.2857142857142857,0.7142857142857143,0.3333333333333333,0.6666666666666666
SF-H12,SF-K18,7,13,3,2,4,11,0.42857142857142855,0.5714285714285714,0.15384615384615385,0.8461538461538461
SF-H12,SF-K17,10,8,3,2,7,6,0.3,0.7,0.25,0.75
SF-H12,SF-J16,16,12,2,2,14,10,0.125,0.875,0.16666666666666666,0.8333333333333334
SF-H12,SF-J18,36,26,1,3,35,23,0.027777777777777776,0.9722222222222222,0.11538461538461539,0.8846153846153846
SF-H12,SF-J20,2,2,0,0,2,2,0.0,1.0,0.0,1.0
SF-H12,SF-J19,15,2,0,0,15,2,0.0,1.0,0.0,1.0
SF-H12,SF-M12,3,9,2,1,1,8,0.6666666666666666,0.3333333333333333,0.1111111111111111,0.8888888888888888
SF-H12,SF-M10,7,9,1,4,6,5,0.14285714285714285,0.8571428571428571,0.4444444444444444,0.5555555555555556
SF-H12,SF-M11,10,14,2,6,8,8,0.2,0.8,0.42857142857142855,0.5714285714285714
SF-H12,SF-R19,34,1,2,0,32,1,0.058823529411764705,0.9411764705882353,0.0,1.0
SF-H12,SF-Q21-1,1,1,0,1,1,0,0.0,1.0,1.0,0.0
SF-H12,SF-P21,4,4,0,0,4,4,0.0,1.0,0.0,1.0
SF-H12,SF-O18,1,5,0,0,1,5,0.0,1.0,0.0,1.0
SF-H12,SF-O19,9,8,0,1,9,7,0.0,1.0,0.125,0.875
SF-H12,SF-O21,5,4,0,3,5,1,0.0,1.0,0.75,0.25
SF-H12,SF-O22,2,9,0,1,2,8,0.0,1.0,0.1111111111111111,0.8888888888888888
SF-H12,SF-N21,1,2,0,1,1,1,0.0,1.0,0.5,0.5
SF-H12,SF-N20-2,3,2,0,0,3,2,0.0,1.0,0.0,1.0
SF-H12,SF-M21,2,2,1,0,1,2,0.5,0.5,0.0,1.0
SF-H12,SF-L21,7,39,0,0,7,39,0.0,1.0,0.0,1.0
SF-H12,SF-L30-1,3,4,2,0,1,4,0.6666666666666666,0.3333333333333333,0.0,1.0
SF-H12,SF-I30,1,4,0,0,1,4,0.0,1.0,0.0,1.0
SF-H12,SF-I29-2,3,1,2,1,1,0,0.6666666666666666,0.3333333333333333,1.0,0.0
SF-H12,SF I29-1,1,1,0,0,1,1,0.0,1.0,0.0,1.0
SF-H12,SF-S24,1,1,0,0,1,1,0.0,1.0,0.0,1.0
SF-H12,SF-Q23-3,13,1,0,0,13,1,0.0,1.0,0.0,1.0
SF-H12,SF-Q22-2,9,10,0,0,9,10,0.0,1.0,0.0,1.0
SF-H12,SF-P22,1,4,0,0,1,4,0.0,1.0,0.0,1.0
SF-H12,SF-U30,1,1,0,0,1,1,0.0,1.0,0.0,1.0
SF-G10-2,SF-L24,2,3,0,0,2,3,0.0,1.0,0.0,1.0
SF-G10-2,SF-O23,2,1,0,0,2,1,0.0,1.0,0.0,1.0
SF-G10-2,SF-G27,2,3,0,3,2,0,0.0,1.0,1.0,0.0
SF-G10-2,SF-M22-2,3,8,0,1,3,7,0.0,1.0,0.125,0.875
SF-G10-2,SF-F27,2,2,0,0,2,2,0.0,1.0,0.0,1.0
SF-G10-2,SF-N22-2,3,2,2,0,1,2,0.6666666666666666,0.3333333333333333,0.0,1.0
SF-G10-2,SF-K24,1,1,0,0,1,1,0.0,1.0,0.0,1.0
SF-G10-2,SF-G24,3,3,0,2,3,1,0.0,1.0,0.6666666666666666,0.3333333333333333
SF-G10-2,SF-G25,1,1,0,0,1,1,0.0,1.0,0.0,1.0
SF-G10-2,SF-F23,2,3,2,2,0,1,1.0,0.0,0.6666666666666666,0.3333333333333333
SF-G10-2,SF-E23,11,2,0,1,11,1,0.0,1.0,0.5,0.5
SF-G10-2,SF-C22,1,2,0,0,1,2,0.0,1.0,0.0,1.0
SF-G10-2,SF-J17,5,3,1,1,4,2,0.2,0.8,0.3333333333333333,0.6666666666666666
SF-G10-2,SF-H16,11,11,3,2,8,9,0.2727272727272727,0.7272727272727273,0.18181818181818182,0.8181818181818182
SF-G10-2,SF-H18,1,2,0,0,1,2,0.0,1.0,0.0,1.0
SF-G10-2,SF-G18,1,4,1,0,0,4,1.0,0.0,0.0,1.0
SF-G10-2,SF-G20,2,2,0,0,2,2,0.0,1.0,0.0,1.0
SF-G10-2,SF-F19,3,2,2,0,1,2,0.6666666666666666,0.3333333333333333,0.0,1.0
SF-G10-2,SF-E20,5,1,1,0,4,1,0.2,0.8,0.0,1.0
SF-G10-2,SF-E29-1,1,3,0,0,1,3,0.0,1.0,0.0,1.0
SF-G10-2,SF-J10,18,33,10,21,8,12,0.5555555555555556,0.4444444444444444,0.6363636363636364,0.36363636363636365
SF-G10-2,SF-J12,23,24,17,14,6,10,0.7391304347826086,0.2608695652173913,0.5833333333333334,0.4166666666666667
SF-G10-2,SF-J13,16,15,3,5,13,10,0.1875,0.8125,0.3333333333333333,0.6666666666666666
SF-G10-2,SF-H13,11,14,3,1,8,13,0.2727272727272727,0.7272727272727273,0.07142857142857142,0.9285714285714286
SF-G10-2,SF-I16,5,3,2,2,3,1,0.4,0.6,0.6666666666666666,0.3333333333333333
SF-G10-2,SF-H12,5,8,2,4,3,4,0.4,0.6,0.5,0.5
SF-G10-2,SF-H15,4,1,2,0,2,1,0.5,0.5,0.0,1.0
SF-G10-2,SF-G9,19,13,11,4,8,9,0.5789473684210527,0.42105263157894735,0.3076923076923077,0.6923076923076923
SF-G10-2,SF-H14,4,7,3,3,1,4,0.75,0.25,0.42857142857142855,0.5714285714285714
SF-G10-2,SF-G13,11,20,3,10,8,10,0.2727272727272727,0.7272727272727273,0.5,0.5
SF-G10-2,SF-G11,6,6,4,5,2,1,0.6666666666666666,0.3333333333333333,0.8333333333333334,0.16666666666666666
SF-G10-2,SF-G12,19,11,11,7,8,4,0.5789473684210527,0.42105263157894735,0.6363636363636364,0.36363636363636365
SF-G10-2,SF-G10-1,38,27,27,10,11,17,0.7105263157894737,0.2894736842105263,0.37037037037037035,0.6296296296296297
SF-G10-2,SF-F15,6,5,1,5,5,0,0.16666666666666666,0.8333333333333334,1.0,0.0
SF-G10-2,SF-F16,4,5,1,2,3,3,0.25,0.75,0.4,0.6
SF-G10-2,SF-A20,1,3,0,0,1,3,0.0,1.0,0.0,1.0
SF-G10-2,SF-A19,1,6,1,2,0,4,1.0,0.0,0.3333333333333333,0.6666666666666666
SF-G10-2,SF-E27,1,4,0,0,1,4,0.0,1.0,0.0,1.0
SF-G10-2,SF-J1,10,19,3,9,7,10,0.3,0.7,0.47368421052631576,0.5263157894736842
SF-G10-2,SF-H0,5,8,0,4,5,4,0.0,1.0,0.5,0.5
SF-G10-2,SF-J3,10,17,3,3,7,14,0.3,0.7,0.17647058823529413,0.8235294117647058
SF-G10-2,SF-J5,10,13,6,9,4,4,0.6,0.4,0.6923076923076923,0.3076923076923077
SF-G10-2,SF-G6,20,17,4,8,16,9,0.2,0.8,0.47058823529411764,0.5294117647058824
SF-G10-2,SF-G8,19,9,12,8,7,1,0.631578947368421,0.3684210526315789,0.8888888888888888,0.1111111111111111
SF-G10-2,SF-G5,13,11,6,5,7,6,0.46153846153846156,0.5384615384615384,0.45454545454545453,0.5454545454545454
SF-G10-2,SF-G7,18,27,5,11,13,16,0.2777777777777778,0.7222222222222222,0.4074074074074074,0.5925925925925926
SF-G10-2,SF-F9,18,16,13,8,5,8,0.7222222222222222,0.2777777777777778,0.5,0.5
SF-G10-2,SF-K21,3,3,0,0,3,3,0.0,1.0,0.0,1.0
SF-G10-2,SF-J23-1,1,2,1,1,0,1,1.0,0.0,0.5,0.5
SF-G10-2,SF-J21,1,3,0,0,1,3,0.0,1.0,0.0,1.0
SF-G10-2,SF-I22,1,1,0,0,1,1,0.0,1.0,0.0,1.0
SF-G10-2,SF-M13,16,18,1,3,15,15,0.0625,0.9375,0.16666666666666666,0.8333333333333334
SF-G10-2,SF-M15,6,10,2,0,4,10,0.3333333333333333,0.6666666666666666,0.0,1.0
SF-G10-2,SF-L19,5,10,0,2,5,8,0.0,1.0,0.2,0.8
SF-G10-2,SF-M20,8,6,1,4,7,2,0.125,0.875,0.6666666666666666,0.3333333333333333
SF-G10-2,SF-K17-2,3,7,1,1,2,6,0.3333333333333333,0.6666666666666666,0.14285714285714285,0.8571428571428571
SF-G10-2,SF-K20,2,11,0,4,2,7,0.0,1.0,0.36363636363636365,0.6363636363636364
SF-G10-2,SF-K15-,9,17,1,3,8,14,0.1111111111111111,0.8888888888888888,0.17647058823529413,0.8235294117647058
SF-G10-2,SF-K19,6,3,5,0,1,3,0.8333333333333334,0.16666666666666666,0.0,1.0
SF-G10-2,SF-K18,12,15,4,2,8,13,0.3333333333333333,0.6666666666666666,0.13333333333333333,0.8666666666666667
SF-G10-2,SF-K17,4,2,0,0,4,2,0.0,1.0,0.0,1.0
SF-G10-2,SF-J18,9,10,3,3,6,7,0.3333333333333333,0.6666666666666666,0.3,0.7
SF-G10-2,SF-J20,3,5,0,2,3,3,0.0,1.0,0.4,0.6
SF-G10-2,SF-J19,5,2,0,1,5,1,0.0,1.0,0.5,0.5
SF-G10-2,SF-M12,8,6,0,1,8,5,0.0,1.0,0.16666666666666666,0.8333333333333334
SF-G10-2,SF-M10,3,15,1,4,2,11,0.3333333333333333,0.6666666666666666,0.26666666666666666,0.7333333333333333
SF-G10-2,SF-M11,5,17,0,8,5,9,0.0,1.0,0.47058823529411764,0.5294117647058824
SF-G10-2,SF-R19,2,3,0,0,2,3,0.0,1.0,0.0,1.0
SF-G10-2,SF-R20,8,1,0,0,8,1,0.0,1.0,0.0,1.0
SF-G10-2,SF-Q21-2,3,1,0,0,3,1,0.0,1.0,0.0,1.0
SF-G10-2,SF-O18,1,3,0,0,1,3,0.0,1.0,0.0,1.0
SF-G10-2,SF-O19,1,5,0,2,1,3,0.0,1.0,0.4,0.6
SF-G10-2,SF-O21,1,3,0,0,1,3,0.0,1.0,0.0,1.0
SF-G10-2,SF-O22,2,4,0,1,2,3,0.0,1.0,0.25,0.75
SF-G10-2,SF-N21,3,1,0,0,3,1,0.0,1.0,0.0,1.0
SF-G10-2,SF-N28,2,4,0,2,2,2,0.0,1.0,0.5,0.5
SF-G10-2,SF-N22-1B,2,2,0,0,2,2,0.0,1.0,0.0,1.0
SF-G10-2,SF-Q23-3,2,1,0,0,2,1,0.0,1.0,0.0,1.0
SF-G10-2,SF-Q22-1,4,3,0,1,4,2,0.0,1.0,0.3333333333333333,0.6666666666666666
SF-G10-2,SF-Q22-2,3,10,0,2,3,8,0.0,1.0,0.2,0.8
SF-G10-2,SF-P22,9,4,2,0,7,4,0.2222222222222222,0.7777777777777778,0.0,1.0
SF-H15,SF-K27,1,1,1,1,0,0,1.0,0.0,1.0,0.0
SF-H15,SF-J25,1,1,0,0,1,1,0.0,1.0,0.0,1.0
SF-H15,SF-P24,1,2,0,0,1,2,0.0,1.0,0.0,1.0
SF-H15,SF-J24,2,3,0,0,2,3,0.0,1.0,0.0,1.0
SF-H15,SF-F28-2,1,4,0,0,1,4,0.0,1.0,0.0,1.0
SF-H15,SF-M22-2,6,4,1,2,5,2,0.16666666666666666,0.8333333333333334,0.5,0.5
SF-H15,SF-L22,1,1,0,0,1,1,0.0,1.0,0.0,1.0
SF-H15,SF-M22-1,1,2,0,0,1,2,0.0,1.0,0.0,1.0
SF-H15,SF-K24,3,3,0,0,3,3,0.0,1.0,0.0,1.0
SF-H15,SF-G24,3,5,0,1,3,4,0.0,1.0,0.2,0.8
SF-H15,SF-G25,3,3,0,0,3,3,0.0,1.0,0.0,1.0
SF-H15,SF-F23,2,1,0,0,2,1,0.0,1.0,0.0,1.0
SF-H15,SF-D24,2,1,1,0,1,1,0.5,0.5,0.0,1.0
SF-H15,SF-J17,10,11,1,1,9,10,0.1,0.9,0.09090909090909091,0.9090909090909091
SF-H15,SF-I19,2,1,1,1,1,0,0.5,0.5,1.0,0.0
SF-H15,SF-I20,1,2,0,1,1,1,0.0,1.0,0.5,0.5
SF-H15,SF-H16,28,28,17,17,11,11,0.6071428571428571,0.39285714285714285,0.6071428571428571,0.39285714285714285
SF-H15,SF-H20,2,1,0,0,2,1,0.0,1.0,0.0,1.0
SF-H15,SF-H18,1,2,0,0,1,2,0.0,1.0,0.0,1.0
SF-H15,SF-G19,6,3,0,1,6,2,0.0,1.0,0.3333333333333333,0.6666666666666666
SF-H15,SF-G17,2,2,1,1,1,1,0.5,0.5,0.5,0.5
SF-H15,SF-G18,7,3,0,2,7,1,0.0,1.0,0.6666666666666666,0.3333333333333333
SF-H15,SF-G20,18,12,1,9,17,3,0.05555555555555555,0.9444444444444444,0.75,0.25
SF-H15,SF-F19,3,3,0,1,3,2,0.0,1.0,0.3333333333333333,0.6666666666666666
SF-H15,SF-E18,1,2,0,0,1,2,0.0,1.0,0.0,1.0
SF-H15,SF-E20,2,3,0,3,2,0,0.0,1.0,1.0,0.0
SF-H15,SF-J10,5,8,1,5,4,3,0.2,0.8,0.625,0.375
SF-H15,SF-J12,13,14,2,3,11,11,0.15384615384615385,0.8461538461538461,0.21428571428571427,0.7857142857142857
SF-H15,SF-J13,12,9,3,1,9,8,0.25,0.75,0.1111111111111111,0.8888888888888888
SF-H15,SF-J15,9,10,6,6,3,4,0.6666666666666666,0.3333333333333333,0.6,0.4
SF-H15,SF-J14,2,3,2,2,0,1,1.0,0.0,0.6666666666666666,0.3333333333333333
SF-H15,SF-H13,7,13,4,8,3,5,0.5714285714285714,0.42857142857142855,0.6153846153846154,0.38461538461538464
SF-H15,SF-I16,17,23,11,7,6,16,0.6470588235294118,0.35294117647058826,0.30434782608695654,0.6956521739130435
SF-H15,SF-H12,10,7,7,2,3,5,0.7,0.3,0.2857142857142857,0.7142857142857143
SF-H15,SF-G10-2,1,4,0,2,1,2,0.0,1.0,0.5,0.5
SF-H15,SF-G9,4,2,1,1,3,1,0.25,0.75,0.5,0.5
SF-H15,SF-H14,8,9,5,5,3,4,0.625,0.375,0.5555555555555556,0.4444444444444444
SF-H15,SF-G13,14,11,2,7,12,4,0.14285714285714285,0.8571428571428571,0.6363636363636364,0.36363636363636365
SF-H15,SF-G11,14,12,2,2,12,10,0.14285714285714285,0.8571428571428571,0.16666666666666666,0.8333333333333334
SF-H15,SF-G12,7,9,4,5,3,4,0.5714285714285714,0.42857142857142855,0.5555555555555556,0.4444444444444444
SF-H15,SF-G10-1,1,3,0,2,1,1,0.0,1.0,0.6666666666666666,0.3333333333333333
SF-H15,SF-F15,8,8,6,4,2,4,0.75,0.25,0.5,0.5
SF-H15,SF-F16,10,6,7,3,3,3,0.7,0.3,0.5,0.5
SF-H15,SF-C20,1,3,1,0,0,3,1.0,0.0,0.0,1.0
SF-H15,SF-C25,2,4,0,0,2,4,0.0,1.0,0.0,1.0
SF-H15,SF-J1,35,23,3,14,32,9,0.08571428571428572,0.9142857142857143,0.6086956521739131,0.391304347826087
SF-H15,SF-H0,2,1,0,0,2,1,0.0,1.0,0.0,1.0
SF-H15,SF-J3,8,9,0,2,8,7,0.0,1.0,0.2222222222222222,0.7777777777777778
SF-H15,SF-J5,4,2,1,2,3,0,0.25,0.75,1.0,0.0
SF-H15,SF-G8,16,7,3,2,13,5,0.1875,0.8125,0.2857142857142857,0.7142857142857143
SF-H15,SF-G5,3,4,0,1,3,3,0.0,1.0,0.25,0.75
SF-H15,SF-G7,10,6,5,3,5,3,0.5,0.5,0.5,0.5
SF-H15,SF-F9,1,4,1,0,0,4,1.0,0.0,0.0,1.0
SF-H15,SF-G26,1,3,0,1,1,2,0.0,1.0,0.3333333333333333,0.6666666666666666
SF-H15,SF-J23-1,7,7,0,0,7,7,0.0,1.0,0.0,1.0
SF-H15,SF-J22-1,2,2,0,2,2,0,0.0,1.0,1.0,0.0
SF-H15,SF-J21,7,9,0,1,7,8,0.0,1.0,0.1111111111111111,0.8888888888888888
SF-H15,SF-I22,2,5,0,3,2,2,0.0,1.0,0.6,0.4
SF-H15,SF-F26,1,5,0,3,1,2,0.0,1.0,0.6,0.4
SF-H15,SF-M13,5,2,3,0,2,2,0.6,0.4,0.0,1.0
SF-H15,SF-M15,5,8,0,2,5,6,0.0,1.0,0.25,0.75
SF-H15,SF-L19,6,4,0,0,6,4,0.0,1.0,0.0,1.0
SF-H15,SF-M20,6,6,1,3,5,3,0.16666666666666666,0.8333333333333334,0.5,0.5
SF-H15,SF-K17-2,4,13,2,6,2,7,0.5,0.5,0.46153846153846156,0.5384615384615384
SF-H15,SF-K20,2,2,0,0,2,2,0.0,1.0,0.0,1.0
SF-H15,SF-K15-,4,18,2,10,2,8,0.5,0.5,0.5555555555555556,0.4444444444444444
SF-H15,SF-K19,2,27,2,6,0,21,1.0,0.0,0.2222222222222222,0.7777777777777778
SF-H15,SF-K18,2,6,0,4,2,2,0.0,1.0,0.6666666666666666,0.3333333333333333
SF-H15,SF-K17,4,7,0,6,4,1,0.0,1.0,0.8571428571428571,0.14285714285714285
SF-H15,SF-J16,8,9,5,6,3,3,0.625,0.375,0.6666666666666666,0.3333333333333333
SF-H15,SF-J18,11,12,1,2,10,10,0.09090909090909091,0.9090909090909091,0.16666666666666666,0.8333333333333334
SF-H15,SF-J19,8,7,0,0,8,7,0.0,1.0,0.0,1.0
SF-H15,SF-M12,4,2,0,0,4,2,0.0,1.0,0.0,1.0
SF-H15,SF-M11,3,4,3,0,0,4,1.0,0.0,0.0,1.0
SF-H15,SF-O18,2,2,1,2,1,0,0.5,0.5,1.0,0.0
SF-H15,SF-O21,4,5,1,2,3,3,0.25,0.75,0.4,0.6
SF-H15,SF-L21,2,1,0,0,2,1,0.0,1.0,0.0,1.0
SF-H15,SF-O30,1,1,0,0,1,1,0.0,1.0,0.0,1.0
SF-H15,SF-L30-1,3,1,1,1,2,0,0.3333333333333333,0.6666666666666666,1.0,0.0
SF-H15,SF-Q22-2,2,1,0,1,2,0,0.0,1.0,1.0,0.0
SF-G9,SF-J25,2,6,0,0,2,6,0.0,1.0,0.0,1.0
SF-G9,SF-G27,1,1,0,0,1,1,0.0,1.0,0.0,1.0
SF-G9,SF-F27,1,1,0,0,1,1,0.0,1.0,0.0,1.0
SF-G9,SF-G24,2,2,2,0,0,2,1.0,0.0,0.0,1.0
SF-G9,SF-F23,4,2,0,1,4,1,0.0,1.0,0.5,0.5
SF-G9,SF-E23,1,4,0,0,1,4,0.0,1.0,0.0,1.0
SF-G9,SF-D24,2,2,0,0,2,2,0.0,1.0,0.0,1.0
SF-G9,SF-C22,1,1,0,0,1,1,0.0,1.0,0.0,1.0
SF-G9,SF-B22,1,3,0,1,1,2,0.0,1.0,0.3333333333333333,0.6666666666666666
SF-G9,SF-J17,13,5,1,1,12,4,0.07692307692307693,0.9230769230769231,0.2,0.8
SF-G9,SF-H16,15,14,5,6,10,8,0.3333333333333333,0.6666666666666666,0.42857142857142855,0.5714285714285714
SF-G9,SF-H18,6,7,3,4,3,3,0.5,0.5,0.5714285714285714,0.42857142857142855
SF-G9,SF-H17,2,1,0,0,2,1,0.0,1.0,0.0,1.0
SF-G9,SF-G17,28,39,24,38,4,1,0.8571428571428571,0.14285714285714285,0.9743589743589743,0.02564102564102564
SF-G9,SF-G18,6,3,1,0,5,3,0.16666666666666666,0.8333333333333334,0.0,1.0
SF-G9,SF-G20,14,10,8,6,6,4,0.5714285714285714,0.42857142857142855,0.6,0.4
SF-G9,SF-F19,3,9,1,4,2,5,0.3333333333333333,0.6666666666666666,0.4444444444444444,0.5555555555555556
SF-G9,SF-E18,5,2,1,0,4,2,0.2,0.8,0.0,1.0
SF-G9,SF-E20,8,9,2,3,6,6,0.25,0.75,0.3333333333333333,0.6666666666666666
SF-G9,SF-G30-2,2,2,0,0,2,2,0.0,1.0,0.0,1.0
SF-G9,SF-E29-2,3,2,0,0,3,2,0.0,1.0,0.0,1.0
SF-G9,SF-D29,2,1,2,1,0,0,1.0,0.0,1.0,0.0
SF-G9,SF-J10,7,15,7,7,0,8,1.0,0.0,0.4666666666666667,0.5333333333333333
SF-G9,SF-J12,31,32,14,15,17,17,0.45161290322580644,0.5483870967741935,0.46875,0.53125
SF-G9,SF-J13,12,10,2,2,10,8,0.16666666666666666,0.8333333333333334,0.2,0.8
SF-G9,SF-J15,4,1,0,0,4,1,0.0,1.0,0.0,1.0
SF-G9,SF-H13,23,7,6,1,17,6,0.2608695652173913,0.7391304347826086,0.14285714285714285,0.8571428571428571
SF-G9,SF-I16,9,3,1,0,8,3,0.1111111111111111,0.8888888888888888,0.0,1.0
SF-G9,SF-H12,9,9,1,5,8,4,0.1111111111111111,0.8888888888888888,0.5555555555555556,0.4444444444444444
SF-G9,SF-G10-2,13,19,4,11,9,8,0.3076923076923077,0.6923076923076923,0.5789473684210527,0.42105263157894735
SF-G9,SF-H15,2,4,1,1,1,3,0.5,0.5,0.25,0.75
SF-G9,SF-H14,29,12,1,0,28,12,0.034482758620689655,0.9655172413793104,0.0,1.0
SF-G9,SF-G13,29,27,11,14,18,13,0.3793103448275862,0.6206896551724138,0.5185185185185185,0.48148148148148145
SF-G9,SF-G11,24,26,18,19,6,7,0.75,0.25,0.7307692307692307,0.2692307692307692
SF-G9,SF-G12,17,18,9,13,8,5,0.5294117647058824,0.47058823529411764,0.7222222222222222,0.2777777777777778
SF-G9,SF-G10-1,14,11,3,5,11,6,0.21428571428571427,0.7857142857142857,0.45454545454545453,0.5454545454545454
SF-G9,SF-F15,14,10,8,2,6,8,0.5714285714285714,0.42857142857142855,0.2,0.8
SF-G9,SF-F16,7,8,2,1,5,7,0.2857142857142857,0.7142857142857143,0.125,0.875
SF-G9,SF-C20,2,5,0,0,2,5,0.0,1.0,0.0,1.0
SF-G9,SF-B19,4,2,0,0,4,2,0.0,1.0,0.0,1.0
SF-G9,SF-C25,1,1,0,0,1,1,0.0,1.0,0.0,1.0
SF-G9,SF-J1,10,23,4,17,6,6,0.4,0.6,0.7391304347826086,0.2608695652173913
SF-G9,SF-H0,2,7,1,3,1,4,0.5,0.5,0.42857142857142855,0.5714285714285714
SF-G9,SF-J3,5,2,3,1,2,1,0.6,0.4,0.5,0.5
SF-G9,SF-J5,19,6,6,1,13,5,0.3157894736842105,0.6842105263157895,0.16666666666666666,0.8333333333333334
SF-G9,SF-G6,13,9,11,6,2,3,0.8461538461538461,0.15384615384615385,0.6666666666666666,0.3333333333333333
SF-G9,SF-G8,10,7,3,5,7,2,0.3,0.7,0.7142857142857143,0.2857142857142857
SF-G9,SF-G5,19,18,9,10,10,8,0.47368421052631576,0.5263157894736842,0.5555555555555556,0.4444444444444444
SF-G9,SF-G7,27,26,15,14,12,12,0.5555555555555556,0.4444444444444444,0.5384615384615384,0.46153846153846156
SF-G9,SF-F9,44,25,30,11,14,14,0.6818181818181818,0.3181818181818182,0.44,0.56
SF-G9,SF-J23-1,4,4,0,0,4,4,0.0,1.0,0.0,1.0
SF-G9,SF-J22-1,4,3,0,3,4,0,0.0,1.0,1.0,0.0
SF-G9,SF-J22-2,1,2,0,1,1,1,0.0,1.0,0.5,0.5
SF-G9,SF-J21,9,1,2,0,7,1,0.2222222222222222,0.7777777777777778,0.0,1.0
SF-G9,SF-F26,3,3,3,1,0,2,1.0,0.0,0.3333333333333333,0.6666666666666666
SF-G9,SF-M13,12,11,1,0,11,11,0.08333333333333333,0.9166666666666666,0.0,1.0
SF-G9,SF-M15,5,9,4,4,1,5,0.8,0.2,0.4444444444444444,0.5555555555555556
SF-G9,SF-L19,3,6,1,0,2,6,0.3333333333333333,0.6666666666666666,0.0,1.0
SF-G9,SF-M20,4,6,2,1,2,5,0.5,0.5,0.16666666666666666,0.8333333333333334
SF-G9,SF-K17-2,25,14,24,12,1,2,0.96,0.04,0.8571428571428571,0.14285714285714285
SF-G9,SF-K20,4,15,0,1,4,14,0.0,1.0,0.06666666666666667,0.9333333333333333
SF-G9,SF-K15-,29,19,16,7,13,12,0.5517241379310345,0.4482758620689655,0.3684210526315789,0.631578947368421
SF-G9,SF-K19,1,1,0,0,1,1,0.0,1.0,0.0,1.0
SF-G9,SF-K18,2,3,1,1,1,2,0.5,0.5,0.3333333333333333,0.6666666666666666
SF-G9,SF-K17,5,7,0,0,5,7,0.0,1.0,0.0,1.0
SF-G9,SF-J18,3,5,1,2,2,3,0.3333333333333333,0.6666666666666666,0.4,0.6
SF-G9,SF-J20,2,3,1,0,1,3,0.5,0.5,0.0,1.0
SF-G9,SF-J19,3,1,2,0,1,1,0.6666666666666666,0.3333333333333333,0.0,1.0
SF-G9,SF-O12,2,1,0,0,2,1,0.0,1.0,0.0,1.0
SF-G9,SF-M12,5,3,5,2,0,1,1.0,0.0,0.6666666666666666,0.3333333333333333
SF-G9,SF-M10,4,8,2,3,2,5,0.5,0.5,0.375,0.625
SF-G9,SF-M11,5,7,0,3,5,4,0.0,1.0,0.42857142857142855,0.5714285714285714
SF-G9,SF-R19,2,2,0,0,2,2,0.0,1.0,0.0,1.0
SF-G9,SF-R20,1,1,0,0,1,1,0.0,1.0,0.0,1.0
SF-G9,SF-Q21-1,7,3,6,3,1,0,0.8571428571428571,0.14285714285714285,1.0,0.0
SF-G9,SF-O18,1,1,0,0,1,1,0.0,1.0,0.0,1.0
SF-G9,SF-O21,1,2,0,0,1,2,0.0,1.0,0.0,1.0
SF-G9,SF-M21,3,5,0,0,3,5,0.0,1.0,0.0,1.0
SF-G9,SF-L21,5,2,0,1,5,1,0.0,1.0,0.5,0.5
SF-G9,SF-N27,1,4,0,4,1,0,0.0,1.0,1.0,0.0
SF-G9,SF-Q22-2,4,1,0,0,4,1,0.0,1.0,0.0,1.0
SF-G9,SF-P22,7,4,0,0,7,4,0.0,1.0,0.0,1.0
SF-H14,SF-H26,1,2,0,0,1,2,0.0,1.0,0.0,1.0
SF-H14,SF-M22-2,1,1,0,1,1,0,0.0,1.0,1.0,0.0
SF-H14,SF-C22,5,2,0,0,5,2,0.0,1.0,0.0,1.0
SF-H14,SF-J17,12,19,0,1,12,18,0.0,1.0,0.05263157894736842,0.9473684210526315
SF-H14,SF-I19,3,1,0,0,3,1,0.0,1.0,0.0,1.0
SF-H14,SF-H16,18,18,13,7,5,11,0.7222222222222222,0.2777777777777778,0.3888888888888889,0.6111111111111112
SF-H14,SF-H19,1,4,0,0,1,4,0.0,1.0,0.0,1.0
SF-H14,SF-H18,2,5,1,4,1,1,0.5,0.5,0.8,0.2
SF-H14,SF-H17,5,2,0,0,5,2,0.0,1.0,0.0,1.0
SF-H14,SF-G17,2,6,0,1,2,5,0.0,1.0,0.16666666666666666,0.8333333333333334
SF-H14,SF-G18,2,2,1,2,1,0,0.5,0.5,1.0,0.0
SF-H14,SF-G20,3,2,0,0,3,2,0.0,1.0,0.0,1.0
SF-H14,SF-E18,6,5,4,0,2,5,0.6666666666666666,0.3333333333333333,0.0,1.0
SF-H14,SF-E20,3,2,1,2,2,0,0.3333333333333333,0.6666666666666666,1.0,0.0
SF-H14,SF-E29-1,1,1,0,0,1,1,0.0,1.0,0.0,1.0
SF-H14,SF-F28-1,1,4,0,0,1,4,0.0,1.0,0.0,1.0
SF-H14,SF-J10,7,3,4,2,3,1,0.5714285714285714,0.42857142857142855,0.6666666666666666,0.3333333333333333
SF-H14,SF-J12,12,13,9,7,3,6,0.75,0.25,0.5384615384615384,0.46153846153846156
SF-H14,SF-J13,14,7,13,5,1,2,0.9285714285714286,0.07142857142857142,0.7142857142857143,0.2857142857142857
SF-H14,SF-J15,6,9,3,1,3,8,0.5,0.5,0.1111111111111111,0.8888888888888888
SF-H14,SF-J14,7,3,4,1,3,2,0.5714285714285714,0.42857142857142855,0.3333333333333333,0.6666666666666666
SF-H14,SF-H13,10,17,5,15,5,2,0.5,0.5,0.8823529411764706,0.11764705882352941
SF-H14,SF-I16,8,9,3,2,5,7,0.375,0.625,0.2222222222222222,0.7777777777777778
SF-H14,SF-H12,5,4,3,4,2,0,0.6,0.4,1.0,0.0
SF-H14,SF-G10-2,7,4,3,3,4,1,0.42857142857142855,0.5714285714285714,0.75,0.25
SF-H14,SF-H15,9,8,5,5,4,3,0.5555555555555556,0.4444444444444444,0.625,0.375
SF-H14,SF-G9,12,29,0,1,12,28,0.0,1.0,0.034482758620689655,0.9655172413793104
SF-H14,SF-G13,48,52,32,36,16,16,0.6666666666666666,0.3333333333333333,0.6923076923076923,0.3076923076923077
SF-H14,SF-G11,14,6,7,1,7,5,0.5,0.5,0.16666666666666666,0.8333333333333334
SF-H14,SF-G12,10,15,2,6,8,9,0.2,0.8,0.4,0.6
SF-H14,SF-G10-1,2,5,1,2,1,3,0.5,0.5,0.4,0.6
SF-H14,SF-F15,6,10,0,6,6,4,0.0,1.0,0.6,0.4
SF-H14,SF-F16,8,4,2,1,6,3,0.25,0.75,0.25,0.75
SF-H14,SF-C21,2,1,0,1,2,0,0.0,1.0,1.0,0.0
SF-H14,SF-C20,6,8,0,4,6,4,0.0,1.0,0.5,0.5
SF-H14,SF-C25,1,3,0,0,1,3,0.0,1.0,0.0,1.0
SF-H14,SF-D27,3,1,0,0,3,1,0.0,1.0,0.0,1.0
SF-H14,SF-J1,2,10,1,5,1,5,0.5,0.5,0.5,0.5
SF-H14,SF-H0,2,1,0,1,2,0,0.0,1.0,1.0,0.0
SF-H14,SF-J3,7,3,2,1,5,2,0.2857142857142857,0.7142857142857143,0.3333333333333333,0.6666666666666666
SF-H14,SF-J5,3,4,1,0,2,4,0.3333333333333333,0.6666666666666666,0.0,1.0
SF-H14,SF-G8,4,2,0,1,4,1,0.0,1.0,0.5,0.5
SF-H14,SF-G5,1,2,0,0,1,2,0.0,1.0,0.0,1.0
SF-H14,SF-G7,6,6,1,2,5,4,0.16666666666666666,0.8333333333333334,0.3333333333333333,0.6666666666666666
SF-H14,SF-F9,3,3,3,2,0,1,1.0,0.0,0.6666666666666666,0.3333333333333333
SF-H14,SF-J22-1,1,2,0,2,1,0,0.0,1.0,1.0,0.0
SF-H14,SF-J21,4,4,2,3,2,1,0.5,0.5,0.75,0.25
SF-H14,SF-M13,3,6,1,1,2,5,0.3333333333333333,0.6666666666666666,0.16666666666666666,0.8333333333333334
SF-H14,SF-M15,4,5,1,1,3,4,0.25,0.75,0.2,0.8
SF-H14,SF-M20,3,1,0,1,3,0,0.0,1.0,1.0,0.0
SF-H14,SF-K20,4,4,0,2,4,2,0.0,1.0,0.5,0.5
SF-H14,SF-K15-,7,12,1,5,6,7,0.14285714285714285,0.8571428571428571,0.4166666666666667,0.5833333333333334
SF-H14,SF-K19,2,4,0,1,2,3,0.0,1.0,0.25,0.75
SF-H14,SF-K18,6,10,2,4,4,6,0.3333333333333333,0.6666666666666666,0.4,0.6
SF-H14,SF-K17,4,4,0,0,4,4,0.0,1.0,0.0,1.0
SF-H14,SF-J16,7,8,0,3,7,5,0.0,1.0,0.375,0.625
SF-H14,SF-J18,4,6,0,2,4,4,0.0,1.0,0.3333333333333333,0.6666666666666666
SF-H14,SF-J19,2,2,1,0,1,2,0.5,0.5,0.0,1.0
SF-H14,SF-M12,1,2,0,2,1,0,0.0,1.0,1.0,0.0
SF-H14,SF-M10,5,6,1,4,4,2,0.2,0.8,0.6666666666666666,0.3333333333333333
SF-H14,SF-P21,1,1,0,0,1,1,0.0,1.0,0.0,1.0
SF-H14,SF-O22,1,1,0,0,1,1,0.0,1.0,0.0,1.0
SF-H14,SF-N21,2,29,2,29,0,0,1.0,0.0,1.0,0.0
SF-H14,SF-M21,1,2,1,2,0,0,1.0,0.0,1.0,0.0
SF-H14,SF-L21,1,1,0,0,1,1,0.0,1.0,0.0,1.0
SF-H14,SF-S22-1,1,1,0,0,1,1,0.0,1.0,0.0,1.0
SF-G13,SF-M30,2,2,0,0,2,2,0.0,1.0,0.0,1.0
SF-G13,SF-K27-2,1,1,0,0,1,1,0.0,1.0,0.0,1.0
SF-G13,SF-J26-2,1,1,0,0,1,1,0.0,1.0,0.0,1.0
SF-G13,SF-J25,2,6,0,0,2,6,0.0,1.0,0.0,1.0
SF-G13,SF-J24,1,1,0,0,1,1,0.0,1.0,0.0,1.0
SF-G13,SF-I25,3,2,0,0,3,2,0.0,1.0,0.0,1.0
SF-G13,SF-H26,2,1,0,0,2,1,0.0,1.0,0.0,1.0
SF-G13,SF-O23,1,18,1,18,0,0,1.0,0.0,1.0,0.0
SF-G13,SF-F28-2,10,11,0,0,10,11,0.0,1.0,0.0,1.0
SF-G13,SF-G27,4,5,0,0,4,5,0.0,1.0,0.0,1.0
SF-G13,SF-M22-2,1,3,0,2,1,1,0.0,1.0,0.6666666666666666,0.3333333333333333
SF-G13,SF-L22,3,1,1,1,2,0,0.3333333333333333,0.6666666666666666,1.0,0.0
SF-G13,SF-F27,5,6,0,0,5,6,0.0,1.0,0.0,1.0
SF-G13,SF-N22-2,3,4,1,2,2,2,0.3333333333333333,0.6666666666666666,0.5,0.5
SF-G13,SF-K22-2,1,3,0,0,1,3,0.0,1.0,0.0,1.0
SF-G13,SF-J23-2,1,4,0,2,1,2,0.0,1.0,0.5,0.5
SF-G13,SF-G23,4,2,2,0,2,2,0.5,0.5,0.0,1.0
SF-G13,SF-G24,2,13,0,3,2,10,0.0,1.0,0.23076923076923078,0.7692307692307693
SF-G13,SF-G25,9,8,4,0,5,8,0.4444444444444444,0.5555555555555556,0.0,1.0
SF-G13,SF-F23,3,8,0,2,3,6,0.0,1.0,0.25,0.75
SF-G13,SF-E23,21,11,6,0,15,11,0.2857142857142857,0.7142857142857143,0.0,1.0
SF-G13,SF-D24,5,8,2,0,3,8,0.4,0.6,0.0,1.0
SF-G13,SF-C22,6,14,1,3,5,11,0.16666666666666666,0.8333333333333334,0.21428571428571427,0.7857142857142857
SF-G13,SF-B22,1,13,0,3,1,10,0.0,1.0,0.23076923076923078,0.7692307692307693
SF-G13,SF-J17,29,27,4,14,25,13,0.13793103448275862,0.8620689655172413,0.5185185185185185,0.48148148148148145
SF-G13,SF-I19,3,4,0,0,3,4,0.0,1.0,0.0,1.0
SF-G13,SF-I20,1,1,1,0,0,1,1.0,0.0,0.0,1.0
SF-G13,SF-H16,28,36,8,14,20,22,0.2857142857142857,0.7142857142857143,0.3888888888888889,0.6111111111111112
SF-G13,SF-H19,1,1,0,1,1,0,0.0,1.0,1.0,0.0
SF-G13,SF-H20,2,1,0,0,2,1,0.0,1.0,0.0,1.0
SF-G13,SF-H18,4,10,1,0,3,10,0.25,0.75,0.0,1.0
SF-G13,SF-H17,3,24,0,0,3,24,0.0,1.0,0.0,1.0
SF-G13,SF-G19,6,8,1,7,5,1,0.16666666666666666,0.8333333333333334,0.875,0.125
SF-G13,SF-G17,6,9,2,2,4,7,0.3333333333333333,0.6666666666666666,0.2222222222222222,0.7777777777777778
SF-G13,SF-G18,18,12,0,1,18,11,0.0,1.0,0.08333333333333333,0.9166666666666666
SF-G13,SF-G20,7,18,5,8,2,10,0.7142857142857143,0.2857142857142857,0.4444444444444444,0.5555555555555556
SF-G13,SF-F19,12,9,4,2,8,7,0.3333333333333333,0.6666666666666666,0.2222222222222222,0.7777777777777778
SF-G13,SF-E18,23,21,14,7,9,14,0.6086956521739131,0.391304347826087,0.3333333333333333,0.6666666666666666
SF-G13,SF-E20,19,8,5,4,14,4,0.2631578947368421,0.7368421052631579,0.5,0.5
SF-G13,SF-G30-2,3,2,0,0,3,2,0.0,1.0,0.0,1.0
SF-G13,SF-E29-2,1,1,0,0,1,1,0.0,1.0,0.0,1.0
SF-G13,SF-D28,1,2,0,0,1,2,0.0,1.0,0.0,1.0
SF-G13,SF-G29-2,1,1,1,0,0,1,1.0,0.0,0.0,1.0
SF-G13,SF-G29-1,1,3,1,1,0,2,1.0,0.0,0.3333333333333333,0.6666666666666666
SF-G13,SF-G29-3,1,1,0,0,1,1,0.0,1.0,0.0,1.0
SF-G13,SF-F30-2,2,1,2,0,0,1,1.0,0.0,0.0,1.0
SF-G13,SF-F28-1,1,2,0,1,1,1,0.0,1.0,0.5,0.5
SF-G13,SF-J10,39,37,12,17,27,20,0.3076923076923077,0.6923076923076923,0.4594594594594595,0.5405405405405406
SF-G13,SF-J12,76,84,40,37,36,47,0.5263157894736842,0.47368421052631576,0.44047619047619047,0.5595238095238095
SF-G13,SF-J13,113,153,59,88,54,65,0.5221238938053098,0.4778761061946903,0.5751633986928104,0.42483660130718953
SF-G13,SF-J15,28,10,24,3,4,7,0.8571428571428571,0.14285714285714285,0.3,0.7
SF-G13,SF-J14,7,1,5,1,2,0,0.7142857142857143,0.2857142857142857,1.0,0.0
SF-G13,SF-H13,61,80,35,39,26,41,0.5737704918032787,0.4262295081967213,0.4875,0.5125
SF-G13,SF-I16,16,10,9,4,7,6,0.5625,0.4375,0.4,0.6
SF-G13,SF-H12,22,22,7,20,15,2,0.3181818181818182,0.6818181818181818,0.9090909090909091,0.09090909090909091
SF-G13,SF-G10-2,20,11,10,3,10,8,0.5,0.5,0.2727272727272727,0.7272727272727273
SF-G13,SF-H15,11,14,7,2,4,12,0.6363636363636364,0.36363636363636365,0.14285714285714285,0.8571428571428571
SF-G13,SF-G9,27,29,14,11,13,18,0.5185185185185185,0.48148148148148145,0.3793103448275862,0.6206896551724138
SF-G13,SF-H14,52,48,36,32,16,16,0.6923076923076923,0.3076923076923077,0.6666666666666666,0.3333333333333333
SF-G13,SF-G11,16,20,10,14,6,6,0.625,0.375,0.7,0.3
SF-G13,SF-G12,25,32,13,21,12,11,0.52,0.48,0.65625,0.34375
SF-G13,SF-G10-1,16,9,9,7,7,2,0.5625,0.4375,0.7777777777777778,0.2222222222222222
SF-G13,SF-F15,31,29,15,11,16,18,0.4838709677419355,0.5161290322580645,0.3793103448275862,0.6206896551724138
SF-G13,SF-F16,20,13,12,5,8,8,0.6,0.4,0.38461538461538464,0.6153846153846154
SF-G13,SF-C21,3,2,0,0,3,2,0.0,1.0,0.0,1.0
SF-G13,SF-C20,4,32,1,5,3,27,0.25,0.75,0.15625,0.84375
SF-G13,SF-B21,1,4,0,2,1,2,0.0,1.0,0.5,0.5
SF-G13,SF-B19,8,14,0,2,8,12,0.0,1.0,0.14285714285714285,0.8571428571428571
SF-G13,SF-A20,8,9,2,1,6,8,0.25,0.75,0.1111111111111111,0.8888888888888888
SF-G13,SF-A19,9,5,3,1,6,4,0.3333333333333333,0.6666666666666666,0.2,0.8
SF-G13,SF-C26,5,4,0,0,5,4,0.0,1.0,0.0,1.0
SF-G13,SF-C25,8,7,0,0,8,7,0.0,1.0,0.0,1.0
SF-G13,SF-B25,10,11,0,1,10,10,0.0,1.0,0.09090909090909091,0.9090909090909091
SF-G13,SF-D27,1,2,0,0,1,2,0.0,1.0,0.0,1.0
SF-G13,SF-J1,14,35,3,13,11,22,0.21428571428571427,0.7857142857142857,0.37142857142857144,0.6285714285714286
SF-G13,SF-H0,4,3,0,3,4,0,0.0,1.0,1.0,0.0
SF-G13,SF-J3,5,13,4,5,1,8,0.8,0.2,0.38461538461538464,0.6153846153846154
SF-G13,SF-J5,6,11,1,5,5,6,0.16666666666666666,0.8333333333333334,0.45454545454545453,0.5454545454545454
SF-G13,SF-G6,10,6,6,3,4,3,0.6,0.4,0.5,0.5
SF-G13,SF-G8,13,11,5,2,8,9,0.38461538461538464,0.6153846153846154,0.18181818181818182,0.8181818181818182
SF-G13,SF-G5,22,14,8,3,14,11,0.36363636363636365,0.6363636363636364,0.21428571428571427,0.7857142857142857
SF-G13,SF-G7,59,42,29,15,30,27,0.4915254237288136,0.5084745762711864,0.35714285714285715,0.6428571428571429
SF-G13,SF-F9,14,13,9,9,5,4,0.6428571428571429,0.35714285714285715,0.6923076923076923,0.3076923076923077
SF-G13,SF-G26,4,2,1,0,3,2,0.25,0.75,0.0,1.0
SF-G13,SF-K21,5,10,0,2,5,8,0.0,1.0,0.2,0.8
SF-G13,SF-J23-1,8,6,2,0,6,6,0.25,0.75,0.0,1.0
SF-G13,SF-J22-1,7,5,0,0,7,5,0.0,1.0,0.0,1.0
SF-G13,SF-J22-2,9,7,2,0,7,7,0.2222222222222222,0.7777777777777778,0.0,1.0
SF-G13,SF-J21,14,17,1,3,13,14,0.07142857142857142,0.9285714285714286,0.17647058823529413,0.8235294117647058
SF-G13,SF-I21,4,9,0,1,4,8,0.0,1.0,0.1111111111111111,0.8888888888888888
SF-G13,SF-I23-2,3,3,1,1,2,2,0.3333333333333333,0.6666666666666666,0.3333333333333333,0.6666666666666666
SF-G13,SF-I23-1,2,4,0,0,2,4,0.0,1.0,0.0,1.0
SF-G13,SF-F26,6,4,0,0,6,4,0.0,1.0,0.0,1.0
SF-G13,SF-M13,45,49,12,9,33,40,0.26666666666666666,0.7333333333333333,0.1836734693877551,0.8163265306122449
SF-G13,SF-M15,17,30,6,11,11,19,0.35294117647058826,0.6470588235294118,0.36666666666666664,0.6333333333333333
SF-G13,SF-L19,9,5,2,1,7,4,0.2222222222222222,0.7777777777777778,0.2,0.8
SF-G13,SF-L20,6,9,3,3,3,6,0.5,0.5,0.3333333333333333,0.6666666666666666
SF-G13,SF-N20-1,7,3,0,0,7,3,0.0,1.0,0.0,1.0
SF-G13,SF-M20,28,20,6,4,22,16,0.21428571428571427,0.7857142857142857,0.2,0.8
SF-G13,SF-K17-2,3,12,0,4,3,8,0.0,1.0,0.3333333333333333,0.6666666666666666
SF-G13,SF-K20,17,10,6,4,11,6,0.35294117647058826,0.6470588235294118,0.4,0.6
SF-G13,SF-K15-,37,35,9,12,28,23,0.24324324324324326,0.7567567567567568,0.34285714285714286,0.6571428571428571
SF-G13,SF-K19,13,14,3,6,10,8,0.23076923076923078,0.7692307692307693,0.42857142857142855,0.5714285714285714
SF-G13,SF-K18,30,37,3,4,27,33,0.1,0.9,0.10810810810810811,0.8918918918918919
SF-G13,SF-K17,28,16,11,6,17,10,0.39285714285714285,0.6071428571428571,0.375,0.625
SF-G13,SF-J16,11,10,1,2,10,8,0.09090909090909091,0.9090909090909091,0.2,0.8
SF-G13,SF-J18,28,16,3,3,25,13,0.10714285714285714,0.8928571428571429,0.1875,0.8125
SF-G13,SF-J20,5,2,0,1,5,1,0.0,1.0,0.5,0.5
SF-G13,SF-J19,23,14,1,6,22,8,0.043478260869565216,0.9565217391304348,0.42857142857142855,0.5714285714285714
SF-G13,SF-M12,16,20,4,8,12,12,0.25,0.75,0.4,0.6
SF-G13,SF-M10,16,18,5,9,11,9,0.3125,0.6875,0.5,0.5
SF-G13,SF-M11,23,18,8,6,15,12,0.34782608695652173,0.6521739130434783,0.3333333333333333,0.6666666666666666
SF-G13,SF-R19,2,3,1,0,1,3,0.5,0.5,0.0,1.0
SF-G13,SF-P21,6,1,0,0,6,1,0.0,1.0,0.0,1.0
SF-G13,SF-O18,4,20,1,6,3,14,0.25,0.75,0.3,0.7
SF-G13,SF-O19,2,4,0,0,2,4,0.0,1.0,0.0,1.0
SF-G13,SF-O21,3,6,1,1,2,5,0.3333333333333333,0.6666666666666666,0.16666666666666666,0.8333333333333334
SF-G13,SF-O22,2,2,0,0,2,2,0.0,1.0,0.0,1.0
SF-G13,SF-N21,153,131,152,129,1,2,0.9934640522875817,0.006535947712418301,0.9847328244274809,0.015267175572519083
SF-G13,SF-N20-2,3,3,2,1,1,2,0.6666666666666666,0.3333333333333333,0.3333333333333333,0.6666666666666666
SF-G13,SF-L21,29,22,1,10,28,12,0.034482758620689655,0.9655172413793104,0.45454545454545453,0.5454545454545454
SF-G13,SF-P30,1,1,0,0,1,1,0.0,1.0,0.0,1.0
SF-G13,SF-O30,2,1,0,0,2,1,0.0,1.0,0.0,1.0
SF-G13,SF-N29,2,1,0,0,2,1,0.0,1.0,0.0,1.0
SF-G13,SF-L30-1,7,4,2,2,5,2,0.2857142857142857,0.7142857142857143,0.5,0.5
SF-G13,SF-I30,1,1,0,0,1,1,0.0,1.0,0.0,1.0
SF-G13,SF-R24,1,1,1,0,0,1,1.0,0.0,0.0,1.0
SF-G13,SF-P26,30,17,5,2,25,15,0.16666666666666666,0.8333333333333334,0.11764705882352941,0.8823529411764706
SF-G13,SF-O25-2,1,1,0,0,1,1,0.0,1.0,0.0,1.0
SF-G13,SF-T22,3,7,0,0,3,7,0.0,1.0,0.0,1.0
SF-G13,SF-S22-2,1,1,1,0,0,1,1.0,0.0,0.0,1.0
SF-G13,SF-S22-1,3,4,0,0,3,4,0.0,1.0,0.0,1.0
SF-G13,SF-Q22-1,5,5,1,1,4,4,0.2,0.8,0.2,0.8
SF-G13,SF-Q22-2,1,2,0,1,1,1,0.0,1.0,0.5,0.5
SF-G13,SF-P22,3,3,0,2,3,1,0.0,1.0,0.6666666666666666,0.3333333333333333
SF-G11,SF-M24,1,1,0,0,1,1,0.0,1.0,0.0,1.0
SF-G11,SF-N23,1,9,0,2,1,7,0.0,1.0,0.2222222222222222,0.7777777777777778
SF-G11,SF-K27-2,1,1,0,0,1,1,0.0,1.0,0.0,1.0
SF-G11,SF-J25,1,2,0,1,1,1,0.0,1.0,0.5,0.5
SF-G11,SF-I25,2,1,0,1,2,0,0.0,1.0,1.0,0.0
SF-G11,SF-H26,1,2,0,0,1,2,0.0,1.0,0.0,1.0
SF-G11,SF-F28-2,1,1,0,0,1,1,0.0,1.0,0.0,1.0
SF-G11,SF-L22,2,2,0,0,2,2,0.0,1.0,0.0,1.0
SF-G11,SF-N22-2,4,3,0,0,4,3,0.0,1.0,0.0,1.0
SF-G11,SF-M22-1,1,3,0,0,1,3,0.0,1.0,0.0,1.0
SF-G11,SF-K24,1,1,0,0,1,1,0.0,1.0,0.0,1.0
SF-G11,SF-G24,4,4,0,1,4,3,0.0,1.0,0.25,0.75
SF-G11,SF-G25,2,1,1,0,1,1,0.5,0.5,0.0,1.0
SF-G11,SF-E23,6,8,1,0,5,8,0.16666666666666666,0.8333333333333334,0.0,1.0
SF-G11,SF-C22,2,3,0,0,2,3,0.0,1.0,0.0,1.0
SF-G11,SF-B22,2,1,0,0,2,1,0.0,1.0,0.0,1.0
SF-G11,SF-J17,5,1,2,0,3,1,0.4,0.6,0.0,1.0
SF-G11,SF-I19,1,2,0,0,1,2,0.0,1.0,0.0,1.0
SF-G11,SF-I20,2,1,0,1,2,0,0.0,1.0,1.0,0.0
SF-G11,SF-H16,11,9,3,3,8,6,0.2727272727272727,0.7272727272727273,0.3333333333333333,0.6666666666666666
SF-G11,SF-G19,2,2,1,2,1,0,0.5,0.5,1.0,0.0
SF-G11,SF-G17,2,4,1,2,1,2,0.5,0.5,0.5,0.5
SF-G11,SF-G18,9,3,1,0,8,3,0.1111111111111111,0.8888888888888888,0.0,1.0
SF-G11,SF-G20,4,3,2,0,2,3,0.5,0.5,0.0,1.0
SF-G11,SF-E18,4,3,1,0,3,3,0.25,0.75,0.0,1.0
SF-G11,SF-E20,4,6,3,3,1,3,0.75,0.25,0.5,0.5
SF-G11,SF-G30-2,1,2,0,0,1,2,0.0,1.0,0.0,1.0
SF-G11,SF-E29-2,1,1,0,0,1,1,0.0,1.0,0.0,1.0
SF-G11,SF-D29,4,7,0,0,4,7,0.0,1.0,0.0,1.0
SF-G11,SF-D28,1,1,0,0,1,1,0.0,1.0,0.0,1.0
SF-G11,SF-J10,17,21,7,16,10,5,0.4117647058823529,0.5882352941176471,0.7619047619047619,0.23809523809523808
SF-G11,SF-J12,47,56,25,32,22,24,0.5319148936170213,0.46808510638297873,0.5714285714285714,0.42857142857142855
SF-G11,SF-J13,35,20,31,14,4,6,0.8857142857142857,0.11428571428571428,0.7,0.3
SF-G11,SF-J15,1,1,0,1,1,0,0.0,1.0,1.0,0.0
SF-G11,SF-J14,3,2,3,0,0,2,1.0,0.0,0.0,1.0
SF-G11,SF-H13,34,25,20,14,14,11,0.5882352941176471,0.4117647058823529,0.56,0.44
SF-G11,SF-H12,6,5,5,3,1,2,0.8333333333333334,0.16666666666666666,0.6,0.4
SF-G11,SF-G10-2,6,6,5,4,1,2,0.8333333333333334,0.16666666666666666,0.6666666666666666,0.3333333333333333
SF-G11,SF-H15,12,14,2,2,10,12,0.16666666666666666,0.8333333333333334,0.14285714285714285,0.8571428571428571
SF-G11,SF-G9,26,24,19,18,7,6,0.7307692307692307,0.2692307692307692,0.75,0.25
SF-G11,SF-H14,6,14,1,7,5,7,0.16666666666666666,0.8333333333333334,0.5,0.5
SF-G11,SF-G13,20,16,14,10,6,6,0.7,0.3,0.625,0.375
SF-G11,SF-G12,21,20,4,18,17,2,0.19047619047619047,0.8095238095238095,0.9,0.1
SF-G11,SF-G10-1,20,12,9,5,11,7,0.45,0.55,0.4166666666666667,0.5833333333333334
SF-G11,SF-F15,46,23,27,21,19,2,0.5869565217391305,0.41304347826086957,0.9130434782608695,0.08695652173913043
SF-G11,SF-F16,2,9,2,4,0,5,1.0,0.0,0.4444444444444444,0.5555555555555556
SF-G11,SF-C21,2,2,0,0,2,2,0.0,1.0,0.0,1.0
SF-G11,SF-B19,5,22,2,6,3,16,0.4,0.6,0.2727272727272727,0.7272727272727273
SF-G11,SF-C25,1,1,0,0,1,1,0.0,1.0,0.0,1.0
SF-G11,SF-J1,15,15,5,12,10,3,0.3333333333333333,0.6666666666666666,0.8,0.2
SF-G11,SF-H0,3,4,0,2,3,2,0.0,1.0,0.5,0.5
SF-G11,SF-J3,2,8,2,5,0,3,1.0,0.0,0.625,0.375
SF-G11,SF-J5,3,4,1,2,2,2,0.3333333333333333,0.6666666666666666,0.5,0.5
SF-G11,SF-G6,5,5,2,4,3,1,0.4,0.6,0.8,0.2
SF-G11,SF-G8,4,13,1,7,3,6,0.25,0.75,0.5384615384615384,0.46153846153846156
SF-G11,SF-G5,18,12,9,5,9,7,0.5,0.5,0.4166666666666667,0.5833333333333334
SF-G11,SF-G7,42,35,16,22,26,13,0.38095238095238093,0.6190476190476191,0.6285714285714286,0.37142857142857144
SF-G11,SF-F9,18,8,15,3,3,5,0.8333333333333334,0.16666666666666666,0.375,0.625
SF-G11,SF-G26,1,3,0,0,1,3,0.0,1.0,0.0,1.0
SF-G11,SF-K21,19,12,2,1,17,11,0.10526315789473684,0.8947368421052632,0.08333333333333333,0.9166666666666666
SF-G11,SF-K22-1,2,2,0,1,2,1,0.0,1.0,0.5,0.5
SF-G11,SF-J23-1,3,3,1,2,2,1,0.3333333333333333,0.6666666666666666,0.6666666666666666,0.3333333333333333
SF-G11,SF-J22-1,2,3,0,0,2,3,0.0,1.0,0.0,1.0
SF-G11,SF-J21,1,3,0,1,1,2,0.0,1.0,0.3333333333333333,0.6666666666666666
SF-G11,SF-I21,2,2,0,0,2,2,0.0,1.0,0.0,1.0
SF-G11,SF-F26,2,5,0,0,2,5,0.0,1.0,0.0,1.0
SF-G11,SF-M13,37,42,28,35,9,7,0.7567567567567568,0.24324324324324326,0.8333333333333334,0.16666666666666666
SF-G11,SF-M15,2,7,0,0,2,7,0.0,1.0,0.0,1.0
SF-G11,SF-L19,3,4,1,1,2,3,0.3333333333333333,0.6666666666666666,0.25,0.75
SF-G11,SF-L20,2,10,0,0,2,10,0.0,1.0,0.0,1.0
SF-G11,SF-N20-1,1,2,0,0,1,2,0.0,1.0,0.0,1.0
SF-G11,SF-M20,9,9,1,1,8,8,0.1111111111111111,0.8888888888888888,0.1111111111111111,0.8888888888888888
SF-G11,SF-K17-2,6,6,5,3,1,3,0.8333333333333334,0.16666666666666666,0.5,0.5
SF-G11,SF-K20,12,13,5,1,7,12,0.4166666666666667,0.5833333333333334,0.07692307692307693,0.9230769230769231
SF-G11,SF-K15-,32,30,11,9,21,21,0.34375,0.65625,0.3,0.7
SF-G11,SF-K19,11,15,7,4,4,11,0.6363636363636364,0.36363636363636365,0.26666666666666666,0.7333333333333333
SF-G11,SF-K18,13,14,7,4,6,10,0.5384615384615384,0.46153846153846156,0.2857142857142857,0.7142857142857143
SF-G11,SF-K17,20,23,6,3,14,20,0.3,0.7,0.13043478260869565,0.8695652173913043
SF-G11,SF-J16,6,6,1,0,5,6,0.16666666666666666,0.8333333333333334,0.0,1.0
SF-G11,SF-J18,16,17,10,9,6,8,0.625,0.375,0.5294117647058824,0.47058823529411764
SF-G11,SF-J20,1,1,0,1,1,0,0.0,1.0,1.0,0.0
SF-G11,SF-J19,4,9,1,2,3,7,0.25,0.75,0.2222222222222222,0.7777777777777778
SF-G11,SF-O12,3,1,2,0,1,1,0.6666666666666666,0.3333333333333333,0.0,1.0
SF-G11,SF-M12,10,9,6,4,4,5,0.6,0.4,0.4444444444444444,0.5555555555555556
SF-G11,SF-M10,6,6,1,2,5,4,0.16666666666666666,0.8333333333333334,0.3333333333333333,0.6666666666666666
SF-G11,SF-M11,20,10,12,9,8,1,0.6,0.4,0.9,0.1
SF-G11,SF-R19,1,1,0,0,1,1,0.0,1.0,0.0,1.0
SF-G11,SF-Q21-1,4,2,1,1,3,1,0.25,0.75,0.5,0.5
SF-G11,SF-O18,14,5,3,0,11,5,0.21428571428571427,0.7857142857142857,0.0,1.0
SF-G11,SF-O19,1,3,1,3,0,0,1.0,0.0,1.0,0.0
SF-G11,SF-O21,1,2,0,0,1,2,0.0,1.0,0.0,1.0
SF-G11,SF-O22,2,2,0,0,2,2,0.0,1.0,0.0,1.0
SF-G11,SF-N20-2,3,1,2,0,1,1,0.6666666666666666,0.3333333333333333,0.0,1.0
SF-G11,SF-M21,3,1,0,0,3,1,0.0,1.0,0.0,1.0
SF-G11,SF-L21,5,3,0,0,5,3,0.0,1.0,0.0,1.0
SF-G11,SF-I27,1,1,0,0,1,1,0.0,1.0,0.0,1.0
SF-G11,SF-I28,1,3,0,0,1,3,0.0,1.0,0.0,1.0
SF-G11,SF-T22,2,1,0,0,2,1,0.0,1.0,0.0,1.0
SF-G11,SF-Q22-1,14,16,0,2,14,14,0.0,1.0,0.125,0.875
SF-G11,SF-P22,6,1,2,1,4,0,0.3333333333333333,0.6666666666666666,1.0,0.0
SF-G12,SF-M25,2,5,0,0,2,5,0.0,1.0,0.0,1.0
SF-G12,SF-K26,1,1,0,0,1,1,0.0,1.0,0.0,1.0
SF-G12,SF-M30,3,6,0,0,3,6,0.0,1.0,0.0,1.0
SF-G12,SF-L25,1,2,0,0,1,2,0.0,1.0,0.0,1.0
SF-G12,SF-M24,2,5,0,1,2,4,0.0,1.0,0.2,0.8
SF-G12,SF-J26-2,1,2,0,2,1,0,0.0,1.0,1.0,0.0
SF-G12,SF-J25,1,3,0,0,1,3,0.0,1.0,0.0,1.0
SF-G12,SF-H26-2,4,2,0,0,4,2,0.0,1.0,0.0,1.0
SF-G12,SF-J26,4,1,0,0,4,1,0.0,1.0,0.0,1.0
SF-G12,SF-H26,1,8,0,0,1,8,0.0,1.0,0.0,1.0
SF-G12,SF-F28-2,3,6,0,1,3,5,0.0,1.0,0.16666666666666666,0.8333333333333334
SF-G12,SF-G27,1,7,0,4,1,3,0.0,1.0,0.5714285714285714,0.42857142857142855
SF-G12,SF-M22-2,9,14,0,1,9,13,0.0,1.0,0.07142857142857142,0.9285714285714286
SF-G12,SF-L22,13,11,0,0,13,11,0.0,1.0,0.0,1.0
SF-G12,SF-F27,1,1,0,0,1,1,0.0,1.0,0.0,1.0
SF-G12,SF-N22-2,10,5,0,0,10,5,0.0,1.0,0.0,1.0
SF-G12,SF-G28-2,1,2,0,0,1,2,0.0,1.0,0.0,1.0
SF-G12,SF-K24,2,2,0,1,2,1,0.0,1.0,0.5,0.5
SF-G12,SF-J23-2,3,1,0,0,3,1,0.0,1.0,0.0,1.0
SF-G12,SF-G24,10,5,2,0,8,5,0.2,0.8,0.0,1.0
SF-G12,SF-G25,8,11,0,1,8,10,0.0,1.0,0.09090909090909091,0.9090909090909091
SF-G12,SF-F23,8,5,0,0,8,5,0.0,1.0,0.0,1.0
SF-G12,SF-E23,11,14,1,2,10,12,0.09090909090909091,0.9090909090909091,0.14285714285714285,0.8571428571428571
SF-G12,SF-C22,4,3,0,0,4,3,0.0,1.0,0.0,1.0
SF-G12,SF-B22,3,5,0,0,3,5,0.0,1.0,0.0,1.0
SF-G12,SF-J17,12,13,1,3,11,10,0.08333333333333333,0.9166666666666666,0.23076923076923078,0.7692307692307693
SF-G12,SF-I19,2,5,0,2,2,3,0.0,1.0,0.4,0.6
SF-G12,SF-H16,19,28,6,4,13,24,0.3157894736842105,0.6842105263157895,0.14285714285714285,0.8571428571428571
SF-G12,SF-H19,4,2,1,0,3,2,0.25,0.75,0.0,1.0
SF-G12,SF-H20,2,1,0,1,2,0,0.0,1.0,1.0,0.0
SF-G12,SF-H18,3,14,0,0,3,14,0.0,1.0,0.0,1.0
SF-G12,SF-H17,5,4,0,0,5,4,0.0,1.0,0.0,1.0
SF-G12,SF-G19,13,15,8,5,5,10,0.6153846153846154,0.38461538461538464,0.3333333333333333,0.6666666666666666
SF-G12,SF-G17,13,5,8,3,5,2,0.6153846153846154,0.38461538461538464,0.6,0.4
SF-G12,SF-G18,5,9,2,2,3,7,0.4,0.6,0.2222222222222222,0.7777777777777778
SF-G12,SF-G20,13,9,3,3,10,6,0.23076923076923078,0.7692307692307693,0.3333333333333333,0.6666666666666666
SF-G12,SF-F19,30,22,4,4,26,18,0.13333333333333333,0.8666666666666667,0.18181818181818182,0.8181818181818182
SF-G12,SF-E18,19,15,6,3,13,12,0.3157894736842105,0.6842105263157895,0.2,0.8
SF-G12,SF-E20,10,10,5,1,5,9,0.5,0.5,0.1,0.9
SF-G12,SF-E29-2,3,2,0,0,3,2,0.0,1.0,0.0,1.0
SF-G12,SF-E29-1,3,2,0,0,3,2,0.0,1.0,0.0,1.0
SF-G12,SF-G29-2,1,2,0,0,1,2,0.0,1.0,0.0,1.0
SF-G12,SF-E28,3,1,0,1,3,0,0.0,1.0,1.0,0.0
SF-G12,SF-J10,48,33,38,25,10,8,0.7916666666666666,0.20833333333333334,0.7575757575757576,0.24242424242424243
SF-G12,SF-J12,117,120,71,73,46,47,0.6068376068376068,0.39316239316239315,0.6083333333333333,0.39166666666666666
SF-G12,SF-J13,50,42,22,15,28,27,0.44,0.56,0.35714285714285715,0.6428571428571429
SF-G12,SF-J15,7,3,2,1,5,2,0.2857142857142857,0.7142857142857143,0.3333333333333333,0.6666666666666666
SF-G12,SF-J14,5,3,2,1,3,2,0.4,0.6,0.3333333333333333,0.6666666666666666
SF-G12,SF-H13,15,22,10,13,5,9,0.6666666666666666,0.3333333333333333,0.5909090909090909,0.4090909090909091
SF-G12,SF-I16,14,16,5,6,9,10,0.35714285714285715,0.6428571428571429,0.375,0.625
SF-G12,SF-H12,9,20,7,15,2,5,0.7777777777777778,0.2222222222222222,0.75,0.25
SF-G12,SF-G10-2,11,19,7,11,4,8,0.6363636363636364,0.36363636363636365,0.5789473684210527,0.42105263157894735
SF-G12,SF-H15,9,7,5,4,4,3,0.5555555555555556,0.4444444444444444,0.5714285714285714,0.42857142857142855
SF-G12,SF-G9,18,17,13,9,5,8,0.7222222222222222,0.2777777777777778,0.5294117647058824,0.47058823529411764
SF-G12,SF-H14,15,10,6,2,9,8,0.4,0.6,0.2,0.8
SF-G12,SF-G13,32,25,21,13,11,12,0.65625,0.34375,0.52,0.48
SF-G12,SF-G11,20,21,18,4,2,17,0.9,0.1,0.19047619047619047,0.8095238095238095
SF-G12,SF-G10-1,24,21,19,11,5,10,0.7916666666666666,0.20833333333333334,0.5238095238095238,0.47619047619047616
SF-G12,SF-F15,19,20,10,12,9,8,0.5263157894736842,0.47368421052631576,0.6,0.4
SF-G12,SF-F16,17,15,9,3,8,12,0.5294117647058824,0.47058823529411764,0.2,0.8
SF-G12,SF-C21,1,6,0,0,1,6,0.0,1.0,0.0,1.0
SF-G12,SF-C20,9,14,0,2,9,12,0.0,1.0,0.14285714285714285,0.8571428571428571
SF-G12,SF-B21,8,2,2,1,6,1,0.25,0.75,0.5,0.5
SF-G12,SF-B19,7,19,1,4,6,15,0.14285714285714285,0.8571428571428571,0.21052631578947367,0.7894736842105263
SF-G12,SF-A20,5,22,2,5,3,17,0.4,0.6,0.22727272727272727,0.7727272727272727
SF-G12,SF-A19,1,5,0,0,1,5,0.0,1.0,0.0,1.0
SF-G12,SF-C26,2,5,0,0,2,5,0.0,1.0,0.0,1.0
SF-G12,SF-C25,7,12,0,0,7,12,0.0,1.0,0.0,1.0
SF-G12,SF-B25,4,3,1,0,3,3,0.25,0.75,0.0,1.0
SF-G12,SF-J1,18,29,4,17,14,12,0.2222222222222222,0.7777777777777778,0.5862068965517241,0.41379310344827586
SF-G12,SF-H0,5,7,4,7,1,0,0.8,0.2,1.0,0.0
SF-G12,SF-J3,25,20,16,4,9,16,0.64,0.36,0.2,0.8
SF-G12,SF-J5,22,18,4,1,18,17,0.18181818181818182,0.8181818181818182,0.05555555555555555,0.9444444444444444
SF-G12,SF-G6,10,12,2,4,8,8,0.2,0.8,0.3333333333333333,0.6666666666666666
SF-G12,SF-G8,17,17,10,6,7,11,0.5882352941176471,0.4117647058823529,0.35294117647058826,0.6470588235294118
SF-G12,SF-G5,41,48,15,12,26,36,0.36585365853658536,0.6341463414634146,0.25,0.75
SF-G12,SF-G7,82,60,32,34,50,26,0.3902439024390244,0.6097560975609756,0.5666666666666667,0.43333333333333335
SF-G12,SF-F9,39,34,22,18,17,16,0.5641025641025641,0.4358974358974359,0.5294117647058824,0.47058823529411764
SF-G12,SF-K21,6,12,1,0,5,12,0.16666666666666666,0.8333333333333334,0.0,1.0
SF-G12,SF-J23-1,1,2,0,2,1,0,0.0,1.0,1.0,0.0
SF-G12,SF-J22-1,5,48,0,45,5,3,0.0,1.0,0.9375,0.0625
SF-G12,SF-J22-2,4,8,1,3,3,5,0.25,0.75,0.375,0.625
SF-G12,SF-J21,10,15,1,1,9,14,0.1,0.9,0.06666666666666667,0.9333333333333333
SF-G12,SF-I21,1,3,0,1,1,2,0.0,1.0,0.3333333333333333,0.6666666666666666
SF-G12,SF-I23-2,1,1,1,1,0,0,1.0,0.0,1.0,0.0
SF-G12,SF-I24,2,1,0,1,2,0,0.0,1.0,1.0,0.0
SF-G12,SF-I23-1,3,1,1,1,2,0,0.3333333333333333,0.6666666666666666,1.0,0.0
SF-G12,SF-F26,4,3,0,0,4,3,0.0,1.0,0.0,1.0
SF-G12,SF-M13,24,15,2,2,22,13,0.08333333333333333,0.9166666666666666,0.13333333333333333,0.8666666666666667
SF-G12,SF-M15,32,13,8,5,24,8,0.25,0.75,0.38461538461538464,0.6153846153846154
SF-G12,SF-L19,10,11,2,1,8,10,0.2,0.8,0.09090909090909091,0.9090909090909091
SF-G12,SF-L20,27,36,0,4,27,32,0.0,1.0,0.1111111111111111,0.8888888888888888
SF-G12,SF-N20-1,2,2,0,0,2,2,0.0,1.0,0.0,1.0
SF-G12,SF-M20,5,13,0,3,5,10,0.0,1.0,0.23076923076923078,0.7692307692307693
SF-G12,SF-K17-2,8,25,1,8,7,17,0.125,0.875,0.32,0.68
SF-G12,SF-K20,22,18,3,1,19,17,0.13636363636363635,0.8636363636363636,0.05555555555555555,0.9444444444444444
SF-G12,SF-K15-,84,76,19,7,65,69,0.2261904761904762,0.7738095238095238,0.09210526315789473,0.9078947368421053
SF-G12,SF-K19,14,11,3,2,11,9,0.21428571428571427,0.7857142857142857,0.18181818181818182,0.8181818181818182
SF-G12,SF-K18,24,28,9,9,15,19,0.375,0.625,0.32142857142857145,0.6785714285714286
SF-G12,SF-K17,25,25,11,11,14,14,0.44,0.56,0.44,0.56
SF-G12,SF-J16,8,6,4,0,4,6,0.5,0.5,0.0,1.0
SF-G12,SF-J18,29,35,4,8,25,27,0.13793103448275862,0.8620689655172413,0.22857142857142856,0.7714285714285715
SF-G12,SF-J20,5,2,1,1,4,1,0.2,0.8,0.5,0.5
SF-G12,SF-J19,4,6,2,1,2,5,0.5,0.5,0.16666666666666666,0.8333333333333334
SF-G12,SF-M12,34,22,2,4,32,18,0.058823529411764705,0.9411764705882353,0.18181818181818182,0.8181818181818182
SF-G12,SF-M10,25,14,14,3,11,11,0.56,0.44,0.21428571428571427,0.7857142857142857
SF-G12,SF-M11,37,29,22,12,15,17,0.5945945945945946,0.40540540540540543,0.41379310344827586,0.5862068965517241
SF-G12,SF-P21,8,8,2,0,6,8,0.25,0.75,0.0,1.0
SF-G12,SF-O18,4,4,0,0,4,4,0.0,1.0,0.0,1.0
SF-G12,SF-O19,6,5,0,2,6,3,0.0,1.0,0.4,0.6
SF-G12,SF-O21,6,6,2,4,4,2,0.3333333333333333,0.6666666666666666,0.6666666666666666,0.3333333333333333
SF-G12,SF-O22,2,10,0,0,2,10,0.0,1.0,0.0,1.0
SF-G12,SF-N21,4,3,3,0,1,3,0.75,0.25,0.0,1.0
SF-G12,SF-N20-2,1,3,0,0,1,3,0.0,1.0,0.0,1.0
SF-G12,SF-M21,6,7,0,2,6,5,0.0,1.0,0.2857142857142857,0.7142857142857143
SF-G12,SF-L21,19,10,1,3,18,7,0.05263157894736842,0.9473684210526315,0.3,0.7
SF-G12,SF-P30,1,2,0,0,1,2,0.0,1.0,0.0,1.0
SF-G12,SF-L29,1,2,0,0,1,2,0.0,1.0,0.0,1.0
SF-G12,SF-I28,1,1,0,0,1,1,0.0,1.0,0.0,1.0
SF-G12,SF-I30-2,1,2,0,1,1,1,0.0,1.0,0.5,0.5
SF-G12,SF-H29,1,2,1,0,0,2,1.0,0.0,0.0,1.0
SF-G12,SF-R24,4,4,2,3,2,1,0.5,0.5,0.75,0.25
SF-G12,SF-N22-1B,1,1,0,0,1,1,0.0,1.0,0.0,1.0
SF-G12,SF-T21,1,1,1,1,0,0,1.0,0.0,1.0,0.0
SF-G12,SF-S22-2,1,1,1,0,0,1,1.0,0.0,0.0,1.0
SF-G12,SF-Q23-3,3,3,0,1,3,2,0.0,1.0,0.3333333333333333,0.6666666666666666
SF-G12,SF-Q22-1,6,11,0,0,6,11,0.0,1.0,0.0,1.0
SF-G12,SF-Q22-2,4,6,0,2,4,4,0.0,1.0,0.3333333333333333,0.6666666666666666
SF-G12,SF-P22,5,2,0,1,5,1,0.0,1.0,0.5,0.5
SF-G12,SF-T20,3,1,0,0,3,1,0.0,1.0,0.0,1.0
SF-G12,SF-S21,1,2,0,0,1,2,0.0,1.0,0.0,1.0
SF-G10-1,SF-K26,1,2,0,1,1,1,0.0,1.0,0.5,0.5
SF-G10-1,SF-M28,1,1,0,0,1,1,0.0,1.0,0.0,1.0
SF-G10-1,SF-M24,3,1,0,0,3,1,0.0,1.0,0.0,1.0
SF-G10-1,SF-K23,1,1,0,0,1,1,0.0,1.0,0.0,1.0
SF-G10-1,SF-O23,1,2,1,0,0,2,1.0,0.0,0.0,1.0
SF-G10-1,SF-G27,2,2,2,0,0,2,1.0,0.0,0.0,1.0
SF-G10-1,SF-M22-2,6,1,0,0,6,1,0.0,1.0,0.0,1.0
SF-G10-1,SF-L22,1,10,0,0,1,10,0.0,1.0,0.0,1.0
SF-G10-1,SF-G28-1,1,1,0,0,1,1,0.0,1.0,0.0,1.0
SF-G10-1,SF-M22-1,1,1,0,0,1,1,0.0,1.0,0.0,1.0
SF-G10-1,SF-K24,1,5,0,0,1,5,0.0,1.0,0.0,1.0
SF-G10-1,SF-G24,6,4,1,0,5,4,0.16666666666666666,0.8333333333333334,0.0,1.0
SF-G10-1,SF-G25,6,1,0,0,6,1,0.0,1.0,0.0,1.0
SF-G10-1,SF-F23,4,1,0,1,4,0,0.0,1.0,1.0,0.0
SF-G10-1,SF-D24,1,1,0,0,1,1,0.0,1.0,0.0,1.0
SF-G10-1,SF-B22,6,2,3,0,3,2,0.5,0.5,0.0,1.0
SF-G10-1,SF-J17,2,4,1,2,1,2,0.5,0.5,0.5,0.5
SF-G10-1,SF-H16,8,3,2,1,6,2,0.25,0.75,0.3333333333333333,0.6666666666666666
SF-G10-1,SF-H18,2,2,0,0,2,2,0.0,1.0,0.0,1.0
SF-G10-1,SF-H17,1,4,0,0,1,4,0.0,1.0,0.0,1.0
SF-G10-1,SF-G19,1,2,0,0,1,2,0.0,1.0,0.0,1.0
SF-G10-1,SF-G18,2,3,0,1,2,2,0.0,1.0,0.3333333333333333,0.6666666666666666
SF-G10-1,SF-G20,2,2,0,0,2,2,0.0,1.0,0.0,1.0
SF-G10-1,SF-F19,7,16,1,3,6,13,0.14285714285714285,0.8571428571428571,0.1875,0.8125
SF-G10-1,SF-E18,3,4,1,1,2,3,0.3333333333333333,0.6666666666666666,0.25,0.75
SF-G10-1,SF-E20,1,7,0,1,1,6,0.0,1.0,0.14285714285714285,0.8571428571428571
SF-G10-1,SF-G30-2,11,11,0,0,11,11,0.0,1.0,0.0,1.0
SF-G10-1,SF-D29,6,7,2,0,4,7,0.3333333333333333,0.6666666666666666,0.0,1.0
SF-G10-1,SF-J10,23,20,15,14,8,6,0.6521739130434783,0.34782608695652173,0.7,0.3
SF-G10-1,SF-J12,25,21,15,5,10,16,0.6,0.4,0.23809523809523808,0.7619047619047619
SF-G10-1,SF-J13,33,24,16,8,17,16,0.48484848484848486,0.5151515151515151,0.3333333333333333,0.6666666666666666
SF-G10-1,SF-J14,2,3,1,0,1,3,0.5,0.5,0.0,1.0
SF-G10-1,SF-H13,12,7,6,4,6,3,0.5,0.5,0.5714285714285714,0.42857142857142855
SF-G10-1,SF-I16,4,3,2,0,2,3,0.5,0.5,0.0,1.0
SF-G10-1,SF-H12,4,5,0,1,4,4,0.0,1.0,0.2,0.8
SF-G10-1,SF-G10-2,27,38,10,27,17,11,0.37037037037037035,0.6296296296296297,0.7105263157894737,0.2894736842105263
SF-G10-1,SF-H15,3,1,2,0,1,1,0.6666666666666666,0.3333333333333333,0.0,1.0
SF-G10-1,SF-G9,11,14,5,3,6,11,0.45454545454545453,0.5454545454545454,0.21428571428571427,0.7857142857142857
SF-G10-1,SF-H14,5,2,2,1,3,1,0.4,0.6,0.5,0.5
SF-G10-1,SF-G13,9,16,7,9,2,7,0.7777777777777778,0.2222222222222222,0.5625,0.4375
SF-G10-1,SF-G11,12,20,5,9,7,11,0.4166666666666667,0.5833333333333334,0.45,0.55
SF-G10-1,SF-G12,21,24,11,19,10,5,0.5238095238095238,0.47619047619047616,0.7916666666666666,0.20833333333333334
SF-G10-1,SF-F15,17,19,6,10,11,9,0.35294117647058826,0.6470588235294118,0.5263157894736842,0.47368421052631576
SF-G10-1,SF-F16,12,4,4,1,8,3,0.3333333333333333,0.6666666666666666,0.25,0.75
SF-G10-1,SF-C20,6,3,3,0,3,3,0.5,0.5,0.0,1.0
SF-G10-1,SF-B19,13,11,2,4,11,7,0.15384615384615385,0.8461538461538461,0.36363636363636365,0.6363636363636364
SF-G10-1,SF-A20,3,2,0,0,3,2,0.0,1.0,0.0,1.0
SF-G10-1,SF-A19,2,1,0,0,2,1,0.0,1.0,0.0,1.0
SF-G10-1,SF-C26,2,1,0,0,2,1,0.0,1.0,0.0,1.0
SF-G10-1,SF-C25,4,5,1,1,3,4,0.25,0.75,0.2,0.8
SF-G10-1,SF-B25,2,1,0,1,2,0,0.0,1.0,1.0,0.0
SF-G10-1,SF-E27,3,3,0,0,3,3,0.0,1.0,0.0,1.0
SF-G10-1,SF-B28,1,2,0,0,1,2,0.0,1.0,0.0,1.0
SF-G10-1,SF-J1,9,21,1,9,8,12,0.1111111111111111,0.8888888888888888,0.42857142857142855,0.5714285714285714
SF-G10-1,SF-H0,6,9,1,4,5,5,0.16666666666666666,0.8333333333333334,0.4444444444444444,0.5555555555555556
SF-G10-1,SF-J3,13,2,7,2,6,0,0.5384615384615384,0.46153846153846156,1.0,0.0
SF-G10-1,SF-J5,3,8,2,5,1,3,0.6666666666666666,0.3333333333333333,0.625,0.375
SF-G10-1,SF-G6,5,15,4,5,1,10,0.8,0.2,0.3333333333333333,0.6666666666666666
SF-G10-1,SF-G8,8,10,5,6,3,4,0.625,0.375,0.6,0.4
SF-G10-1,SF-G5,18,33,11,15,7,18,0.6111111111111112,0.3888888888888889,0.45454545454545453,0.5454545454545454
SF-G10-1,SF-G7,48,37,17,24,31,13,0.3541666666666667,0.6458333333333334,0.6486486486486487,0.35135135135135137
SF-G10-1,SF-F9,20,8,12,5,8,3,0.6,0.4,0.625,0.375
SF-G10-1,SF-K21,1,2,1,0,0,2,1.0,0.0,0.0,1.0
SF-G10-1,SF-K22-1,5,4,0,0,5,4,0.0,1.0,0.0,1.0
SF-G10-1,SF-J23-1,2,5,0,0,2,5,0.0,1.0,0.0,1.0
SF-G10-1,SF-J22-1,1,2,0,0,1,2,0.0,1.0,0.0,1.0
SF-G10-1,SF-J21,3,3,0,0,3,3,0.0,1.0,0.0,1.0
SF-G10-1,SF-F26,3,5,0,1,3,4,0.0,1.0,0.2,0.8
SF-G10-1,SF-M13,7,11,1,4,6,7,0.14285714285714285,0.8571428571428571,0.36363636363636365,0.6363636363636364
SF-G10-1,SF-M15,2,4,0,2,2,2,0.0,1.0,0.5,0.5
SF-G10-1,SF-L19,2,2,0,0,2,2,0.0,1.0,0.0,1.0
SF-G10-1,SF-L20,1,1,0,0,1,1,0.0,1.0,0.0,1.0
SF-G10-1,SF-M20,6,5,0,0,6,5,0.0,1.0,0.0,1.0
SF-G10-1,SF-K17-2,4,2,0,2,4,0,0.0,1.0,1.0,0.0
SF-G10-1,SF-K20,2,3,0,0,2,3,0.0,1.0,0.0,1.0
SF-G10-1,SF-K15-,10,13,3,2,7,11,0.3,0.7,0.15384615384615385,0.8461538461538461
SF-G10-1,SF-K19,2,1,0,0,2,1,0.0,1.0,0.0,1.0
SF-G10-1,SF-K18,7,4,3,1,4,3,0.42857142857142855,0.5714285714285714,0.25,0.75
SF-G10-1,SF-K17,7,4,3,2,4,2,0.42857142857142855,0.5714285714285714,0.5,0.5
SF-G10-1,SF-J16,4,2,0,0,4,2,0.0,1.0,0.0,1.0
SF-G10-1,SF-J18,6,7,0,2,6,5,0.0,1.0,0.2857142857142857,0.7142857142857143
SF-G10-1,SF-J20,2,1,1,0,1,1,0.5,0.5,0.0,1.0
SF-G10-1,SF-O12,10,1,8,0,2,1,0.8,0.2,0.0,1.0
SF-G10-1,SF-M12,48,7,31,3,17,4,0.6458333333333334,0.3541666666666667,0.42857142857142855,0.5714285714285714
SF-G10-1,SF-M11,29,28,18,16,11,12,0.6206896551724138,0.3793103448275862,0.5714285714285714,0.42857142857142855
SF-G10-1,SF-R19,1,1,0,0,1,1,0.0,1.0,0.0,1.0
SF-G10-1,SF-O19,4,2,2,0,2,2,0.5,0.5,0.0,1.0
SF-G10-1,SF-O21,6,5,0,0,6,5,0.0,1.0,0.0,1.0
SF-G10-1,SF-O22,5,1,1,0,4,1,0.2,0.8,0.0,1.0
SF-G10-1,SF-N21,1,1,0,0,1,1,0.0,1.0,0.0,1.0
SF-G10-1,SF-N20-2,2,1,0,0,2,1,0.0,1.0,0.0,1.0
SF-G10-1,SF-L21,4,3,0,0,4,3,0.0,1.0,0.0,1.0
SF-G10-1,SF-N22-1B,1,1,1,0,0,1,1.0,0.0,0.0,1.0
SF-G10-1,SF-Q23-3,1,3,0,0,1,3,0.0,1.0,0.0,1.0
SF-F15,SF-L27,1,1,0,0,1,1,0.0,1.0,0.0,1.0
SF-F15,SF-J27,2,1,0,0,2,1,0.0,1.0,0.0,1.0
SF-F15,SF-M28,1,2,1,1,0,1,1.0,0.0,0.5,0.5
SF-F15,SF-L24,3,3,0,0,3,3,0.0,1.0,0.0,1.0
SF-F15,SF-J26-2,7,9,0,8,7,1,0.0,1.0,0.8888888888888888,0.1111111111111111
SF-F15,SF-K28,1,1,0,1,1,0,0.0,1.0,1.0,0.0
SF-F15,SF-K29-1,6,1,0,0,6,1,0.0,1.0,0.0,1.0
SF-F15,SF-J25,2,1,2,0,0,1,1.0,0.0,0.0,1.0
SF-F15,SF-P24,1,1,0,0,1,1,0.0,1.0,0.0,1.0
SF-F15,SF-J24,2,1,1,1,1,0,0.5,0.5,1.0,0.0
SF-F15,SF-O24,2,1,0,0,2,1,0.0,1.0,0.0,1.0
SF-F15,SF-I25,5,9,3,1,2,8,0.6,0.4,0.1111111111111111,0.8888888888888888
SF-F15,SF-H26,4,2,3,1,1,1,0.75,0.25,0.5,0.5
SF-F15,SF-O23,1,5,0,0,1,5,0.0,1.0,0.0,1.0
SF-F15,SF-F28-2,2,2,0,0,2,2,0.0,1.0,0.0,1.0
SF-F15,SF-G27,1,4,0,1,1,3,0.0,1.0,0.25,0.75
SF-F15,SF-F27,4,4,0,0,4,4,0.0,1.0,0.0,1.0
SF-F15,SF-N22-2,2,11,0,2,2,9,0.0,1.0,0.18181818181818182,0.8181818181818182
SF-F15,SF-M22-1,6,5,0,0,6,5,0.0,1.0,0.0,1.0
SF-F15,SF-K24,2,1,0,0,2,1,0.0,1.0,0.0,1.0
SF-F15,SF-G24,3,3,0,0,3,3,0.0,1.0,0.0,1.0
SF-F15,SF-G25,10,3,1,0,9,3,0.1,0.9,0.0,1.0
SF-F15,SF-F23,2,1,0,0,2,1,0.0,1.0,0.0,1.0
SF-F15,SF-E23,21,15,7,3,14,12,0.3333333333333333,0.6666666666666666,0.2,0.8
SF-F15,SF-D24,30,20,3,1,27,19,0.1,0.9,0.05,0.95
SF-F15,SF-C22,6,8,0,3,6,5,0.0,1.0,0.375,0.625
SF-F15,SF-B22,10,5,3,2,7,3,0.3,0.7,0.4,0.6
SF-F15,SF-J17,20,5,1,0,19,5,0.05,0.95,0.0,1.0
SF-F15,SF-I19,3,9,0,6,3,3,0.0,1.0,0.6666666666666666,0.3333333333333333
SF-F15,SF-I20,2,2,0,0,2,2,0.0,1.0,0.0,1.0
SF-F15,SF-H16,19,26,5,10,14,16,0.2631578947368421,0.7368421052631579,0.38461538461538464,0.6153846153846154
SF-F15,SF-H19,5,1,2,0,3,1,0.4,0.6,0.0,1.0
SF-F15,SF-H18,3,2,1,1,2,1,0.3333333333333333,0.6666666666666666,0.5,0.5
SF-F15,SF-H17,2,2,0,1,2,1,0.0,1.0,0.5,0.5
SF-F15,SF-G19,4,7,0,6,4,1,0.0,1.0,0.8571428571428571,0.14285714285714285
SF-F15,SF-G17,4,3,3,1,1,2,0.75,0.25,0.3333333333333333,0.6666666666666666
SF-F15,SF-G18,21,16,3,13,18,3,0.14285714285714285,0.8571428571428571,0.8125,0.1875
SF-F15,SF-G20,3,6,1,5,2,1,0.3333333333333333,0.6666666666666666,0.8333333333333334,0.16666666666666666
SF-F15,SF-F19,32,30,7,22,25,8,0.21875,0.78125,0.7333333333333333,0.26666666666666666
SF-F15,SF-E18,21,14,4,7,17,7,0.19047619047619047,0.8095238095238095,0.5,0.5
SF-F15,SF-E20,30,41,9,7,21,34,0.3,0.7,0.17073170731707318,0.8292682926829268
SF-F15,SF-G30-2,2,1,0,0,2,1,0.0,1.0,0.0,1.0
SF-F15,SF-E29-1,2,1,0,0,2,1,0.0,1.0,0.0,1.0
SF-F15,SF-D29,1,5,0,0,1,5,0.0,1.0,0.0,1.0
SF-F15,SF-D28,1,1,0,1,1,0,0.0,1.0,1.0,0.0
SF-F15,SF-G30-1,3,2,1,0,2,2,0.3333333333333333,0.6666666666666666,0.0,1.0
SF-F15,SF-F30-2,1,2,1,0,0,2,1.0,0.0,0.0,1.0
SF-F15,SF-E29-3,1,1,0,0,1,1,0.0,1.0,0.0,1.0
SF-F15,SF-F28-1,2,2,2,0,0,2,1.0,0.0,0.0,1.0
SF-F15,SF-E28,2,2,0,2,2,0,0.0,1.0,1.0,0.0
SF-F15,SF-J10,20,8,9,3,11,5,0.45,0.55,0.375,0.625
SF-F15,SF-J12,27,29,5,9,22,20,0.18518518518518517,0.8148148148148148,0.3103448275862069,0.6896551724137931
SF-F15,SF-J13,24,22,13,8,11,14,0.5416666666666666,0.4583333333333333,0.36363636363636365,0.6363636363636364
SF-F15,SF-J15,11,2,4,1,7,1,0.36363636363636365,0.6363636363636364,0.5,0.5
SF-F15,SF-J14,2,1,1,1,1,0,0.5,0.5,1.0,0.0
SF-F15,SF-H13,5,4,1,2,4,2,0.2,0.8,0.5,0.5
SF-F15,SF-I16,11,5,5,1,6,4,0.45454545454545453,0.5454545454545454,0.2,0.8
SF-F15,SF-H12,13,7,5,3,8,4,0.38461538461538464,0.6153846153846154,0.42857142857142855,0.5714285714285714
SF-F15,SF-G10-2,5,6,5,1,0,5,1.0,0.0,0.16666666666666666,0.8333333333333334
SF-F15,SF-H15,8,8,4,6,4,2,0.5,0.5,0.75,0.25
SF-F15,SF-G9,10,14,2,8,8,6,0.2,0.8,0.5714285714285714,0.42857142857142855
SF-F15,SF-H14,10,6,6,0,4,6,0.6,0.4,0.0,1.0
SF-F15,SF-G13,29,31,11,15,18,16,0.3793103448275862,0.6206896551724138,0.4838709677419355,0.5161290322580645
SF-F15,SF-G11,23,46,21,27,2,19,0.9130434782608695,0.08695652173913043,0.5869565217391305,0.41304347826086957
SF-F15,SF-G12,20,19,12,10,8,9,0.6,0.4,0.5263157894736842,0.47368421052631576
SF-F15,SF-G10-1,19,17,10,6,9,11,0.5263157894736842,0.47368421052631576,0.35294117647058826,0.6470588235294118
SF-F15,SF-F16,18,23,10,17,8,6,0.5555555555555556,0.4444444444444444,0.7391304347826086,0.2608695652173913
SF-F15,SF-C21,1,4,0,2,1,2,0.0,1.0,0.5,0.5
SF-F15,SF-C20,7,8,3,2,4,6,0.42857142857142855,0.5714285714285714,0.25,0.75
SF-F15,SF-B19,6,19,4,14,2,5,0.6666666666666666,0.3333333333333333,0.7368421052631579,0.2631578947368421
SF-F15,SF-A20,11,19,8,6,3,13,0.7272727272727273,0.2727272727272727,0.3157894736842105,0.6842105263157895
SF-F15,SF-A19,5,3,1,3,4,0,0.2,0.8,1.0,0.0
SF-F15,SF-C26,8,3,1,0,7,3,0.125,0.875,0.0,1.0
SF-F15,SF-C25,10,7,2,1,8,6,0.2,0.8,0.14285714285714285,0.8571428571428571
SF-F15,SF-B25,5,6,0,0,5,6,0.0,1.0,0.0,1.0
SF-F15,SF-B28-2,1,3,0,1,1,2,0.0,1.0,0.3333333333333333,0.6666666666666666
SF-F15,SF-J1,13,12,6,4,7,8,0.46153846153846156,0.5384615384615384,0.3333333333333333,0.6666666666666666
SF-F15,SF-J3,5,4,2,0,3,4,0.4,0.6,0.0,1.0
SF-F15,SF-G6,6,7,3,3,3,4,0.5,0.5,0.42857142857142855,0.5714285714285714
SF-F15,SF-G8,8,8,5,3,3,5,0.625,0.375,0.375,0.625
SF-F15,SF-G5,37,27,9,11,28,16,0.24324324324324326,0.7567567567567568,0.4074074074074074,0.5925925925925926
SF-F15,SF-G7,18,34,9,17,9,17,0.5,0.5,0.5,0.5
SF-F15,SF-F9,15,27,5,15,10,12,0.3333333333333333,0.6666666666666666,0.5555555555555556,0.4444444444444444
SF-F15,SF-K21,1,1,0,0,1,1,0.0,1.0,0.0,1.0
SF-F15,SF-J23-1,23,49,0,5,23,44,0.0,1.0,0.10204081632653061,0.8979591836734694
SF-F15,SF-J22-1,2,1,1,0,1,1,0.5,0.5,0.0,1.0
SF-F15,SF-J22-2,3,3,1,1,2,2,0.3333333333333333,0.6666666666666666,0.3333333333333333,0.6666666666666666
SF-F15,SF-J21,5,4,1,3,4,1,0.2,0.8,0.75,0.25
SF-F15,SF-I21,3,5,0,0,3,5,0.0,1.0,0.0,1.0
SF-F15,SF-I22,3,2,0,0,3,2,0.0,1.0,0.0,1.0
SF-F15,SF-I23-2,1,2,0,1,1,1,0.0,1.0,0.5,0.5
SF-F15,SF-I24,5,3,3,3,2,0,0.6,0.4,1.0,0.0
SF-F15,SF-F26,4,5,0,0,4,5,0.0,1.0,0.0,1.0
SF-F15,SF-M13,13,8,0,3,13,5,0.0,1.0,0.375,0.625
SF-F15,SF-M15,18,14,3,1,15,13,0.16666666666666666,0.8333333333333334,0.07142857142857142,0.9285714285714286
SF-F15,SF-L19,2,2,0,0,2,2,0.0,1.0,0.0,1.0
SF-F15,SF-L20,8,1,2,0,6,1,0.25,0.75,0.0,1.0
SF-F15,SF-N20-1,2,3,0,0,2,3,0.0,1.0,0.0,1.0
SF-F15,SF-M20,3,6,0,0,3,6,0.0,1.0,0.0,1.0
SF-F15,SF-K17-2,6,13,1,1,5,12,0.16666666666666666,0.8333333333333334,0.07692307692307693,0.9230769230769231
SF-F15,SF-K20,6,5,2,1,4,4,0.3333333333333333,0.6666666666666666,0.2,0.8
SF-F15,SF-K15-,23,18,4,11,19,7,0.17391304347826086,0.8260869565217391,0.6111111111111112,0.3888888888888889
SF-F15,SF-K19,3,7,1,2,2,5,0.3333333333333333,0.6666666666666666,0.2857142857142857,0.7142857142857143
SF-F15,SF-K18,11,8,0,0,11,8,0.0,1.0,0.0,1.0
SF-F15,SF-K17,6,5,0,0,6,5,0.0,1.0,0.0,1.0
SF-F15,SF-J16,5,17,0,2,5,15,0.0,1.0,0.11764705882352941,0.8823529411764706
SF-F15,SF-J18,10,9,3,3,7,6,0.3,0.7,0.3333333333333333,0.6666666666666666
SF-F15,SF-J20,2,6,1,5,1,1,0.5,0.5,0.8333333333333334,0.16666666666666666
SF-F15,SF-J19,4,3,1,0,3,3,0.25,0.75,0.0,1.0
SF-F15,SF-M12,5,3,2,3,3,0,0.4,0.6,1.0,0.0
SF-F15,SF-M10,2,8,0,5,2,3,0.0,1.0,0.625,0.375
SF-F15,SF-M11,10,7,3,4,7,3,0.3,0.7,0.5714285714285714,0.42857142857142855
SF-F15,SF-R19,1,2,0,0,1,2,0.0,1.0,0.0,1.0
SF-F15,SF-Q21-1,1,1,1,0,0,1,1.0,0.0,0.0,1.0
SF-F15,SF-P21,1,3,0,1,1,2,0.0,1.0,0.3333333333333333,0.6666666666666666
SF-F15,SF-O19,3,6,3,2,0,4,1.0,0.0,0.3333333333333333,0.6666666666666666
SF-F15,SF-O21,2,7,0,1,2,6,0.0,1.0,0.14285714285714285,0.8571428571428571
SF-F15,SF-O22,3,3,0,1,3,2,0.0,1.0,0.3333333333333333,0.6666666666666666
SF-F15,SF-N21,1,2,1,0,0,2,1.0,0.0,0.0,1.0
SF-F15,SF-M21,6,3,2,1,4,2,0.3333333333333333,0.6666666666666666,0.3333333333333333,0.6666666666666666
SF-F15,SF-L21,1,4,0,2,1,2,0.0,1.0,0.5,0.5
SF-F15,SF-P30,1,1,1,0,0,1,1.0,0.0,0.0,1.0
SF-F15,SF-L30-1,1,2,0,1,1,1,0.0,1.0,0.5,0.5
SF-F15,SF-L31-1,4,8,0,0,4,8,0.0,1.0,0.0,1.0
SF-F15,SF-K30-2,3,1,0,0,3,1,0.0,1.0,0.0,1.0
SF-F15,SF-L29,3,4,0,4,3,0,0.0,1.0,1.0,0.0
SF-F15,SF-S24,2,1,0,0,2,1,0.0,1.0,0.0,1.0
SF-F15,SF-R24,1,2,0,2,1,0,0.0,1.0,1.0,0.0
SF-F15,SF-T22,2,1,0,0,2,1,0.0,1.0,0.0,1.0
SF-F15,SF-S22-1,2,1,0,1,2,0,0.0,1.0,1.0,0.0
SF-F15,SF-Q22-2,3,4,2,2,1,2,0.6666666666666666,0.3333333333333333,0.5,0.5
SF-F15,SF-P22,2,1,2,1,0,0,1.0,0.0,1.0,0.0
SF-F16,SF-M25,19,27,3,18,16,9,0.15789473684210525,0.8421052631578947,0.6666666666666666,0.3333333333333333
SF-F16,SF-K26,1,4,0,4,1,0,0.0,1.0,1.0,0.0
SF-F16,SF-M30,6,4,0,0,6,4,0.0,1.0,0.0,1.0
SF-F16,SF-L25,1,1,0,0,1,1,0.0,1.0,0.0,1.0
SF-F16,SF-M24,1,1,1,0,0,1,1.0,0.0,0.0,1.0
SF-F16,SF-J26-2,1,1,0,1,1,0,0.0,1.0,1.0,0.0
SF-F16,SF-J25,1,3,0,1,1,2,0.0,1.0,0.3333333333333333,0.6666666666666666
SF-F16,SF-I25,3,4,0,0,3,4,0.0,1.0,0.0,1.0
SF-F16,SF-H26,7,2,5,1,2,1,0.7142857142857143,0.2857142857142857,0.5,0.5
SF-F16,SF-O23,2,2,0,0,2,2,0.0,1.0,0.0,1.0
SF-F16,SF-F28-2,1,3,0,2,1,1,0.0,1.0,0.6666666666666666,0.3333333333333333
SF-F16,SF-G27,1,3,1,2,0,1,1.0,0.0,0.6666666666666666,0.3333333333333333
SF-F16,SF-L22,1,2,0,1,1,1,0.0,1.0,0.5,0.5
SF-F16,SF-N22-2,4,9,1,2,3,7,0.25,0.75,0.2222222222222222,0.7777777777777778
SF-F16,SF-M22-1,1,2,0,0,1,2,0.0,1.0,0.0,1.0
SF-F16,SF-K22-2,2,2,1,1,1,1,0.5,0.5,0.5,0.5
SF-F16,SF-G24,4,9,0,2,4,7,0.0,1.0,0.2222222222222222,0.7777777777777778
SF-F16,SF-G25,7,7,1,0,6,7,0.14285714285714285,0.8571428571428571,0.0,1.0
SF-F16,SF-F23,5,5,1,2,4,3,0.2,0.8,0.4,0.6
SF-F16,SF-E23,25,26,2,2,23,24,0.08,0.92,0.07692307692307693,0.9230769230769231
SF-F16,SF-D24,3,5,1,0,2,5,0.3333333333333333,0.6666666666666666,0.0,1.0
SF-F16,SF-C22,18,15,2,1,16,14,0.1111111111111111,0.8888888888888888,0.06666666666666667,0.9333333333333333
SF-F16,SF-B22,4,8,1,4,3,4,0.25,0.75,0.5,0.5
SF-F16,SF-J17,8,7,3,1,5,6,0.375,0.625,0.14285714285714285,0.8571428571428571
SF-F16,SF-H16,11,16,4,8,7,8,0.36363636363636365,0.6363636363636364,0.5,0.5
SF-F16,SF-H20,8,4,1,4,7,0,0.125,0.875,1.0,0.0
SF-F16,SF-H18,1,3,0,2,1,1,0.0,1.0,0.6666666666666666,0.3333333333333333
SF-F16,SF-H17,1,3,0,2,1,1,0.0,1.0,0.6666666666666666,0.3333333333333333
SF-F16,SF-G19,5,11,2,7,3,4,0.4,0.6,0.6363636363636364,0.36363636363636365
SF-F16,SF-G17,8,4,3,1,5,3,0.375,0.625,0.25,0.75
SF-F16,SF-G18,12,27,2,20,10,7,0.16666666666666666,0.8333333333333334,0.7407407407407407,0.25925925925925924
SF-F16,SF-G20,10,18,1,12,9,6,0.1,0.9,0.6666666666666666,0.3333333333333333
SF-F16,SF-F19,23,21,10,12,13,9,0.43478260869565216,0.5652173913043478,0.5714285714285714,0.42857142857142855
SF-F16,SF-E18,9,15,4,8,5,7,0.4444444444444444,0.5555555555555556,0.5333333333333333,0.4666666666666667
SF-F16,SF-E20,13,22,3,4,10,18,0.23076923076923078,0.7692307692307693,0.18181818181818182,0.8181818181818182
SF-F16,SF-H30,3,2,0,0,3,2,0.0,1.0,0.0,1.0
SF-F16,SF-E29-2,1,1,0,0,1,1,0.0,1.0,0.0,1.0
SF-F16,SF-G29-2,1,3,0,0,1,3,0.0,1.0,0.0,1.0
SF-F16,SF-G29-1,2,2,1,1,1,1,0.5,0.5,0.5,0.5
SF-F16,SF-J12,24,19,1,6,23,13,0.041666666666666664,0.9583333333333334,0.3157894736842105,0.6842105263157895
SF-F16,SF-J13,18,9,2,1,16,8,0.1111111111111111,0.8888888888888888,0.1111111111111111,0.8888888888888888
SF-F16,SF-J15,4,4,2,0,2,4,0.5,0.5,0.0,1.0
SF-F16,SF-J14,1,1,0,0,1,1,0.0,1.0,0.0,1.0
SF-F16,SF-H13,10,2,2,1,8,1,0.2,0.8,0.5,0.5
SF-F16,SF-I16,12,14,5,1,7,13,0.4166666666666667,0.5833333333333334,0.07142857142857142,0.9285714285714286
SF-F16,SF-H12,24,15,2,7,22,8,0.08333333333333333,0.9166666666666666,0.4666666666666667,0.5333333333333333
SF-F16,SF-G10-2,5,4,2,1,3,3,0.4,0.6,0.25,0.75
SF-F16,SF-H15,6,10,3,7,3,3,0.5,0.5,0.7,0.3
SF-F16,SF-G9,8,7,1,2,7,5,0.125,0.875,0.2857142857142857,0.7142857142857143
SF-F16,SF-H14,4,8,1,2,3,6,0.25,0.75,0.25,0.75
SF-F16,SF-G13,13,20,5,12,8,8,0.38461538461538464,0.6153846153846154,0.6,0.4
SF-F16,SF-G11,9,2,4,2,5,0,0.4444444444444444,0.5555555555555556,1.0,0.0
SF-F16,SF-G12,15,17,3,9,12,8,0.2,0.8,0.5294117647058824,0.47058823529411764
SF-F16,SF-G10-1,4,12,1,4,3,8,0.25,0.75,0.3333333333333333,0.6666666666666666
SF-F16,SF-F15,23,18,17,10,6,8,0.7391304347826086,0.2608695652173913,0.5555555555555556,0.4444444444444444
SF-F16,SF-C21,3,6,0,0,3,6,0.0,1.0,0.0,1.0
SF-F16,SF-C20,3,14,1,8,2,6,0.3333333333333333,0.6666666666666666,0.5714285714285714,0.42857142857142855
SF-F16,SF-B19,6,19,0,5,6,14,0.0,1.0,0.2631578947368421,0.7368421052631579
SF-F16,SF-A20,4,10,0,3,4,7,0.0,1.0,0.3,0.7
SF-F16,SF-C26,3,2,0,0,3,2,0.0,1.0,0.0,1.0
SF-F16,SF-C25,7,10,3,1,4,9,0.42857142857142855,0.5714285714285714,0.1,0.9
SF-F16,SF-B25,3,11,0,1,3,10,0.0,1.0,0.09090909090909091,0.9090909090909091
SF-F16,SF-E27,1,1,0,0,1,1,0.0,1.0,0.0,1.0
SF-F16,SF-C28-2,1,3,0,2,1,1,0.0,1.0,0.6666666666666666,0.3333333333333333
SF-F16,SF-J1,2,4,0,4,2,0,0.0,1.0,1.0,0.0
SF-F16,SF-H0,5,8,2,5,3,3,0.4,0.6,0.625,0.375
SF-F16,SF-J3,3,4,0,1,3,3,0.0,1.0,0.25,0.75
SF-F16,SF-J5,3,2,1,1,2,1,0.3333333333333333,0.6666666666666666,0.5,0.5
SF-F16,SF-G6,1,2,0,1,1,1,0.0,1.0,0.5,0.5
SF-F16,SF-G5,10,21,2,8,8,13,0.2,0.8,0.38095238095238093,0.6190476190476191
SF-F16,SF-G7,14,10,8,5,6,5,0.5714285714285714,0.42857142857142855,0.5,0.5
SF-F16,SF-F9,8,14,4,7,4,7,0.5,0.5,0.5,0.5
SF-F16,SF-G26,2,2,0,0,2,2,0.0,1.0,0.0,1.0
SF-F16,SF-K21,18,13,0,2,18,11,0.0,1.0,0.15384615384615385,0.8461538461538461
SF-F16,SF-J23-1,8,17,2,1,6,16,0.25,0.75,0.058823529411764705,0.9411764705882353
SF-F16,SF-J22-1,3,5,0,1,3,4,0.0,1.0,0.2,0.8
SF-F16,SF-J21,7,6,0,3,7,3,0.0,1.0,0.5,0.5
SF-F16,SF-I21,3,5,3,2,0,3,1.0,0.0,0.4,0.6
SF-F16,SF-I23-2,3,9,0,2,3,7,0.0,1.0,0.2222222222222222,0.7777777777777778
SF-F16,SF-I23-1,1,1,0,0,1,1,0.0,1.0,0.0,1.0
SF-F16,SF-F26,8,4,0,0,8,4,0.0,1.0,0.0,1.0
SF-F16,SF-M13,7,11,1,1,6,10,0.14285714285714285,0.8571428571428571,0.09090909090909091,0.9090909090909091
SF-F16,SF-M15,9,10,1,3,8,7,0.1111111111111111,0.8888888888888888,0.3,0.7
SF-F16,SF-L19,2,4,0,1,2,3,0.0,1.0,0.25,0.75
SF-F16,SF-L20,3,2,1,0,2,2,0.3333333333333333,0.6666666666666666,0.0,1.0
SF-F16,SF-N20-1,3,1,0,0,3,1,0.0,1.0,0.0,1.0
SF-F16,SF-M20,8,4,5,2,3,2,0.625,0.375,0.5,0.5
SF-F16,SF-K17-2,2,8,0,0,2,8,0.0,1.0,0.0,1.0
SF-F16,SF-K20,10,6,0,1,10,5,0.0,1.0,0.16666666666666666,0.8333333333333334
SF-F16,SF-K15-,1,11,0,6,1,5,0.0,1.0,0.5454545454545454,0.45454545454545453
SF-F16,SF-K19,10,11,1,2,9,9,0.1,0.9,0.18181818181818182,0.8181818181818182
SF-F16,SF-K18,8,10,2,2,6,8,0.25,0.75,0.2,0.8
SF-F16,SF-K17,6,5,1,0,5,5,0.16666666666666666,0.8333333333333334,0.0,1.0
SF-F16,SF-J16,10,3,4,0,6,3,0.4,0.6,0.0,1.0
SF-F16,SF-J18,9,11,4,5,5,6,0.4444444444444444,0.5555555555555556,0.45454545454545453,0.5454545454545454
SF-F16,SF-J20,8,7,1,6,7,1,0.125,0.875,0.8571428571428571,0.14285714285714285
SF-F16,SF-J19,8,10,0,3,8,7,0.0,1.0,0.3,0.7
SF-F16,SF-M12,5,6,1,2,4,4,0.2,0.8,0.3333333333333333,0.6666666666666666
SF-F16,SF-M10,3,4,1,1,2,3,0.3333333333333333,0.6666666666666666,0.25,0.75
SF-F16,SF-M11,2,13,1,6,1,7,0.5,0.5,0.46153846153846156,0.5384615384615384
SF-F16,SF-O18,9,5,2,2,7,3,0.2222222222222222,0.7777777777777778,0.4,0.6
SF-F16,SF-O19,2,3,0,1,2,2,0.0,1.0,0.3333333333333333,0.6666666666666666
SF-F16,SF-O21,1,6,0,1,1,5,0.0,1.0,0.16666666666666666,0.8333333333333334
SF-F16,SF-O22,4,8,0,1,4,7,0.0,1.0,0.125,0.875
SF-F16,SF-N21,5,8,3,2,2,6,0.6,0.4,0.25,0.75
SF-F16,SF-M21,2,3,1,1,1,2,0.5,0.5,0.3333333333333333,0.6666666666666666
SF-F16,SF-L21,4,2,0,0,4,2,0.0,1.0,0.0,1.0
SF-F16,SF-O30,6,8,2,1,4,7,0.3333333333333333,0.6666666666666666,0.125,0.875
SF-F16,SF-L29,1,2,1,0,0,2,1.0,0.0,0.0,1.0
SF-F16,SF-I30,6,10,1,5,5,5,0.16666666666666666,0.8333333333333334,0.5,0.5
SF-F16,SF-I27,2,1,1,0,1,1,0.5,0.5,0.0,1.0
SF-F16,SF-I28,1,2,1,1,0,1,1.0,0.0,0.5,0.5
SF-F16,SF-I30-2,8,3,0,0,8,3,0.0,1.0,0.0,1.0
SF-F16,SF-T20,1,1,0,0,1,1,0.0,1.0,0.0,1.0
SF-C21,SF-N24-2,5,10,0,0,5,10,0.0,1.0,0.0,1.0
SF-C21,SF-K25,2,1,1,1,1,0,0.5,0.5,1.0,0.0
SF-C21,SF-P24,1,2,1,2,0,0,1.0,0.0,1.0,0.0
SF-C21,SF-J24,4,3,0,1,4,2,0.0,1.0,0.3333333333333333,0.6666666666666666
SF-C21,SF-H26,1,3,0,2,1,1,0.0,1.0,0.6666666666666666,0.3333333333333333
SF-C21,SF-O23,6,2,0,0,6,2,0.0,1.0,0.0,1.0
SF-C21,SF-G27,3,2,1,0,2,2,0.3333333333333333,0.6666666666666666,0.0,1.0
SF-C21,SF-F27,4,9,0,0,4,9,0.0,1.0,0.0,1.0
SF-C21,SF-K22-2,1,2,0,0,1,2,0.0,1.0,0.0,1.0
SF-C21,SF-J23-2,1,3,0,0,1,3,0.0,1.0,0.0,1.0
SF-C21,SF-G24,7,3,3,0,4,3,0.42857142857142855,0.5714285714285714,0.0,1.0
SF-C21,SF-G25,1,6,0,0,1,6,0.0,1.0,0.0,1.0
SF-C21,SF-F23,3,10,0,0,3,10,0.0,1.0,0.0,1.0
SF-C21,SF-E23,9,26,3,12,6,14,0.3333333333333333,0.6666666666666666,0.46153846153846156,0.5384615384615384
SF-C21,SF-D24,17,5,15,3,2,2,0.8823529411764706,0.11764705882352941,0.6,0.4
SF-C21,SF-C22,36,48,23,12,13,36,0.6388888888888888,0.3611111111111111,0.25,0.75
SF-C21,SF-B22,9,7,2,6,7,1,0.2222222222222222,0.7777777777777778,0.8571428571428571,0.14285714285714285
SF-C21,SF-J17,1,2,0,0,1,2,0.0,1.0,0.0,1.0
SF-C21,SF-H16,2,1,0,0,2,1,0.0,1.0,0.0,1.0
SF-C21,SF-H18,2,1,1,0,1,1,0.5,0.5,0.0,1.0
SF-C21,SF-G18,4,2,1,0,3,2,0.25,0.75,0.0,1.0
SF-C21,SF-G20,9,6,6,0,3,6,0.6666666666666666,0.3333333333333333,0.0,1.0
SF-C21,SF-F19,2,4,1,3,1,1,0.5,0.5,0.75,0.25
SF-C21,SF-E18,5,3,4,1,1,2,0.8,0.2,0.3333333333333333,0.6666666666666666
SF-C21,SF-E20,6,3,4,1,2,2,0.6666666666666666,0.3333333333333333,0.3333333333333333,0.6666666666666666
SF-C21,SF-G30-2,10,12,3,6,7,6,0.3,0.7,0.5,0.5
SF-C21,SF-E29-2,2,3,0,0,2,3,0.0,1.0,0.0,1.0
SF-C21,SF-E29-1,2,7,0,1,2,6,0.0,1.0,0.14285714285714285,0.8571428571428571
SF-C21,SF-D29,5,6,1,2,4,4,0.2,0.8,0.3333333333333333,0.6666666666666666
SF-C21,SF-D28,1,2,1,2,0,0,1.0,0.0,1.0,0.0
SF-C21,SF-A27,1,2,1,2,0,0,1.0,0.0,1.0,0.0
SF-C21,SF-G29-2,2,2,2,1,0,1,1.0,0.0,0.5,0.5
SF-C21,SF-G30-1,1,14,1,14,0,0,1.0,0.0,1.0,0.0
SF-C21,SF-F30-2,2,1,2,0,0,1,1.0,0.0,0.0,1.0
SF-C21,SF-F29,3,1,0,1,3,0,0.0,1.0,1.0,0.0
SF-C21,SF-F28-1,1,2,1,1,0,1,1.0,0.0,0.5,0.5
SF-C21,SF-J12,6,6,0,0,6,6,0.0,1.0,0.0,1.0
SF-C21,SF-J13,7,4,0,0,7,4,0.0,1.0,0.0,1.0
SF-C21,SF-J15,7,2,0,0,7,2,0.0,1.0,0.0,1.0
SF-C21,SF-H12,3,2,0,0,3,2,0.0,1.0,0.0,1.0
SF-C21,SF-H14,1,2,1,0,0,2,1.0,0.0,0.0,1.0
SF-C21,SF-G13,2,3,0,0,2,3,0.0,1.0,0.0,1.0
SF-C21,SF-G11,2,2,0,0,2,2,0.0,1.0,0.0,1.0
SF-C21,SF-G12,6,1,0,0,6,1,0.0,1.0,0.0,1.0
SF-C21,SF-F15,4,1,2,0,2,1,0.5,0.5,0.0,1.0
SF-C21,SF-F16,6,3,0,0,6,3,0.0,1.0,0.0,1.0
SF-C21,SF-C20,14,15,8,7,6,8,0.5714285714285714,0.42857142857142855,0.4666666666666667,0.5333333333333333
SF-C21,SF-B21,11,3,5,2,6,1,0.45454545454545453,0.5454545454545454,0.6666666666666666,0.3333333333333333
SF-C21,SF-B19,6,18,1,14,5,4,0.16666666666666666,0.8333333333333334,0.7777777777777778,0.2222222222222222
SF-C21,SF-A20,22,19,5,11,17,8,0.22727272727272727,0.7727272727272727,0.5789473684210527,0.42105263157894735
SF-C21,SF-A19,17,16,7,13,10,3,0.4117647058823529,0.5882352941176471,0.8125,0.1875
SF-C21,SF-C26,1,1,0,0,1,1,0.0,1.0,0.0,1.0
SF-C21,SF-C25,14,20,5,6,9,14,0.35714285714285715,0.6428571428571429,0.3,0.7
SF-C21,SF-B25,4,10,0,6,4,4,0.0,1.0,0.6,0.4
SF-C21,SF-D27,3,2,2,0,1,2,0.6666666666666666,0.3333333333333333,0.0,1.0
SF-C21,SF-C28-2,1,1,0,1,1,0,0.0,1.0,1.0,0.0
SF-C21,SF-B28,2,5,0,2,2,3,0.0,1.0,0.4,0.6
SF-C21,SF-G5,2,7,0,1,2,6,0.0,1.0,0.14285714285714285,0.8571428571428571
SF-C21,SF-K21,4,2,0,0,4,2,0.0,1.0,0.0,1.0
SF-C21,SF-J23-1,1,5,0,1,1,4,0.0,1.0,0.2,0.8
SF-C21,SF-J22-2,6,2,2,1,4,1,0.3333333333333333,0.6666666666666666,0.5,0.5
SF-C21,SF-J21,4,8,0,4,4,4,0.0,1.0,0.5,0.5
SF-C21,SF-I21,1,1,0,1,1,0,0.0,1.0,1.0,0.0
SF-C21,SF-I23-2,4,3,1,0,3,3,0.25,0.75,0.0,1.0
SF-C21,SF-F26,6,3,0,2,6,1,0.0,1.0,0.6666666666666666,0.3333333333333333
SF-C21,SF-M15,1,1,0,0,1,1,0.0,1.0,0.0,1.0
SF-C21,SF-M20,6,1,0,0,6,1,0.0,1.0,0.0,1.0
SF-C21,SF-K17-2,15,13,0,0,15,13,0.0,1.0,0.0,1.0
SF-C21,SF-K20,7,3,1,1,6,2,0.14285714285714285,0.8571428571428571,0.3333333333333333,0.6666666666666666
SF-C21,SF-K15-,2,4,0,0,2,4,0.0,1.0,0.0,1.0
SF-C21,SF-K19,2,5,0,0,2,5,0.0,1.0,0.0,1.0
SF-C21,SF-K18,3,1,0,0,3,1,0.0,1.0,0.0,1.0
SF-C21,SF-K17,3,2,0,0,3,2,0.0,1.0,0.0,1.0
SF-C21,SF-J16,8,14,0,1,8,13,0.0,1.0,0.07142857142857142,0.9285714285714286
SF-C21,SF-J18,3,6,0,0,3,6,0.0,1.0,0.0,1.0
SF-C21,SF-J19,7,14,0,2,7,12,0.0,1.0,0.14285714285714285,0.8571428571428571
SF-C21,SF-O12,2,1,0,0,2,1,0.0,1.0,0.0,1.0
SF-C21,SF-M10,1,1,0,0,1,1,0.0,1.0,0.0,1.0
SF-C21,SF-M11,4,2,1,0,3,2,0.25,0.75,0.0,1.0
SF-C21,SF-O18,2,6,0,3,2,3,0.0,1.0,0.5,0.5
SF-C21,SF-O22,1,3,0,0,1,3,0.0,1.0,0.0,1.0
SF-C21,SF-L21,3,1,1,1,2,0,0.3333333333333333,0.6666666666666666,1.0,0.0
SF-C21,SF-P30,2,5,0,0,2,5,0.0,1.0,0.0,1.0
SF-C21,SF-O30,1,2,0,1,1,1,0.0,1.0,0.5,0.5
SF-C21,SF-N27,3,2,0,0,3,2,0.0,1.0,0.0,1.0
SF-C21,SF-L31-1,1,2,0,0,1,2,0.0,1.0,0.0,1.0
SF-C21,SF-Q23-3,2,1,0,0,2,1,0.0,1.0,0.0,1.0
SF-C21,SF-Q22-1,2,2,0,0,2,2,0.0,1.0,0.0,1.0
SF-C21,SF-P22,1,2,0,1,1,1,0.0,1.0,0.5,0.5
SF-C20,SF-M26-2,1,2,0,0,1,2,0.0,1.0,0.0,1.0
SF-C20,SF-K26,1,1,1,0,0,1,1.0,0.0,0.0,1.0
SF-C20,SF-M30,11,3,1,3,10,0,0.09090909090909091,0.9090909090909091,1.0,0.0
SF-C20,SF-J29-3,1,1,1,0,0,1,1.0,0.0,0.0,1.0
SF-C20,SF-M28,1,2,1,0,0,2,1.0,0.0,0.0,1.0
SF-C20,SF-M24,1,1,0,0,1,1,0.0,1.0,0.0,1.0
SF-C20,SF-K27-2,2,1,2,0,0,1,1.0,0.0,0.0,1.0
SF-C20,SF-J26-2,3,5,0,0,3,5,0.0,1.0,0.0,1.0
SF-C20,SF-K29-1,5,4,2,0,3,4,0.4,0.6,0.0,1.0
SF-C20,SF-J25,2,6,1,3,1,3,0.5,0.5,0.5,0.5
SF-C20,SF-H26-2,3,3,0,0,3,3,0.0,1.0,0.0,1.0
SF-C20,SF-J24,3,4,2,0,1,4,0.6666666666666666,0.3333333333333333,0.0,1.0
SF-C20,SF-J26,2,4,1,0,1,4,0.5,0.5,0.0,1.0
SF-C20,SF-I25,4,2,2,0,2,2,0.5,0.5,0.0,1.0
SF-C20,SF-H26,6,9,1,0,5,9,0.16666666666666666,0.8333333333333334,0.0,1.0
SF-C20,SF-O23,1,1,0,0,1,1,0.0,1.0,0.0,1.0
SF-C20,SF-F28-2,25,13,2,1,23,12,0.08,0.92,0.07692307692307693,0.9230769230769231
SF-C20,SF-G27,4,13,1,2,3,11,0.25,0.75,0.15384615384615385,0.8461538461538461
SF-C20,SF-M22-2,2,1,1,0,1,1,0.5,0.5,0.0,1.0
SF-C20,SF-F27,52,18,6,0,46,18,0.11538461538461539,0.8846153846153846,0.0,1.0
SF-C20,SF-N22-2,4,3,2,0,2,3,0.5,0.5,0.0,1.0
SF-C20,SF-G28-2,1,3,0,1,1,2,0.0,1.0,0.3333333333333333,0.6666666666666666
SF-C20,SF-G28-1,1,2,0,1,1,1,0.0,1.0,0.5,0.5
SF-C20,SF-O25-1,3,1,0,0,3,1,0.0,1.0,0.0,1.0
SF-C20,SF-K22-2,3,4,0,0,3,4,0.0,1.0,0.0,1.0
SF-C20,SF-K24,3,3,0,0,3,3,0.0,1.0,0.0,1.0
SF-C20,SF-J23-2,4,2,1,0,3,2,0.25,0.75,0.0,1.0
SF-C20,SF-G23,7,13,2,3,5,10,0.2857142857142857,0.7142857142857143,0.23076923076923078,0.7692307692307693
SF-C20,SF-G24,54,11,0,2,54,9,0.0,1.0,0.18181818181818182,0.8181818181818182
SF-C20,SF-G25,10,14,3,0,7,14,0.3,0.7,0.0,1.0
SF-C20,SF-F23,28,22,12,3,16,19,0.42857142857142855,0.5714285714285714,0.13636363636363635,0.8636363636363636
SF-C20,SF-E23,83,43,47,10,36,33,0.5662650602409639,0.43373493975903615,0.23255813953488372,0.7674418604651163
SF-C20,SF-D24,50,30,24,4,26,26,0.48,0.52,0.13333333333333333,0.8666666666666667
SF-C20,SF-C22,50,40,36,14,14,26,0.72,0.28,0.35,0.65
SF-C20,SF-B22,48,41,25,6,23,35,0.5208333333333334,0.4791666666666667,0.14634146341463414,0.8536585365853658
SF-C20,SF-I19,9,2,2,0,7,2,0.2222222222222222,0.7777777777777778,0.0,1.0
SF-C20,SF-I20,5,1,0,0,5,1,0.0,1.0,0.0,1.0
SF-C20,SF-H16,2,7,0,1,2,6,0.0,1.0,0.14285714285714285,0.8571428571428571
SF-C20,SF-H20,4,2,0,1,4,1,0.0,1.0,0.5,0.5
SF-C20,SF-H18,6,5,0,0,6,5,0.0,1.0,0.0,1.0
SF-C20,SF-H17,39,1,0,0,39,1,0.0,1.0,0.0,1.0
SF-C20,SF-G19,4,5,0,1,4,4,0.0,1.0,0.2,0.8
SF-C20,SF-G17,16,3,2,0,14,3,0.125,0.875,0.0,1.0
SF-C20,SF-G18,9,2,1,0,8,2,0.1111111111111111,0.8888888888888888,0.0,1.0
SF-C20,SF-G20,7,5,4,5,3,0,0.5714285714285714,0.42857142857142855,1.0,0.0
SF-C20,SF-F19,34,4,13,0,21,4,0.38235294117647056,0.6176470588235294,0.0,1.0
SF-C20,SF-E18,25,8,14,1,11,7,0.56,0.44,0.125,0.875
SF-C20,SF-E20,26,6,14,1,12,5,0.5384615384615384,0.46153846153846156,0.16666666666666666,0.8333333333333334
SF-C20,SF-H30,8,1,2,0,6,1,0.25,0.75,0.0,1.0
SF-C20,SF-G30-2,10,6,2,1,8,5,0.2,0.8,0.16666666666666666,0.8333333333333334
SF-C20,SF-F30-1,3,5,2,3,1,2,0.6666666666666666,0.3333333333333333,0.6,0.4
SF-C20,SF-E29-2,14,8,4,3,10,5,0.2857142857142857,0.7142857142857143,0.375,0.625
SF-C20,SF-E29-1,17,9,6,1,11,8,0.35294117647058826,0.6470588235294118,0.1111111111111111,0.8888888888888888
SF-C20,SF-D29,17,11,5,3,12,8,0.29411764705882354,0.7058823529411765,0.2727272727272727,0.7272727272727273
SF-C20,SF-D28,8,8,3,1,5,7,0.375,0.625,0.125,0.875
SF-C20,SF-A27,8,18,4,7,4,11,0.5,0.5,0.3888888888888889,0.6111111111111112
SF-C20,SF-G29-2,10,12,5,4,5,8,0.5,0.5,0.3333333333333333,0.6666666666666666
SF-C20,SF-G29-1,4,3,1,1,3,2,0.25,0.75,0.3333333333333333,0.6666666666666666
SF-C20,SF-G30-1,9,5,7,1,2,4,0.7777777777777778,0.2222222222222222,0.2,0.8
SF-C20,SF-G29-3,3,1,1,0,2,1,0.3333333333333333,0.6666666666666666,0.0,1.0
SF-C20,SF-F30-2,5,3,3,2,2,1,0.6,0.4,0.6666666666666666,0.3333333333333333
SF-C20,SF-F29,2,3,2,2,0,1,1.0,0.0,0.6666666666666666,0.3333333333333333
SF-C20,SF-E29-3,4,2,2,0,2,2,0.5,0.5,0.0,1.0
SF-C20,SF-F28-1,7,11,2,1,5,10,0.2857142857142857,0.7142857142857143,0.09090909090909091,0.9090909090909091
SF-C20,SF-E28-2,7,2,1,0,6,2,0.14285714285714285,0.8571428571428571,0.0,1.0
SF-C20,SF-E28,15,9,1,2,14,7,0.06666666666666667,0.9333333333333333,0.2222222222222222,0.7777777777777778
SF-C20,SF-J10,3,4,3,0,0,4,1.0,0.0,0.0,1.0
SF-C20,SF-J12,4,1,3,0,1,1,0.75,0.25,0.0,1.0
SF-C20,SF-J13,3,6,0,0,3,6,0.0,1.0,0.0,1.0
SF-C20,SF-H13,12,1,7,0,5,1,0.5833333333333334,0.4166666666666667,0.0,1.0
SF-C20,SF-H15,3,1,0,1,3,0,0.0,1.0,1.0,0.0
SF-C20,SF-G9,5,2,0,0,5,2,0.0,1.0,0.0,1.0
SF-C20,SF-H14,8,6,4,0,4,6,0.5,0.5,0.0,1.0
SF-C20,SF-G13,32,4,5,1,27,3,0.15625,0.84375,0.25,0.75
SF-C20,SF-G12,14,9,2,0,12,9,0.14285714285714285,0.8571428571428571,0.0,1.0
SF-C20,SF-G10-1,3,6,0,3,3,3,0.0,1.0,0.5,0.5
SF-C20,SF-F15,8,7,2,3,6,4,0.25,0.75,0.42857142857142855,0.5714285714285714
SF-C20,SF-F16,14,3,8,1,6,2,0.5714285714285714,0.42857142857142855,0.3333333333333333,0.6666666666666666
SF-C20,SF-C21,15,14,7,8,8,6,0.4666666666666667,0.5333333333333333,0.5714285714285714,0.42857142857142855
SF-C20,SF-B21,48,39,32,13,16,26,0.6666666666666666,0.3333333333333333,0.3333333333333333,0.6666666666666666
SF-C20,SF-B19,43,69,24,51,19,18,0.5581395348837209,0.4418604651162791,0.7391304347826086,0.2608695652173913
SF-C20,SF-A20,60,61,35,35,25,26,0.5833333333333334,0.4166666666666667,0.5737704918032787,0.4262295081967213
SF-C20,SF-A19,55,48,43,34,12,14,0.7818181818181819,0.21818181818181817,0.7083333333333334,0.2916666666666667
SF-C20,SF-C26,18,23,2,1,16,22,0.1111111111111111,0.8888888888888888,0.043478260869565216,0.9565217391304348
SF-C20,SF-C25,50,66,7,1,43,65,0.14,0.86,0.015151515151515152,0.9848484848484849
SF-C20,SF-B25,48,85,14,5,34,80,0.2916666666666667,0.7083333333333334,0.058823529411764705,0.9411764705882353
SF-C20,SF-E27,1,1,0,1,1,0,0.0,1.0,1.0,0.0
SF-C20,SF-B28-2,1,1,0,0,1,1,0.0,1.0,0.0,1.0
SF-C20,SF-D27,12,8,3,1,9,7,0.25,0.75,0.125,0.875
SF-C20,SF-C28-2,3,3,0,1,3,2,0.0,1.0,0.3333333333333333,0.6666666666666666
SF-C20,SF-C28-1,8,3,6,0,2,3,0.75,0.25,0.0,1.0
SF-C20,SF-B28,16,5,12,2,4,3,0.75,0.25,0.4,0.6
SF-C20,SF-H0,3,2,0,0,3,2,0.0,1.0,0.0,1.0
SF-C20,SF-J5,5,2,2,1,3,1,0.4,0.6,0.5,0.5
SF-C20,SF-G5,7,2,3,0,4,2,0.42857142857142855,0.5714285714285714,0.0,1.0
SF-C20,SF-G7,2,7,0,0,2,7,0.0,1.0,0.0,1.0
SF-C20,SF-F9,8,5,5,0,3,5,0.625,0.375,0.0,1.0
SF-C20,SF-G26,3,4,1,0,2,4,0.3333333333333333,0.6666666666666666,0.0,1.0
SF-C20,SF-K21,10,5,2,0,8,5,0.2,0.8,0.0,1.0
SF-C20,SF-J23-1,20,30,2,1,18,29,0.1,0.9,0.03333333333333333,0.9666666666666667
SF-C20,SF-J22-1,7,3,1,1,6,2,0.14285714285714285,0.8571428571428571,0.3333333333333333,0.6666666666666666
SF-C20,SF-J22-2,4,12,1,2,3,10,0.25,0.75,0.16666666666666666,0.8333333333333334
SF-C20,SF-J21,19,7,0,0,19,7,0.0,1.0,0.0,1.0
SF-C20,SF-I21,2,2,0,1,2,1,0.0,1.0,0.5,0.5
SF-C20,SF-I22,3,6,0,0,3,6,0.0,1.0,0.0,1.0
SF-C20,SF-I23-2,13,10,5,1,8,9,0.38461538461538464,0.6153846153846154,0.1,0.9
SF-C20,SF-I24,8,2,2,0,6,2,0.25,0.75,0.0,1.0
SF-C20,SF-I23-1,13,4,2,0,11,4,0.15384615384615385,0.8461538461538461,0.0,1.0
SF-C20,SF-F26,24,9,8,0,16,9,0.3333333333333333,0.6666666666666666,0.0,1.0
SF-C20,SF-M13,13,3,0,0,13,3,0.0,1.0,0.0,1.0
SF-C20,SF-M15,7,6,3,1,4,5,0.42857142857142855,0.5714285714285714,0.16666666666666666,0.8333333333333334
SF-C20,SF-L20,1,3,1,0,0,3,1.0,0.0,0.0,1.0
SF-C20,SF-M20,4,1,1,0,3,1,0.25,0.75,0.0,1.0
SF-C20,SF-K20,12,4,4,0,8,4,0.3333333333333333,0.6666666666666666,0.0,1.0
SF-C20,SF-K15-,16,10,1,1,15,9,0.0625,0.9375,0.1,0.9
SF-C20,SF-K19,6,9,2,1,4,8,0.3333333333333333,0.6666666666666666,0.1111111111111111,0.8888888888888888
SF-C20,SF-K18,20,5,3,0,17,5,0.15,0.85,0.0,1.0
SF-C20,SF-J16,2,3,0,0,2,3,0.0,1.0,0.0,1.0
SF-C20,SF-J18,18,4,1,1,17,3,0.05555555555555555,0.9444444444444444,0.25,0.75
SF-C20,SF-J20,5,2,1,0,4,2,0.2,0.8,0.0,1.0
SF-C20,SF-J19,18,15,4,2,14,13,0.2222222222222222,0.7777777777777778,0.13333333333333333,0.8666666666666667
SF-C20,SF-M10,1,4,0,1,1,3,0.0,1.0,0.25,0.75
SF-C20,SF-Q21-2,3,2,0,0,3,2,0.0,1.0,0.0,1.0
SF-C20,SF-Q21-1,12,1,0,0,12,1,0.0,1.0,0.0,1.0
SF-C20,SF-O18,10,5,0,0,10,5,0.0,1.0,0.0,1.0
SF-C20,SF-O19,3,1,2,0,1,1,0.6666666666666666,0.3333333333333333,0.0,1.0
SF-C20,SF-O21,9,8,0,0,9,8,0.0,1.0,0.0,1.0
SF-C20,SF-O22,6,15,1,0,5,15,0.16666666666666666,0.8333333333333334,0.0,1.0
SF-C20,SF-N20-2,1,1,0,0,1,1,0.0,1.0,0.0,1.0
SF-C20,SF-M21,1,4,0,0,1,4,0.0,1.0,0.0,1.0
SF-C20,SF-L21,3,3,0,0,3,3,0.0,1.0,0.0,1.0
SF-C20,SF-O30,3,3,0,0,3,3,0.0,1.0,0.0,1.0
SF-C20,SF-N27,2,6,0,3,2,3,0.0,1.0,0.5,0.5
SF-C20,SF-N28,2,1,1,0,1,1,0.5,0.5,0.0,1.0
SF-C20,SF-L30-1,26,11,2,3,24,8,0.07692307692307693,0.9230769230769231,0.2727272727272727,0.7272727272727273
SF-C20,SF-L31-1,1,1,0,0,1,1,0.0,1.0,0.0,1.0
SF-C20,SF-K30-2,2,3,2,0,0,3,1.0,0.0,0.0,1.0
SF-C20,SF-L29,25,25,3,0,22,25,0.12,0.88,0.0,1.0
SF-C20,SF-I30,1,3,1,0,0,3,1.0,0.0,0.0,1.0
SF-C20,SF-I27,3,2,1,0,2,2,0.3333333333333333,0.6666666666666666,0.0,1.0
SF-C20,SF-I30-2,1,3,1,0,0,3,1.0,0.0,0.0,1.0
SF-C20,SF I29-1,3,1,0,0,3,1,0.0,1.0,0.0,1.0
SF-C20,SF-H28,3,1,0,0,3,1,0.0,1.0,0.0,1.0
SF-C20,SF-R24,4,1,0,0,4,1,0.0,1.0,0.0,1.0
SF-C20,SF-Q26,1,5,0,0,1,5,0.0,1.0,0.0,1.0
SF-C20,SF-S22-2,1,3,0,0,1,3,0.0,1.0,0.0,1.0
SF-C20,SF-Q23-3,1,1,0,0,1,1,0.0,1.0,0.0,1.0
SF-C20,SF-Q22-1,2,4,1,0,1,4,0.5,0.5,0.0,1.0
SF-C20,SF-Q22-2,10,3,2,0,8,3,0.2,0.8,0.0,1.0
SF-C20,SF-P22,3,1,2,1,1,0,0.6666666666666666,0.3333333333333333,1.0,0.0
SF-C20,SF-W19-2,2,3,0,0,2,3,0.0,1.0,0.0,1.0
SF-C20,SF-T20,4,7,0,0,4,7,0.0,1.0,0.0,1.0
SF-B21,SF-L27,1,1,1,1,0,0,1.0,0.0,1.0,0.0
SF-B21,SF-K26,1,3,0,0,1,3,0.0,1.0,0.0,1.0
SF-B21,SF-J29-3,2,1,0,0,2,1,0.0,1.0,0.0,1.0
SF-B21,SF-L26,1,2,1,2,0,0,1.0,0.0,1.0,0.0
SF-B21,SF-M24,7,14,0,0,7,14,0.0,1.0,0.0,1.0
SF-B21,SF-L24,3,2,0,0,3,2,0.0,1.0,0.0,1.0
SF-B21,SF-N23,1,1,0,0,1,1,0.0,1.0,0.0,1.0
SF-B21,SF-K27-2,2,1,1,0,1,1,0.5,0.5,0.0,1.0
SF-B21,SF-K28,1,2,0,0,1,2,0.0,1.0,0.0,1.0
SF-B21,SF-K29-1,3,4,1,2,2,2,0.3333333333333333,0.6666666666666666,0.5,0.5
SF-B21,SF-K25,1,1,0,0,1,1,0.0,1.0,0.0,1.0
SF-B21,SF-J25,1,1,0,0,1,1,0.0,1.0,0.0,1.0
SF-B21,SF-I26-,1,1,0,0,1,1,0.0,1.0,0.0,1.0
SF-B21,SF-K23,1,4,1,0,0,4,1.0,0.0,0.0,1.0
SF-B21,SF-H26,7,4,5,2,2,2,0.7142857142857143,0.2857142857142857,0.5,0.5
SF-B21,SF-H27-1,1,1,0,0,1,1,0.0,1.0,0.0,1.0
SF-B21,SF-F28-2,20,4,1,0,19,4,0.05,0.95,0.0,1.0
SF-B21,SF-G27,1,5,0,0,1,5,0.0,1.0,0.0,1.0
SF-B21,SF-M22-2,2,2,1,1,1,1,0.5,0.5,0.5,0.5
SF-B21,SF-F27,3,5,0,1,3,4,0.0,1.0,0.2,0.8
SF-B21,SF-N22-2,3,5,1,1,2,4,0.3333333333333333,0.6666666666666666,0.2,0.8
SF-B21,SF-K22-2,4,2,0,0,4,2,0.0,1.0,0.0,1.0
SF-B21,SF-K24,1,9,0,1,1,8,0.0,1.0,0.1111111111111111,0.8888888888888888
SF-B21,SF-J23-2,4,1,2,1,2,0,0.5,0.5,1.0,0.0
SF-B21,SF-G23,15,15,8,4,7,11,0.5333333333333333,0.4666666666666667,0.26666666666666666,0.7333333333333333
SF-B21,SF-G24,1,5,0,1,1,4,0.0,1.0,0.2,0.8
SF-B21,SF-G25,10,3,2,1,8,2,0.2,0.8,0.3333333333333333,0.6666666666666666
SF-B21,SF-F23,8,19,4,5,4,14,0.5,0.5,0.2631578947368421,0.7368421052631579
SF-B21,SF-E23,26,14,17,6,9,8,0.6538461538461539,0.34615384615384615,0.42857142857142855,0.5714285714285714
SF-B21,SF-D24,6,3,3,0,3,3,0.5,0.5,0.0,1.0
SF-B21,SF-C22,7,9,4,6,3,3,0.5714285714285714,0.42857142857142855,0.6666666666666666,0.3333333333333333
SF-B21,SF-B22,16,15,14,9,2,6,0.875,0.125,0.6,0.4
SF-B21,SF-I19,4,1,0,1,4,0,0.0,1.0,1.0,0.0
SF-B21,SF-H20,1,2,0,0,1,2,0.0,1.0,0.0,1.0
SF-B21,SF-G19,5,2,5,1,0,1,1.0,0.0,0.5,0.5
SF-B21,SF-G18,6,3,3,0,3,3,0.5,0.5,0.0,1.0
SF-B21,SF-G20,4,1,2,1,2,0,0.5,0.5,1.0,0.0
SF-B21,SF-F19,5,3,0,1,5,2,0.0,1.0,0.3333333333333333,0.6666666666666666
SF-B21,SF-E18,6,2,3,2,3,0,0.5,0.5,1.0,0.0
SF-B21,SF-E20,7,2,2,1,5,1,0.2857142857142857,0.7142857142857143,0.5,0.5
SF-B21,SF-G30-2,4,14,2,0,2,14,0.5,0.5,0.0,1.0
SF-B21,SF-F30-1,4,4,3,3,1,1,0.75,0.25,0.75,0.25
SF-B21,SF-E29-2,6,3,0,1,6,2,0.0,1.0,0.3333333333333333,0.6666666666666666
SF-B21,SF-E29-1,8,12,7,3,1,9,0.875,0.125,0.25,0.75
SF-B21,SF-D29,11,8,6,4,5,4,0.5454545454545454,0.45454545454545453,0.5,0.5
SF-B21,SF-A27,13,7,11,5,2,2,0.8461538461538461,0.15384615384615385,0.7142857142857143,0.2857142857142857
SF-B21,SF-G29-2,6,1,5,0,1,1,0.8333333333333334,0.16666666666666666,0.0,1.0
SF-B21,SF-F30-2,9,4,7,1,2,3,0.7777777777777778,0.2222222222222222,0.25,0.75
SF-B21,SF-E28,3,6,0,2,3,4,0.0,1.0,0.3333333333333333,0.6666666666666666
SF-B21,SF-J12,2,1,0,0,2,1,0.0,1.0,0.0,1.0
SF-B21,SF-H13,1,1,1,1,0,0,1.0,0.0,1.0,0.0
SF-B21,SF-H12,1,1,0,0,1,1,0.0,1.0,0.0,1.0
SF-B21,SF-G13,4,1,2,0,2,1,0.5,0.5,0.0,1.0
SF-B21,SF-G12,2,8,1,2,1,6,0.5,0.5,0.25,0.75
SF-B21,SF-C21,3,11,2,5,1,6,0.6666666666666666,0.3333333333333333,0.45454545454545453,0.5454545454545454
SF-B21,SF-C20,39,48,13,32,26,16,0.3333333333333333,0.6666666666666666,0.6666666666666666,0.3333333333333333
SF-B21,SF-B19,17,34,6,24,11,10,0.35294117647058826,0.6470588235294118,0.7058823529411765,0.29411764705882354
SF-B21,SF-A20,44,40,9,20,35,20,0.20454545454545456,0.7954545454545454,0.5,0.5
SF-B21,SF-A19,11,5,6,4,5,1,0.5454545454545454,0.45454545454545453,0.8,0.2
SF-B21,SF-C26,11,8,0,3,11,5,0.0,1.0,0.375,0.625
SF-B21,SF-C25,22,27,5,7,17,20,0.22727272727272727,0.7727272727272727,0.25925925925925924,0.7407407407407407
SF-B21,SF-B25,16,22,6,13,10,9,0.375,0.625,0.5909090909090909,0.4090909090909091
SF-B21,SF-E27,2,3,0,1,2,2,0.0,1.0,0.3333333333333333,0.6666666666666666
SF-B21,SF-D27,11,8,2,3,9,5,0.18181818181818182,0.8181818181818182,0.375,0.625
SF-B21,SF-C28-1,6,1,4,1,2,0,0.6666666666666666,0.3333333333333333,1.0,0.0
SF-B21,SF-B28,11,6,8,4,3,2,0.7272727272727273,0.2727272727272727,0.6666666666666666,0.3333333333333333
SF-B21,SF-G7,2,1,0,0,2,1,0.0,1.0,0.0,1.0
SF-B21,SF-F9,4,3,3,2,1,1,0.75,0.25,0.6666666666666666,0.3333333333333333
SF-B21,SF-K21,7,2,0,0,7,2,0.0,1.0,0.0,1.0
SF-B21,SF-K22-1,2,10,0,2,2,8,0.0,1.0,0.2,0.8
SF-B21,SF-J23-1,6,3,3,1,3,2,0.5,0.5,0.3333333333333333,0.6666666666666666
SF-B21,SF-J22-2,13,11,3,3,10,8,0.23076923076923078,0.7692307692307693,0.2727272727272727,0.7272727272727273
SF-B21,SF-J21,4,8,0,1,4,7,0.0,1.0,0.125,0.875
SF-B21,SF-I21,3,2,0,0,3,2,0.0,1.0,0.0,1.0
SF-B21,SF-I22,1,2,0,0,1,2,0.0,1.0,0.0,1.0
SF-B21,SF-I24,3,4,2,1,1,3,0.6666666666666666,0.3333333333333333,0.25,0.75
SF-B21,SF-I23-1,5,3,2,0,3,3,0.4,0.6,0.0,1.0
SF-B21,SF-F26,5,5,1,2,4,3,0.2,0.8,0.4,0.6
SF-B21,SF-M13,3,2,0,0,3,2,0.0,1.0,0.0,1.0
SF-B21,SF-M15,2,1,1,0,1,1,0.5,0.5,0.0,1.0
SF-B21,SF-L19,2,2,1,0,1,2,0.5,0.5,0.0,1.0
SF-B21,SF-N20-1,1,1,0,0,1,1,0.0,1.0,0.0,1.0
SF-B21,SF-K20,2,5,0,0,2,5,0.0,1.0,0.0,1.0
SF-B21,SF-K15-,4,3,1,1,3,2,0.25,0.75,0.3333333333333333,0.6666666666666666
SF-B21,SF-K19,3,1,1,1,2,0,0.3333333333333333,0.6666666666666666,1.0,0.0
SF-B21,SF-K18,1,2,0,0,1,2,0.0,1.0,0.0,1.0
SF-B21,SF-K17,5,2,1,0,4,2,0.2,0.8,0.0,1.0
SF-B21,SF-J16,4,1,0,0,4,1,0.0,1.0,0.0,1.0
SF-B21,SF-J18,8,4,2,0,6,4,0.25,0.75,0.0,1.0
SF-B21,SF-J19,6,6,2,3,4,3,0.3333333333333333,0.6666666666666666,0.5,0.5
SF-B21,SF-R19,1,2,0,0,1,2,0.0,1.0,0.0,1.0
SF-B21,SF-P21,3,1,3,0,0,1,1.0,0.0,0.0,1.0
SF-B21,SF-O21,3,3,0,1,3,2,0.0,1.0,0.3333333333333333,0.6666666666666666
SF-B21,SF-O22,1,3,0,0,1,3,0.0,1.0,0.0,1.0
SF-B21,SF-M21,2,5,1,1,1,4,0.5,0.5,0.2,0.8
SF-B21,SF-L21,4,4,1,0,3,4,0.25,0.75,0.0,1.0
SF-B21,SF-N28,2,1,2,1,0,0,1.0,0.0,1.0,0.0
SF-B21,SF-L31-1,1,2,0,0,1,2,0.0,1.0,0.0,1.0
SF-B21,SF-J29-1,1,1,0,0,1,1,0.0,1.0,0.0,1.0
SF-B21,SF-H28,1,2,0,2,1,0,0.0,1.0,1.0,0.0
SF-B21,SF-Q22-2,1,3,1,0,0,3,1.0,0.0,0.0,1.0
SF-B21,SF-P22,1,2,0,0,1,2,0.0,1.0,0.0,1.0
SF-B19,SF-M26-2,5,5,0,1,5,4,0.0,1.0,0.2,0.8
SF-B19,SF-K26,1,1,0,0,1,1,0.0,1.0,0.0,1.0
SF-B19,SF-M30,30,34,2,2,28,32,0.06666666666666667,0.9333333333333333,0.058823529411764705,0.9411764705882353
SF-B19,SF-J29-3,3,2,2,0,1,2,0.6666666666666666,0.3333333333333333,0.0,1.0
SF-B19,SF-J29,55,56,3,2,52,54,0.05454545454545454,0.9454545454545454,0.03571428571428571,0.9642857142857143
SF-B19,SF-L25,1,1,0,1,1,0,0.0,1.0,1.0,0.0
SF-B19,SF-K27-2,6,1,6,0,0,1,1.0,0.0,0.0,1.0
SF-B19,SF-J26-2,4,7,3,1,1,6,0.75,0.25,0.14285714285714285,0.8571428571428571
SF-B19,SF-L28,8,2,6,0,2,2,0.75,0.25,0.0,1.0
SF-B19,SF-K28,2,1,2,0,0,1,1.0,0.0,0.0,1.0
SF-B19,SF-K29-1,34,12,23,7,11,5,0.6764705882352942,0.3235294117647059,0.5833333333333334,0.4166666666666667
SF-B19,SF-J28-2,2,27,1,0,1,27,0.5,0.5,0.0,1.0
SF-B19,SF-K25,6,4,2,1,4,3,0.3333333333333333,0.6666666666666666,0.25,0.75
SF-B19,SF-J25,2,7,0,3,2,4,0.0,1.0,0.42857142857142855,0.5714285714285714
SF-B19,SF-H26-2,1,1,0,0,1,1,0.0,1.0,0.0,1.0
SF-B19,SF-O24,1,1,0,0,1,1,0.0,1.0,0.0,1.0
SF-B19,SF-J26,2,1,2,0,0,1,1.0,0.0,0.0,1.0
SF-B19,SF-I26-,3,2,0,0,3,2,0.0,1.0,0.0,1.0
SF-B19,SF-I25,8,5,3,2,5,3,0.375,0.625,0.4,0.6
SF-B19,SF-H26,17,9,11,6,6,3,0.6470588235294118,0.35294117647058826,0.6666666666666666,0.3333333333333333
SF-B19,SF-O23,2,3,1,1,1,2,0.5,0.5,0.3333333333333333,0.6666666666666666
SF-B19,SF-H27-1,1,1,0,1,1,0,0.0,1.0,1.0,0.0
SF-B19,SF-F28-2,10,8,4,1,6,7,0.4,0.6,0.125,0.875
SF-B19,SF-G27,13,16,3,2,10,14,0.23076923076923078,0.7692307692307693,0.125,0.875
SF-B19,SF-M22-2,3,1,0,0,3,1,0.0,1.0,0.0,1.0
SF-B19,SF-F27,14,17,4,0,10,17,0.2857142857142857,0.7142857142857143,0.0,1.0
SF-B19,SF-N22-2,6,1,0,0,6,1,0.0,1.0,0.0,1.0
SF-B19,SF-G28-1,3,1,0,1,3,0,0.0,1.0,1.0,0.0
SF-B19,SF-M22-1,4,5,1,0,3,5,0.25,0.75,0.0,1.0
SF-B19,SF-K22-2,6,3,0,0,6,3,0.0,1.0,0.0,1.0
SF-B19,SF-K24,10,5,6,0,4,5,0.6,0.4,0.0,1.0
SF-B19,SF-J23-2,10,1,8,1,2,0,0.8,0.2,1.0,0.0
SF-B19,SF-G23,12,4,5,0,7,4,0.4166666666666667,0.5833333333333334,0.0,1.0
SF-B19,SF-G24,47,38,4,2,43,36,0.0851063829787234,0.9148936170212766,0.05263157894736842,0.9473684210526315
SF-B19,SF-G25,16,28,5,1,11,27,0.3125,0.6875,0.03571428571428571,0.9642857142857143
SF-B19,SF-F23,50,22,18,6,32,16,0.36,0.64,0.2727272727272727,0.7272727272727273
SF-B19,SF-E23,98,70,50,8,48,62,0.5102040816326531,0.4897959183673469,0.11428571428571428,0.8857142857142857
SF-B19,SF-D24,57,10,35,1,22,9,0.6140350877192983,0.38596491228070173,0.1,0.9
SF-B19,SF-C22,74,44,49,17,25,27,0.6621621621621622,0.33783783783783783,0.38636363636363635,0.6136363636363636
SF-B19,SF-B22,137,111,100,43,37,68,0.7299270072992701,0.27007299270072993,0.38738738738738737,0.6126126126126126
SF-B19,SF-J17,6,3,3,2,3,1,0.5,0.5,0.6666666666666666,0.3333333333333333
SF-B19,SF-I19,6,6,4,1,2,5,0.6666666666666666,0.3333333333333333,0.16666666666666666,0.8333333333333334
SF-B19,SF-I20,10,2,0,0,10,2,0.0,1.0,0.0,1.0
SF-B19,SF-H16,15,5,7,0,8,5,0.4666666666666667,0.5333333333333333,0.0,1.0
SF-B19,SF-H19,1,1,1,0,0,1,1.0,0.0,0.0,1.0
SF-B19,SF-H20,8,2,3,0,5,2,0.375,0.625,0.0,1.0
SF-B19,SF-H18,1,1,0,0,1,1,0.0,1.0,0.0,1.0
SF-B19,SF-H17,1,2,1,0,0,2,1.0,0.0,0.0,1.0
SF-B19,SF-G19,14,2,7,2,7,0,0.5,0.5,1.0,0.0
SF-B19,SF-G18,8,5,3,0,5,5,0.375,0.625,0.0,1.0
SF-B19,SF-G20,11,3,7,1,4,2,0.6363636363636364,0.36363636363636365,0.3333333333333333,0.6666666666666666
SF-B19,SF-F19,19,8,6,0,13,8,0.3157894736842105,0.6842105263157895,0.0,1.0
SF-B19,SF-E18,13,7,2,2,11,5,0.15384615384615385,0.8461538461538461,0.2857142857142857,0.7142857142857143
SF-B19,SF-E20,28,13,20,4,8,9,0.7142857142857143,0.2857142857142857,0.3076923076923077,0.6923076923076923
SF-B19,SF-H30,36,12,18,2,18,10,0.5,0.5,0.16666666666666666,0.8333333333333334
SF-B19,SF-G30-2,49,31,20,13,29,18,0.40816326530612246,0.5918367346938775,0.41935483870967744,0.5806451612903226
SF-B19,SF-F30-1,16,14,6,1,10,13,0.375,0.625,0.07142857142857142,0.9285714285714286
SF-B19,SF-E29-2,24,19,13,10,11,9,0.5416666666666666,0.4583333333333333,0.5263157894736842,0.47368421052631576
SF-B19,SF-E29-1,41,15,27,8,14,7,0.6585365853658537,0.34146341463414637,0.5333333333333333,0.4666666666666667
SF-B19,SF-D29,56,40,30,15,26,25,0.5357142857142857,0.4642857142857143,0.375,0.625
SF-B19,SF-D28,26,10,20,6,6,4,0.7692307692307693,0.23076923076923078,0.6,0.4
SF-B19,SF-A27,34,41,20,31,14,10,0.5882352941176471,0.4117647058823529,0.7560975609756098,0.24390243902439024
SF-B19,SF-G29-2,19,12,10,5,9,7,0.5263157894736842,0.47368421052631576,0.4166666666666667,0.5833333333333334
SF-B19,SF-G29-1,5,2,2,1,3,1,0.4,0.6,0.5,0.5
SF-B19,SF-G30-1,16,8,7,4,9,4,0.4375,0.5625,0.5,0.5
SF-B19,SF-G29-3,7,3,7,0,0,3,1.0,0.0,0.0,1.0
SF-B19,SF-F30-2,17,9,8,4,9,5,0.47058823529411764,0.5294117647058824,0.4444444444444444,0.5555555555555556
SF-B19,SF-F29,13,13,7,4,6,9,0.5384615384615384,0.46153846153846156,0.3076923076923077,0.6923076923076923
SF-B19,SF-E29-3,10,11,4,6,6,5,0.4,0.6,0.5454545454545454,0.45454545454545453
SF-B19,SF-F28-1,11,2,0,0,11,2,0.0,1.0,0.0,1.0
SF-B19,SF-E28-2,9,1,0,0,9,1,0.0,1.0,0.0,1.0
SF-B19,SF-E28,13,4,6,2,7,2,0.46153846153846156,0.5384615384615384,0.5,0.5
SF-B19,SF-J12,18,6,5,0,13,6,0.2777777777777778,0.7222222222222222,0.0,1.0
SF-B19,SF-J13,7,9,3,2,4,7,0.42857142857142855,0.5714285714285714,0.2222222222222222,0.7777777777777778
SF-B19,SF-J15,10,2,4,0,6,2,0.4,0.6,0.0,1.0
SF-B19,SF-J14,5,1,1,1,4,0,0.2,0.8,1.0,0.0
SF-B19,SF-H13,9,6,4,0,5,6,0.4444444444444444,0.5555555555555556,0.0,1.0
SF-B19,SF-I16,7,1,1,0,6,1,0.14285714285714285,0.8571428571428571,0.0,1.0
SF-B19,SF-H12,10,4,1,0,9,4,0.1,0.9,0.0,1.0
SF-B19,SF-G9,2,4,0,0,2,4,0.0,1.0,0.0,1.0
SF-B19,SF-G13,14,8,2,0,12,8,0.14285714285714285,0.8571428571428571,0.0,1.0
SF-B19,SF-G11,22,5,6,2,16,3,0.2727272727272727,0.7272727272727273,0.4,0.6
SF-B19,SF-G12,19,7,4,1,15,6,0.21052631578947367,0.7894736842105263,0.14285714285714285,0.8571428571428571
SF-B19,SF-G10-1,11,13,4,2,7,11,0.36363636363636365,0.6363636363636364,0.15384615384615385,0.8461538461538461
SF-B19,SF-F15,19,6,14,4,5,2,0.7368421052631579,0.2631578947368421,0.6666666666666666,0.3333333333333333
SF-B19,SF-F16,19,6,5,0,14,6,0.2631578947368421,0.7368421052631579,0.0,1.0
SF-B19,SF-C21,18,6,14,1,4,5,0.7777777777777778,0.2222222222222222,0.16666666666666666,0.8333333333333334
SF-B19,SF-C20,69,43,51,24,18,19,0.7391304347826086,0.2608695652173913,0.5581395348837209,0.4418604651162791
SF-B19,SF-B21,34,17,24,6,10,11,0.7058823529411765,0.29411764705882354,0.35294117647058826,0.6470588235294118
SF-B19,SF-A20,135,115,101,75,34,40,0.7481481481481481,0.2518518518518518,0.6521739130434783,0.34782608695652173
SF-B19,SF-A19,30,53,20,27,10,26,0.6666666666666666,0.3333333333333333,0.5094339622641509,0.49056603773584906
SF-B19,SF-C26,32,9,18,4,14,5,0.5625,0.4375,0.4444444444444444,0.5555555555555556
SF-B19,SF-C25,120,137,27,21,93,116,0.225,0.775,0.15328467153284672,0.8467153284671532
SF-B19,SF-B25,126,109,56,46,70,63,0.4444444444444444,0.5555555555555556,0.42201834862385323,0.5779816513761468
SF-B19,SF-E27,7,23,0,2,7,21,0.0,1.0,0.08695652173913043,0.9130434782608695
SF-B19,SF-B28-2,7,3,6,3,1,0,0.8571428571428571,0.14285714285714285,1.0,0.0
SF-B19,SF-D27,20,20,10,10,10,10,0.5,0.5,0.5,0.5
SF-B19,SF-C28-2,9,5,5,4,4,1,0.5555555555555556,0.4444444444444444,0.8,0.2
SF-B19,SF-C28-1,14,12,12,7,2,5,0.8571428571428571,0.14285714285714285,0.5833333333333334,0.4166666666666667
SF-B19,SF-B28,61,21,40,9,21,12,0.6557377049180327,0.3442622950819672,0.42857142857142855,0.5714285714285714
SF-B19,SF-J1,2,1,0,0,2,1,0.0,1.0,0.0,1.0
SF-B19,SF-J3,4,1,2,0,2,1,0.5,0.5,0.0,1.0
SF-B19,SF-G6,1,2,0,0,1,2,0.0,1.0,0.0,1.0
SF-B19,SF-G5,19,1,12,0,7,1,0.631578947368421,0.3684210526315789,0.0,1.0
SF-B19,SF-G7,8,6,1,2,7,4,0.125,0.875,0.3333333333333333,0.6666666666666666
SF-B19,SF-F9,18,10,11,4,7,6,0.6111111111111112,0.3888888888888889,0.4,0.6
SF-B19,SF-G26,7,12,0,0,7,12,0.0,1.0,0.0,1.0
SF-B19,SF-K22-1,3,3,0,1,3,2,0.0,1.0,0.3333333333333333,0.6666666666666666
SF-B19,SF-J23-1,21,11,4,0,17,11,0.19047619047619047,0.8095238095238095,0.0,1.0
SF-B19,SF-J22-2,23,5,13,0,10,5,0.5652173913043478,0.43478260869565216,0.0,1.0
SF-B19,SF-J21,10,5,6,1,4,4,0.6,0.4,0.2,0.8
SF-B19,SF-I21,3,2,1,0,2,2,0.3333333333333333,0.6666666666666666,0.0,1.0
SF-B19,SF-I22,2,3,1,1,1,2,0.5,0.5,0.3333333333333333,0.6666666666666666
SF-B19,SF-I23-2,9,10,3,1,6,9,0.3333333333333333,0.6666666666666666,0.1,0.9
SF-B19,SF-I24,4,1,3,0,1,1,0.75,0.25,0.0,1.0
SF-B19,SF-I23-1,14,2,1,0,13,2,0.07142857142857142,0.9285714285714286,0.0,1.0
SF-B19,SF-F26,25,19,3,5,22,14,0.12,0.88,0.2631578947368421,0.7368421052631579
SF-B19,SF-M13,3,1,2,1,1,0,0.6666666666666666,0.3333333333333333,1.0,0.0
SF-B19,SF-M15,9,9,5,1,4,8,0.5555555555555556,0.4444444444444444,0.1111111111111111,0.8888888888888888
SF-B19,SF-L20,3,1,0,0,3,1,0.0,1.0,0.0,1.0
SF-B19,SF-N20-1,5,4,0,0,5,4,0.0,1.0,0.0,1.0
SF-B19,SF-M20,5,3,0,1,5,2,0.0,1.0,0.3333333333333333,0.6666666666666666
SF-B19,SF-K17-2,5,1,2,0,3,1,0.4,0.6,0.0,1.0
SF-B19,SF-K15-,10,1,3,0,7,1,0.3,0.7,0.0,1.0
SF-B19,SF-K19,13,3,3,0,10,3,0.23076923076923078,0.7692307692307693,0.0,1.0
SF-B19,SF-K18,26,4,0,0,26,4,0.0,1.0,0.0,1.0
SF-B19,SF-K17,12,5,0,1,12,4,0.0,1.0,0.2,0.8
SF-B19,SF-J16,8,5,6,0,2,5,0.75,0.25,0.0,1.0
SF-B19,SF-J18,8,4,0,0,8,4,0.0,1.0,0.0,1.0
SF-B19,SF-J20,10,7,1,3,9,4,0.1,0.9,0.42857142857142855,0.5714285714285714
SF-B19,SF-J19,16,9,5,5,11,4,0.3125,0.6875,0.5555555555555556,0.4444444444444444
SF-B19,SF-M10,2,5,0,0,2,5,0.0,1.0,0.0,1.0
SF-B19,SF-M11,3,2,0,0,3,2,0.0,1.0,0.0,1.0
SF-B19,SF-R20,3,1,0,0,3,1,0.0,1.0,0.0,1.0
SF-B19,SF-Q21-2,2,4,0,0,2,4,0.0,1.0,0.0,1.0
SF-B19,SF-P21,2,1,0,0,2,1,0.0,1.0,0.0,1.0
SF-B19,SF-O19,3,8,0,0,3,8,0.0,1.0,0.0,1.0
SF-B19,SF-O21,14,7,3,1,11,6,0.21428571428571427,0.7857142857142857,0.14285714285714285,0.8571428571428571
SF-B19,SF-O22,3,4,0,0,3,4,0.0,1.0,0.0,1.0
SF-B19,SF-N20-2,3,5,0,1,3,4,0.0,1.0,0.2,0.8
SF-B19,SF-L21,4,16,0,0,4,16,0.0,1.0,0.0,1.0
SF-B19,SF-Q30,3,1,1,0,2,1,0.3333333333333333,0.6666666666666666,0.0,1.0
SF-B19,SF-P30,6,5,3,2,3,3,0.5,0.5,0.4,0.6
SF-B19,SF-O30-2,1,1,0,0,1,1,0.0,1.0,0.0,1.0
SF-B19,SF-O30,4,4,0,2,4,2,0.0,1.0,0.5,0.5
SF-B19,SF-N27,4,2,1,1,3,1,0.25,0.75,0.5,0.5
SF-B19,SF-N29,2,1,2,0,0,1,1.0,0.0,0.0,1.0
SF-B19,SF-N28,4,3,1,2,3,1,0.25,0.75,0.6666666666666666,0.3333333333333333
SF-B19,SF-L30-1,15,5,2,0,13,5,0.13333333333333333,0.8666666666666667,0.0,1.0
SF-B19,SF-L31-1,1,5,0,4,1,1,0.0,1.0,0.8,0.2
SF-B19,SF-K30-2,4,5,0,0,4,5,0.0,1.0,0.0,1.0
SF-B19,SF-L29,3,7,0,2,3,5,0.0,1.0,0.2857142857142857,0.7142857142857143
SF-B19,SF-I30,9,12,1,2,8,10,0.1111111111111111,0.8888888888888888,0.16666666666666666,0.8333333333333334
SF-B19,SF-I27,11,4,7,0,4,4,0.6363636363636364,0.36363636363636365,0.0,1.0
SF-B19,SF-I30-2,9,26,1,0,8,26,0.1111111111111111,0.8888888888888888,0.0,1.0
SF-B19,SF I29-1,3,2,0,0,3,2,0.0,1.0,0.0,1.0
SF-B19,SF-H28,16,1,9,0,7,1,0.5625,0.4375,0.0,1.0
SF-B19,SF-P26,1,1,1,1,0,0,1.0,0.0,1.0,0.0
SF-B19,SF-N25,1,1,1,0,0,1,1.0,0.0,0.0,1.0
SF-B19,SF-T22,2,2,0,0,2,2,0.0,1.0,0.0,1.0
SF-B19,SF-S22-1,1,4,0,0,1,4,0.0,1.0,0.0,1.0
SF-B19,SF-Q22-2,5,3,2,0,3,3,0.4,0.6,0.0,1.0
SF-B19,SF-P22,6,3,1,2,5,1,0.16666666666666666,0.8333333333333334,0.6666666666666666,0.3333333333333333
SF-B19,SF-T20,1,1,0,0,1,1,0.0,1.0,0.0,1.0
SF-A20,SF-M26-2,9,12,3,0,6,12,0.3333333333333333,0.6666666666666666,0.0,1.0
SF-A20,SF-K26,13,14,3,0,10,14,0.23076923076923078,0.7692307692307693,0.0,1.0
SF-A20,SF-J27,3,1,0,0,3,1,0.0,1.0,0.0,1.0
SF-A20,SF-M30,7,4,4,0,3,4,0.5714285714285714,0.42857142857142855,0.0,1.0
SF-A20,SF-J29-3,5,2,1,1,4,1,0.2,0.8,0.5,0.5
SF-A20,SF-J29,19,12,3,0,16,12,0.15789473684210525,0.8421052631578947,0.0,1.0
SF-A20,SF-M27,2,1,0,1,2,0,0.0,1.0,1.0,0.0
SF-A20,SF-L25,4,2,1,0,3,2,0.25,0.75,0.0,1.0
SF-A20,SF-M24,2,1,1,0,1,1,0.5,0.5,0.0,1.0
SF-A20,SF-N23,2,2,0,0,2,2,0.0,1.0,0.0,1.0
SF-A20,SF-K27-2,10,6,6,1,4,5,0.6,0.4,0.16666666666666666,0.8333333333333334
SF-A20,SF-J26-2,8,5,3,1,5,4,0.375,0.625,0.2,0.8
SF-A20,SF-L28,15,10,13,10,2,0,0.8666666666666667,0.13333333333333333,1.0,0.0
SF-A20,SF-K28,4,8,2,3,2,5,0.5,0.5,0.375,0.625
SF-A20,SF-K29-1,26,24,16,9,10,15,0.6153846153846154,0.38461538461538464,0.375,0.625
SF-A20,SF-J28-2,9,5,2,3,7,2,0.2222222222222222,0.7777777777777778,0.6,0.4
SF-A20,SF-K27,1,2,0,0,1,2,0.0,1.0,0.0,1.0
SF-A20,SF-K25,8,2,2,0,6,2,0.25,0.75,0.0,1.0
SF-A20,SF-J25,8,7,4,2,4,5,0.5,0.5,0.2857142857142857,0.7142857142857143
SF-A20,SF-H26-2,1,2,1,1,0,1,1.0,0.0,0.5,0.5
SF-A20,SF-P24,4,1,3,0,1,1,0.75,0.25,0.0,1.0
SF-A20,SF-J26,2,2,1,1,1,1,0.5,0.5,0.5,0.5
SF-A20,SF-I26-,1,4,0,0,1,4,0.0,1.0,0.0,1.0
SF-A20,SF-I25,11,11,9,5,2,6,0.8181818181818182,0.18181818181818182,0.45454545454545453,0.5454545454545454
SF-A20,SF-H26,36,18,31,10,5,8,0.8611111111111112,0.1388888888888889,0.5555555555555556,0.4444444444444444
SF-A20,SF-H27-1,2,1,0,1,2,0,0.0,1.0,1.0,0.0
SF-A20,SF-F28-2,11,5,4,4,7,1,0.36363636363636365,0.6363636363636364,0.8,0.2
SF-A20,SF-G27,22,15,12,8,10,7,0.5454545454545454,0.45454545454545453,0.5333333333333333,0.4666666666666667
SF-A20,SF-M22-2,7,4,0,0,7,4,0.0,1.0,0.0,1.0
SF-A20,SF-L22,8,8,3,0,5,8,0.375,0.625,0.0,1.0
SF-A20,SF-F27,9,15,4,3,5,12,0.4444444444444444,0.5555555555555556,0.2,0.8
SF-A20,SF-N22-2,4,5,2,0,2,5,0.5,0.5,0.0,1.0
SF-A20,SF-G28-2,11,19,0,0,11,19,0.0,1.0,0.0,1.0
SF-A20,SF-G28-1,6,2,3,2,3,0,0.5,0.5,1.0,0.0
SF-A20,SF-M22-1,1,1,0,0,1,1,0.0,1.0,0.0,1.0
SF-A20,SF-O25-1,1,2,0,0,1,2,0.0,1.0,0.0,1.0
SF-A20,SF-K22-2,5,4,1,0,4,4,0.2,0.8,0.0,1.0
SF-A20,SF-K24,3,9,1,1,2,8,0.3333333333333333,0.6666666666666666,0.1111111111111111,0.8888888888888888
SF-A20,SF-J23-2,47,41,44,39,3,2,0.9361702127659575,0.06382978723404255,0.9512195121951219,0.04878048780487805
SF-A20,SF-G23,7,1,3,0,4,1,0.42857142857142855,0.5714285714285714,0.0,1.0
SF-A20,SF-G24,63,72,5,5,58,67,0.07936507936507936,0.9206349206349206,0.06944444444444445,0.9305555555555556
SF-A20,SF-G25,48,16,11,1,37,15,0.22916666666666666,0.7708333333333334,0.0625,0.9375
SF-A20,SF-F23,31,35,12,4,19,31,0.3870967741935484,0.6129032258064516,0.11428571428571428,0.8857142857142857
SF-A20,SF-E23,87,70,33,5,54,65,0.3793103448275862,0.6206896551724138,0.07142857142857142,0.9285714285714286
SF-A20,SF-D24,67,29,37,3,30,26,0.5522388059701493,0.44776119402985076,0.10344827586206896,0.896551724137931
SF-A20,SF-C22,65,67,40,13,25,54,0.6153846153846154,0.38461538461538464,0.19402985074626866,0.8059701492537313
SF-A20,SF-B22,131,88,94,32,37,56,0.7175572519083969,0.2824427480916031,0.36363636363636365,0.6363636363636364
SF-A20,SF-J17,5,1,1,0,4,1,0.2,0.8,0.0,1.0
SF-A20,SF-H16,5,1,3,0,2,1,0.6,0.4,0.0,1.0
SF-A20,SF-H20,4,3,2,0,2,3,0.5,0.5,0.0,1.0
SF-A20,SF-G19,4,5,0,3,4,2,0.0,1.0,0.6,0.4
SF-A20,SF-G17,4,3,1,1,3,2,0.25,0.75,0.3333333333333333,0.6666666666666666
SF-A20,SF-G18,7,3,0,1,7,2,0.0,1.0,0.3333333333333333,0.6666666666666666
SF-A20,SF-G20,8,8,2,5,6,3,0.25,0.75,0.625,0.375
SF-A20,SF-F19,21,11,6,3,15,8,0.2857142857142857,0.7142857142857143,0.2727272727272727,0.7272727272727273
SF-A20,SF-E18,11,4,4,2,7,2,0.36363636363636365,0.6363636363636364,0.5,0.5
SF-A20,SF-E20,16,10,7,0,9,10,0.4375,0.5625,0.0,1.0
SF-A20,SF-H30,53,27,36,14,17,13,0.6792452830188679,0.32075471698113206,0.5185185185185185,0.48148148148148145
SF-A20,SF-G30-2,28,33,11,17,17,16,0.39285714285714285,0.6071428571428571,0.5151515151515151,0.48484848484848486
SF-A20,SF-F30-1,36,27,15,10,21,17,0.4166666666666667,0.5833333333333334,0.37037037037037035,0.6296296296296297
SF-A20,SF-E29-2,56,42,40,26,16,16,0.7142857142857143,0.2857142857142857,0.6190476190476191,0.38095238095238093
SF-A20,SF-E29-1,112,57,83,18,29,39,0.7410714285714286,0.25892857142857145,0.3157894736842105,0.6842105263157895
SF-A20,SF-D29,116,56,72,30,44,26,0.6206896551724138,0.3793103448275862,0.5357142857142857,0.4642857142857143
SF-A20,SF-D28,43,31,29,20,14,11,0.6744186046511628,0.32558139534883723,0.6451612903225806,0.3548387096774194
SF-A20,SF-A27,30,35,13,20,17,15,0.43333333333333335,0.5666666666666667,0.5714285714285714,0.42857142857142855
SF-A20,SF-G29-2,23,17,12,6,11,11,0.5217391304347826,0.4782608695652174,0.35294117647058826,0.6470588235294118
SF-A20,SF-G29-1,13,9,0,4,13,5,0.0,1.0,0.4444444444444444,0.5555555555555556
SF-A20,SF-G30-1,28,28,16,14,12,14,0.5714285714285714,0.42857142857142855,0.5,0.5
SF-A20,SF-G29-3,20,7,18,1,2,6,0.9,0.1,0.14285714285714285,0.8571428571428571
SF-A20,SF-F30-2,29,22,15,7,14,15,0.5172413793103449,0.4827586206896552,0.3181818181818182,0.6818181818181818
SF-A20,SF-F29,17,13,15,12,2,1,0.8823529411764706,0.11764705882352941,0.9230769230769231,0.07692307692307693
SF-A20,SF-E29-3,79,27,68,26,11,1,0.8607594936708861,0.13924050632911392,0.9629629629629629,0.037037037037037035
SF-A20,SF-F28-1,2,10,0,7,2,3,0.0,1.0,0.7,0.3
SF-A20,SF-E28-2,8,11,1,0,7,11,0.125,0.875,0.0,1.0
SF-A20,SF-E28,28,9,16,3,12,6,0.5714285714285714,0.42857142857142855,0.3333333333333333,0.6666666666666666
SF-A20,SF-J10,10,4,6,0,4,4,0.6,0.4,0.0,1.0
SF-A20,SF-J12,15,2,2,2,13,0,0.13333333333333333,0.8666666666666667,1.0,0.0
SF-A20,SF-J13,2,6,0,2,2,4,0.0,1.0,0.3333333333333333,0.6666666666666666
SF-A20,SF-H13,8,4,3,2,5,2,0.375,0.625,0.5,0.5
SF-A20,SF-I16,3,3,1,0,2,3,0.3333333333333333,0.6666666666666666,0.0,1.0
SF-A20,SF-H12,6,1,1,0,5,1,0.16666666666666666,0.8333333333333334,0.0,1.0
SF-A20,SF-G10-2,3,1,0,0,3,1,0.0,1.0,0.0,1.0
SF-A20,SF-G13,9,8,1,2,8,6,0.1111111111111111,0.8888888888888888,0.25,0.75
SF-A20,SF-G12,22,5,5,2,17,3,0.22727272727272727,0.7727272727272727,0.4,0.6
SF-A20,SF-G10-1,2,3,0,0,2,3,0.0,1.0,0.0,1.0
SF-A20,SF-F15,19,11,6,8,13,3,0.3157894736842105,0.6842105263157895,0.7272727272727273,0.2727272727272727
SF-A20,SF-F16,10,4,3,0,7,4,0.3,0.7,0.0,1.0
SF-A20,SF-C21,19,22,11,5,8,17,0.5789473684210527,0.42105263157894735,0.22727272727272727,0.7727272727272727
SF-A20,SF-C20,61,60,35,35,26,25,0.5737704918032787,0.4262295081967213,0.5833333333333334,0.4166666666666667
SF-A20,SF-B21,40,44,20,9,20,35,0.5,0.5,0.20454545454545456,0.7954545454545454
SF-A20,SF-B19,115,135,75,101,40,34,0.6521739130434783,0.34782608695652173,0.7481481481481481,0.2518518518518518
SF-A20,SF-A19,38,42,25,24,13,18,0.6578947368421053,0.34210526315789475,0.5714285714285714,0.42857142857142855
SF-A20,SF-C26,32,44,6,15,26,29,0.1875,0.8125,0.3409090909090909,0.6590909090909091
SF-A20,SF-C25,211,136,55,46,156,90,0.26066350710900477,0.7393364928909952,0.3382352941176471,0.6617647058823529
SF-A20,SF-B25,82,77,37,36,45,41,0.45121951219512196,0.5487804878048781,0.4675324675324675,0.5324675324675324
SF-A20,SF-E27,16,25,5,13,11,12,0.3125,0.6875,0.52,0.48
SF-A20,SF-B28-2,7,5,0,5,7,0,0.0,1.0,1.0,0.0
SF-A20,SF-D27,45,37,22,3,23,34,0.4888888888888889,0.5111111111111111,0.08108108108108109,0.918918918918919
SF-A20,SF-C28-2,12,12,9,5,3,7,0.75,0.25,0.4166666666666667,0.5833333333333334
SF-A20,SF-C28-1,21,15,16,8,5,7,0.7619047619047619,0.23809523809523808,0.5333333333333333,0.4666666666666667
SF-A20,SF-B28,130,46,98,36,32,10,0.7538461538461538,0.24615384615384617,0.782608695652174,0.21739130434782608
SF-A20,SF-H0,2,3,0,0,2,3,0.0,1.0,0.0,1.0
SF-A20,SF-J5,3,2,1,0,2,2,0.3333333333333333,0.6666666666666666,0.0,1.0
SF-A20,SF-G6,11,10,3,1,8,9,0.2727272727272727,0.7272727272727273,0.1,0.9
SF-A20,SF-G8,2,2,2,0,0,2,1.0,0.0,0.0,1.0
SF-A20,SF-G5,9,19,8,5,1,14,0.8888888888888888,0.1111111111111111,0.2631578947368421,0.7368421052631579
SF-A20,SF-G7,5,8,1,5,4,3,0.2,0.8,0.625,0.375
SF-A20,SF-F9,10,23,6,9,4,14,0.6,0.4,0.391304347826087,0.6086956521739131
SF-A20,SF-H25,1,3,0,0,1,3,0.0,1.0,0.0,1.0
SF-A20,SF-G26,10,6,4,1,6,5,0.4,0.6,0.16666666666666666,0.8333333333333334
SF-A20,SF-K21,4,7,1,0,3,7,0.25,0.75,0.0,1.0
SF-A20,SF-K22-1,1,4,1,0,0,4,1.0,0.0,0.0,1.0
SF-A20,SF-J23-1,12,19,6,0,6,19,0.5,0.5,0.0,1.0
SF-A20,SF-J22-1,9,7,2,4,7,3,0.2222222222222222,0.7777777777777778,0.5714285714285714,0.42857142857142855
SF-A20,SF-J22-2,10,5,1,0,9,5,0.1,0.9,0.0,1.0
SF-A20,SF-J21,4,11,0,0,4,11,0.0,1.0,0.0,1.0
SF-A20,SF-I21,6,4,0,2,6,2,0.0,1.0,0.5,0.5
SF-A20,SF-I22,15,13,4,2,11,11,0.26666666666666666,0.7333333333333333,0.15384615384615385,0.8461538461538461
SF-A20,SF-I23-2,11,15,5,4,6,11,0.45454545454545453,0.5454545454545454,0.26666666666666666,0.7333333333333333
SF-A20,SF-I24,4,1,0,0,4,1,0.0,1.0,0.0,1.0
SF-A20,SF-I23-1,6,3,1,3,5,0,0.16666666666666666,0.8333333333333334,1.0,0.0
SF-A20,SF-F26,24,7,13,0,11,7,0.5416666666666666,0.4583333333333333,0.0,1.0
SF-A20,SF-M13,2,4,0,0,2,4,0.0,1.0,0.0,1.0
SF-A20,SF-M15,6,7,2,0,4,7,0.3333333333333333,0.6666666666666666,0.0,1.0
SF-A20,SF-L19,12,7,0,1,12,6,0.0,1.0,0.14285714285714285,0.8571428571428571
SF-A20,SF-L20,3,3,3,1,0,2,1.0,0.0,0.3333333333333333,0.6666666666666666
SF-A20,SF-M20,3,4,0,0,3,4,0.0,1.0,0.0,1.0
SF-A20,SF-K17-2,1,2,0,0,1,2,0.0,1.0,0.0,1.0
SF-A20,SF-K20,6,4,1,0,5,4,0.16666666666666666,0.8333333333333334,0.0,1.0
SF-A20,SF-K15-,7,4,1,3,6,1,0.14285714285714285,0.8571428571428571,0.75,0.25
SF-A20,SF-K19,9,2,6,0,3,2,0.6666666666666666,0.3333333333333333,0.0,1.0
SF-A20,SF-K18,4,8,1,0,3,8,0.25,0.75,0.0,1.0
SF-A20,SF-K17,14,3,4,0,10,3,0.2857142857142857,0.7142857142857143,0.0,1.0
SF-A20,SF-J16,2,5,1,0,1,5,0.5,0.5,0.0,1.0
SF-A20,SF-J18,8,7,1,1,7,6,0.125,0.875,0.14285714285714285,0.8571428571428571
SF-A20,SF-J20,1,2,0,0,1,2,0.0,1.0,0.0,1.0
SF-A20,SF-J19,13,13,4,2,9,11,0.3076923076923077,0.6923076923076923,0.15384615384615385,0.8461538461538461
SF-A20,SF-O12,5,1,0,0,5,1,0.0,1.0,0.0,1.0
SF-A20,SF-M12,1,2,0,0,1,2,0.0,1.0,0.0,1.0
SF-A20,SF-Q21-2,3,1,0,0,3,1,0.0,1.0,0.0,1.0
SF-A20,SF-Q21-1,2,2,0,0,2,2,0.0,1.0,0.0,1.0
SF-A20,SF-P21,5,8,0,0,5,8,0.0,1.0,0.0,1.0
SF-A20,SF-O18,7,8,2,0,5,8,0.2857142857142857,0.7142857142857143,0.0,1.0
SF-A20,SF-O19,5,1,3,0,2,1,0.6,0.4,0.0,1.0
SF-A20,SF-O21,9,11,2,0,7,11,0.2222222222222222,0.7777777777777778,0.0,1.0
SF-A20,SF-O22,4,1,1,0,3,1,0.25,0.75,0.0,1.0
SF-A20,SF-N21,7,4,5,1,2,3,0.7142857142857143,0.2857142857142857,0.25,0.75
SF-A20,SF-N20-2,4,2,2,0,2,2,0.5,0.5,0.0,1.0
SF-A20,SF-M21,1,1,0,0,1,1,0.0,1.0,0.0,1.0
SF-A20,SF-L21,8,9,0,1,8,8,0.0,1.0,0.1111111111111111,0.8888888888888888
SF-A20,SF-Q30,3,2,3,0,0,2,1.0,0.0,0.0,1.0
SF-A20,SF-P30,6,4,4,3,2,1,0.6666666666666666,0.3333333333333333,0.75,0.25
SF-A20,SF-O30-2,13,33,9,10,4,23,0.6923076923076923,0.3076923076923077,0.30303030303030304,0.696969696969697
SF-A20,SF-O30,6,8,2,0,4,8,0.3333333333333333,0.6666666666666666,0.0,1.0
SF-A20,SF-N27,5,6,0,0,5,6,0.0,1.0,0.0,1.0
SF-A20,SF-N29,2,3,0,1,2,2,0.0,1.0,0.3333333333333333,0.6666666666666666
SF-A20,SF-L30-1,20,9,11,3,9,6,0.55,0.45,0.3333333333333333,0.6666666666666666
SF-A20,SF-L31-1,7,3,3,2,4,1,0.42857142857142855,0.5714285714285714,0.6666666666666666,0.3333333333333333
SF-A20,SF-K30-2,2,2,0,2,2,0,0.0,1.0,1.0,0.0
SF-A20,SF-L29,17,8,7,2,10,6,0.4117647058823529,0.5882352941176471,0.25,0.75
SF-A20,SF-J29-1,19,11,11,2,8,9,0.5789473684210527,0.42105263157894735,0.18181818181818182,0.8181818181818182
SF-A20,SF-I30,21,8,11,1,10,7,0.5238095238095238,0.47619047619047616,0.125,0.875
SF-A20,SF-I29-2,5,1,3,1,2,0,0.6,0.4,1.0,0.0
SF-A20,SF-I27,8,5,4,2,4,3,0.5,0.5,0.4,0.6
SF-A20,SF-I28,3,3,0,0,3,3,0.0,1.0,0.0,1.0
SF-A20,SF-I30-2,11,8,6,2,5,6,0.5454545454545454,0.45454545454545453,0.25,0.75
SF-A20,SF I29-1,6,1,0,0,6,1,0.0,1.0,0.0,1.0
SF-A20,SF-H28,17,3,9,1,8,2,0.5294117647058824,0.47058823529411764,0.3333333333333333,0.6666666666666666
SF-A20,SF-H29,4,1,2,0,2,1,0.5,0.5,0.0,1.0
SF-A20,SF-S24,3,5,1,0,2,5,0.3333333333333333,0.6666666666666666,0.0,1.0
SF-A20,SF-R24,3,2,0,0,3,2,0.0,1.0,0.0,1.0
SF-A20,SF-R26,1,1,1,0,0,1,1.0,0.0,0.0,1.0
SF-A20,SF-O25-2,6,1,0,0,6,1,0.0,1.0,0.0,1.0
SF-A20,SF-T22,1,3,0,3,1,0,0.0,1.0,1.0,0.0
SF-A20,SF-S22-1,1,1,0,0,1,1,0.0,1.0,0.0,1.0
SF-A20,SF-Q23-3,5,1,0,0,5,1,0.0,1.0,0.0,1.0
SF-A20,SF-Q22-1,2,1,0,0,2,1,0.0,1.0,0.0,1.0
SF-A20,SF-Q22-2,4,5,1,1,3,4,0.25,0.75,0.2,0.8
SF-A20,SF-P22,7,6,5,3,2,3,0.7142857142857143,0.2857142857142857,0.5,0.5
SF-A20,SF-W19,1,1,0,0,1,1,0.0,1.0,0.0,1.0
SF-A20,SF-W14,3,2,0,0,3,2,0.0,1.0,0.0,1.0
SF-A19,SF-J29,6,1,1,1,5,0,0.16666666666666666,0.8333333333333334,1.0,0.0
SF-A19,SF-K27-2,2,3,2,0,0,3,1.0,0.0,0.0,1.0
SF-A19,SF-J26-2,1,2,0,0,1,2,0.0,1.0,0.0,1.0
SF-A19,SF-L28,1,1,0,1,1,0,0.0,1.0,1.0,0.0
SF-A19,SF-K28,2,2,1,2,1,0,0.5,0.5,1.0,0.0
SF-A19,SF-K29-1,10,6,5,2,5,4,0.5,0.5,0.3333333333333333,0.6666666666666666
SF-A19,SF-J28-2,1,1,0,0,1,1,0.0,1.0,0.0,1.0
SF-A19,SF-J25,1,2,0,1,1,1,0.0,1.0,0.5,0.5
SF-A19,SF-J24,1,2,1,0,0,2,1.0,0.0,0.0,1.0
SF-A19,SF-H26,4,4,3,1,1,3,0.75,0.25,0.25,0.75
SF-A19,SF-F28-2,8,2,0,1,8,1,0.0,1.0,0.5,0.5
SF-A19,SF-L22,1,7,0,0,1,7,0.0,1.0,0.0,1.0
SF-A19,SF-F27,4,1,3,0,1,1,0.75,0.25,0.0,1.0
SF-A19,SF-N22-2,2,2,0,0,2,2,0.0,1.0,0.0,1.0
SF-A19,SF-K22-2,1,1,1,0,0,1,1.0,0.0,0.0,1.0
SF-A19,SF-J23-2,3,2,2,1,1,1,0.6666666666666666,0.3333333333333333,0.5,0.5
SF-A19,SF-G23,1,3,0,1,1,2,0.0,1.0,0.3333333333333333,0.6666666666666666
SF-A19,SF-G24,11,3,2,0,9,3,0.18181818181818182,0.8181818181818182,0.0,1.0
SF-A19,SF-G25,1,3,1,0,0,3,1.0,0.0,0.0,1.0
SF-A19,SF-F23,12,4,8,1,4,3,0.6666666666666666,0.3333333333333333,0.25,0.75
SF-A19,SF-E23,27,14,16,3,11,11,0.5925925925925926,0.4074074074074074,0.21428571428571427,0.7857142857142857
SF-A19,SF-D24,8,2,3,0,5,2,0.375,0.625,0.0,1.0
SF-A19,SF-C22,16,6,13,2,3,4,0.8125,0.1875,0.3333333333333333,0.6666666666666666
SF-A19,SF-B22,35,45,25,24,10,21,0.7142857142857143,0.2857142857142857,0.5333333333333333,0.4666666666666667
SF-A19,SF-I20,2,5,1,1,1,4,0.5,0.5,0.2,0.8
SF-A19,SF-G19,6,3,1,1,5,2,0.16666666666666666,0.8333333333333334,0.3333333333333333,0.6666666666666666
SF-A19,SF-G17,4,2,2,0,2,2,0.5,0.5,0.0,1.0
SF-A19,SF-G20,2,2,1,1,1,1,0.5,0.5,0.5,0.5
SF-A19,SF-F19,19,20,2,0,17,20,0.10526315789473684,0.8947368421052632,0.0,1.0
SF-A19,SF-E18,5,3,2,2,3,1,0.4,0.6,0.6666666666666666,0.3333333333333333
SF-A19,SF-E20,15,3,3,1,12,2,0.2,0.8,0.3333333333333333,0.6666666666666666
SF-A19,SF-H30,8,4,5,3,3,1,0.625,0.375,0.75,0.25
SF-A19,SF-G30-2,1,5,1,2,0,3,1.0,0.0,0.4,0.6
SF-A19,SF-F30-1,4,8,1,0,3,8,0.25,0.75,0.0,1.0
SF-A19,SF-E29-2,15,11,9,6,6,5,0.6,0.4,0.5454545454545454,0.45454545454545453
SF-A19,SF-E29-1,18,3,17,3,1,0,0.9444444444444444,0.05555555555555555,1.0,0.0
SF-A19,SF-D29,32,14,19,8,13,6,0.59375,0.40625,0.5714285714285714,0.42857142857142855
SF-A19,SF-D28,9,5,7,4,2,1,0.7777777777777778,0.2222222222222222,0.8,0.2
SF-A19,SF-A27,6,17,3,13,3,4,0.5,0.5,0.7647058823529411,0.23529411764705882
SF-A19,SF-G29-2,9,5,5,1,4,4,0.5555555555555556,0.4444444444444444,0.2,0.8
SF-A19,SF-G30-1,11,7,6,4,5,3,0.5454545454545454,0.45454545454545453,0.5714285714285714,0.42857142857142855
SF-A19,SF-G29-3,1,1,1,1,0,0,1.0,0.0,1.0,0.0
SF-A19,SF-F30-2,8,1,8,0,0,1,1.0,0.0,0.0,1.0
SF-A19,SF-F29,2,5,0,5,2,0,0.0,1.0,1.0,0.0
SF-A19,SF-E29-3,4,6,2,4,2,2,0.5,0.5,0.6666666666666666,0.3333333333333333
SF-A19,SF-F28-1,2,3,1,1,1,2,0.5,0.5,0.3333333333333333,0.6666666666666666
SF-A19,SF-E28-2,2,3,1,0,1,3,0.5,0.5,0.0,1.0
SF-A19,SF-E28,5,7,4,3,1,4,0.8,0.2,0.42857142857142855,0.5714285714285714
SF-A19,SF-J12,3,2,2,0,1,2,0.6666666666666666,0.3333333333333333,0.0,1.0
SF-A19,SF-J13,4,1,3,1,1,0,0.75,0.25,1.0,0.0
SF-A19,SF-H13,3,1,1,0,2,1,0.3333333333333333,0.6666666666666666,0.0,1.0
SF-A19,SF-I16,1,1,1,0,0,1,1.0,0.0,0.0,1.0
SF-A19,SF-H12,2,2,0,0,2,2,0.0,1.0,0.0,1.0
SF-A19,SF-G10-2,6,1,2,1,4,0,0.3333333333333333,0.6666666666666666,1.0,0.0
SF-A19,SF-G13,5,9,1,3,4,6,0.2,0.8,0.3333333333333333,0.6666666666666666
SF-A19,SF-G12,5,1,0,0,5,1,0.0,1.0,0.0,1.0
SF-A19,SF-G10-1,1,2,0,0,1,2,0.0,1.0,0.0,1.0
SF-A19,SF-F15,3,5,3,1,0,4,1.0,0.0,0.2,0.8
SF-A19,SF-C21,16,17,13,7,3,10,0.8125,0.1875,0.4117647058823529,0.5882352941176471
SF-A19,SF-C20,48,55,34,43,14,12,0.7083333333333334,0.2916666666666667,0.7818181818181819,0.21818181818181817
SF-A19,SF-B21,5,11,4,6,1,5,0.8,0.2,0.5454545454545454,0.45454545454545453
SF-A19,SF-B19,53,30,27,20,26,10,0.5094339622641509,0.49056603773584906,0.6666666666666666,0.3333333333333333
SF-A19,SF-A20,42,38,24,25,18,13,0.5714285714285714,0.42857142857142855,0.6578947368421053,0.34210526315789475
SF-A19,SF-C26,7,4,3,2,4,2,0.42857142857142855,0.5714285714285714,0.5,0.5
SF-A19,SF-C25,23,14,8,7,15,7,0.34782608695652173,0.6521739130434783,0.5,0.5
SF-A19,SF-B25,34,26,13,17,21,9,0.38235294117647056,0.6176470588235294,0.6538461538461539,0.34615384615384615
SF-A19,SF-E27,3,1,2,1,1,0,0.6666666666666666,0.3333333333333333,1.0,0.0
SF-A19,SF-D27,8,5,5,2,3,3,0.625,0.375,0.4,0.6
SF-A19,SF-C28-2,3,4,2,3,1,1,0.6666666666666666,0.3333333333333333,0.75,0.25
SF-A19,SF-C28-1,9,1,6,0,3,1,0.6666666666666666,0.3333333333333333,0.0,1.0
SF-A19,SF-B28,20,10,14,7,6,3,0.7,0.3,0.7,0.3
SF-A19,SF-G5,4,7,1,3,3,4,0.25,0.75,0.42857142857142855,0.5714285714285714
SF-A19,SF-G7,3,7,0,0,3,7,0.0,1.0,0.0,1.0
SF-A19,SF-F9,7,4,5,0,2,4,0.7142857142857143,0.2857142857142857,0.0,1.0
SF-A19,SF-K21,2,2,0,0,2,2,0.0,1.0,0.0,1.0
SF-A19,SF-K22-1,2,2,2,1,0,1,1.0,0.0,0.5,0.5
SF-A19,SF-J23-1,6,2,2,0,4,2,0.3333333333333333,0.6666666666666666,0.0,1.0
SF-A19,SF-J22-2,4,2,1,1,3,1,0.25,0.75,0.5,0.5
SF-A19,SF-I21,3,2,3,0,0,2,1.0,0.0,0.0,1.0
SF-A19,SF-I23-2,3,4,2,2,1,2,0.6666666666666666,0.3333333333333333,0.5,0.5
SF-A19,SF-I24,1,1,1,0,0,1,1.0,0.0,0.0,1.0
SF-A19,SF-I23-1,4,1,1,0,3,1,0.25,0.75,0.0,1.0
SF-A19,SF-F26,13,7,9,1,4,6,0.6923076923076923,0.3076923076923077,0.14285714285714285,0.8571428571428571
SF-A19,SF-M15,2,1,0,0,2,1,0.0,1.0,0.0,1.0
SF-A19,SF-M20,4,3,0,0,4,3,0.0,1.0,0.0,1.0
SF-A19,SF-K17-2,1,2,0,0,1,2,0.0,1.0,0.0,1.0
SF-A19,SF-K20,1,3,1,1,0,2,1.0,0.0,0.3333333333333333,0.6666666666666666
SF-A19,SF-K15-,8,3,3,0,5,3,0.375,0.625,0.0,1.0
SF-A19,SF-K19,2,1,0,1,2,0,0.0,1.0,1.0,0.0
SF-A19,SF-K18,2,1,0,0,2,1,0.0,1.0,0.0,1.0
SF-A19,SF-K17,4,3,1,0,3,3,0.25,0.75,0.0,1.0
SF-A19,SF-J18,3,2,0,0,3,2,0.0,1.0,0.0,1.0
SF-A19,SF-J20,3,1,1,0,2,1,0.3333333333333333,0.6666666666666666,0.0,1.0
SF-A19,SF-J19,3,4,2,0,1,4,0.6666666666666666,0.3333333333333333,0.0,1.0
SF-A19,SF-M11,1,2,0,0,1,2,0.0,1.0,0.0,1.0
SF-A19,SF-R19,3,1,0,0,3,1,0.0,1.0,0.0,1.0
SF-A19,SF-O18,3,1,0,0,3,1,0.0,1.0,0.0,1.0
SF-A19,SF-O19,4,3,1,0,3,3,0.25,0.75,0.0,1.0
SF-A19,SF-O22,4,5,2,0,2,5,0.5,0.5,0.0,1.0
SF-A19,SF-N20-2,2,2,0,0,2,2,0.0,1.0,0.0,1.0
SF-A19,SF-M21,4,2,1,2,3,0,0.25,0.75,1.0,0.0
SF-A19,SF-Q30,1,1,0,0,1,1,0.0,1.0,0.0,1.0
SF-A19,SF-P30,3,1,0,1,3,0,0.0,1.0,1.0,0.0
SF-A19,SF-O30-2,3,1,1,0,2,1,0.3333333333333333,0.6666666666666666,0.0,1.0
SF-A19,SF-O30,7,3,3,0,4,3,0.42857142857142855,0.5714285714285714,0.0,1.0
SF-A19,SF-N27,4,2,2,0,2,2,0.5,0.5,0.0,1.0
SF-A19,SF-N28,2,3,1,3,1,0,0.5,0.5,1.0,0.0
SF-A19,SF-L30-1,7,6,4,2,3,4,0.5714285714285714,0.42857142857142855,0.3333333333333333,0.6666666666666666
SF-A19,SF-L31-1,4,2,2,0,2,2,0.5,0.5,0.0,1.0
SF-A19,SF-K30-2,3,1,2,0,1,1,0.6666666666666666,0.3333333333333333,0.0,1.0
SF-A19,SF-L29,2,2,1,1,1,1,0.5,0.5,0.5,0.5
SF-A19,SF-J29-1,8,2,6,0,2,2,0.75,0.25,0.0,1.0
SF-A19,SF-I30,1,1,0,0,1,1,0.0,1.0,0.0,1.0
SF-A19,SF-H28,3,3,2,0,1,3,0.6666666666666666,0.3333333333333333,0.0,1.0
SF-A19,SF-R24,1,1,1,0,0,1,1.0,0.0,0.0,1.0
SF-A19,SF-Q26,1,1,0,1,1,0,0.0,1.0,1.0,0.0
SF-A19,SF-N26,1,2,0,0,1,2,0.0,1.0,0.0,1.0
SF-A19,SF-T20,1,2,0,0,1,2,0.0,1.0,0.0,1.0
SF-C26,SF-M26-2,6,2,1,0,5,2,0.16666666666666666,0.8333333333333334,0.0,1.0
SF-C26,SF-L27,6,1,1,0,5,1,0.16666666666666666,0.8333333333333334,0.0,1.0
SF-C26,SF-K26,7,7,0,5,7,2,0.0,1.0,0.7142857142857143,0.2857142857142857
SF-C26,SF-J27,2,4,1,1,1,3,0.5,0.5,0.25,0.75
SF-C26,SF-M30,26,57,1,7,25,50,0.038461538461538464,0.9615384615384616,0.12280701754385964,0.8771929824561403
SF-C26,SF-J29-3,23,41,3,25,20,16,0.13043478260869565,0.8695652173913043,0.6097560975609756,0.3902439024390244
SF-C26,SF-J29,60,84,6,15,54,69,0.1,0.9,0.17857142857142858,0.8214285714285714
SF-C26,SF-L25,9,9,3,3,6,6,0.3333333333333333,0.6666666666666666,0.3333333333333333,0.6666666666666666
SF-C26,SF-L24,6,8,1,2,5,6,0.16666666666666666,0.8333333333333334,0.25,0.75
SF-C26,SF-N23,3,27,1,21,2,6,0.3333333333333333,0.6666666666666666,0.7777777777777778,0.2222222222222222
SF-C26,SF-N24-2,2,1,1,0,1,1,0.5,0.5,0.0,1.0
SF-C26,SF-K27-2,6,8,4,6,2,2,0.6666666666666666,0.3333333333333333,0.75,0.25
SF-C26,SF-J26-2,11,9,5,5,6,4,0.45454545454545453,0.5454545454545454,0.5555555555555556,0.4444444444444444
SF-C26,SF-L28,5,9,4,9,1,0,0.8,0.2,1.0,0.0
SF-C26,SF-K28,3,2,0,1,3,1,0.0,1.0,0.5,0.5
SF-C26,SF-K29-1,69,37,15,12,54,25,0.21739130434782608,0.782608695652174,0.32432432432432434,0.6756756756756757
SF-C26,SF-J28-2,13,2,2,1,11,1,0.15384615384615385,0.8461538461538461,0.5,0.5
SF-C26,SF-K27,1,4,0,3,1,1,0.0,1.0,0.75,0.25
SF-C26,SF-K25,3,3,0,2,3,1,0.0,1.0,0.6666666666666666,0.3333333333333333
SF-C26,SF-J25,5,8,4,4,1,4,0.8,0.2,0.5,0.5
SF-C26,SF-H26-2,73,195,23,24,50,171,0.3150684931506849,0.684931506849315,0.12307692307692308,0.8769230769230769
SF-C26,SF-J24,5,2,1,1,4,1,0.2,0.8,0.5,0.5
SF-C26,SF-J26,2,2,2,2,0,0,1.0,0.0,1.0,0.0
SF-C26,SF-I26-,7,19,5,10,2,9,0.7142857142857143,0.2857142857142857,0.5263157894736842,0.47368421052631576
SF-C26,SF-I25,17,21,6,11,11,10,0.35294117647058826,0.6470588235294118,0.5238095238095238,0.47619047619047616
SF-C26,SF-K23,1,1,0,0,1,1,0.0,1.0,0.0,1.0
SF-C26,SF-H26,34,27,11,12,23,15,0.3235294117647059,0.6764705882352942,0.4444444444444444,0.5555555555555556
SF-C26,SF-O23,4,2,0,1,4,1,0.0,1.0,0.5,0.5
SF-C26,SF-H27-1,7,11,3,3,4,8,0.42857142857142855,0.5714285714285714,0.2727272727272727,0.7272727272727273
SF-C26,SF-F28-2,68,64,17,24,51,40,0.25,0.75,0.375,0.625
SF-C26,SF-G27,104,68,42,28,62,40,0.40384615384615385,0.5961538461538461,0.4117647058823529,0.5882352941176471
SF-C26,SF-M22-2,9,9,0,0,9,9,0.0,1.0,0.0,1.0
SF-C26,SF-L22,12,5,4,0,8,5,0.3333333333333333,0.6666666666666666,0.0,1.0
SF-C26,SF-F27,58,35,19,16,39,19,0.3275862068965517,0.6724137931034483,0.45714285714285713,0.5428571428571428
SF-C26,SF-N22-2,10,12,2,3,8,9,0.2,0.8,0.25,0.75
SF-C26,SF-G28-2,11,5,10,1,1,4,0.9090909090909091,0.09090909090909091,0.2,0.8
SF-C26,SF-G28-1,8,7,6,4,2,3,0.75,0.25,0.5714285714285714,0.42857142857142855
SF-C26,SF-O25-1,2,5,1,1,1,4,0.5,0.5,0.2,0.8
SF-C26,SF-K22-2,2,4,0,0,2,4,0.0,1.0,0.0,1.0
SF-C26,SF-K24,2,1,0,0,2,1,0.0,1.0,0.0,1.0
SF-C26,SF-J23-2,5,2,0,1,5,1,0.0,1.0,0.5,0.5
SF-C26,SF-G23,12,27,5,1,7,26,0.4166666666666667,0.5833333333333334,0.037037037037037035,0.9629629629629629
SF-C26,SF-G24,21,23,2,2,19,21,0.09523809523809523,0.9047619047619048,0.08695652173913043,0.9130434782608695
SF-C26,SF-G25,17,62,3,4,14,58,0.17647058823529413,0.8235294117647058,0.06451612903225806,0.9354838709677419
SF-C26,SF-F23,16,4,3,0,13,4,0.1875,0.8125,0.0,1.0
SF-C26,SF-E23,56,37,11,12,45,25,0.19642857142857142,0.8035714285714286,0.32432432432432434,0.6756756756756757
SF-C26,SF-D24,21,4,11,1,10,3,0.5238095238095238,0.47619047619047616,0.25,0.75
SF-C26,SF-C22,5,10,0,1,5,9,0.0,1.0,0.1,0.9
SF-C26,SF-B22,10,18,6,5,4,13,0.6,0.4,0.2777777777777778,0.7222222222222222
SF-C26,SF-J17,4,2,0,0,4,2,0.0,1.0,0.0,1.0
SF-C26,SF-I19,1,4,0,0,1,4,0.0,1.0,0.0,1.0
SF-C26,SF-I20,3,4,1,0,2,4,0.3333333333333333,0.6666666666666666,0.0,1.0
SF-C26,SF-H16,2,1,2,1,0,0,1.0,0.0,1.0,0.0
SF-C26,SF-H20,3,1,1,0,2,1,0.3333333333333333,0.6666666666666666,0.0,1.0
SF-C26,SF-H18,3,1,3,0,0,1,1.0,0.0,0.0,1.0
SF-C26,SF-G19,4,7,1,0,3,7,0.25,0.75,0.0,1.0
SF-C26,SF-G17,1,4,0,0,1,4,0.0,1.0,0.0,1.0
SF-C26,SF-G18,3,5,1,0,2,5,0.3333333333333333,0.6666666666666666,0.0,1.0
SF-C26,SF-G20,23,12,0,2,23,10,0.0,1.0,0.16666666666666666,0.8333333333333334
SF-C26,SF-F19,4,14,0,0,4,14,0.0,1.0,0.0,1.0
SF-C26,SF-E18,9,5,1,0,8,5,0.1111111111111111,0.8888888888888888,0.0,1.0
SF-C26,SF-E20,11,7,1,0,10,7,0.09090909090909091,0.9090909090909091,0.0,1.0
SF-C26,SF-H30,32,37,9,18,23,19,0.28125,0.71875,0.4864864864864865,0.5135135135135135
SF-C26,SF-G30-2,51,50,10,19,41,31,0.19607843137254902,0.803921568627451,0.38,0.62
SF-C26,SF-F30-1,13,21,3,11,10,10,0.23076923076923078,0.7692307692307693,0.5238095238095238,0.47619047619047616
SF-C26,SF-E29-2,25,29,12,14,13,15,0.48,0.52,0.4827586206896552,0.5172413793103449
SF-C26,SF-E29-1,31,10,14,6,17,4,0.45161290322580644,0.5483870967741935,0.6,0.4
SF-C26,SF-D29,32,36,10,21,22,15,0.3125,0.6875,0.5833333333333334,0.4166666666666667
SF-C26,SF-D28,36,37,11,20,25,17,0.3055555555555556,0.6944444444444444,0.5405405405405406,0.4594594594594595
SF-C26,SF-A27,25,25,18,13,7,12,0.72,0.28,0.52,0.48
SF-C26,SF-G29-2,31,23,10,6,21,17,0.3225806451612903,0.6774193548387096,0.2608695652173913,0.7391304347826086
SF-C26,SF-G29-1,39,37,5,10,34,27,0.1282051282051282,0.8717948717948718,0.2702702702702703,0.7297297297297297
SF-C26,SF-G30-1,14,15,2,9,12,6,0.14285714285714285,0.8571428571428571,0.6,0.4
SF-C26,SF-G29-3,20,13,7,6,13,7,0.35,0.65,0.46153846153846156,0.5384615384615384
SF-C26,SF-F30-2,9,14,4,8,5,6,0.4444444444444444,0.5555555555555556,0.5714285714285714,0.42857142857142855
SF-C26,SF-F29,8,11,5,4,3,7,0.625,0.375,0.36363636363636365,0.6363636363636364
SF-C26,SF-E29-3,15,10,7,6,8,4,0.4666666666666667,0.5333333333333333,0.6,0.4
SF-C26,SF-F28-1,13,12,3,7,10,5,0.23076923076923078,0.7692307692307693,0.5833333333333334,0.4166666666666667
SF-C26,SF-E28-2,9,15,2,7,7,8,0.2222222222222222,0.7777777777777778,0.4666666666666667,0.5333333333333333
SF-C26,SF-E28,30,22,9,7,21,15,0.3,0.7,0.3181818181818182,0.6818181818181818
SF-C26,SF-J12,3,3,0,0,3,3,0.0,1.0,0.0,1.0
SF-C26,SF-J13,1,5,1,0,0,5,1.0,0.0,0.0,1.0
SF-C26,SF-J15,3,2,0,0,3,2,0.0,1.0,0.0,1.0
SF-C26,SF-H13,1,1,0,0,1,1,0.0,1.0,0.0,1.0
SF-C26,SF-H12,2,2,0,0,2,2,0.0,1.0,0.0,1.0
SF-C26,SF-G13,4,5,0,0,4,5,0.0,1.0,0.0,1.0
SF-C26,SF-G12,5,2,0,0,5,2,0.0,1.0,0.0,1.0
SF-C26,SF-G10-1,1,2,0,0,1,2,0.0,1.0,0.0,1.0
SF-C26,SF-F15,3,8,0,1,3,7,0.0,1.0,0.125,0.875
SF-C26,SF-F16,2,3,0,0,2,3,0.0,1.0,0.0,1.0
SF-C26,SF-C21,1,1,0,0,1,1,0.0,1.0,0.0,1.0
SF-C26,SF-C20,23,18,1,2,22,16,0.043478260869565216,0.9565217391304348,0.1111111111111111,0.8888888888888888
SF-C26,SF-B21,8,11,3,0,5,11,0.375,0.625,0.0,1.0
SF-C26,SF-B19,9,32,4,18,5,14,0.4444444444444444,0.5555555555555556,0.5625,0.4375
SF-C26,SF-A20,44,32,15,6,29,26,0.3409090909090909,0.6590909090909091,0.1875,0.8125
SF-C26,SF-A19,4,7,2,3,2,4,0.5,0.5,0.42857142857142855,0.5714285714285714
SF-C26,SF-C25,33,41,18,18,15,23,0.5454545454545454,0.45454545454545453,0.43902439024390244,0.5609756097560976
SF-C26,SF-B25,27,24,10,7,17,17,0.37037037037037035,0.6296296296296297,0.2916666666666667,0.7083333333333334
SF-C26,SF-E27,21,24,17,19,4,5,0.8095238095238095,0.19047619047619047,0.7916666666666666,0.20833333333333334
SF-C26,SF-B28-2,5,1,1,1,4,0,0.2,0.8,1.0,0.0
SF-C26,SF-D27,66,47,39,21,27,26,0.5909090909090909,0.4090909090909091,0.44680851063829785,0.5531914893617021
SF-C26,SF-C28-2,11,33,1,23,10,10,0.09090909090909091,0.9090909090909091,0.696969696969697,0.30303030303030304
SF-C26,SF-C28-1,4,2,3,2,1,0,0.75,0.25,1.0,0.0
SF-C26,SF-B28,11,10,6,4,5,6,0.5454545454545454,0.45454545454545453,0.4,0.6
SF-C26,SF-J3,4,3,0,0,4,3,0.0,1.0,0.0,1.0
SF-C26,SF-G7,8,5,0,0,8,5,0.0,1.0,0.0,1.0
SF-C26,SF-H25,5,9,0,2,5,7,0.0,1.0,0.2222222222222222,0.7777777777777778
SF-C26,SF-G26,25,42,6,20,19,22,0.24,0.76,0.47619047619047616,0.5238095238095238
SF-C26,SF-K21,16,3,0,0,16,3,0.0,1.0,0.0,1.0
SF-C26,SF-K22-1,5,22,2,11,3,11,0.4,0.6,0.5,0.5
SF-C26,SF-J23-1,28,30,4,7,24,23,0.14285714285714285,0.8571428571428571,0.23333333333333334,0.7666666666666667
SF-C26,SF-J22-1,50,69,2,3,48,66,0.04,0.96,0.043478260869565216,0.9565217391304348
SF-C26,SF-J22-2,9,2,1,1,8,1,0.1111111111111111,0.8888888888888888,0.5,0.5
SF-C26,SF-J21,8,11,1,3,7,8,0.125,0.875,0.2727272727272727,0.7272727272727273
SF-C26,SF-I21,7,4,0,0,7,4,0.0,1.0,0.0,1.0
SF-C26,SF-I22,3,1,2,1,1,0,0.6666666666666666,0.3333333333333333,1.0,0.0
SF-C26,SF-I23-2,5,3,0,0,5,3,0.0,1.0,0.0,1.0
SF-C26,SF-I24,3,12,0,3,3,9,0.0,1.0,0.25,0.75
SF-C26,SF-I23-1,11,8,1,0,10,8,0.09090909090909091,0.9090909090909091,0.0,1.0
SF-C26,SF-F26,98,35,37,21,61,14,0.37755102040816324,0.6224489795918368,0.6,0.4
SF-C26,SF-M13,1,2,0,0,1,2,0.0,1.0,0.0,1.0
SF-C26,SF-M15,2,2,0,0,2,2,0.0,1.0,0.0,1.0
SF-C26,SF-L19,10,1,2,0,8,1,0.2,0.8,0.0,1.0
SF-C26,SF-L20,9,6,3,0,6,6,0.3333333333333333,0.6666666666666666,0.0,1.0
SF-C26,SF-N20-1,2,11,0,1,2,10,0.0,1.0,0.09090909090909091,0.9090909090909091
SF-C26,SF-M20,30,22,10,6,20,16,0.3333333333333333,0.6666666666666666,0.2727272727272727,0.7272727272727273
SF-C26,SF-K20,46,6,3,0,43,6,0.06521739130434782,0.9347826086956522,0.0,1.0
SF-C26,SF-K15-,14,20,1,1,13,19,0.07142857142857142,0.9285714285714286,0.05,0.95
SF-C26,SF-K18,9,5,0,1,9,4,0.0,1.0,0.2,0.8
SF-C26,SF-K17,6,3,1,1,5,2,0.16666666666666666,0.8333333333333334,0.3333333333333333,0.6666666666666666
SF-C26,SF-J16,7,11,0,0,7,11,0.0,1.0,0.0,1.0
SF-C26,SF-J18,6,3,0,0,6,3,0.0,1.0,0.0,1.0
SF-C26,SF-J20,8,6,7,2,1,4,0.875,0.125,0.3333333333333333,0.6666666666666666
SF-C26,SF-J19,11,15,0,2,11,13,0.0,1.0,0.13333333333333333,0.8666666666666667
SF-C26,SF-M10,5,7,1,1,4,6,0.2,0.8,0.14285714285714285,0.8571428571428571
SF-C26,SF-M11,2,2,0,1,2,1,0.0,1.0,0.5,0.5
SF-C26,SF-R19,3,2,1,1,2,1,0.3333333333333333,0.6666666666666666,0.5,0.5
SF-C26,SF-Q21-2,4,1,3,0,1,1,0.75,0.25,0.0,1.0
SF-C26,SF-P21,6,2,3,0,3,2,0.5,0.5,0.0,1.0
SF-C26,SF-O18,3,5,0,1,3,4,0.0,1.0,0.2,0.8
SF-C26,SF-O19,10,3,1,0,9,3,0.1,0.9,0.0,1.0
SF-C26,SF-O21,11,7,2,2,9,5,0.18181818181818182,0.8181818181818182,0.2857142857142857,0.7142857142857143
SF-C26,SF-O22,10,11,2,4,8,7,0.2,0.8,0.36363636363636365,0.6363636363636364
SF-C26,SF-N21,5,5,1,1,4,4,0.2,0.8,0.2,0.8
SF-C26,SF-N20-2,1,2,0,0,1,2,0.0,1.0,0.0,1.0
SF-C26,SF-M21,3,5,1,1,2,4,0.3333333333333333,0.6666666666666666,0.2,0.8
SF-C26,SF-L21,16,9,7,1,9,8,0.4375,0.5625,0.1111111111111111,0.8888888888888888
SF-C26,SF-Q30,18,7,0,3,18,4,0.0,1.0,0.42857142857142855,0.5714285714285714
SF-C26,SF-P30,17,51,2,28,15,23,0.11764705882352941,0.8823529411764706,0.5490196078431373,0.45098039215686275
SF-C26,SF-O30-2,8,7,2,2,6,5,0.25,0.75,0.2857142857142857,0.7142857142857143
SF-C26,SF-O30,10,11,7,5,3,6,0.7,0.3,0.45454545454545453,0.5454545454545454
SF-C26,SF-N27,32,39,4,0,28,39,0.125,0.875,0.0,1.0
SF-C26,SF-N29,2,7,0,2,2,5,0.0,1.0,0.2857142857142857,0.7142857142857143
SF-C26,SF-N28,10,10,2,1,8,9,0.2,0.8,0.1,0.9
SF-C26,SF-L30-1,35,14,6,4,29,10,0.17142857142857143,0.8285714285714286,0.2857142857142857,0.7142857142857143
SF-C26,SF-L31-1,11,6,2,4,9,2,0.18181818181818182,0.8181818181818182,0.6666666666666666,0.3333333333333333
SF-C26,SF-K30-2,16,11,4,4,12,7,0.25,0.75,0.36363636363636365,0.6363636363636364
SF-C26,SF-L29,19,7,0,1,19,6,0.0,1.0,0.14285714285714285,0.8571428571428571
SF-C26,SF-J29-1,18,20,5,4,13,16,0.2777777777777778,0.7222222222222222,0.2,0.8
SF-C26,SF-I30,20,16,2,3,18,13,0.1,0.9,0.1875,0.8125
SF-C26,SF-I29-2,109,4,102,1,7,3,0.9357798165137615,0.06422018348623854,0.25,0.75
SF-C26,SF-I27,7,13,4,3,3,10,0.5714285714285714,0.42857142857142855,0.23076923076923078,0.7692307692307693
SF-C26,SF-I28,24,68,8,29,16,39,0.3333333333333333,0.6666666666666666,0.4264705882352941,0.5735294117647058
SF-C26,SF-I30-2,9,17,5,3,4,14,0.5555555555555556,0.4444444444444444,0.17647058823529413,0.8235294117647058
SF-C26,SF I29-1,5,2,0,0,5,2,0.0,1.0,0.0,1.0
SF-C26,SF-H28,26,17,16,7,10,10,0.6153846153846154,0.38461538461538464,0.4117647058823529,0.5882352941176471
SF-C26,SF-H29,3,2,0,1,3,1,0.0,1.0,0.5,0.5
SF-C26,SF-S24,2,5,0,0,2,5,0.0,1.0,0.0,1.0
SF-C26,SF-N22-1B,1,1,0,0,1,1,0.0,1.0,0.0,1.0
SF-C26,SF-N26,3,3,2,2,1,1,0.6666666666666666,0.3333333333333333,0.6666666666666666,0.3333333333333333
SF-C26,SF-N25,3,1,0,1,3,0,0.0,1.0,1.0,0.0
SF-C26,SF-T21,2,2,0,0,2,2,0.0,1.0,0.0,1.0
SF-C26,SF-T22,1,3,1,0,0,3,1.0,0.0,0.0,1.0
SF-C26,SF-S22-1,3,4,0,1,3,3,0.0,1.0,0.25,0.75
SF-C26,SF-Q22-2,4,1,0,0,4,1,0.0,1.0,0.0,1.0
SF-C26,SF-U21,2,2,1,0,1,2,0.5,0.5,0.0,1.0
SF-C26,SF-T20,2,3,0,0,2,3,0.0,1.0,0.0,1.0
SF-C26,SF-S21,3,2,0,0,3,2,0.0,1.0,0.0,1.0
SF-C25,SF-M26,1,1,0,1,1,0,0.0,1.0,1.0,0.0
SF-C25,SF-M25,3,3,1,0,2,3,0.3333333333333333,0.6666666666666666,0.0,1.0
SF-C25,SF-M26-2,4,3,0,1,4,2,0.0,1.0,0.3333333333333333,0.6666666666666666
SF-C25,SF-L27,1,1,0,0,1,1,0.0,1.0,0.0,1.0
SF-C25,SF-K26,7,75,0,2,7,73,0.0,1.0,0.02666666666666667,0.9733333333333334
SF-C25,SF-J27,5,4,1,3,4,1,0.2,0.8,0.75,0.25
SF-C25,SF-M30,18,19,2,1,16,18,0.1111111111111111,0.8888888888888888,0.05263157894736842,0.9473684210526315
SF-C25,SF-L27-2,6,1,6,0,0,1,1.0,0.0,0.0,1.0
SF-C25,SF-J29-3,6,6,1,0,5,6,0.16666666666666666,0.8333333333333334,0.0,1.0
SF-C25,SF-J29,11,7,1,1,10,6,0.09090909090909091,0.9090909090909091,0.14285714285714285,0.8571428571428571
SF-C25,SF-L26,91,43,0,5,91,38,0.0,1.0,0.11627906976744186,0.8837209302325582
SF-C25,SF-M28,4,3,0,0,4,3,0.0,1.0,0.0,1.0
SF-C25,SF-L25,6,13,3,7,3,6,0.5,0.5,0.5384615384615384,0.46153846153846156
SF-C25,SF-M24,4,2,2,0,2,2,0.5,0.5,0.0,1.0
SF-C25,SF-L24,14,12,0,2,14,10,0.0,1.0,0.16666666666666666,0.8333333333333334
SF-C25,SF-N23,3,3,1,1,2,2,0.3333333333333333,0.6666666666666666,0.3333333333333333,0.6666666666666666
SF-C25,SF-N24-2,2,3,0,0,2,3,0.0,1.0,0.0,1.0
SF-C25,SF-K27-2,13,12,3,3,10,9,0.23076923076923078,0.7692307692307693,0.25,0.75
SF-C25,SF-J26-2,11,5,2,1,9,4,0.18181818181818182,0.8181818181818182,0.2,0.8
SF-C25,SF-L28,11,9,7,9,4,0,0.6363636363636364,0.36363636363636365,1.0,0.0
SF-C25,SF-K28,4,2,2,2,2,0,0.5,0.5,1.0,0.0
SF-C25,SF-K29-1,31,11,4,2,27,9,0.12903225806451613,0.8709677419354839,0.18181818181818182,0.8181818181818182
SF-C25,SF-J28-2,38,18,0,1,38,17,0.0,1.0,0.05555555555555555,0.9444444444444444
SF-C25,SF-K27,2,2,2,0,0,2,1.0,0.0,0.0,1.0
SF-C25,SF-K25,6,4,4,2,2,2,0.6666666666666666,0.3333333333333333,0.5,0.5
SF-C25,SF-J25,23,34,6,3,17,31,0.2608695652173913,0.7391304347826086,0.08823529411764706,0.9117647058823529
SF-C25,SF-H26-2,4,10,1,2,3,8,0.25,0.75,0.2,0.8
SF-C25,SF-P24,2,10,0,2,2,8,0.0,1.0,0.2,0.8
SF-C25,SF-N22-1A,2,1,0,0,2,1,0.0,1.0,0.0,1.0
SF-C25,SF-J24,6,4,3,0,3,4,0.5,0.5,0.0,1.0
SF-C25,SF-O24,4,2,1,2,3,0,0.25,0.75,1.0,0.0
SF-C25,SF-J26,5,6,2,3,3,3,0.4,0.6,0.5,0.5
SF-C25,SF-I26-,4,8,3,6,1,2,0.75,0.25,0.75,0.25
SF-C25,SF-I25,21,19,10,11,11,8,0.47619047619047616,0.5238095238095238,0.5789473684210527,0.42105263157894735
SF-C25,SF-H26,31,44,12,19,19,25,0.3870967741935484,0.6129032258064516,0.4318181818181818,0.5681818181818182
SF-C25,SF-O23,7,15,1,4,6,11,0.14285714285714285,0.8571428571428571,0.26666666666666666,0.7333333333333333
SF-C25,SF-H27-1,12,19,3,3,9,16,0.25,0.75,0.15789473684210525,0.8421052631578947
SF-C25,SF-F28-2,29,42,16,19,13,23,0.5517241379310345,0.4482758620689655,0.4523809523809524,0.5476190476190477
SF-C25,SF-G27,89,58,23,13,66,45,0.25842696629213485,0.7415730337078652,0.22413793103448276,0.7758620689655172
SF-C25,SF-M22-2,28,33,2,6,26,27,0.07142857142857142,0.9285714285714286,0.18181818181818182,0.8181818181818182
SF-C25,SF-L22,22,6,3,3,19,3,0.13636363636363635,0.8636363636363636,0.5,0.5
SF-C25,SF-F27,44,44,18,14,26,30,0.4090909090909091,0.5909090909090909,0.3181818181818182,0.6818181818181818
SF-C25,SF-N22-2,19,11,0,1,19,10,0.0,1.0,0.09090909090909091,0.9090909090909091
SF-C25,SF-G28-2,5,8,1,2,4,6,0.2,0.8,0.25,0.75
SF-C25,SF-G28-1,6,3,1,0,5,3,0.16666666666666666,0.8333333333333334,0.0,1.0
SF-C25,SF-M22-1,4,1,0,0,4,1,0.0,1.0,0.0,1.0
SF-C25,SF-O25-1,3,3,0,0,3,3,0.0,1.0,0.0,1.0
SF-C25,SF-K22-2,15,8,5,4,10,4,0.3333333333333333,0.6666666666666666,0.5,0.5
SF-C25,SF-K24,13,10,3,2,10,8,0.23076923076923078,0.7692307692307693,0.2,0.8
SF-C25,SF-J23-2,3,3,2,1,1,2,0.6666666666666666,0.3333333333333333,0.3333333333333333,0.6666666666666666
SF-C25,SF-G23,8,10,0,1,8,9,0.0,1.0,0.1,0.9
SF-C25,SF-G24,50,48,4,2,46,46,0.08,0.92,0.041666666666666664,0.9583333333333334
SF-C25,SF-G25,29,24,3,6,26,18,0.10344827586206896,0.896551724137931,0.25,0.75
SF-C25,SF-F23,19,17,1,1,18,16,0.05263157894736842,0.9473684210526315,0.058823529411764705,0.9411764705882353
SF-C25,SF-E23,59,32,11,5,48,27,0.1864406779661017,0.8135593220338984,0.15625,0.84375
SF-C25,SF-D24,32,14,14,2,18,12,0.4375,0.5625,0.14285714285714285,0.8571428571428571
SF-C25,SF-C22,24,22,7,0,17,22,0.2916666666666667,0.7083333333333334,0.0,1.0
SF-C25,SF-B22,82,81,22,34,60,47,0.2682926829268293,0.7317073170731707,0.41975308641975306,0.5802469135802469
SF-C25,SF-J17,17,15,5,2,12,13,0.29411764705882354,0.7058823529411765,0.13333333333333333,0.8666666666666667
SF-C25,SF-I19,6,4,0,1,6,3,0.0,1.0,0.25,0.75
SF-C25,SF-I20,5,1,0,0,5,1,0.0,1.0,0.0,1.0
SF-C25,SF-H16,5,4,0,0,5,4,0.0,1.0,0.0,1.0
SF-C25,SF-H20,3,2,0,0,3,2,0.0,1.0,0.0,1.0
SF-C25,SF-H18,3,1,1,0,2,1,0.3333333333333333,0.6666666666666666,0.0,1.0
SF-C25,SF-G19,14,6,2,0,12,6,0.14285714285714285,0.8571428571428571,0.0,1.0
SF-C25,SF-G17,6,11,2,0,4,11,0.3333333333333333,0.6666666666666666,0.0,1.0
SF-C25,SF-G18,12,18,0,1,12,17,0.0,1.0,0.05555555555555555,0.9444444444444444
SF-C25,SF-G20,10,12,1,1,9,11,0.1,0.9,0.08333333333333333,0.9166666666666666
SF-C25,SF-F19,14,7,2,0,12,7,0.14285714285714285,0.8571428571428571,0.0,1.0
SF-C25,SF-E18,16,17,0,4,16,13,0.0,1.0,0.23529411764705882,0.7647058823529411
SF-C25,SF-E20,22,25,1,5,21,20,0.045454545454545456,0.9545454545454546,0.2,0.8
SF-C25,SF-H30,21,25,6,4,15,21,0.2857142857142857,0.7142857142857143,0.16,0.84
SF-C25,SF-G30-2,75,120,19,48,56,72,0.25333333333333335,0.7466666666666667,0.4,0.6
SF-C25,SF-F30-1,15,6,6,1,9,5,0.4,0.6,0.16666666666666666,0.8333333333333334
SF-C25,SF-E29-2,50,36,22,16,28,20,0.44,0.56,0.4444444444444444,0.5555555555555556
SF-C25,SF-E29-1,60,59,22,25,38,34,0.36666666666666664,0.6333333333333333,0.423728813559322,0.576271186440678
SF-C25,SF-D29,62,27,29,15,33,12,0.46774193548387094,0.532258064516129,0.5555555555555556,0.4444444444444444
SF-C25,SF-D28,45,20,24,9,21,11,0.5333333333333333,0.4666666666666667,0.45,0.55
SF-C25,SF-A27,34,33,27,18,7,15,0.7941176470588235,0.20588235294117646,0.5454545454545454,0.45454545454545453
SF-C25,SF-G29-2,30,17,6,2,24,15,0.2,0.8,0.11764705882352941,0.8823529411764706
SF-C25,SF-G29-1,16,12,1,6,15,6,0.0625,0.9375,0.5,0.5
SF-C25,SF-G30-1,14,11,6,6,8,5,0.42857142857142855,0.5714285714285714,0.5454545454545454,0.45454545454545453
SF-C25,SF-G29-3,9,62,2,42,7,20,0.2222222222222222,0.7777777777777778,0.6774193548387096,0.3225806451612903
SF-C25,SF-F30-2,14,8,8,5,6,3,0.5714285714285714,0.42857142857142855,0.625,0.375
SF-C25,SF-F29,2,9,0,4,2,5,0.0,1.0,0.4444444444444444,0.5555555555555556
SF-C25,SF-E29-3,22,13,8,8,14,5,0.36363636363636365,0.6363636363636364,0.6153846153846154,0.38461538461538464
SF-C25,SF-F28-1,26,34,11,21,15,13,0.4230769230769231,0.5769230769230769,0.6176470588235294,0.38235294117647056
SF-C25,SF-E28-2,39,35,7,17,32,18,0.1794871794871795,0.8205128205128205,0.4857142857142857,0.5142857142857142
SF-C25,SF-E28,38,37,6,22,32,15,0.15789473684210525,0.8421052631578947,0.5945945945945946,0.40540540540540543
SF-C25,SF-J10,1,6,0,0,1,6,0.0,1.0,0.0,1.0
SF-C25,SF-J12,7,3,2,0,5,3,0.2857142857142857,0.7142857142857143,0.0,1.0
SF-C25,SF-J13,2,2,1,0,1,2,0.5,0.5,0.0,1.0
SF-C25,SF-J15,6,3,1,0,5,3,0.16666666666666666,0.8333333333333334,0.0,1.0
SF-C25,SF-H13,4,5,1,0,3,5,0.25,0.75,0.0,1.0
SF-C25,SF-H12,4,1,0,0,4,1,0.0,1.0,0.0,1.0
SF-C25,SF-H15,4,2,0,0,4,2,0.0,1.0,0.0,1.0
SF-C25,SF-G9,1,1,0,0,1,1,0.0,1.0,0.0,1.0
SF-C25,SF-H14,3,1,0,0,3,1,0.0,1.0,0.0,1.0
SF-C25,SF-G13,7,8,0,0,7,8,0.0,1.0,0.0,1.0
SF-C25,SF-G11,1,1,0,0,1,1,0.0,1.0,0.0,1.0
SF-C25,SF-G12,12,7,0,0,12,7,0.0,1.0,0.0,1.0
SF-C25,SF-G10-1,5,4,1,1,4,3,0.2,0.8,0.25,0.75
SF-C25,SF-F15,7,10,1,2,6,8,0.14285714285714285,0.8571428571428571,0.2,0.8
SF-C25,SF-F16,10,7,1,3,9,4,0.1,0.9,0.42857142857142855,0.5714285714285714
SF-C25,SF-C21,20,14,6,5,14,9,0.3,0.7,0.35714285714285715,0.6428571428571429
SF-C25,SF-C20,66,50,1,7,65,43,0.015151515151515152,0.9848484848484849,0.14,0.86
SF-C25,SF-B21,27,22,7,5,20,17,0.25925925925925924,0.7407407407407407,0.22727272727272727,0.7727272727272727
SF-C25,SF-B19,137,120,21,27,116,93,0.15328467153284672,0.8467153284671532,0.225,0.775
SF-C25,SF-A20,136,211,46,55,90,156,0.3382352941176471,0.6617647058823529,0.26066350710900477,0.7393364928909952
SF-C25,SF-A19,14,23,7,8,7,15,0.5,0.5,0.34782608695652173,0.6521739130434783
SF-C25,SF-C26,41,33,18,18,23,15,0.43902439024390244,0.5609756097560976,0.5454545454545454,0.45454545454545453
SF-C25,SF-B25,104,59,57,35,47,24,0.5480769230769231,0.4519230769230769,0.5932203389830508,0.4067796610169492
SF-C25,SF-E27,25,51,4,23,21,28,0.16,0.84,0.45098039215686275,0.5490196078431373
SF-C25,SF-B28-2,37,29,19,12,18,17,0.5135135135135135,0.4864864864864865,0.41379310344827586,0.5862068965517241
SF-C25,SF-D27,56,36,33,13,23,23,0.5892857142857143,0.4107142857142857,0.3611111111111111,0.6388888888888888
SF-C25,SF-C28-2,17,10,5,2,12,8,0.29411764705882354,0.7058823529411765,0.2,0.8
SF-C25,SF-C28-1,17,11,13,4,4,7,0.7647058823529411,0.23529411764705882,0.36363636363636365,0.6363636363636364
SF-C25,SF-B28,22,11,16,8,6,3,0.7272727272727273,0.2727272727272727,0.7272727272727273,0.2727272727272727
SF-C25,SF-J1,5,4,0,0,5,4,0.0,1.0,0.0,1.0
SF-C25,SF-H0,3,3,0,0,3,3,0.0,1.0,0.0,1.0
SF-C25,SF-J3,1,1,1,0,0,1,1.0,0.0,0.0,1.0
SF-C25,SF-J5,2,2,1,0,1,2,0.5,0.5,0.0,1.0
SF-C25,SF-G8,6,5,0,0,6,5,0.0,1.0,0.0,1.0
SF-C25,SF-G5,1,9,0,0,1,9,0.0,1.0,0.0,1.0
SF-C25,SF-G7,12,15,0,0,12,15,0.0,1.0,0.0,1.0
SF-C25,SF-F9,4,5,0,0,4,5,0.0,1.0,0.0,1.0
SF-C25,SF-H25,5,2,2,0,3,2,0.4,0.6,0.0,1.0
SF-C25,SF-G26,23,18,9,4,14,14,0.391304347826087,0.6086956521739131,0.2222222222222222,0.7777777777777778
SF-C25,SF-K21,14,9,1,0,13,9,0.07142857142857142,0.9285714285714286,0.0,1.0
SF-C25,SF-K22-1,2,12,2,7,0,5,1.0,0.0,0.5833333333333334,0.4166666666666667
SF-C25,SF-J23-1,30,18,6,5,24,13,0.2,0.8,0.2777777777777778,0.7222222222222222
SF-C25,SF-J22-1,8,7,1,0,7,7,0.125,0.875,0.0,1.0
SF-C25,SF-J22-2,6,24,1,6,5,18,0.16666666666666666,0.8333333333333334,0.25,0.75
SF-C25,SF-J21,26,20,4,5,22,15,0.15384615384615385,0.8461538461538461,0.25,0.75
SF-C25,SF-I21,4,1,3,0,1,1,0.75,0.25,0.0,1.0
SF-C25,SF-I22,9,4,2,2,7,2,0.2222222222222222,0.7777777777777778,0.5,0.5
SF-C25,SF-I23-2,25,21,4,1,21,20,0.16,0.84,0.047619047619047616,0.9523809523809523
SF-C25,SF-I24,12,6,1,2,11,4,0.08333333333333333,0.9166666666666666,0.3333333333333333,0.6666666666666666
SF-C25,SF-I23-1,11,21,0,3,11,18,0.0,1.0,0.14285714285714285,0.8571428571428571
SF-C25,SF-F26,55,59,12,14,43,45,0.21818181818181817,0.7818181818181819,0.23728813559322035,0.7627118644067796
SF-C25,SF-M13,4,13,1,0,3,13,0.25,0.75,0.0,1.0
SF-C25,SF-M15,7,4,2,0,5,4,0.2857142857142857,0.7142857142857143,0.0,1.0
SF-C25,SF-L19,14,6,2,1,12,5,0.14285714285714285,0.8571428571428571,0.16666666666666666,0.8333333333333334
SF-C25,SF-L20,5,3,0,0,5,3,0.0,1.0,0.0,1.0
SF-C25,SF-N20-1,10,3,2,0,8,3,0.2,0.8,0.0,1.0
SF-C25,SF-M20,10,16,3,3,7,13,0.3,0.7,0.1875,0.8125
SF-C25,SF-K17-2,5,1,1,0,4,1,0.2,0.8,0.0,1.0
SF-C25,SF-K20,9,10,1,0,8,10,0.1111111111111111,0.8888888888888888,0.0,1.0
SF-C25,SF-K15-,11,15,0,1,11,14,0.0,1.0,0.06666666666666667,0.9333333333333333
SF-C25,SF-K19,9,14,2,4,7,10,0.2222222222222222,0.7777777777777778,0.2857142857142857,0.7142857142857143
SF-C25,SF-K18,6,15,2,2,4,13,0.3333333333333333,0.6666666666666666,0.13333333333333333,0.8666666666666667
SF-C25,SF-K17,17,14,0,2,17,12,0.0,1.0,0.14285714285714285,0.8571428571428571
SF-C25,SF-J16,27,17,4,0,23,17,0.14814814814814814,0.8518518518518519,0.0,1.0
SF-C25,SF-J18,15,11,2,0,13,11,0.13333333333333333,0.8666666666666667,0.0,1.0
SF-C25,SF-J20,6,3,3,0,3,3,0.5,0.5,0.0,1.0
SF-C25,SF-J19,29,30,3,2,26,28,0.10344827586206896,0.896551724137931,0.06666666666666667,0.9333333333333333
SF-C25,SF-M12,4,5,0,0,4,5,0.0,1.0,0.0,1.0
SF-C25,SF-M10,5,3,1,0,4,3,0.2,0.8,0.0,1.0
SF-C25,SF-M11,7,4,1,0,6,4,0.14285714285714285,0.8571428571428571,0.0,1.0
SF-C25,SF-R19,8,2,5,0,3,2,0.625,0.375,0.0,1.0
SF-C25,SF-R20,4,3,0,0,4,3,0.0,1.0,0.0,1.0
SF-C25,SF-Q21-2,2,6,0,0,2,6,0.0,1.0,0.0,1.0
SF-C25,SF-Q21-1,2,7,1,2,1,5,0.5,0.5,0.2857142857142857,0.7142857142857143
SF-C25,SF-P21,13,6,3,2,10,4,0.23076923076923078,0.7692307692307693,0.3333333333333333,0.6666666666666666
SF-C25,SF-O18,6,7,0,1,6,6,0.0,1.0,0.14285714285714285,0.8571428571428571
SF-C25,SF-O19,7,11,0,0,7,11,0.0,1.0,0.0,1.0
SF-C25,SF-O21,21,29,5,5,16,24,0.23809523809523808,0.7619047619047619,0.1724137931034483,0.8275862068965517
SF-C25,SF-O22,11,18,2,3,9,15,0.18181818181818182,0.8181818181818182,0.16666666666666666,0.8333333333333334
SF-C25,SF-N21,5,7,2,1,3,6,0.4,0.6,0.14285714285714285,0.8571428571428571
SF-C25,SF-N20-2,6,2,1,1,5,1,0.16666666666666666,0.8333333333333334,0.5,0.5
SF-C25,SF-M21,14,22,0,0,14,22,0.0,1.0,0.0,1.0
SF-C25,SF-L21,21,22,2,3,19,19,0.09523809523809523,0.9047619047619048,0.13636363636363635,0.8636363636363636
SF-C25,SF-Q30,5,8,0,1,5,7,0.0,1.0,0.125,0.875
SF-C25,SF-P30,11,8,2,2,9,6,0.18181818181818182,0.8181818181818182,0.25,0.75
SF-C25,SF-O30-2,6,16,4,4,2,12,0.6666666666666666,0.3333333333333333,0.25,0.75
SF-C25,SF-O30,21,13,4,0,17,13,0.19047619047619047,0.8095238095238095,0.0,1.0
SF-C25,SF-N27,3,7,1,0,2,7,0.3333333333333333,0.6666666666666666,0.0,1.0
SF-C25,SF-N29,5,6,3,3,2,3,0.6,0.4,0.5,0.5
SF-C25,SF-N28,5,10,0,3,5,7,0.0,1.0,0.3,0.7
SF-C25,SF-L30-1,48,85,3,11,45,74,0.0625,0.9375,0.12941176470588237,0.8705882352941177
SF-C25,SF-L31-1,12,7,6,6,6,1,0.5,0.5,0.8571428571428571,0.14285714285714285
SF-C25,SF-K30-2,4,6,0,0,4,6,0.0,1.0,0.0,1.0
SF-C25,SF-L29,14,4,3,0,11,4,0.21428571428571427,0.7857142857142857,0.0,1.0
SF-C25,SF-J29-1,10,11,3,0,7,11,0.3,0.7,0.0,1.0
SF-C25,SF-I30,25,18,7,9,18,9,0.28,0.72,0.5,0.5
SF-C25,SF-I29-2,84,29,39,4,45,25,0.4642857142857143,0.5357142857142857,0.13793103448275862,0.8620689655172413
SF-C25,SF-I27,11,6,6,2,5,4,0.5454545454545454,0.45454545454545453,0.3333333333333333,0.6666666666666666
SF-C25,SF-I28,5,17,3,16,2,1,0.6,0.4,0.9411764705882353,0.058823529411764705
SF-C25,SF-I30-2,6,131,2,16,4,115,0.3333333333333333,0.6666666666666666,0.12213740458015267,0.8778625954198473
SF-C25,SF I29-1,9,8,0,1,9,7,0.0,1.0,0.125,0.875
SF-C25,SF-H28,19,11,3,4,16,7,0.15789473684210525,0.8421052631578947,0.36363636363636365,0.6363636363636364
SF-C25,SF-H29,3,3,2,0,1,3,0.6666666666666666,0.3333333333333333,0.0,1.0
SF-C25,SF-S24,6,16,0,3,6,13,0.0,1.0,0.1875,0.8125
SF-C25,SF-R24,4,9,0,1,4,8,0.0,1.0,0.1111111111111111,0.8888888888888888
SF-C25,SF-O25-2,4,1,0,0,4,1,0.0,1.0,0.0,1.0
SF-C25,SF-N22-1B,4,3,1,0,3,3,0.25,0.75,0.0,1.0
SF-C25,SF-N26,5,6,1,1,4,5,0.2,0.8,0.16666666666666666,0.8333333333333334
SF-C25,SF-T22,4,7,1,2,3,5,0.25,0.75,0.2857142857142857,0.7142857142857143
SF-C25,SF-S22-2,3,3,0,0,3,3,0.0,1.0,0.0,1.0
SF-C25,SF-S22-1,5,8,2,1,3,7,0.4,0.6,0.125,0.875
SF-C25,SF-Q23-3,6,5,0,0,6,5,0.0,1.0,0.0,1.0
SF-C25,SF-Q22-1,4,3,1,0,3,3,0.25,0.75,0.0,1.0
SF-C25,SF-Q22-2,11,20,1,2,10,18,0.09090909090909091,0.9090909090909091,0.1,0.9
SF-C25,SF-P22,9,14,3,6,6,8,0.3333333333333333,0.6666666666666666,0.42857142857142855,0.5714285714285714
SF-C25,SF-S21,2,7,0,0,2,7,0.0,1.0,0.0,1.0
SF-C25,SF-X30,2,2,0,0,2,2,0.0,1.0,0.0,1.0
SF-C25,SF-X29,1,1,0,0,1,1,0.0,1.0,0.0,1.0
SF-B25,SF-M26,1,1,1,1,0,0,1.0,0.0,1.0,0.0
SF-B25,SF-M25,2,1,0,1,2,0,0.0,1.0,1.0,0.0
SF-B25,SF-M26-2,3,5,3,0,0,5,1.0,0.0,0.0,1.0
SF-B25,SF-L27,2,1,2,1,0,0,1.0,0.0,1.0,0.0
SF-B25,SF-K26,6,3,2,1,4,2,0.3333333333333333,0.6666666666666666,0.3333333333333333,0.6666666666666666
SF-B25,SF-J27,4,2,2,2,2,0,0.5,0.5,1.0,0.0
SF-B25,SF-M30,12,13,7,9,5,4,0.5833333333333334,0.4166666666666667,0.6923076923076923,0.3076923076923077
SF-B25,SF-J29-3,8,3,8,2,0,1,1.0,0.0,0.6666666666666666,0.3333333333333333
SF-B25,SF-J29,12,7,7,3,5,4,0.5833333333333334,0.4166666666666667,0.42857142857142855,0.5714285714285714
SF-B25,SF-M28,4,2,2,0,2,2,0.5,0.5,0.0,1.0
SF-B25,SF-L25,6,7,0,3,6,4,0.0,1.0,0.42857142857142855,0.5714285714285714
SF-B25,SF-M24,2,2,0,0,2,2,0.0,1.0,0.0,1.0
SF-B25,SF-L24,3,3,2,0,1,3,0.6666666666666666,0.3333333333333333,0.0,1.0
SF-B25,SF-N24-2,1,2,0,0,1,2,0.0,1.0,0.0,1.0
SF-B25,SF-K27-2,6,12,2,3,4,9,0.3333333333333333,0.6666666666666666,0.25,0.75
SF-B25,SF-J26-2,9,2,2,0,7,2,0.2222222222222222,0.7777777777777778,0.0,1.0
SF-B25,SF-K28-3,1,1,0,1,1,0,0.0,1.0,1.0,0.0
SF-B25,SF-L28,27,40,25,37,2,3,0.9259259259259259,0.07407407407407407,0.925,0.075
SF-B25,SF-K28,6,4,4,1,2,3,0.6666666666666666,0.3333333333333333,0.25,0.75
SF-B25,SF-K29-1,22,17,16,4,6,13,0.7272727272727273,0.2727272727272727,0.23529411764705882,0.7647058823529411
SF-B25,SF-J28-2,16,15,7,1,9,14,0.4375,0.5625,0.06666666666666667,0.9333333333333333
SF-B25,SF-K25,9,1,1,0,8,1,0.1111111111111111,0.8888888888888888,0.0,1.0
SF-B25,SF-J25,13,5,6,1,7,4,0.46153846153846156,0.5384615384615384,0.2,0.8
SF-B25,SF-H26-2,60,45,13,1,47,44,0.21666666666666667,0.7833333333333333,0.022222222222222223,0.9777777777777777
SF-B25,SF-J24,19,14,4,1,15,13,0.21052631578947367,0.7894736842105263,0.07142857142857142,0.9285714285714286
SF-B25,SF-O24,3,1,0,1,3,0,0.0,1.0,1.0,0.0
SF-B25,SF-J26,2,2,0,1,2,1,0.0,1.0,0.5,0.5
SF-B25,SF-I26-,2,3,1,0,1,3,0.5,0.5,0.0,1.0
SF-B25,SF-I25,26,13,20,8,6,5,0.7692307692307693,0.23076923076923078,0.6153846153846154,0.38461538461538464
SF-B25,SF-H26,29,13,16,5,13,8,0.5517241379310345,0.4482758620689655,0.38461538461538464,0.6153846153846154
SF-B25,SF-H27-1,16,3,12,0,4,3,0.75,0.25,0.0,1.0
SF-B25,SF-F28-2,46,26,24,7,22,19,0.5217391304347826,0.4782608695652174,0.2692307692307692,0.7307692307692307
SF-B25,SF-G27,73,31,30,9,43,22,0.410958904109589,0.589041095890411,0.2903225806451613,0.7096774193548387
SF-B25,SF-M22-2,7,3,2,0,5,3,0.2857142857142857,0.7142857142857143,0.0,1.0
SF-B25,SF-L22,7,3,3,0,4,3,0.42857142857142855,0.5714285714285714,0.0,1.0
SF-B25,SF-F27,26,27,9,6,17,21,0.34615384615384615,0.6538461538461539,0.2222222222222222,0.7777777777777778
SF-B25,SF-N22-2,4,6,0,0,4,6,0.0,1.0,0.0,1.0
SF-B25,SF-G28-2,6,2,3,0,3,2,0.5,0.5,0.0,1.0
SF-B25,SF-G28-1,6,4,4,2,2,2,0.6666666666666666,0.3333333333333333,0.5,0.5
SF-B25,SF-K24,4,3,1,2,3,1,0.25,0.75,0.6666666666666666,0.3333333333333333
SF-B25,SF-G23,9,3,5,0,4,3,0.5555555555555556,0.4444444444444444,0.0,1.0
SF-B25,SF-G24,42,81,1,1,41,80,0.023809523809523808,0.9761904761904762,0.012345679012345678,0.9876543209876543
SF-B25,SF-G25,15,15,5,4,10,11,0.3333333333333333,0.6666666666666666,0.26666666666666666,0.7333333333333333
SF-B25,SF-F23,13,11,4,2,9,9,0.3076923076923077,0.6923076923076923,0.18181818181818182,0.8181818181818182
SF-B25,SF-E23,91,39,28,5,63,34,0.3076923076923077,0.6923076923076923,0.1282051282051282,0.8717948717948718
SF-B25,SF-D24,15,5,8,1,7,4,0.5333333333333333,0.4666666666666667,0.2,0.8
SF-B25,SF-C22,31,16,16,10,15,6,0.5161290322580645,0.4838709677419355,0.625,0.375
SF-B25,SF-B22,89,47,48,21,41,26,0.5393258426966292,0.4606741573033708,0.44680851063829785,0.5531914893617021
SF-B25,SF-J17,13,4,7,0,6,4,0.5384615384615384,0.46153846153846156,0.0,1.0
SF-B25,SF-H19,3,1,0,0,3,1,0.0,1.0,0.0,1.0
SF-B25,SF-H20,2,2,0,0,2,2,0.0,1.0,0.0,1.0
SF-B25,SF-G19,8,4,1,0,7,4,0.125,0.875,0.0,1.0
SF-B25,SF-G17,1,2,0,0,1,2,0.0,1.0,0.0,1.0
SF-B25,SF-G18,4,5,0,0,4,5,0.0,1.0,0.0,1.0
SF-B25,SF-G20,6,6,2,0,4,6,0.3333333333333333,0.6666666666666666,0.0,1.0
SF-B25,SF-F19,25,24,1,1,24,23,0.04,0.96,0.041666666666666664,0.9583333333333334
SF-B25,SF-E18,7,2,1,0,6,2,0.14285714285714285,0.8571428571428571,0.0,1.0
SF-B25,SF-E20,20,6,2,2,18,4,0.1,0.9,0.3333333333333333,0.6666666666666666
SF-B25,SF-H30,71,41,59,31,12,10,0.8309859154929577,0.16901408450704225,0.7560975609756098,0.24390243902439024
SF-B25,SF-G30-2,93,75,58,30,35,45,0.6236559139784946,0.3763440860215054,0.4,0.6
SF-B25,SF-F30-1,20,25,14,13,6,12,0.7,0.3,0.52,0.48
SF-B25,SF-E29-2,88,45,50,13,38,32,0.5681818181818182,0.4318181818181818,0.28888888888888886,0.7111111111111111
SF-B25,SF-E29-1,148,47,108,29,40,18,0.7297297297297297,0.2702702702702703,0.6170212765957447,0.3829787234042553
SF-B25,SF-D29,198,47,170,35,28,12,0.8585858585858586,0.1414141414141414,0.7446808510638298,0.2553191489361702
SF-B25,SF-D28,134,83,105,64,29,19,0.7835820895522388,0.21641791044776118,0.7710843373493976,0.2289156626506024
SF-B25,SF-A27,70,70,59,50,11,20,0.8428571428571429,0.15714285714285714,0.7142857142857143,0.2857142857142857
SF-B25,SF-G29-2,37,16,17,5,20,11,0.4594594594594595,0.5405405405405406,0.3125,0.6875
SF-B25,SF-G29-1,4,5,0,2,4,3,0.0,1.0,0.4,0.6
SF-B25,SF-G30-1,47,31,32,14,15,17,0.6808510638297872,0.3191489361702128,0.45161290322580644,0.5483870967741935
SF-B25,SF-G29-3,17,20,7,7,10,13,0.4117647058823529,0.5882352941176471,0.35,0.65
SF-B25,SF-F30-2,11,4,6,1,5,3,0.5454545454545454,0.45454545454545453,0.25,0.75
SF-B25,SF-F29,24,11,15,6,9,5,0.625,0.375,0.5454545454545454,0.45454545454545453
SF-B25,SF-E29-3,36,33,9,5,27,28,0.25,0.75,0.15151515151515152,0.8484848484848485
SF-B25,SF-F28-1,27,4,13,2,14,2,0.48148148148148145,0.5185185185185185,0.5,0.5
SF-B25,SF-E28-2,10,5,3,1,7,4,0.3,0.7,0.2,0.8
SF-B25,SF-E28,25,21,13,6,12,15,0.52,0.48,0.2857142857142857,0.7142857142857143
SF-B25,SF-J10,5,2,1,1,4,1,0.2,0.8,0.5,0.5
SF-B25,SF-J12,4,4,1,0,3,4,0.25,0.75,0.0,1.0
SF-B25,SF-J13,2,2,0,0,2,2,0.0,1.0,0.0,1.0
SF-B25,SF-J15,1,1,0,0,1,1,0.0,1.0,0.0,1.0
SF-B25,SF-G13,11,10,1,0,10,10,0.09090909090909091,0.9090909090909091,0.0,1.0
SF-B25,SF-G12,3,4,0,1,3,3,0.0,1.0,0.25,0.75
SF-B25,SF-G10-1,1,2,1,0,0,2,1.0,0.0,0.0,1.0
SF-B25,SF-F15,6,5,0,0,6,5,0.0,1.0,0.0,1.0
SF-B25,SF-F16,11,3,1,0,10,3,0.09090909090909091,0.9090909090909091,0.0,1.0
SF-B25,SF-C21,10,4,6,0,4,4,0.6,0.4,0.0,1.0
SF-B25,SF-C20,85,48,5,14,80,34,0.058823529411764705,0.9411764705882353,0.2916666666666667,0.7083333333333334
SF-B25,SF-B21,22,16,13,6,9,10,0.5909090909090909,0.4090909090909091,0.375,0.625
SF-B25,SF-B19,109,126,46,56,63,70,0.42201834862385323,0.5779816513761468,0.4444444444444444,0.5555555555555556
SF-B25,SF-A20,77,82,36,37,41,45,0.4675324675324675,0.5324675324675324,0.45121951219512196,0.5487804878048781
SF-B25,SF-A19,26,34,17,13,9,21,0.6538461538461539,0.34615384615384615,0.38235294117647056,0.6176470588235294
SF-B25,SF-C26,24,27,7,10,17,17,0.2916666666666667,0.7083333333333334,0.37037037037037035,0.6296296296296297
SF-B25,SF-C25,59,104,35,57,24,47,0.5932203389830508,0.4067796610169492,0.5480769230769231,0.4519230769230769
SF-B25,SF-E27,18,29,8,12,10,17,0.4444444444444444,0.5555555555555556,0.41379310344827586,0.5862068965517241
SF-B25,SF-B28-2,23,21,19,10,4,11,0.8260869565217391,0.17391304347826086,0.47619047619047616,0.5238095238095238
SF-B25,SF-D27,56,49,35,19,21,30,0.625,0.375,0.3877551020408163,0.6122448979591837
SF-B25,SF-C28-2,14,10,9,1,5,9,0.6428571428571429,0.35714285714285715,0.1,0.9
SF-B25,SF-C28-1,41,10,36,5,5,5,0.8780487804878049,0.12195121951219512,0.5,0.5
SF-B25,SF-B28,121,26,108,15,13,11,0.8925619834710744,0.10743801652892562,0.5769230769230769,0.4230769230769231
SF-B25,SF-H0,1,3,0,0,1,3,0.0,1.0,0.0,1.0
SF-B25,SF-G8,1,1,0,0,1,1,0.0,1.0,0.0,1.0
SF-B25,SF-G5,8,6,0,1,8,5,0.0,1.0,0.16666666666666666,0.8333333333333334
SF-B25,SF-G7,10,1,1,0,9,1,0.1,0.9,0.0,1.0
SF-B25,SF-F9,5,10,0,2,5,8,0.0,1.0,0.2,0.8
SF-B25,SF-H25,5,3,3,0,2,3,0.6,0.4,0.0,1.0
SF-B25,SF-G26,17,7,6,3,11,4,0.35294117647058826,0.6470588235294118,0.42857142857142855,0.5714285714285714
SF-B25,SF-K21,2,2,0,2,2,0,0.0,1.0,1.0,0.0
SF-B25,SF-K22-1,11,12,8,10,3,2,0.7272727272727273,0.2727272727272727,0.8333333333333334,0.16666666666666666
SF-B25,SF-J23-1,22,20,13,3,9,17,0.5909090909090909,0.4090909090909091,0.15,0.85
SF-B25,SF-J22-1,10,6,0,1,10,5,0.0,1.0,0.16666666666666666,0.8333333333333334
SF-B25,SF-J22-2,14,9,1,1,13,8,0.07142857142857142,0.9285714285714286,0.1111111111111111,0.8888888888888888
SF-B25,SF-J21,53,11,3,3,50,8,0.05660377358490566,0.9433962264150944,0.2727272727272727,0.7272727272727273
SF-B25,SF-I23-2,4,3,2,1,2,2,0.5,0.5,0.3333333333333333,0.6666666666666666
SF-B25,SF-I24,5,5,3,2,2,3,0.6,0.4,0.4,0.6
SF-B25,SF-I23-1,12,1,5,1,7,0,0.4166666666666667,0.5833333333333334,1.0,0.0
SF-B25,SF-F26,51,39,17,16,34,23,0.3333333333333333,0.6666666666666666,0.41025641025641024,0.5897435897435898
SF-B25,SF-M13,8,3,2,0,6,3,0.25,0.75,0.0,1.0
SF-B25,SF-M15,8,6,0,0,8,6,0.0,1.0,0.0,1.0
SF-B25,SF-L19,4,1,1,0,3,1,0.25,0.75,0.0,1.0
SF-B25,SF-L20,5,11,2,0,3,11,0.4,0.6,0.0,1.0
SF-B25,SF-N20-1,24,15,1,2,23,13,0.041666666666666664,0.9583333333333334,0.13333333333333333,0.8666666666666667
SF-B25,SF-M20,7,5,1,0,6,5,0.14285714285714285,0.8571428571428571,0.0,1.0
SF-B25,SF-K20,3,9,2,0,1,9,0.6666666666666666,0.3333333333333333,0.0,1.0
SF-B25,SF-K15-,3,4,0,0,3,4,0.0,1.0,0.0,1.0
SF-B25,SF-K19,11,1,4,0,7,1,0.36363636363636365,0.6363636363636364,0.0,1.0
SF-B25,SF-K18,3,7,1,2,2,5,0.3333333333333333,0.6666666666666666,0.2857142857142857,0.7142857142857143
SF-B25,SF-K17,9,7,2,1,7,6,0.2222222222222222,0.7777777777777778,0.14285714285714285,0.8571428571428571
SF-B25,SF-J16,13,8,0,1,13,7,0.0,1.0,0.125,0.875
SF-B25,SF-J18,13,5,3,0,10,5,0.23076923076923078,0.7692307692307693,0.0,1.0
SF-B25,SF-J20,8,3,4,1,4,2,0.5,0.5,0.3333333333333333,0.6666666666666666
SF-B25,SF-J19,15,14,4,0,11,14,0.26666666666666666,0.7333333333333333,0.0,1.0
SF-B25,SF-M12,2,3,0,0,2,3,0.0,1.0,0.0,1.0
SF-B25,SF-M11,4,7,0,0,4,7,0.0,1.0,0.0,1.0
SF-B25,SF-R19,2,1,0,0,2,1,0.0,1.0,0.0,1.0
SF-B25,SF-Q21-1,5,1,2,0,3,1,0.4,0.6,0.0,1.0
SF-B25,SF-P21,1,6,0,0,1,6,0.0,1.0,0.0,1.0
SF-B25,SF-O19,4,2,0,0,4,2,0.0,1.0,0.0,1.0
SF-B25,SF-O21,5,8,1,0,4,8,0.2,0.8,0.0,1.0
SF-B25,SF-O22,5,1,3,0,2,1,0.6,0.4,0.0,1.0
SF-B25,SF-N20-2,5,2,0,0,5,2,0.0,1.0,0.0,1.0
SF-B25,SF-M21,3,4,1,1,2,3,0.3333333333333333,0.6666666666666666,0.25,0.75
SF-B25,SF-L21,15,12,5,2,10,10,0.3333333333333333,0.6666666666666666,0.16666666666666666,0.8333333333333334
SF-B25,SF-S30,1,3,0,0,1,3,0.0,1.0,0.0,1.0
SF-B25,SF-Q30,4,6,2,0,2,6,0.5,0.5,0.0,1.0
SF-B25,SF-P30,6,10,2,1,4,9,0.3333333333333333,0.6666666666666666,0.1,0.9
SF-B25,SF-O30-2,25,6,1,3,24,3,0.04,0.96,0.5,0.5
SF-B25,SF-O30,17,18,9,5,8,13,0.5294117647058824,0.47058823529411764,0.2777777777777778,0.7222222222222222
SF-B25,SF-N27,2,6,1,0,1,6,0.5,0.5,0.0,1.0
SF-B25,SF-N29,15,11,2,1,13,10,0.13333333333333333,0.8666666666666667,0.09090909090909091,0.9090909090909091
SF-B25,SF-N28,3,4,0,2,3,2,0.0,1.0,0.5,0.5
SF-B25,SF-L30-1,28,16,11,11,17,5,0.39285714285714285,0.6071428571428571,0.6875,0.3125
SF-B25,SF-L31-1,21,10,8,3,13,7,0.38095238095238093,0.6190476190476191,0.3,0.7
SF-B25,SF-K30-2,5,6,0,0,5,6,0.0,1.0,0.0,1.0
SF-B25,SF-L29,10,8,6,3,4,5,0.6,0.4,0.375,0.625
SF-B25,SF-J29-1,15,6,6,4,9,2,0.4,0.6,0.6666666666666666,0.3333333333333333
SF-B25,SF-I30,28,15,20,7,8,8,0.7142857142857143,0.2857142857142857,0.4666666666666667,0.5333333333333333
SF-B25,SF-I29-2,10,29,7,0,3,29,0.7,0.3,0.0,1.0
SF-B25,SF-I27,11,5,4,1,7,4,0.36363636363636365,0.6363636363636364,0.2,0.8
SF-B25,SF-I28,9,5,3,2,6,3,0.3333333333333333,0.6666666666666666,0.4,0.6
SF-B25,SF-I30-2,10,14,5,5,5,9,0.5,0.5,0.35714285714285715,0.6428571428571429
SF-B25,SF I29-1,4,18,1,0,3,18,0.25,0.75,0.0,1.0
SF-B25,SF-H28,44,39,14,7,30,32,0.3181818181818182,0.6818181818181818,0.1794871794871795,0.8205128205128205
SF-B25,SF-S24,3,6,3,4,0,2,1.0,0.0,0.6666666666666666,0.3333333333333333
SF-B25,SF-R24,6,7,1,1,5,6,0.16666666666666666,0.8333333333333334,0.14285714285714285,0.8571428571428571
SF-B25,SF-Q26,1,1,1,0,0,1,1.0,0.0,0.0,1.0
SF-B25,SF-O25-2,3,1,1,0,2,1,0.3333333333333333,0.6666666666666666,0.0,1.0
SF-B25,SF-T22,2,2,0,0,2,2,0.0,1.0,0.0,1.0
SF-B25,SF-Q22-1,4,2,0,0,4,2,0.0,1.0,0.0,1.0
SF-B25,SF-P22,5,1,0,0,5,1,0.0,1.0,0.0,1.0
SF-B25,SF-W19,2,2,0,0,2,2,0.0,1.0,0.0,1.0
SF-B25,SF-T20,1,1,0,0,1,1,0.0,1.0,0.0,1.0
SF-B25,SF-Z28,3,1,2,0,1,1,0.6666666666666666,0.3333333333333333,0.0,1.0
SF-B25,SF-X29,2,2,0,0,2,2,0.0,1.0,0.0,1.0
SF-B25,SF-V30,1,1,0,1,1,0,0.0,1.0,1.0,0.0
SF-B25,SF-X19,1,1,0,0,1,1,0.0,1.0,0.0,1.0
SF-E27,SF-K26,4,3,0,2,4,1,0.0,1.0,0.6666666666666666,0.3333333333333333
SF-E27,SF-M30,2,1,2,0,0,1,1.0,0.0,0.0,1.0
SF-E27,SF-J29-3,6,11,4,10,2,1,0.6666666666666666,0.3333333333333333,0.9090909090909091,0.09090909090909091
SF-E27,SF-J29,2,7,1,1,1,6,0.5,0.5,0.14285714285714285,0.8571428571428571
SF-E27,SF-L25,1,3,0,2,1,1,0.0,1.0,0.6666666666666666,0.3333333333333333
SF-E27,SF-M24,1,1,0,0,1,1,0.0,1.0,0.0,1.0
SF-E27,SF-K27-2,1,4,0,2,1,2,0.0,1.0,0.5,0.5
SF-E27,SF-L28,2,1,2,0,0,1,1.0,0.0,0.0,1.0
SF-E27,SF-K29-1,31,18,13,9,18,9,0.41935483870967744,0.5806451612903226,0.5,0.5
SF-E27,SF-J28-2,4,2,2,0,2,2,0.5,0.5,0.0,1.0
SF-E27,SF-K27,1,4,0,0,1,4,0.0,1.0,0.0,1.0
SF-E27,SF-K25,11,14,3,1,8,13,0.2727272727272727,0.7272727272727273,0.07142857142857142,0.9285714285714286
SF-E27,SF-J25,7,23,2,1,5,22,0.2857142857142857,0.7142857142857143,0.043478260869565216,0.9565217391304348
SF-E27,SF-H26-2,5,8,2,4,3,4,0.4,0.6,0.5,0.5
SF-E27,SF-J24,4,3,2,2,2,1,0.5,0.5,0.6666666666666666,0.3333333333333333
SF-E27,SF-J26,5,3,1,0,4,3,0.2,0.8,0.0,1.0
SF-E27,SF-I26-,2,2,1,0,1,2,0.5,0.5,0.0,1.0
SF-E27,SF-I25,11,10,6,7,5,3,0.5454545454545454,0.45454545454545453,0.7,0.3
SF-E27,SF-H26,77,50,71,41,6,9,0.922077922077922,0.07792207792207792,0.82,0.18
SF-E27,SF-O23,9,3,1,1,8,2,0.1111111111111111,0.8888888888888888,0.3333333333333333,0.6666666666666666
SF-E27,SF-H27-1,5,2,3,2,2,0,0.6,0.4,1.0,0.0
SF-E27,SF-F28-2,7,28,4,21,3,7,0.5714285714285714,0.42857142857142855,0.75,0.25
SF-E27,SF-G27,48,53,28,26,20,27,0.5833333333333334,0.4166666666666667,0.49056603773584906,0.5094339622641509
SF-E27,SF-M22-2,7,5,2,1,5,4,0.2857142857142857,0.7142857142857143,0.2,0.8
SF-E27,SF-L22,4,3,0,0,4,3,0.0,1.0,0.0,1.0
SF-E27,SF-F27,16,12,6,6,10,6,0.375,0.625,0.5,0.5
SF-E27,SF-N22-2,1,7,1,3,0,4,1.0,0.0,0.42857142857142855,0.5714285714285714
SF-E27,SF-G28-2,1,2,0,0,1,2,0.0,1.0,0.0,1.0
SF-E27,SF-G28-1,1,4,1,3,0,1,1.0,0.0,0.75,0.25
SF-E27,SF-O25-1,1,1,0,0,1,1,0.0,1.0,0.0,1.0
SF-E27,SF-K22-2,3,2,0,1,3,1,0.0,1.0,0.5,0.5
SF-E27,SF-G23,2,1,0,0,2,1,0.0,1.0,0.0,1.0
SF-E27,SF-G24,8,11,5,0,3,11,0.625,0.375,0.0,1.0
SF-E27,SF-G25,17,17,9,2,8,15,0.5294117647058824,0.47058823529411764,0.11764705882352941,0.8823529411764706
SF-E27,SF-F23,14,7,8,1,6,6,0.5714285714285714,0.42857142857142855,0.14285714285714285,0.8571428571428571
SF-E27,SF-E23,132,8,0,0,132,8,0.0,1.0,0.0,1.0
SF-E27,SF-D24,10,7,7,1,3,6,0.7,0.3,0.14285714285714285,0.8571428571428571
SF-E27,SF-C22,21,1,1,1,20,0,0.047619047619047616,0.9523809523809523,1.0,0.0
SF-E27,SF-B22,21,20,6,6,15,14,0.2857142857142857,0.7142857142857143,0.3,0.7
SF-E27,SF-J17,1,2,0,0,1,2,0.0,1.0,0.0,1.0
SF-E27,SF-H20,4,4,2,2,2,2,0.5,0.5,0.5,0.5
SF-E27,SF-G20,4,1,4,0,0,1,1.0,0.0,0.0,1.0
SF-E27,SF-F19,2,2,0,1,2,1,0.0,1.0,0.5,0.5
SF-E27,SF-E18,10,4,0,0,10,4,0.0,1.0,0.0,1.0
SF-E27,SF-E20,7,3,0,0,7,3,0.0,1.0,0.0,1.0
SF-E27,SF-H30,6,3,4,2,2,1,0.6666666666666666,0.3333333333333333,0.6666666666666666,0.3333333333333333
SF-E27,SF-G30-2,37,46,25,28,12,18,0.6756756756756757,0.32432432432432434,0.6086956521739131,0.391304347826087
SF-E27,SF-F30-1,1,4,1,3,0,1,1.0,0.0,0.75,0.25
SF-E27,SF-E29-2,12,23,9,10,3,13,0.75,0.25,0.43478260869565216,0.5652173913043478
SF-E27,SF-E29-1,7,5,6,3,1,2,0.8571428571428571,0.14285714285714285,0.6,0.4
SF-E27,SF-D29,3,4,3,2,0,2,1.0,0.0,0.5,0.5
SF-E27,SF-D28,48,46,41,34,7,12,0.8541666666666666,0.14583333333333334,0.7391304347826086,0.2608695652173913
SF-E27,SF-A27,6,11,2,8,4,3,0.3333333333333333,0.6666666666666666,0.7272727272727273,0.2727272727272727
SF-E27,SF-G29-2,19,16,5,4,14,12,0.2631578947368421,0.7368421052631579,0.25,0.75
SF-E27,SF-G29-1,16,3,11,3,5,0,0.6875,0.3125,1.0,0.0
SF-E27,SF-G30-1,39,14,7,6,32,8,0.1794871794871795,0.8205128205128205,0.42857142857142855,0.5714285714285714
SF-E27,SF-G29-3,22,18,18,8,4,10,0.8181818181818182,0.18181818181818182,0.4444444444444444,0.5555555555555556
SF-E27,SF-F30-2,8,7,4,6,4,1,0.5,0.5,0.8571428571428571,0.14285714285714285
SF-E27,SF-F29,5,1,3,1,2,0,0.6,0.4,1.0,0.0
SF-E27,SF-E29-3,3,6,3,3,0,3,1.0,0.0,0.5,0.5
SF-E27,SF-F28-1,62,140,39,120,23,20,0.6290322580645161,0.3709677419354839,0.8571428571428571,0.14285714285714285
SF-E27,SF-E28-2,10,4,5,2,5,2,0.5,0.5,0.5,0.5
SF-E27,SF-E28,2,11,1,4,1,7,0.5,0.5,0.36363636363636365,0.6363636363636364
SF-E27,SF-J12,3,4,2,0,1,4,0.6666666666666666,0.3333333333333333,0.0,1.0
SF-E27,SF-H13,1,2,0,0,1,2,0.0,1.0,0.0,1.0
SF-E27,SF-H12,3,4,2,1,1,3,0.6666666666666666,0.3333333333333333,0.25,0.75
SF-E27,SF-G10-2,4,1,0,0,4,1,0.0,1.0,0.0,1.0
SF-E27,SF-G10-1,3,3,0,0,3,3,0.0,1.0,0.0,1.0
SF-E27,SF-F16,1,1,0,0,1,1,0.0,1.0,0.0,1.0
SF-E27,SF-C20,1,1,1,0,0,1,1.0,0.0,0.0,1.0
SF-E27,SF-B21,3,2,1,0,2,2,0.3333333333333333,0.6666666666666666,0.0,1.0
SF-E27,SF-B19,23,7,2,0,21,7,0.08695652173913043,0.9130434782608695,0.0,1.0
SF-E27,SF-A20,25,16,13,5,12,11,0.52,0.48,0.3125,0.6875
SF-E27,SF-A19,1,3,1,2,0,1,1.0,0.0,0.6666666666666666,0.3333333333333333
SF-E27,SF-C26,24,21,19,17,5,4,0.7916666666666666,0.20833333333333334,0.8095238095238095,0.19047619047619047
SF-E27,SF-C25,51,25,23,4,28,21,0.45098039215686275,0.5490196078431373,0.16,0.84
SF-E27,SF-B25,29,18,12,8,17,10,0.41379310344827586,0.5862068965517241,0.4444444444444444,0.5555555555555556
SF-E27,SF-B28-2,2,1,1,1,1,0,0.5,0.5,1.0,0.0
SF-E27,SF-D27,39,26,32,11,7,15,0.8205128205128205,0.1794871794871795,0.4230769230769231,0.5769230769230769
SF-E27,SF-C28-2,5,4,3,2,2,2,0.6,0.4,0.5,0.5
SF-E27,SF-C28-1,4,2,4,1,0,1,1.0,0.0,0.5,0.5
SF-E27,SF-B28,15,7,10,6,5,1,0.6666666666666666,0.3333333333333333,0.8571428571428571,0.14285714285714285
SF-E27,SF-J1,4,4,0,0,4,4,0.0,1.0,0.0,1.0
SF-E27,SF-G7,2,2,0,0,2,2,0.0,1.0,0.0,1.0
SF-E27,SF-F9,8,2,0,0,8,2,0.0,1.0,0.0,1.0
SF-E27,SF-H25,2,3,0,2,2,1,0.0,1.0,0.6666666666666666,0.3333333333333333
SF-E27,SF-G26,4,6,3,2,1,4,0.75,0.25,0.3333333333333333,0.6666666666666666
SF-E27,SF-K21,6,7,1,0,5,7,0.16666666666666666,0.8333333333333334,0.0,1.0
SF-E27,SF-J23-1,19,25,12,11,7,14,0.631578947368421,0.3684210526315789,0.44,0.56
SF-E27,SF-J22-1,3,4,0,0,3,4,0.0,1.0,0.0,1.0
SF-E27,SF-J22-2,2,4,0,0,2,4,0.0,1.0,0.0,1.0
SF-E27,SF-J21,2,3,1,1,1,2,0.5,0.5,0.3333333333333333,0.6666666666666666
SF-E27,SF-I21,2,5,0,0,2,5,0.0,1.0,0.0,1.0
SF-E27,SF-I22,2,1,2,1,0,0,1.0,0.0,1.0,0.0
SF-E27,SF-I23-2,1,3,1,2,0,1,1.0,0.0,0.6666666666666666,0.3333333333333333
SF-E27,SF-I24,4,3,1,1,3,2,0.25,0.75,0.3333333333333333,0.6666666666666666
SF-E27,SF-I23-1,1,11,1,11,0,0,1.0,0.0,1.0,0.0
SF-E27,SF-F26,10,15,4,9,6,6,0.4,0.6,0.6,0.4
SF-E27,SF-M13,3,1,0,0,3,1,0.0,1.0,0.0,1.0
SF-E27,SF-M15,3,1,2,0,1,1,0.6666666666666666,0.3333333333333333,0.0,1.0
SF-E27,SF-L19,2,5,0,0,2,5,0.0,1.0,0.0,1.0
SF-E27,SF-L20,5,8,0,1,5,7,0.0,1.0,0.125,0.875
SF-E27,SF-M20,9,13,1,3,8,10,0.1111111111111111,0.8888888888888888,0.23076923076923078,0.7692307692307693
SF-E27,SF-K20,2,2,0,1,2,1,0.0,1.0,0.5,0.5
SF-E27,SF-K15-,3,7,1,0,2,7,0.3333333333333333,0.6666666666666666,0.0,1.0
SF-E27,SF-K19,4,2,0,0,4,2,0.0,1.0,0.0,1.0
SF-E27,SF-K18,3,5,2,1,1,4,0.6666666666666666,0.3333333333333333,0.2,0.8
SF-E27,SF-K17,1,5,0,0,1,5,0.0,1.0,0.0,1.0
SF-E27,SF-J16,33,3,29,0,4,3,0.8787878787878788,0.12121212121212122,0.0,1.0
SF-E27,SF-J18,2,4,2,1,0,3,1.0,0.0,0.25,0.75
SF-E27,SF-J20,1,2,0,1,1,1,0.0,1.0,0.5,0.5
SF-E27,SF-J19,5,5,2,1,3,4,0.4,0.6,0.2,0.8
SF-E27,SF-M11,1,1,0,0,1,1,0.0,1.0,0.0,1.0
SF-E27,SF-R19,2,2,0,0,2,2,0.0,1.0,0.0,1.0
SF-E27,SF-R20,1,5,0,0,1,5,0.0,1.0,0.0,1.0
SF-E27,SF-Q21-2,2,3,1,1,1,2,0.5,0.5,0.3333333333333333,0.6666666666666666
SF-E27,SF-Q21-1,10,4,0,1,10,3,0.0,1.0,0.25,0.75
SF-E27,SF-P21,2,1,0,0,2,1,0.0,1.0,0.0,1.0
SF-E27,SF-O18,3,6,1,2,2,4,0.3333333333333333,0.6666666666666666,0.3333333333333333,0.6666666666666666
SF-E27,SF-O19,4,46,0,15,4,31,0.0,1.0,0.32608695652173914,0.6739130434782609
SF-E27,SF-O21,4,5,1,2,3,3,0.25,0.75,0.4,0.6
SF-E27,SF-O22,11,43,6,5,5,38,0.5454545454545454,0.45454545454545453,0.11627906976744186,0.8837209302325582
SF-E27,SF-N21,4,1,0,0,4,1,0.0,1.0,0.0,1.0
SF-E27,SF-N20-2,2,4,0,1,2,3,0.0,1.0,0.25,0.75
SF-E27,SF-L21,6,11,2,2,4,9,0.3333333333333333,0.6666666666666666,0.18181818181818182,0.8181818181818182
SF-E27,SF-O30-2,6,6,3,4,3,2,0.5,0.5,0.6666666666666666,0.3333333333333333
SF-E27,SF-O30,5,1,2,1,3,0,0.4,0.6,1.0,0.0
SF-E27,SF-N29,7,6,3,1,4,5,0.42857142857142855,0.5714285714285714,0.16666666666666666,0.8333333333333334
SF-E27,SF-N28,12,5,5,0,7,5,0.4166666666666667,0.5833333333333334,0.0,1.0
SF-E27,SF-L30-1,8,10,4,2,4,8,0.5,0.5,0.2,0.8
SF-E27,SF-L31-1,6,14,4,4,2,10,0.6666666666666666,0.3333333333333333,0.2857142857142857,0.7142857142857143
SF-E27,SF-K30-2,5,3,3,3,2,0,0.6,0.4,1.0,0.0
SF-E27,SF-L29,26,11,0,0,26,11,0.0,1.0,0.0,1.0
SF-E27,SF-J29-1,5,8,2,1,3,7,0.4,0.6,0.125,0.875
SF-E27,SF-I30,4,7,3,6,1,1,0.75,0.25,0.8571428571428571,0.14285714285714285
SF-E27,SF-I29-2,3,3,1,1,2,2,0.3333333333333333,0.6666666666666666,0.3333333333333333,0.6666666666666666
SF-E27,SF-I27,5,2,2,1,3,1,0.4,0.6,0.5,0.5
SF-E27,SF-I28,3,12,3,4,0,8,1.0,0.0,0.3333333333333333,0.6666666666666666
SF-E27,SF-I30-2,2,6,0,2,2,4,0.0,1.0,0.3333333333333333,0.6666666666666666
SF-E27,SF I29-1,1,2,0,0,1,2,0.0,1.0,0.0,1.0
SF-E27,SF-H28,3,14,1,11,2,3,0.3333333333333333,0.6666666666666666,0.7857142857142857,0.21428571428571427
SF-E27,SF-H29,3,3,2,1,1,2,0.6666666666666666,0.3333333333333333,0.3333333333333333,0.6666666666666666
SF-E27,SF-S24,4,5,1,1,3,4,0.25,0.75,0.2,0.8
SF-E27,SF-P26,2,5,2,3,0,2,1.0,0.0,0.6,0.4
SF-E27,SF-O25-2,1,1,0,0,1,1,0.0,1.0,0.0,1.0
SF-E27,SF-T21,7,4,7,3,0,1,1.0,0.0,0.75,0.25
SF-E27,SF-T22,6,1,1,0,5,1,0.16666666666666666,0.8333333333333334,0.0,1.0
SF-E27,SF-S22-2,3,4,0,0,3,4,0.0,1.0,0.0,1.0
SF-E27,SF-Q22-1,3,5,0,0,3,5,0.0,1.0,0.0,1.0
SF-E27,SF-Q22-2,6,2,0,0,6,2,0.0,1.0,0.0,1.0
SF-E27,SF-P22,5,6,1,0,4,6,0.2,0.8,0.0,1.0
SF-E27,SF-U21,2,1,0,0,2,1,0.0,1.0,0.0,1.0
SF-E27,SF-T20,2,8,0,0,2,8,0.0,1.0,0.0,1.0
SF-B28-2,SF-M30,3,7,1,0,2,7,0.3333333333333333,0.6666666666666666,0.0,1.0
SF-B28-2,SF-J29,7,8,6,7,1,1,0.8571428571428571,0.14285714285714285,0.875,0.125
SF-B28-2,SF-M28,1,1,0,0,1,1,0.0,1.0,0.0,1.0
SF-B28-2,SF-L25,9,4,0,1,9,3,0.0,1.0,0.25,0.75
SF-B28-2,SF-L24,22,30,1,6,21,24,0.045454545454545456,0.9545454545454546,0.2,0.8
SF-B28-2,SF-L28,7,2,4,2,3,0,0.5714285714285714,0.42857142857142855,1.0,0.0
SF-B28-2,SF-K29-1,6,4,1,2,5,2,0.16666666666666666,0.8333333333333334,0.5,0.5
SF-B28-2,SF-J28-2,2,2,0,0,2,2,0.0,1.0,0.0,1.0
SF-B28-2,SF-K25,14,4,1,3,13,1,0.07142857142857142,0.9285714285714286,0.75,0.25
SF-B28-2,SF-H26-2,2,6,1,3,1,3,0.5,0.5,0.5,0.5
SF-B28-2,SF-O24,2,6,0,1,2,5,0.0,1.0,0.16666666666666666,0.8333333333333334
SF-B28-2,SF-J26,3,9,3,1,0,8,1.0,0.0,0.1111111111111111,0.8888888888888888
SF-B28-2,SF-I25,6,5,4,4,2,1,0.6666666666666666,0.3333333333333333,0.8,0.2
SF-B28-2,SF-H26,8,10,6,6,2,4,0.75,0.25,0.6,0.4
SF-B28-2,SF-F28-2,12,17,7,12,5,5,0.5833333333333334,0.4166666666666667,0.7058823529411765,0.29411764705882354
SF-B28-2,SF-G27,26,23,10,8,16,15,0.38461538461538464,0.6153846153846154,0.34782608695652173,0.6521739130434783
SF-B28-2,SF-M22-2,2,3,0,0,2,3,0.0,1.0,0.0,1.0
SF-B28-2,SF-F27,15,3,9,2,6,1,0.6,0.4,0.6666666666666666,0.3333333333333333
SF-B28-2,SF-N22-2,2,8,1,1,1,7,0.5,0.5,0.125,0.875
SF-B28-2,SF-G28-2,2,2,1,0,1,2,0.5,0.5,0.0,1.0
SF-B28-2,SF-G28-1,4,2,3,1,1,1,0.75,0.25,0.5,0.5
SF-B28-2,SF-K22-2,2,2,1,2,1,0,0.5,0.5,1.0,0.0
SF-B28-2,SF-K24,11,6,2,2,9,4,0.18181818181818182,0.8181818181818182,0.3333333333333333,0.6666666666666666
SF-B28-2,SF-J23-2,2,3,2,3,0,0,1.0,0.0,1.0,0.0
SF-B28-2,SF-G24,2,4,1,1,1,3,0.5,0.5,0.25,0.75
SF-B28-2,SF-G25,7,6,4,2,3,4,0.5714285714285714,0.42857142857142855,0.3333333333333333,0.6666666666666666
SF-B28-2,SF-E23,2,4,0,0,2,4,0.0,1.0,0.0,1.0
SF-B28-2,SF-D24,1,2,0,2,1,0,0.0,1.0,1.0,0.0
SF-B28-2,SF-C22,9,3,2,1,7,2,0.2222222222222222,0.7777777777777778,0.3333333333333333,0.6666666666666666
SF-B28-2,SF-B22,10,18,6,9,4,9,0.6,0.4,0.5,0.5
SF-B28-2,SF-J17,67,13,4,0,63,13,0.05970149253731343,0.9402985074626866,0.0,1.0
SF-B28-2,SF-G17,3,1,0,0,3,1,0.0,1.0,0.0,1.0
SF-B28-2,SF-G18,2,4,0,0,2,4,0.0,1.0,0.0,1.0
SF-B28-2,SF-H30,12,10,8,7,4,3,0.6666666666666666,0.3333333333333333,0.7,0.3
SF-B28-2,SF-G30-2,6,8,3,5,3,3,0.5,0.5,0.625,0.375
SF-B28-2,SF-F30-1,1,4,0,2,1,2,0.0,1.0,0.5,0.5
SF-B28-2,SF-E29-2,60,48,15,16,45,32,0.25,0.75,0.3333333333333333,0.6666666666666666
SF-B28-2,SF-E29-1,32,33,23,23,9,10,0.71875,0.28125,0.696969696969697,0.30303030303030304
SF-B28-2,SF-D29,43,35,36,27,7,8,0.8372093023255814,0.16279069767441862,0.7714285714285715,0.22857142857142856
SF-B28-2,SF-D28,77,74,53,47,24,27,0.6883116883116883,0.3116883116883117,0.6351351351351351,0.36486486486486486
SF-B28-2,SF-A27,20,17,17,11,3,6,0.85,0.15,0.6470588235294118,0.35294117647058826
SF-B28-2,SF-G29-2,87,67,84,58,3,9,0.9655172413793104,0.034482758620689655,0.8656716417910447,0.13432835820895522
SF-B28-2,SF-G29-1,16,32,15,31,1,1,0.9375,0.0625,0.96875,0.03125
SF-B28-2,SF-G30-1,15,21,14,13,1,8,0.9333333333333333,0.06666666666666667,0.6190476190476191,0.38095238095238093
SF-B28-2,SF-G29-3,11,22,7,5,4,17,0.6363636363636364,0.36363636363636365,0.22727272727272727,0.7727272727272727
SF-B28-2,SF-F30-2,3,9,3,6,0,3,1.0,0.0,0.6666666666666666,0.3333333333333333
SF-B28-2,SF-F29,6,12,6,11,0,1,1.0,0.0,0.9166666666666666,0.08333333333333333
SF-B28-2,SF-E29-3,23,9,8,5,15,4,0.34782608695652173,0.6521739130434783,0.5555555555555556,0.4444444444444444
SF-B28-2,SF-F28-1,8,24,5,11,3,13,0.625,0.375,0.4583333333333333,0.5416666666666666
SF-B28-2,SF-E28-2,4,12,3,5,1,7,0.75,0.25,0.4166666666666667,0.5833333333333334
SF-B28-2,SF-E28,10,22,9,17,1,5,0.9,0.1,0.7727272727272727,0.22727272727272727
SF-B28-2,SF-F15,3,1,1,0,2,1,0.3333333333333333,0.6666666666666666,0.0,1.0
SF-B28-2,SF-C20,1,1,0,0,1,1,0.0,1.0,0.0,1.0
SF-B28-2,SF-B19,3,7,3,6,0,1,1.0,0.0,0.8571428571428571,0.14285714285714285
SF-B28-2,SF-A20,5,7,5,0,0,7,1.0,0.0,0.0,1.0
SF-B28-2,SF-C26,1,5,1,1,0,4,1.0,0.0,0.2,0.8
SF-B28-2,SF-C25,29,37,12,19,17,18,0.41379310344827586,0.5862068965517241,0.5135135135135135,0.4864864864864865
SF-B28-2,SF-B25,21,23,10,19,11,4,0.47619047619047616,0.5238095238095238,0.8260869565217391,0.17391304347826086
SF-B28-2,SF-E27,1,2,1,1,0,1,1.0,0.0,0.5,0.5
SF-B28-2,SF-D27,2,10,2,7,0,3,1.0,0.0,0.7,0.3
SF-B28-2,SF-C28-2,7,21,4,19,3,2,0.5714285714285714,0.42857142857142855,0.9047619047619048,0.09523809523809523
SF-B28-2,SF-C28-1,1,9,1,7,0,2,1.0,0.0,0.7777777777777778,0.2222222222222222
SF-B28-2,SF-B28,16,8,14,6,2,2,0.875,0.125,0.75,0.25
SF-B28-2,SF-G26,1,2,1,1,0,1,1.0,0.0,0.5,0.5
SF-B28-2,SF-K22-1,4,4,0,1,4,3,0.0,1.0,0.25,0.75
SF-B28-2,SF-J23-1,24,31,8,11,16,20,0.3333333333333333,0.6666666666666666,0.3548387096774194,0.6451612903225806
SF-B28-2,SF-J22-1,4,3,1,1,3,2,0.25,0.75,0.3333333333333333,0.6666666666666666
SF-B28-2,SF-J21,4,3,1,1,3,2,0.25,0.75,0.3333333333333333,0.6666666666666666
SF-B28-2,SF-I23-2,1,3,1,1,0,2,1.0,0.0,0.3333333333333333,0.6666666666666666
SF-B28-2,SF-I23-1,3,1,1,1,2,0,0.3333333333333333,0.6666666666666666,1.0,0.0
SF-B28-2,SF-F26,2,12,0,2,2,10,0.0,1.0,0.16666666666666666,0.8333333333333334
SF-B28-2,SF-M20,5,4,1,0,4,4,0.2,0.8,0.0,1.0
SF-B28-2,SF-K20,2,4,0,0,2,4,0.0,1.0,0.0,1.0
SF-B28-2,SF-K18,1,1,0,0,1,1,0.0,1.0,0.0,1.0
SF-B28-2,SF-J18,12,16,1,0,11,16,0.08333333333333333,0.9166666666666666,0.0,1.0
SF-B28-2,SF-J20,2,1,0,0,2,1,0.0,1.0,0.0,1.0
SF-B28-2,SF-J19,19,16,9,1,10,15,0.47368421052631576,0.5263157894736842,0.0625,0.9375
SF-B28-2,SF-P21,12,11,0,0,12,11,0.0,1.0,0.0,1.0
SF-B28-2,SF-O19,1,2,0,2,1,0,0.0,1.0,1.0,0.0
SF-B28-2,SF-O21,4,1,0,0,4,1,0.0,1.0,0.0,1.0
SF-B28-2,SF-L21,44,18,36,0,8,18,0.8181818181818182,0.18181818181818182,0.0,1.0
SF-B28-2,SF-P30,2,7,0,4,2,3,0.0,1.0,0.5714285714285714,0.42857142857142855
SF-B28-2,SF-O30-2,1,5,0,3,1,2,0.0,1.0,0.6,0.4
SF-B28-2,SF-O30,4,3,1,0,3,3,0.25,0.75,0.0,1.0
SF-B28-2,SF-N29,21,22,5,3,16,19,0.23809523809523808,0.7619047619047619,0.13636363636363635,0.8636363636363636
SF-B28-2,SF-N28,8,5,2,1,6,4,0.25,0.75,0.2,0.8
SF-B28-2,SF-L30-1,16,7,13,5,3,2,0.8125,0.1875,0.7142857142857143,0.2857142857142857
SF-B28-2,SF-L31-1,4,1,1,1,3,0,0.25,0.75,1.0,0.0
SF-B28-2,SF-L29,4,7,0,2,4,5,0.0,1.0,0.2857142857142857,0.7142857142857143
SF-B28-2,SF-I30,3,3,2,3,1,0,0.6666666666666666,0.3333333333333333,1.0,0.0
SF-B28-2,SF-I29-2,1,2,1,2,0,0,1.0,0.0,1.0,0.0
SF-B28-2,SF-I27,8,7,5,5,3,2,0.625,0.375,0.7142857142857143,0.2857142857142857
SF-B28-2,SF-I28,2,1,0,1,2,0,0.0,1.0,1.0,0.0
SF-B28-2,SF-I30-2,4,1,4,1,0,0,1.0,0.0,1.0,0.0
SF-B28-2,SF-H28,1,1,0,0,1,1,0.0,1.0,0.0,1.0
SF-B28-2,SF-R24,1,2,1,1,0,1,1.0,0.0,0.5,0.5
SF-B28-2,SF-N26,11,9,7,6,4,3,0.6363636363636364,0.36363636363636365,0.6666666666666666,0.3333333333333333
SF-B28-2,SF-S22-1,1,2,0,2,1,0,0.0,1.0,1.0,0.0
SF-B28-2,SF-P22,1,2,0,0,1,2,0.0,1.0,0.0,1.0
SF-B28-2,SF-S21,1,4,0,0,1,4,0.0,1.0,0.0,1.0
SF-D27,SF-M26,3,2,3,1,0,1,1.0,0.0,0.5,0.5
SF-D27,SF-M25,1,1,1,0,0,1,1.0,0.0,0.0,1.0
SF-D27,SF-M26-2,4,1,1,1,3,0,0.25,0.75,1.0,0.0
SF-D27,SF-L27,1,2,0,2,1,0,0.0,1.0,1.0,0.0
SF-D27,SF-K26,5,4,3,2,2,2,0.6,0.4,0.5,0.5
SF-D27,SF-J27,5,1,3,1,2,0,0.6,0.4,1.0,0.0
SF-D27,SF-M30,13,18,7,14,6,4,0.5384615384615384,0.46153846153846156,0.7777777777777778,0.2222222222222222
SF-D27,SF-L27-2,4,1,4,0,0,1,1.0,0.0,0.0,1.0
SF-D27,SF-J29-3,6,7,2,4,4,3,0.3333333333333333,0.6666666666666666,0.5714285714285714,0.42857142857142855
SF-D27,SF-J29,6,6,1,4,5,2,0.16666666666666666,0.8333333333333334,0.6666666666666666,0.3333333333333333
SF-D27,SF-M28,6,2,4,1,2,1,0.6666666666666666,0.3333333333333333,0.5,0.5
SF-D27,SF-L25,17,19,15,11,2,8,0.8823529411764706,0.11764705882352941,0.5789473684210527,0.42105263157894735
SF-D27,SF-M24,8,2,8,1,0,1,1.0,0.0,0.5,0.5
SF-D27,SF-L24,2,3,1,1,1,2,0.5,0.5,0.3333333333333333,0.6666666666666666
SF-D27,SF-N23,2,5,2,5,0,0,1.0,0.0,1.0,0.0
SF-D27,SF-N24-2,1,1,0,0,1,1,0.0,1.0,0.0,1.0
SF-D27,SF-K27-2,19,5,14,3,5,2,0.7368421052631579,0.2631578947368421,0.6,0.4
SF-D27,SF-J26-2,17,5,3,1,14,4,0.17647058823529413,0.8235294117647058,0.2,0.8
SF-D27,SF-K28-3,3,1,1,0,2,1,0.3333333333333333,0.6666666666666666,0.0,1.0
SF-D27,SF-L28,14,9,6,2,8,7,0.42857142857142855,0.5714285714285714,0.2222222222222222,0.7777777777777778
SF-D27,SF-K28,5,2,2,2,3,0,0.4,0.6,1.0,0.0
SF-D27,SF-K29-1,22,22,11,14,11,8,0.5,0.5,0.6363636363636364,0.36363636363636365
SF-D27,SF-J28-2,16,16,7,2,9,14,0.4375,0.5625,0.125,0.875
SF-D27,SF-K27,5,2,3,2,2,0,0.6,0.4,1.0,0.0
SF-D27,SF-J25,20,22,14,10,6,12,0.7,0.3,0.45454545454545453,0.5454545454545454
SF-D27,SF-H26-2,5,17,1,12,4,5,0.2,0.8,0.7058823529411765,0.29411764705882354
SF-D27,SF-P24,1,3,1,1,0,2,1.0,0.0,0.3333333333333333,0.6666666666666666
SF-D27,SF-J24,21,30,2,2,19,28,0.09523809523809523,0.9047619047619048,0.06666666666666667,0.9333333333333333
SF-D27,SF-O24,3,1,1,0,2,1,0.3333333333333333,0.6666666666666666,0.0,1.0
SF-D27,SF-J26,9,3,4,2,5,1,0.4444444444444444,0.5555555555555556,0.6666666666666666,0.3333333333333333
SF-D27,SF-I26-,7,5,0,2,7,3,0.0,1.0,0.4,0.6
SF-D27,SF-I25,92,28,58,16,34,12,0.6304347826086957,0.3695652173913043,0.5714285714285714,0.42857142857142855
SF-D27,SF-K23,6,2,5,1,1,1,0.8333333333333334,0.16666666666666666,0.5,0.5
SF-D27,SF-H26,141,55,83,36,58,19,0.5886524822695035,0.41134751773049644,0.6545454545454545,0.34545454545454546
SF-D27,SF-H27-1,17,13,7,7,10,6,0.4117647058823529,0.5882352941176471,0.5384615384615384,0.46153846153846156
SF-D27,SF-F28-2,36,33,28,19,8,14,0.7777777777777778,0.2222222222222222,0.5757575757575758,0.42424242424242425
SF-D27,SF-G27,127,66,75,37,52,29,0.5905511811023622,0.4094488188976378,0.5606060606060606,0.4393939393939394
SF-D27,SF-M22-2,16,6,4,3,12,3,0.25,0.75,0.5,0.5
SF-D27,SF-L22,9,5,2,1,7,4,0.2222222222222222,0.7777777777777778,0.2,0.8
SF-D27,SF-F27,68,49,50,37,18,12,0.7352941176470589,0.2647058823529412,0.7551020408163265,0.24489795918367346
SF-D27,SF-N22-2,14,9,4,4,10,5,0.2857142857142857,0.7142857142857143,0.4444444444444444,0.5555555555555556
SF-D27,SF-G28-2,7,13,7,4,0,9,1.0,0.0,0.3076923076923077,0.6923076923076923
SF-D27,SF-G28-1,8,2,7,0,1,2,0.875,0.125,0.0,1.0
SF-D27,SF-M22-1,2,2,0,0,2,2,0.0,1.0,0.0,1.0
SF-D27,SF-O25-1,1,1,1,0,0,1,1.0,0.0,0.0,1.0
SF-D27,SF-K22-2,6,4,5,0,1,4,0.8333333333333334,0.16666666666666666,0.0,1.0
SF-D27,SF-K24,7,10,3,2,4,8,0.42857142857142855,0.5714285714285714,0.2,0.8
SF-D27,SF-J23-2,9,2,7,1,2,1,0.7777777777777778,0.2222222222222222,0.5,0.5
SF-D27,SF-G23,50,5,5,1,45,4,0.1,0.9,0.2,0.8
SF-D27,SF-G24,28,17,13,3,15,14,0.4642857142857143,0.5357142857142857,0.17647058823529413,0.8235294117647058
SF-D27,SF-G25,38,104,16,77,22,27,0.42105263157894735,0.5789473684210527,0.7403846153846154,0.25961538461538464
SF-D27,SF-F23,37,16,4,3,33,13,0.10810810810810811,0.8918918918918919,0.1875,0.8125
SF-D27,SF-E23,36,20,14,5,22,15,0.3888888888888889,0.6111111111111112,0.25,0.75
SF-D27,SF-D24,10,3,1,2,9,1,0.1,0.9,0.6666666666666666,0.3333333333333333
SF-D27,SF-C22,3,11,2,2,1,9,0.6666666666666666,0.3333333333333333,0.18181818181818182,0.8181818181818182
SF-D27,SF-B22,44,81,13,37,31,44,0.29545454545454547,0.7045454545454546,0.4567901234567901,0.5432098765432098
SF-D27,SF-J17,20,7,1,0,19,7,0.05,0.95,0.0,1.0
SF-D27,SF-I19,2,1,1,0,1,1,0.5,0.5,0.0,1.0
SF-D27,SF-I20,6,4,0,2,6,2,0.0,1.0,0.5,0.5
SF-D27,SF-H16,1,1,0,0,1,1,0.0,1.0,0.0,1.0
SF-D27,SF-H19,2,2,0,0,2,2,0.0,1.0,0.0,1.0
SF-D27,SF-H20,1,2,0,0,1,2,0.0,1.0,0.0,1.0
SF-D27,SF-G19,1,2,0,0,1,2,0.0,1.0,0.0,1.0
SF-D27,SF-G18,8,1,1,1,7,0,0.125,0.875,1.0,0.0
SF-D27,SF-G20,6,2,4,1,2,1,0.6666666666666666,0.3333333333333333,0.5,0.5
SF-D27,SF-F19,8,3,1,0,7,3,0.125,0.875,0.0,1.0
SF-D27,SF-E18,3,5,2,0,1,5,0.6666666666666666,0.3333333333333333,0.0,1.0
SF-D27,SF-E20,3,12,1,2,2,10,0.3333333333333333,0.6666666666666666,0.16666666666666666,0.8333333333333334
SF-D27,SF-H30,42,20,41,19,1,1,0.9761904761904762,0.023809523809523808,0.95,0.05
SF-D27,SF-G30-2,23,24,9,22,14,2,0.391304347826087,0.6086956521739131,0.9166666666666666,0.08333333333333333
SF-D27,SF-F30-1,8,7,5,4,3,3,0.625,0.375,0.5714285714285714,0.42857142857142855
SF-D27,SF-E29-2,25,20,19,15,6,5,0.76,0.24,0.75,0.25
SF-D27,SF-E29-1,50,16,41,16,9,0,0.82,0.18,1.0,0.0
SF-D27,SF-D29,25,36,19,28,6,8,0.76,0.24,0.7777777777777778,0.2222222222222222
SF-D27,SF-D28,53,47,35,36,18,11,0.660377358490566,0.33962264150943394,0.7659574468085106,0.23404255319148937
SF-D27,SF-A27,28,69,18,48,10,21,0.6428571428571429,0.35714285714285715,0.6956521739130435,0.30434782608695654
SF-D27,SF-G29-2,37,26,26,20,11,6,0.7027027027027027,0.2972972972972973,0.7692307692307693,0.23076923076923078
SF-D27,SF-G29-1,26,38,15,33,11,5,0.5769230769230769,0.4230769230769231,0.868421052631579,0.13157894736842105
SF-D27,SF-G30-1,39,29,27,23,12,6,0.6923076923076923,0.3076923076923077,0.7931034482758621,0.20689655172413793
SF-D27,SF-G29-3,13,21,8,13,5,8,0.6153846153846154,0.38461538461538464,0.6190476190476191,0.38095238095238093
SF-D27,SF-F30-2,8,8,5,6,3,2,0.625,0.375,0.75,0.25
SF-D27,SF-F29,13,29,11,12,2,17,0.8461538461538461,0.15384615384615385,0.41379310344827586,0.5862068965517241
SF-D27,SF-E29-3,12,6,10,6,2,0,0.8333333333333334,0.16666666666666666,1.0,0.0
SF-D27,SF-F28-1,115,13,109,7,6,6,0.9478260869565217,0.05217391304347826,0.5384615384615384,0.46153846153846156
SF-D27,SF-E28-2,15,10,11,9,4,1,0.7333333333333333,0.26666666666666666,0.9,0.1
SF-D27,SF-E28,18,54,16,27,2,27,0.8888888888888888,0.1111111111111111,0.5,0.5
SF-D27,SF-J15,2,1,0,0,2,1,0.0,1.0,0.0,1.0
SF-D27,SF-I16,1,2,0,0,1,2,0.0,1.0,0.0,1.0
SF-D27,SF-H12,1,1,0,0,1,1,0.0,1.0,0.0,1.0
SF-D27,SF-H14,1,3,0,0,1,3,0.0,1.0,0.0,1.0
SF-D27,SF-G13,2,1,0,0,2,1,0.0,1.0,0.0,1.0
SF-D27,SF-C21,2,3,0,2,2,1,0.0,1.0,0.6666666666666666,0.3333333333333333
SF-D27,SF-C20,8,12,1,3,7,9,0.125,0.875,0.25,0.75
SF-D27,SF-B21,8,11,3,2,5,9,0.375,0.625,0.18181818181818182,0.8181818181818182
SF-D27,SF-B19,20,20,10,10,10,10,0.5,0.5,0.5,0.5
SF-D27,SF-A20,37,45,3,22,34,23,0.08108108108108109,0.918918918918919,0.4888888888888889,0.5111111111111111
SF-D27,SF-A19,5,8,2,5,3,3,0.4,0.6,0.625,0.375
SF-D27,SF-C26,47,66,21,39,26,27,0.44680851063829785,0.5531914893617021,0.5909090909090909,0.4090909090909091
SF-D27,SF-C25,36,56,13,33,23,23,0.3611111111111111,0.6388888888888888,0.5892857142857143,0.4107142857142857
SF-D27,SF-B25,49,56,19,35,30,21,0.3877551020408163,0.6122448979591837,0.625,0.375
SF-D27,SF-E27,26,39,11,32,15,7,0.4230769230769231,0.5769230769230769,0.8205128205128205,0.1794871794871795
SF-D27,SF-B28-2,10,2,7,2,3,0,0.7,0.3,1.0,0.0
SF-D27,SF-C28-2,2,11,2,10,0,1,1.0,0.0,0.9090909090909091,0.09090909090909091
SF-D27,SF-C28-1,7,15,3,15,4,0,0.42857142857142855,0.5714285714285714,1.0,0.0
SF-D27,SF-B28,14,74,7,46,7,28,0.5,0.5,0.6216216216216216,0.3783783783783784
SF-D27,SF-J1,11,7,0,0,11,7,0.0,1.0,0.0,1.0
SF-D27,SF-G7,2,1,0,0,2,1,0.0,1.0,0.0,1.0
SF-D27,SF-H25,9,8,3,3,6,5,0.3333333333333333,0.6666666666666666,0.375,0.625
SF-D27,SF-G26,24,10,13,8,11,2,0.5416666666666666,0.4583333333333333,0.8,0.2
SF-D27,SF-K21,3,5,0,1,3,4,0.0,1.0,0.2,0.8
SF-D27,SF-K22-1,5,17,3,13,2,4,0.6,0.4,0.7647058823529411,0.23529411764705882
SF-D27,SF-J23-1,58,51,27,20,31,31,0.46551724137931033,0.5344827586206896,0.39215686274509803,0.6078431372549019
SF-D27,SF-J22-1,8,11,1,4,7,7,0.125,0.875,0.36363636363636365,0.6363636363636364
SF-D27,SF-J22-2,5,4,0,1,5,3,0.0,1.0,0.25,0.75
SF-D27,SF-J21,13,11,9,6,4,5,0.6923076923076923,0.3076923076923077,0.5454545454545454,0.45454545454545453
SF-D27,SF-I21,3,3,2,1,1,2,0.6666666666666666,0.3333333333333333,0.3333333333333333,0.6666666666666666
SF-D27,SF-I22,3,2,1,0,2,2,0.3333333333333333,0.6666666666666666,0.0,1.0
SF-D27,SF-I23-2,9,4,6,1,3,3,0.6666666666666666,0.3333333333333333,0.25,0.75
SF-D27,SF-I24,14,18,7,4,7,14,0.5,0.5,0.2222222222222222,0.7777777777777778
SF-D27,SF-I23-1,2,6,0,0,2,6,0.0,1.0,0.0,1.0
SF-D27,SF-F26,64,37,36,26,28,11,0.5625,0.4375,0.7027027027027027,0.2972972972972973
SF-D27,SF-M15,1,3,0,1,1,2,0.0,1.0,0.3333333333333333,0.6666666666666666
SF-D27,SF-L19,6,3,2,0,4,3,0.3333333333333333,0.6666666666666666,0.0,1.0
SF-D27,SF-M20,18,8,7,0,11,8,0.3888888888888889,0.6111111111111112,0.0,1.0
SF-D27,SF-K17-2,4,3,2,0,2,3,0.5,0.5,0.0,1.0
SF-D27,SF-K20,7,7,1,3,6,4,0.14285714285714285,0.8571428571428571,0.42857142857142855,0.5714285714285714
SF-D27,SF-K15-,2,16,0,0,2,16,0.0,1.0,0.0,1.0
SF-D27,SF-K19,10,4,2,1,8,3,0.2,0.8,0.25,0.75
SF-D27,SF-K18,6,3,2,1,4,2,0.3333333333333333,0.6666666666666666,0.3333333333333333,0.6666666666666666
SF-D27,SF-K17,4,20,0,0,4,20,0.0,1.0,0.0,1.0
SF-D27,SF-J16,3,1,3,1,0,0,1.0,0.0,1.0,0.0
SF-D27,SF-J18,4,3,0,0,4,3,0.0,1.0,0.0,1.0
SF-D27,SF-J20,9,5,6,2,3,3,0.6666666666666666,0.3333333333333333,0.4,0.6
SF-D27,SF-J19,9,10,4,7,5,3,0.4444444444444444,0.5555555555555556,0.7,0.3
SF-D27,SF-R19,1,1,0,0,1,1,0.0,1.0,0.0,1.0
SF-D27,SF-R20,16,36,3,6,13,30,0.1875,0.8125,0.16666666666666666,0.8333333333333334
SF-D27,SF-Q21-2,46,13,37,3,9,10,0.8043478260869565,0.1956521739130435,0.23076923076923078,0.7692307692307693
SF-D27,SF-Q21-1,5,3,2,3,3,0,0.4,0.6,1.0,0.0
SF-D27,SF-P21,3,2,1,1,2,1,0.3333333333333333,0.6666666666666666,0.5,0.5
SF-D27,SF-O18,8,13,0,5,8,8,0.0,1.0,0.38461538461538464,0.6153846153846154
SF-D27,SF-O19,15,4,4,2,11,2,0.26666666666666666,0.7333333333333333,0.5,0.5
SF-D27,SF-O21,11,13,3,3,8,10,0.2727272727272727,0.7272727272727273,0.23076923076923078,0.7692307692307693
SF-D27,SF-O22,7,19,2,9,5,10,0.2857142857142857,0.7142857142857143,0.47368421052631576,0.5263157894736842
SF-D27,SF-N21,3,2,2,2,1,0,0.6666666666666666,0.3333333333333333,1.0,0.0
SF-D27,SF-M21,2,12,1,2,1,10,0.5,0.5,0.16666666666666666,0.8333333333333334
SF-D27,SF-L21,9,13,6,6,3,7,0.6666666666666666,0.3333333333333333,0.46153846153846156,0.5384615384615384
SF-D27,SF-S29,2,1,2,1,0,0,1.0,0.0,1.0,0.0
SF-D27,SF-Q30,27,47,25,23,2,24,0.9259259259259259,0.07407407407407407,0.48936170212765956,0.5106382978723404
SF-D27,SF-P30,4,2,2,1,2,1,0.5,0.5,0.5,0.5
SF-D27,SF-O30-2,2,3,2,1,0,2,1.0,0.0,0.3333333333333333,0.6666666666666666
SF-D27,SF-O30,21,19,16,12,5,7,0.7619047619047619,0.23809523809523808,0.631578947368421,0.3684210526315789
SF-D27,SF-N27,5,4,0,4,5,0,0.0,1.0,1.0,0.0
SF-D27,SF-N29,5,5,4,3,1,2,0.8,0.2,0.6,0.4
SF-D27,SF-N28,3,6,1,1,2,5,0.3333333333333333,0.6666666666666666,0.16666666666666666,0.8333333333333334
SF-D27,SF-L30-1,94,96,88,88,6,8,0.9361702127659575,0.06382978723404255,0.9166666666666666,0.08333333333333333
SF-D27,SF-L31-1,7,11,6,6,1,5,0.8571428571428571,0.14285714285714285,0.5454545454545454,0.45454545454545453
SF-D27,SF-K30-2,3,8,3,7,0,1,1.0,0.0,0.875,0.125
SF-D27,SF-L29,27,18,9,9,18,9,0.3333333333333333,0.6666666666666666,0.5,0.5
SF-D27,SF-J29-1,12,12,7,11,5,1,0.5833333333333334,0.4166666666666667,0.9166666666666666,0.08333333333333333
SF-D27,SF-I30,17,10,15,6,2,4,0.8823529411764706,0.11764705882352941,0.6,0.4
SF-D27,SF-I29-2,6,3,4,2,2,1,0.6666666666666666,0.3333333333333333,0.6666666666666666,0.3333333333333333
SF-D27,SF-I27,14,2,10,1,4,1,0.7142857142857143,0.2857142857142857,0.5,0.5
SF-D27,SF-I28,197,200,164,164,33,36,0.8324873096446701,0.16751269035532995,0.82,0.18
SF-D27,SF-I30-2,7,3,4,0,3,3,0.5714285714285714,0.42857142857142855,0.0,1.0
SF-D27,SF I29-1,4,2,2,2,2,0,0.5,0.5,1.0,0.0
SF-D27,SF-H28,19,25,17,19,2,6,0.8947368421052632,0.10526315789473684,0.76,0.24
SF-D27,SF-R24,8,2,3,2,5,0,0.375,0.625,1.0,0.0
SF-D27,SF-P26,114,143,110,92,4,51,0.9649122807017544,0.03508771929824561,0.6433566433566433,0.35664335664335667
SF-D27,SF-N26,4,1,4,0,0,1,1.0,0.0,0.0,1.0
SF-D27,SF-T21,31,2,29,0,2,2,0.9354838709677419,0.06451612903225806,0.0,1.0
SF-D27,SF-T22,4,16,2,13,2,3,0.5,0.5,0.8125,0.1875
SF-D27,SF-Q23-3,1,2,1,0,0,2,1.0,0.0,0.0,1.0
SF-D27,SF-Q22-1,3,3,0,1,3,2,0.0,1.0,0.3333333333333333,0.6666666666666666
SF-D27,SF-Q22-2,11,4,3,2,8,2,0.2727272727272727,0.7272727272727273,0.5,0.5
SF-D27,SF-P22,4,4,2,2,2,2,0.5,0.5,0.5,0.5
SF-D27,SF-U21,6,2,6,0,0,2,1.0,0.0,0.0,1.0
SF-D27,SF-T20,1,1,0,0,1,1,0.0,1.0,0.0,1.0
SF-C28-2,SF-J27,1,2,0,0,1,2,0.0,1.0,0.0,1.0
SF-C28-2,SF-M30,2,4,0,1,2,3,0.0,1.0,0.25,0.75
SF-C28-2,SF-J29-3,23,3,15,1,8,2,0.6521739130434783,0.34782608695652173,0.3333333333333333,0.6666666666666666
SF-C28-2,SF-J29,27,63,11,20,16,43,0.4074074074074074,0.5925925925925926,0.31746031746031744,0.6825396825396826
SF-C28-2,SF-M28,1,3,0,1,1,2,0.0,1.0,0.3333333333333333,0.6666666666666666
SF-C28-2,SF-L25,5,7,5,5,0,2,1.0,0.0,0.7142857142857143,0.2857142857142857
SF-C28-2,SF-N23,1,3,1,2,0,1,1.0,0.0,0.6666666666666666,0.3333333333333333
SF-C28-2,SF-K27-2,4,3,3,0,1,3,0.75,0.25,0.0,1.0
SF-C28-2,SF-J26-2,2,2,1,2,1,0,0.5,0.5,1.0,0.0
SF-C28-2,SF-K29-1,7,7,2,1,5,6,0.2857142857142857,0.7142857142857143,0.14285714285714285,0.8571428571428571
SF-C28-2,SF-K25,3,1,1,1,2,0,0.3333333333333333,0.6666666666666666,1.0,0.0
SF-C28-2,SF-O24,2,1,0,1,2,0,0.0,1.0,1.0,0.0
SF-C28-2,SF-I26-,2,1,0,1,2,0,0.0,1.0,1.0,0.0
SF-C28-2,SF-I25,8,1,4,0,4,1,0.5,0.5,0.0,1.0
SF-C28-2,SF-H26,3,10,2,4,1,6,0.6666666666666666,0.3333333333333333,0.4,0.6
SF-C28-2,SF-F28-2,33,21,3,14,30,7,0.09090909090909091,0.9090909090909091,0.6666666666666666,0.3333333333333333
SF-C28-2,SF-G27,10,17,3,8,7,9,0.3,0.7,0.47058823529411764,0.5294117647058824
SF-C28-2,SF-M22-2,3,2,2,0,1,2,0.6666666666666666,0.3333333333333333,0.0,1.0
SF-C28-2,SF-L22,1,3,1,1,0,2,1.0,0.0,0.3333333333333333,0.6666666666666666
SF-C28-2,SF-F27,4,3,1,1,3,2,0.25,0.75,0.3333333333333333,0.6666666666666666
SF-C28-2,SF-N22-2,10,7,9,6,1,1,0.9,0.1,0.8571428571428571,0.14285714285714285
SF-C28-2,SF-K22-2,2,2,1,0,1,2,0.5,0.5,0.0,1.0
SF-C28-2,SF-K24,3,3,0,0,3,3,0.0,1.0,0.0,1.0
SF-C28-2,SF-G24,8,5,1,0,7,5,0.125,0.875,0.0,1.0
SF-C28-2,SF-G25,132,108,4,1,128,107,0.030303030303030304,0.9696969696969697,0.009259259259259259,0.9907407407407407
SF-C28-2,SF-F23,3,3,0,0,3,3,0.0,1.0,0.0,1.0
SF-C28-2,SF-E23,5,5,4,0,1,5,0.8,0.2,0.0,1.0
SF-C28-2,SF-D24,5,2,3,0,2,2,0.6,0.4,0.0,1.0
SF-C28-2,SF-C22,1,1,0,1,1,0,0.0,1.0,1.0,0.0
SF-C28-2,SF-B22,2,6,0,2,2,4,0.0,1.0,0.3333333333333333,0.6666666666666666
SF-C28-2,SF-J17,3,2,0,0,3,2,0.0,1.0,0.0,1.0
SF-C28-2,SF-I20,20,20,15,10,5,10,0.75,0.25,0.5,0.5
SF-C28-2,SF-H20,1,2,1,2,0,0,1.0,0.0,1.0,0.0
SF-C28-2,SF-G18,1,1,0,0,1,1,0.0,1.0,0.0,1.0
SF-C28-2,SF-G20,1,1,0,1,1,0,0.0,1.0,1.0,0.0
SF-C28-2,SF-F19,2,1,0,0,2,1,0.0,1.0,0.0,1.0
SF-C28-2,SF-E20,1,1,0,0,1,1,0.0,1.0,0.0,1.0
SF-C28-2,SF-H30,8,7,4,0,4,7,0.5,0.5,0.0,1.0
SF-C28-2,SF-G30-2,13,16,12,9,1,7,0.9230769230769231,0.07692307692307693,0.5625,0.4375
SF-C28-2,SF-F30-1,6,10,4,6,2,4,0.6666666666666666,0.3333333333333333,0.6,0.4
SF-C28-2,SF-E29-2,2,5,2,4,0,1,1.0,0.0,0.8,0.2
SF-C28-2,SF-E29-1,5,12,4,6,1,6,0.8,0.2,0.5,0.5
SF-C28-2,SF-D29,15,18,13,14,2,4,0.8666666666666667,0.13333333333333333,0.7777777777777778,0.2222222222222222
SF-C28-2,SF-D28,12,23,10,19,2,4,0.8333333333333334,0.16666666666666666,0.8260869565217391,0.17391304347826086
SF-C28-2,SF-A27,17,18,12,16,5,2,0.7058823529411765,0.29411764705882354,0.8888888888888888,0.1111111111111111
SF-C28-2,SF-G29-2,17,8,9,7,8,1,0.5294117647058824,0.47058823529411764,0.875,0.125
SF-C28-2,SF-G30-1,8,3,6,1,2,2,0.75,0.25,0.3333333333333333,0.6666666666666666
SF-C28-2,SF-G29-3,9,11,7,4,2,7,0.7777777777777778,0.2222222222222222,0.36363636363636365,0.6363636363636364
SF-C28-2,SF-F30-2,2,4,0,1,2,3,0.0,1.0,0.25,0.75
SF-C28-2,SF-F28-1,7,64,3,61,4,3,0.42857142857142855,0.5714285714285714,0.953125,0.046875
SF-C28-2,SF-E28,4,12,4,11,0,1,1.0,0.0,0.9166666666666666,0.08333333333333333
SF-C28-2,SF-H13,1,1,0,0,1,1,0.0,1.0,0.0,1.0
SF-C28-2,SF-F16,3,1,2,0,1,1,0.6666666666666666,0.3333333333333333,0.0,1.0
SF-C28-2,SF-C21,1,1,1,0,0,1,1.0,0.0,0.0,1.0
SF-C28-2,SF-C20,3,3,1,0,2,3,0.3333333333333333,0.6666666666666666,0.0,1.0
SF-C28-2,SF-B19,5,9,4,5,1,4,0.8,0.2,0.5555555555555556,0.4444444444444444
SF-C28-2,SF-A20,12,12,5,9,7,3,0.4166666666666667,0.5833333333333334,0.75,0.25
SF-C28-2,SF-A19,4,3,3,2,1,1,0.75,0.25,0.6666666666666666,0.3333333333333333
SF-C28-2,SF-C26,33,11,23,1,10,10,0.696969696969697,0.30303030303030304,0.09090909090909091,0.9090909090909091
SF-C28-2,SF-C25,10,17,2,5,8,12,0.2,0.8,0.29411764705882354,0.7058823529411765
SF-C28-2,SF-B25,10,14,1,9,9,5,0.1,0.9,0.6428571428571429,0.35714285714285715
SF-C28-2,SF-E27,4,5,2,3,2,2,0.5,0.5,0.6,0.4
SF-C28-2,SF-B28-2,21,7,19,4,2,3,0.9047619047619048,0.09523809523809523,0.5714285714285714,0.42857142857142855
SF-C28-2,SF-D27,11,2,10,2,1,0,0.9090909090909091,0.09090909090909091,1.0,0.0
SF-C28-2,SF-C28-1,6,4,6,4,0,0,1.0,0.0,1.0,0.0
SF-C28-2,SF-B28,9,14,6,11,3,3,0.6666666666666666,0.3333333333333333,0.7857142857142857,0.21428571428571427
SF-C28-2,SF-H25,6,9,1,0,5,9,0.16666666666666666,0.8333333333333334,0.0,1.0
SF-C28-2,SF-G26,1,3,0,1,1,2,0.0,1.0,0.3333333333333333,0.6666666666666666
SF-C28-2,SF-K21,5,3,0,0,5,3,0.0,1.0,0.0,1.0
SF-C28-2,SF-K22-1,3,1,2,1,1,0,0.6666666666666666,0.3333333333333333,1.0,0.0
SF-C28-2,SF-J23-1,17,17,7,1,10,16,0.4117647058823529,0.5882352941176471,0.058823529411764705,0.9411764705882353
SF-C28-2,SF-J22-1,15,8,3,4,12,4,0.2,0.8,0.5,0.5
SF-C28-2,SF-I23-1,1,1,1,1,0,0,1.0,0.0,1.0,0.0
SF-C28-2,SF-F26,14,9,1,6,13,3,0.07142857142857142,0.9285714285714286,0.6666666666666666,0.3333333333333333
SF-C28-2,SF-M15,3,2,0,0,3,2,0.0,1.0,0.0,1.0
SF-C28-2,SF-L19,3,4,0,0,3,4,0.0,1.0,0.0,1.0
SF-C28-2,SF-L20,4,1,0,0,4,1,0.0,1.0,0.0,1.0
SF-C28-2,SF-M20,8,3,1,1,7,2,0.125,0.875,0.3333333333333333,0.6666666666666666
SF-C28-2,SF-K20,6,5,0,0,6,5,0.0,1.0,0.0,1.0
SF-C28-2,SF-J16,1,1,0,0,1,1,0.0,1.0,0.0,1.0
SF-C28-2,SF-J18,3,2,0,1,3,1,0.0,1.0,0.5,0.5
SF-C28-2,SF-J19,1,11,1,5,0,6,1.0,0.0,0.45454545454545453,0.5454545454545454
SF-C28-2,SF-M11,1,1,1,0,0,1,1.0,0.0,0.0,1.0
SF-C28-2,SF-R19,2,1,0,1,2,0,0.0,1.0,1.0,0.0
SF-C28-2,SF-Q21-2,2,2,0,1,2,1,0.0,1.0,0.5,0.5
SF-C28-2,SF-O21,3,1,2,0,1,1,0.6666666666666666,0.3333333333333333,0.0,1.0
SF-C28-2,SF-O22,2,4,1,0,1,4,0.5,0.5,0.0,1.0
SF-C28-2,SF-L21,1,3,0,0,1,3,0.0,1.0,0.0,1.0
SF-C28-2,SF-Q30,3,1,2,0,1,1,0.6666666666666666,0.3333333333333333,0.0,1.0
SF-C28-2,SF-P30,32,10,25,6,7,4,0.78125,0.21875,0.6,0.4
SF-C28-2,SF-O30-2,2,3,1,3,1,0,0.5,0.5,1.0,0.0
SF-C28-2,SF-O30,4,4,2,2,2,2,0.5,0.5,0.5,0.5
SF-C28-2,SF-N27,5,1,2,0,3,1,0.4,0.6,0.0,1.0
SF-C28-2,SF-N29,1,1,1,1,0,0,1.0,0.0,1.0,0.0
SF-C28-2,SF-N28,4,3,2,2,2,1,0.5,0.5,0.6666666666666666,0.3333333333333333
SF-C28-2,SF-L30-1,5,1,2,0,3,1,0.4,0.6,0.0,1.0
SF-C28-2,SF-L31-1,3,7,3,3,0,4,1.0,0.0,0.42857142857142855,0.5714285714285714
SF-C28-2,SF-K30-2,3,4,2,2,1,2,0.6666666666666666,0.3333333333333333,0.5,0.5
SF-C28-2,SF-L29,5,7,2,3,3,4,0.4,0.6,0.42857142857142855,0.5714285714285714
SF-C28-2,SF-J29-1,6,4,2,2,4,2,0.3333333333333333,0.6666666666666666,0.5,0.5
SF-C28-2,SF-I30,11,8,5,2,6,6,0.45454545454545453,0.5454545454545454,0.25,0.75
SF-C28-2,SF-I30-2,1,3,1,1,0,2,1.0,0.0,0.3333333333333333,0.6666666666666666
SF-C28-2,SF I29-1,4,3,0,1,4,2,0.0,1.0,0.3333333333333333,0.6666666666666666
SF-C28-2,SF-H28,3,7,0,5,3,2,0.0,1.0,0.7142857142857143,0.2857142857142857
SF-C28-2,SF-S24,1,2,0,1,1,1,0.0,1.0,0.5,0.5
SF-C28-2,SF-Q26,1,1,0,0,1,1,0.0,1.0,0.0,1.0
SF-C28-2,SF-O25-2,1,3,0,0,1,3,0.0,1.0,0.0,1.0
SF-C28-2,SF-N26,1,1,0,1,1,0,0.0,1.0,1.0,0.0
SF-C28-2,SF-Q22-1,2,1,1,0,1,1,0.5,0.5,0.0,1.0
SF-C28-2,SF-Q22-2,1,2,0,1,1,1,0.0,1.0,0.5,0.5
SF-C28-2,SF-S21,6,2,6,2,0,0,1.0,0.0,1.0,0.0
SF-C28-1,SF-M26-2,5,1,4,1,1,0,0.8,0.2,1.0,0.0
SF-C28-1,SF-L27,3,3,3,2,0,1,1.0,0.0,0.6666666666666666,0.3333333333333333
SF-C28-1,SF-K26,2,1,0,0,2,1,0.0,1.0,0.0,1.0
SF-C28-1,SF-J29-3,3,8,3,7,0,1,1.0,0.0,0.875,0.125
SF-C28-1,SF-J29,1,2,1,1,0,1,1.0,0.0,0.5,0.5
SF-C28-1,SF-M28,1,1,0,0,1,1,0.0,1.0,0.0,1.0
SF-C28-1,SF-K27-2,1,1,1,1,0,0,1.0,0.0,1.0,0.0
SF-C28-1,SF-J26-2,2,3,2,2,0,1,1.0,0.0,0.6666666666666666,0.3333333333333333
SF-C28-1,SF-L28,5,2,2,1,3,1,0.4,0.6,0.5,0.5
SF-C28-1,SF-K28,1,1,1,1,0,0,1.0,0.0,1.0,0.0
SF-C28-1,SF-K29-1,8,6,5,2,3,4,0.625,0.375,0.3333333333333333,0.6666666666666666
SF-C28-1,SF-J28-2,1,3,1,2,0,1,1.0,0.0,0.6666666666666666,0.3333333333333333
SF-C28-1,SF-K25,5,1,3,0,2,1,0.6,0.4,0.0,1.0
SF-C28-1,SF-H26-2,2,3,2,3,0,0,1.0,0.0,1.0,0.0
SF-C28-1,SF-J26,2,1,2,1,0,0,1.0,0.0,1.0,0.0
SF-C28-1,SF-I26-,2,1,2,0,0,1,1.0,0.0,0.0,1.0
SF-C28-1,SF-I25,1,1,1,0,0,1,1.0,0.0,0.0,1.0
SF-C28-1,SF-H26,6,9,6,8,0,1,1.0,0.0,0.8888888888888888,0.1111111111111111
SF-C28-1,SF-F28-2,10,11,8,7,2,4,0.8,0.2,0.6363636363636364,0.36363636363636365
SF-C28-1,SF-G27,4,12,4,11,0,1,1.0,0.0,0.9166666666666666,0.08333333333333333
SF-C28-1,SF-M22-2,2,4,1,3,1,1,0.5,0.5,0.75,0.25
SF-C28-1,SF-F27,5,2,1,2,4,0,0.2,0.8,1.0,0.0
SF-C28-1,SF-G28-2,1,4,1,3,0,1,1.0,0.0,0.75,0.25
SF-C28-1,SF-G28-1,4,4,4,4,0,0,1.0,0.0,1.0,0.0
SF-C28-1,SF-K22-2,26,2,23,0,3,2,0.8846153846153846,0.11538461538461539,0.0,1.0
SF-C28-1,SF-K24,1,2,1,1,0,1,1.0,0.0,0.5,0.5
SF-C28-1,SF-J23-2,1,2,1,0,0,2,1.0,0.0,0.0,1.0
SF-C28-1,SF-G24,2,2,0,0,2,2,0.0,1.0,0.0,1.0
SF-C28-1,SF-G25,1,3,1,0,0,3,1.0,0.0,0.0,1.0
SF-C28-1,SF-F23,1,3,0,1,1,2,0.0,1.0,0.3333333333333333,0.6666666666666666
SF-C28-1,SF-E23,4,4,1,3,3,1,0.25,0.75,0.75,0.25
SF-C28-1,SF-B22,11,39,6,30,5,9,0.5454545454545454,0.45454545454545453,0.7692307692307693,0.23076923076923078
SF-C28-1,SF-G20,1,3,0,0,1,3,0.0,1.0,0.0,1.0
SF-C28-1,SF-F19,1,1,0,0,1,1,0.0,1.0,0.0,1.0
SF-C28-1,SF-E20,1,2,1,2,0,0,1.0,0.0,1.0,0.0
SF-C28-1,SF-H30,12,17,7,14,5,3,0.5833333333333334,0.4166666666666667,0.8235294117647058,0.17647058823529413
SF-C28-1,SF-G30-2,24,83,20,75,4,8,0.8333333333333334,0.16666666666666666,0.9036144578313253,0.0963855421686747
SF-C28-1,SF-F30-1,14,20,14,18,0,2,1.0,0.0,0.9,0.1
SF-C28-1,SF-E29-2,15,26,13,23,2,3,0.8666666666666667,0.13333333333333333,0.8846153846153846,0.11538461538461539
SF-C28-1,SF-E29-1,34,23,27,21,7,2,0.7941176470588235,0.20588235294117646,0.9130434782608695,0.08695652173913043
SF-C28-1,SF-D29,53,59,45,48,8,11,0.8490566037735849,0.1509433962264151,0.8135593220338984,0.1864406779661017
SF-C28-1,SF-D28,15,9,11,6,4,3,0.7333333333333333,0.26666666666666666,0.6666666666666666,0.3333333333333333
SF-C28-1,SF-A27,33,57,24,52,9,5,0.7272727272727273,0.2727272727272727,0.9122807017543859,0.08771929824561403
SF-C28-1,SF-G29-2,10,7,7,4,3,3,0.7,0.3,0.5714285714285714,0.42857142857142855
SF-C28-1,SF-G30-1,75,45,72,43,3,2,0.96,0.04,0.9555555555555556,0.044444444444444446
SF-C28-1,SF-F30-2,25,15,25,13,0,2,1.0,0.0,0.8666666666666667,0.13333333333333333
SF-C28-1,SF-F29,4,3,4,3,0,0,1.0,0.0,1.0,0.0
SF-C28-1,SF-E29-3,3,5,3,3,0,2,1.0,0.0,0.6,0.4
SF-C28-1,SF-F28-1,12,2,12,2,0,0,1.0,0.0,1.0,0.0
SF-C28-1,SF-E28-2,2,2,2,2,0,0,1.0,0.0,1.0,0.0
SF-C28-1,SF-E28,10,6,7,5,3,1,0.7,0.3,0.8333333333333334,0.16666666666666666
SF-C28-1,SF-C20,3,8,0,6,3,2,0.0,1.0,0.75,0.25
SF-C28-1,SF-B21,1,6,1,4,0,2,1.0,0.0,0.6666666666666666,0.3333333333333333
SF-C28-1,SF-B19,12,14,7,12,5,2,0.5833333333333334,0.4166666666666667,0.8571428571428571,0.14285714285714285
SF-C28-1,SF-A20,15,21,8,16,7,5,0.5333333333333333,0.4666666666666667,0.7619047619047619,0.23809523809523808
SF-C28-1,SF-A19,1,9,0,6,1,3,0.0,1.0,0.6666666666666666,0.3333333333333333
SF-C28-1,SF-C26,2,4,2,3,0,1,1.0,0.0,0.75,0.25
SF-C28-1,SF-C25,11,17,4,13,7,4,0.36363636363636365,0.6363636363636364,0.7647058823529411,0.23529411764705882
SF-C28-1,SF-B25,10,41,5,36,5,5,0.5,0.5,0.8780487804878049,0.12195121951219512
SF-C28-1,SF-E27,2,4,1,4,1,0,0.5,0.5,1.0,0.0
SF-C28-1,SF-B28-2,9,1,7,1,2,0,0.7777777777777778,0.2222222222222222,1.0,0.0
SF-C28-1,SF-D27,15,7,15,3,0,4,1.0,0.0,0.42857142857142855,0.5714285714285714
SF-C28-1,SF-C28-2,4,6,4,6,0,0,1.0,0.0,1.0,0.0
SF-C28-1,SF-B28,53,53,44,43,9,10,0.8301886792452831,0.16981132075471697,0.8113207547169812,0.18867924528301888
SF-C28-1,SF-K22-1,4,17,1,11,3,6,0.25,0.75,0.6470588235294118,0.35294117647058826
SF-C28-1,SF-J23-1,12,11,6,6,6,5,0.5,0.5,0.5454545454545454,0.45454545454545453
SF-C28-1,SF-I23-1,1,4,1,4,0,0,1.0,0.0,1.0,0.0
SF-C28-1,SF-F26,5,8,4,7,1,1,0.8,0.2,0.875,0.125
SF-C28-1,SF-L20,1,1,0,1,1,0,0.0,1.0,1.0,0.0
SF-C28-1,SF-M20,3,3,1,1,2,2,0.3333333333333333,0.6666666666666666,0.3333333333333333,0.6666666666666666
SF-C28-1,SF-J20,3,2,3,1,0,1,1.0,0.0,0.5,0.5
SF-C28-1,SF-J19,6,1,6,1,0,0,1.0,0.0,1.0,0.0
SF-C28-1,SF-O22,3,1,1,0,2,1,0.3333333333333333,0.6666666666666666,0.0,1.0
SF-C28-1,SF-L21,2,3,2,0,0,3,1.0,0.0,0.0,1.0
SF-C28-1,SF-P30,4,3,3,2,1,1,0.75,0.25,0.6666666666666666,0.3333333333333333
SF-C28-1,SF-O30-2,1,8,1,5,0,3,1.0,0.0,0.625,0.375
SF-C28-1,SF-O30,9,6,9,0,0,6,1.0,0.0,0.0,1.0
SF-C28-1,SF-N29,2,1,0,1,2,0,0.0,1.0,1.0,0.0
SF-C28-1,SF-N28,5,4,4,4,1,0,0.8,0.2,1.0,0.0
SF-C28-1,SF-L30-1,2,7,2,4,0,3,1.0,0.0,0.5714285714285714,0.42857142857142855
SF-C28-1,SF-K30-2,1,3,0,3,1,0,0.0,1.0,1.0,0.0
SF-C28-1,SF-L29,9,8,9,6,0,2,1.0,0.0,0.75,0.25
SF-C28-1,SF-J29-1,3,14,2,4,1,10,0.6666666666666666,0.3333333333333333,0.2857142857142857,0.7142857142857143
SF-C28-1,SF-I30,4,4,0,3,4,1,0.0,1.0,0.75,0.25
SF-C28-1,SF-I29-2,2,5,1,3,1,2,0.5,0.5,0.6,0.4
SF-C28-1,SF-I28,5,2,2,2,3,0,0.4,0.6,1.0,0.0
SF-C28-1,SF-I30-2,1,1,1,0,0,1,1.0,0.0,0.0,1.0
SF-C28-1,SF-H28,10,6,8,5,2,1,0.8,0.2,0.8333333333333334,0.16666666666666666
SF-C28-1,SF-R24,1,1,0,0,1,1,0.0,1.0,0.0,1.0
SF-C28-1,SF-R26,2,2,2,2,0,0,1.0,0.0,1.0,0.0
SF-C28-1,SF-O25-2,3,1,0,0,3,1,0.0,1.0,0.0,1.0
SF-C28-1,SF-Z28,1,1,0,1,1,0,0.0,1.0,1.0,0.0
SF-B28,SF-M26-2,3,5,2,4,1,1,0.6666666666666666,0.3333333333333333,0.8,0.2
SF-B28,SF-L27,6,5,6,3,0,2,1.0,0.0,0.6,0.4
SF-B28,SF-K26,7,1,5,1,2,0,0.7142857142857143,0.2857142857142857,1.0,0.0
SF-B28,SF-M30,43,16,38,10,5,6,0.8837209302325582,0.11627906976744186,0.625,0.375
SF-B28,SF-J29-3,13,9,9,6,4,3,0.6923076923076923,0.3076923076923077,0.6666666666666666,0.3333333333333333
SF-B28,SF-J29,14,8,10,6,4,2,0.7142857142857143,0.2857142857142857,0.75,0.25
SF-B28,SF-M27,4,1,4,1,0,0,1.0,0.0,1.0,0.0
SF-B28,SF-L24,1,6,1,0,0,6,1.0,0.0,0.0,1.0
SF-B28,SF-K27-2,28,27,26,24,2,3,0.9285714285714286,0.07142857142857142,0.8888888888888888,0.1111111111111111
SF-B28,SF-J26-2,22,10,20,9,2,1,0.9090909090909091,0.09090909090909091,0.9,0.1
SF-B28,SF-L28,43,26,40,26,3,0,0.9302325581395349,0.06976744186046512,1.0,0.0
SF-B28,SF-K28,3,3,2,3,1,0,0.6666666666666666,0.3333333333333333,1.0,0.0
SF-B28,SF-K29-1,64,56,52,46,12,10,0.8125,0.1875,0.8214285714285714,0.17857142857142858
SF-B28,SF-J28-2,6,4,0,1,6,3,0.0,1.0,0.25,0.75
SF-B28,SF-K27,2,2,1,2,1,0,0.5,0.5,1.0,0.0
SF-B28,SF-K25,8,7,7,6,1,1,0.875,0.125,0.8571428571428571,0.14285714285714285
SF-B28,SF-J25,13,5,8,4,5,1,0.6153846153846154,0.38461538461538464,0.8,0.2
SF-B28,SF-H26-2,4,2,4,2,0,0,1.0,0.0,1.0,0.0
SF-B28,SF-J24,8,5,6,1,2,4,0.75,0.25,0.2,0.8
SF-B28,SF-J26,7,33,1,7,6,26,0.14285714285714285,0.8571428571428571,0.21212121212121213,0.7878787878787878
SF-B28,SF-I25,15,5,13,2,2,3,0.8666666666666667,0.13333333333333333,0.4,0.6
SF-B28,SF-H26,60,46,51,41,9,5,0.85,0.15,0.8913043478260869,0.10869565217391304
SF-B28,SF-H27-1,14,5,11,2,3,3,0.7857142857142857,0.21428571428571427,0.4,0.6
SF-B28,SF-F28-2,30,32,24,16,6,16,0.8,0.2,0.5,0.5
SF-B28,SF-G27,56,32,41,21,15,11,0.7321428571428571,0.26785714285714285,0.65625,0.34375
SF-B28,SF-M22-2,3,3,0,1,3,2,0.0,1.0,0.3333333333333333,0.6666666666666666
SF-B28,SF-F27,37,20,29,14,8,6,0.7837837837837838,0.21621621621621623,0.7,0.3
SF-B28,SF-N22-2,11,9,1,1,10,8,0.09090909090909091,0.9090909090909091,0.1111111111111111,0.8888888888888888
SF-B28,SF-G28-2,9,4,6,0,3,4,0.6666666666666666,0.3333333333333333,0.0,1.0
SF-B28,SF-G28-1,6,3,6,2,0,1,1.0,0.0,0.6666666666666666,0.3333333333333333
SF-B28,SF-M22-1,2,3,0,1,2,2,0.0,1.0,0.3333333333333333,0.6666666666666666
SF-B28,SF-K24,4,1,4,1,0,0,1.0,0.0,1.0,0.0
SF-B28,SF-G24,17,7,7,0,10,7,0.4117647058823529,0.5882352941176471,0.0,1.0
SF-B28,SF-G25,15,13,9,7,6,6,0.6,0.4,0.5384615384615384,0.46153846153846156
SF-B28,SF-F23,9,11,3,6,6,5,0.3333333333333333,0.6666666666666666,0.5454545454545454,0.45454545454545453
SF-B28,SF-E23,11,22,9,12,2,10,0.8181818181818182,0.18181818181818182,0.5454545454545454,0.45454545454545453
SF-B28,SF-D24,6,7,3,1,3,6,0.5,0.5,0.14285714285714285,0.8571428571428571
SF-B28,SF-C22,7,14,7,10,0,4,1.0,0.0,0.7142857142857143,0.2857142857142857
SF-B28,SF-B22,24,137,19,102,5,35,0.7916666666666666,0.20833333333333334,0.7445255474452555,0.25547445255474455
SF-B28,SF-H30,149,123,123,102,26,21,0.825503355704698,0.174496644295302,0.8292682926829268,0.17073170731707318
SF-B28,SF-G30-2,78,86,68,54,10,32,0.8717948717948718,0.1282051282051282,0.627906976744186,0.37209302325581395
SF-B28,SF-F30-1,89,88,82,87,7,1,0.9213483146067416,0.07865168539325842,0.9886363636363636,0.011363636363636364
SF-B28,SF-E29-2,116,89,78,62,38,27,0.6724137931034483,0.3275862068965517,0.6966292134831461,0.30337078651685395
SF-B28,SF-E29-1,162,69,137,56,25,13,0.845679012345679,0.15432098765432098,0.8115942028985508,0.18840579710144928
SF-B28,SF-D29,348,255,267,224,81,31,0.7672413793103449,0.23275862068965517,0.8784313725490196,0.12156862745098039
SF-B28,SF-D28,73,51,66,37,7,14,0.9041095890410958,0.0958904109589041,0.7254901960784313,0.27450980392156865
SF-B28,SF-A27,48,70,43,56,5,14,0.8958333333333334,0.10416666666666667,0.8,0.2
SF-B28,SF-G29-2,46,62,26,43,20,19,0.5652173913043478,0.43478260869565216,0.6935483870967742,0.3064516129032258
SF-B28,SF-G29-1,14,6,12,5,2,1,0.8571428571428571,0.14285714285714285,0.8333333333333334,0.16666666666666666
SF-B28,SF-G30-1,42,30,32,24,10,6,0.7619047619047619,0.23809523809523808,0.8,0.2
SF-B28,SF-G29-3,7,16,6,13,1,3,0.8571428571428571,0.14285714285714285,0.8125,0.1875
SF-B28,SF-F30-2,22,41,17,37,5,4,0.7727272727272727,0.22727272727272727,0.9024390243902439,0.0975609756097561
SF-B28,SF-F29,21,13,17,10,4,3,0.8095238095238095,0.19047619047619047,0.7692307692307693,0.23076923076923078
SF-B28,SF-E29-3,26,30,16,19,10,11,0.6153846153846154,0.38461538461538464,0.6333333333333333,0.36666666666666664
SF-B28,SF-F28-1,23,36,16,34,7,2,0.6956521739130435,0.30434782608695654,0.9444444444444444,0.05555555555555555
SF-B28,SF-E28-2,4,3,4,2,0,1,1.0,0.0,0.6666666666666666,0.3333333333333333
SF-B28,SF-E28,21,8,19,2,2,6,0.9047619047619048,0.09523809523809523,0.25,0.75
SF-B28,SF-J10,1,2,0,2,1,0,0.0,1.0,1.0,0.0
SF-B28,SF-G10-1,2,1,0,0,2,1,0.0,1.0,0.0,1.0
SF-B28,SF-C21,5,2,2,0,3,2,0.4,0.6,0.0,1.0
SF-B28,SF-C20,5,16,2,12,3,4,0.4,0.6,0.75,0.25
SF-B28,SF-B21,6,11,4,8,2,3,0.6666666666666666,0.3333333333333333,0.7272727272727273,0.2727272727272727
SF-B28,SF-B19,21,61,9,40,12,21,0.42857142857142855,0.5714285714285714,0.6557377049180327,0.3442622950819672
SF-B28,SF-A20,46,130,36,98,10,32,0.782608695652174,0.21739130434782608,0.7538461538461538,0.24615384615384617
SF-B28,SF-A19,10,20,7,14,3,6,0.7,0.3,0.7,0.3
SF-B28,SF-C26,10,11,4,6,6,5,0.4,0.6,0.5454545454545454,0.45454545454545453
SF-B28,SF-C25,11,22,8,16,3,6,0.7272727272727273,0.2727272727272727,0.7272727272727273,0.2727272727272727
SF-B28,SF-B25,26,121,15,108,11,13,0.5769230769230769,0.4230769230769231,0.8925619834710744,0.10743801652892562
SF-B28,SF-E27,7,15,6,10,1,5,0.8571428571428571,0.14285714285714285,0.6666666666666666,0.3333333333333333
SF-B28,SF-B28-2,8,16,6,14,2,2,0.75,0.25,0.875,0.125
SF-B28,SF-D27,74,14,46,7,28,7,0.6216216216216216,0.3783783783783784,0.5,0.5
SF-B28,SF-C28-2,14,9,11,6,3,3,0.7857142857142857,0.21428571428571427,0.6666666666666666,0.3333333333333333
SF-B28,SF-C28-1,53,53,43,44,10,9,0.8113207547169812,0.18867924528301888,0.8301886792452831,0.16981132075471697
SF-B28,SF-J1,1,2,0,1,1,1,0.0,1.0,0.5,0.5
SF-B28,SF-H0,2,1,0,0,2,1,0.0,1.0,0.0,1.0
SF-B28,SF-H25,26,24,17,20,9,4,0.6538461538461539,0.34615384615384615,0.8333333333333334,0.16666666666666666
SF-B28,SF-G26,11,4,8,4,3,0,0.7272727272727273,0.2727272727272727,1.0,0.0
SF-B28,SF-K22-1,1,2,1,1,0,1,1.0,0.0,0.5,0.5
SF-B28,SF-J23-1,28,18,17,8,11,10,0.6071428571428571,0.39285714285714285,0.4444444444444444,0.5555555555555556
SF-B28,SF-J22-1,7,6,6,4,1,2,0.8571428571428571,0.14285714285714285,0.6666666666666666,0.3333333333333333
SF-B28,SF-J22-2,7,7,3,3,4,4,0.42857142857142855,0.5714285714285714,0.42857142857142855,0.5714285714285714
SF-B28,SF-I23-2,5,12,3,8,2,4,0.6,0.4,0.6666666666666666,0.3333333333333333
SF-B28,SF-I24,1,2,1,1,0,1,1.0,0.0,0.5,0.5
SF-B28,SF-I23-1,3,4,2,2,1,2,0.6666666666666666,0.3333333333333333,0.5,0.5
SF-B28,SF-F26,31,14,17,11,14,3,0.5483870967741935,0.45161290322580644,0.7857142857142857,0.21428571428571427
SF-B28,SF-L20,2,5,1,0,1,5,0.5,0.5,0.0,1.0
SF-B28,SF-N20-1,2,2,0,0,2,2,0.0,1.0,0.0,1.0
SF-B28,SF-M20,5,3,3,1,2,2,0.6,0.4,0.3333333333333333,0.6666666666666666
SF-B28,SF-K20,4,1,2,0,2,1,0.5,0.5,0.0,1.0
SF-B28,SF-K19,3,1,2,0,1,1,0.6666666666666666,0.3333333333333333,0.0,1.0
SF-B28,SF-K18,4,2,2,0,2,2,0.5,0.5,0.0,1.0
SF-B28,SF-K17,2,2,0,0,2,2,0.0,1.0,0.0,1.0
SF-B28,SF-J18,3,2,0,0,3,2,0.0,1.0,0.0,1.0
SF-B28,SF-J20,3,1,3,1,0,0,1.0,0.0,1.0,0.0
SF-B28,SF-J19,5,9,1,4,4,5,0.2,0.8,0.4444444444444444,0.5555555555555556
SF-B28,SF-O21,6,3,1,1,5,2,0.16666666666666666,0.8333333333333334,0.3333333333333333,0.6666666666666666
SF-B28,SF-O22,9,5,1,0,8,5,0.1111111111111111,0.8888888888888888,0.0,1.0
SF-B28,SF-N21,2,1,2,0,0,1,1.0,0.0,0.0,1.0
SF-B28,SF-M21,3,1,2,0,1,1,0.6666666666666666,0.3333333333333333,0.0,1.0
SF-B28,SF-L21,1,7,0,1,1,6,0.0,1.0,0.14285714285714285,0.8571428571428571
SF-B28,SF-S30,1,1,1,0,0,1,1.0,0.0,0.0,1.0
SF-B28,SF-Q30,28,15,24,15,4,0,0.8571428571428571,0.14285714285714285,1.0,0.0
SF-B28,SF-P30,39,47,35,44,4,3,0.8974358974358975,0.10256410256410256,0.9361702127659575,0.06382978723404255
SF-B28,SF-O30-2,40,14,39,14,1,0,0.975,0.025,1.0,0.0
SF-B28,SF-O30,52,21,46,16,6,5,0.8846153846153846,0.11538461538461539,0.7619047619047619,0.23809523809523808
SF-B28,SF-N27,12,8,8,1,4,7,0.6666666666666666,0.3333333333333333,0.125,0.875
SF-B28,SF-N29,9,7,8,4,1,3,0.8888888888888888,0.1111111111111111,0.5714285714285714,0.42857142857142855
SF-B28,SF-N28,9,4,7,2,2,2,0.7777777777777778,0.2222222222222222,0.5,0.5
SF-B28,SF-L30-1,68,57,58,53,10,4,0.8529411764705882,0.14705882352941177,0.9298245614035088,0.07017543859649122
SF-B28,SF-L31-1,37,35,29,28,8,7,0.7837837837837838,0.21621621621621623,0.8,0.2
SF-B28,SF-K30-2,45,19,45,16,0,3,1.0,0.0,0.8421052631578947,0.15789473684210525
SF-B28,SF-L29,31,23,17,18,14,5,0.5483870967741935,0.45161290322580644,0.782608695652174,0.21739130434782608
SF-B28,SF-J29-1,39,28,29,22,10,6,0.7435897435897436,0.2564102564102564,0.7857142857142857,0.21428571428571427
SF-B28,SF-I30,19,19,15,12,4,7,0.7894736842105263,0.21052631578947367,0.631578947368421,0.3684210526315789
SF-B28,SF-I29-2,16,11,15,11,1,0,0.9375,0.0625,1.0,0.0
SF-B28,SF-I27,21,7,13,4,8,3,0.6190476190476191,0.38095238095238093,0.5714285714285714,0.42857142857142855
SF-B28,SF-I28,2,4,2,2,0,2,1.0,0.0,0.5,0.5
SF-B28,SF-I30-2,7,3,5,3,2,0,0.7142857142857143,0.2857142857142857,1.0,0.0
SF-B28,SF I29-1,6,3,3,3,3,0,0.5,0.5,1.0,0.0
SF-B28,SF-H28,20,20,12,11,8,9,0.6,0.4,0.55,0.45
SF-B28,SF-S24,6,2,3,0,3,2,0.5,0.5,0.0,1.0
SF-B28,SF-P26,6,1,3,0,3,1,0.5,0.5,0.0,1.0
SF-B28,SF-O25-2,3,4,1,1,2,3,0.3333333333333333,0.6666666666666666,0.25,0.75
SF-B28,SF-T22,1,2,0,0,1,2,0.0,1.0,0.0,1.0
SF-B28,SF-S22-1,4,3,1,2,3,1,0.25,0.75,0.6666666666666666,0.3333333333333333
SF-B28,SF-Q22-2,6,4,0,0,6,4,0.0,1.0,0.0,1.0
SF-B28,SF-P22,3,3,1,2,2,1,0.3333333333333333,0.6666666666666666,0.6666666666666666,0.3333333333333333
SF-B28,SF-S21,24,10,0,0,24,10,0.0,1.0,0.0,1.0
SF-B28,SF-V29,7,2,0,0,7,2,0.0,1.0,0.0,1.0
SF-B28,SF-V32,9,1,9,1,0,0,1.0,0.0,1.0,0.0
SF-J1,SF-M26-2,1,2,0,0,1,2,0.0,1.0,0.0,1.0
SF-J1,SF-K26,2,5,1,3,1,2,0.5,0.5,0.6,0.4
SF-J1,SF-N23,4,1,0,0,4,1,0.0,1.0,0.0,1.0
SF-J1,SF-K27-2,2,1,2,0,0,1,1.0,0.0,0.0,1.0
SF-J1,SF-J26-2,2,1,2,0,0,1,1.0,0.0,0.0,1.0
SF-J1,SF-K27,1,1,1,1,0,0,1.0,0.0,1.0,0.0
SF-J1,SF-J25,2,10,1,2,1,8,0.5,0.5,0.2,0.8
SF-J1,SF-P24,11,16,7,3,4,13,0.6363636363636364,0.36363636363636365,0.1875,0.8125
SF-J1,SF-O24,1,3,0,0,1,3,0.0,1.0,0.0,1.0
SF-J1,SF-J26,3,6,2,0,1,6,0.6666666666666666,0.3333333333333333,0.0,1.0
SF-J1,SF-I25,2,2,1,0,1,2,0.5,0.5,0.0,1.0
SF-J1,SF-H26,7,2,2,0,5,2,0.2857142857142857,0.7142857142857143,0.0,1.0
SF-J1,SF-O23,6,7,4,6,2,1,0.6666666666666666,0.3333333333333333,0.8571428571428571,0.14285714285714285
SF-J1,SF-H27-1,1,2,0,0,1,2,0.0,1.0,0.0,1.0
SF-J1,SF-G27,6,6,1,2,5,4,0.16666666666666666,0.8333333333333334,0.3333333333333333,0.6666666666666666
SF-J1,SF-M22-2,5,5,2,0,3,5,0.4,0.6,0.0,1.0
SF-J1,SF-F27,3,1,1,1,2,0,0.3333333333333333,0.6666666666666666,1.0,0.0
SF-J1,SF-N22-2,10,9,2,0,8,9,0.2,0.8,0.0,1.0
SF-J1,SF-M22-1,3,2,0,2,3,0,0.0,1.0,1.0,0.0
SF-J1,SF-K22-2,10,2,6,1,4,1,0.6,0.4,0.5,0.5
SF-J1,SF-J23-2,3,1,0,0,3,1,0.0,1.0,0.0,1.0
SF-J1,SF-G23,2,1,2,0,0,1,1.0,0.0,0.0,1.0
SF-J1,SF-G24,12,9,8,1,4,8,0.6666666666666666,0.3333333333333333,0.1111111111111111,0.8888888888888888
SF-J1,SF-G25,19,3,13,0,6,3,0.6842105263157895,0.3157894736842105,0.0,1.0
SF-J1,SF-F23,9,11,5,9,4,2,0.5555555555555556,0.4444444444444444,0.8181818181818182,0.18181818181818182
SF-J1,SF-E23,17,10,9,0,8,10,0.5294117647058824,0.47058823529411764,0.0,1.0
SF-J1,SF-D24,6,3,1,1,5,2,0.16666666666666666,0.8333333333333334,0.3333333333333333,0.6666666666666666
SF-J1,SF-C22,8,1,3,0,5,1,0.375,0.625,0.0,1.0
SF-J1,SF-B22,10,6,1,0,9,6,0.1,0.9,0.0,1.0
SF-J1,SF-J17,64,60,19,7,45,53,0.296875,0.703125,0.11666666666666667,0.8833333333333333
SF-J1,SF-I19,6,11,2,2,4,9,0.3333333333333333,0.6666666666666666,0.18181818181818182,0.8181818181818182
SF-J1,SF-I20,8,8,0,6,8,2,0.0,1.0,0.75,0.25
SF-J1,SF-H16,15,12,2,0,13,12,0.13333333333333333,0.8666666666666667,0.0,1.0
SF-J1,SF-H19,5,2,2,0,3,2,0.4,0.6,0.0,1.0
SF-J1,SF-H20,8,4,3,1,5,3,0.375,0.625,0.25,0.75
SF-J1,SF-H18,3,1,1,0,2,1,0.3333333333333333,0.6666666666666666,0.0,1.0
SF-J1,SF-G19,19,17,6,11,13,6,0.3157894736842105,0.6842105263157895,0.6470588235294118,0.35294117647058826
SF-J1,SF-G17,13,5,3,1,10,4,0.23076923076923078,0.7692307692307693,0.2,0.8
SF-J1,SF-G18,14,11,9,3,5,8,0.6428571428571429,0.35714285714285715,0.2727272727272727,0.7272727272727273
SF-J1,SF-G20,11,7,2,3,9,4,0.18181818181818182,0.8181818181818182,0.42857142857142855,0.5714285714285714
SF-J1,SF-F19,9,6,2,2,7,4,0.2222222222222222,0.7777777777777778,0.3333333333333333,0.6666666666666666
SF-J1,SF-E18,11,4,5,1,6,3,0.45454545454545453,0.5454545454545454,0.25,0.75
SF-J1,SF-E20,9,5,5,0,4,5,0.5555555555555556,0.4444444444444444,0.0,1.0
SF-J1,SF-E29-2,5,5,2,1,3,4,0.4,0.6,0.2,0.8
SF-J1,SF-D29,4,1,2,0,2,1,0.5,0.5,0.0,1.0
SF-J1,SF-D28,3,9,0,0,3,9,0.0,1.0,0.0,1.0
SF-J1,SF-G29-2,3,3,2,0,1,3,0.6666666666666666,0.3333333333333333,0.0,1.0
SF-J1,SF-F28-1,1,1,0,0,1,1,0.0,1.0,0.0,1.0
SF-J1,SF-E28-2,1,1,0,0,1,1,0.0,1.0,0.0,1.0
SF-J1,SF-J10,139,64,101,35,38,29,0.7266187050359713,0.2733812949640288,0.546875,0.453125
SF-J1,SF-J12,107,65,66,23,41,42,0.616822429906542,0.38317757009345793,0.35384615384615387,0.6461538461538462
SF-J1,SF-J13,100,53,57,26,43,27,0.57,0.43,0.49056603773584906,0.5094339622641509
SF-J1,SF-J15,30,26,13,0,17,26,0.43333333333333335,0.5666666666666667,0.0,1.0
SF-J1,SF-J14,20,8,14,1,6,7,0.7,0.3,0.125,0.875
SF-J1,SF-H13,30,16,22,5,8,11,0.7333333333333333,0.26666666666666666,0.3125,0.6875
SF-J1,SF-I16,14,7,3,2,11,5,0.21428571428571427,0.7857142857142857,0.2857142857142857,0.7142857142857143
SF-J1,SF-H12,27,19,10,1,17,18,0.37037037037037035,0.6296296296296297,0.05263157894736842,0.9473684210526315
SF-J1,SF-G10-2,19,10,9,3,10,7,0.47368421052631576,0.5263157894736842,0.3,0.7
SF-J1,SF-H15,23,35,14,3,9,32,0.6086956521739131,0.391304347826087,0.08571428571428572,0.9142857142857143
SF-J1,SF-G9,23,10,17,4,6,6,0.7391304347826086,0.2608695652173913,0.4,0.6
SF-J1,SF-H14,10,2,5,1,5,1,0.5,0.5,0.5,0.5
SF-J1,SF-G13,35,14,13,3,22,11,0.37142857142857144,0.6285714285714286,0.21428571428571427,0.7857142857142857
SF-J1,SF-G11,15,15,12,5,3,10,0.8,0.2,0.3333333333333333,0.6666666666666666
SF-J1,SF-G12,29,18,17,4,12,14,0.5862068965517241,0.41379310344827586,0.2222222222222222,0.7777777777777778
SF-J1,SF-G10-1,21,9,9,1,12,8,0.42857142857142855,0.5714285714285714,0.1111111111111111,0.8888888888888888
SF-J1,SF-F15,12,13,4,6,8,7,0.3333333333333333,0.6666666666666666,0.46153846153846156,0.5384615384615384
SF-J1,SF-F16,4,2,4,0,0,2,1.0,0.0,0.0,1.0
SF-J1,SF-B19,1,2,0,0,1,2,0.0,1.0,0.0,1.0
SF-J1,SF-C25,4,5,0,0,4,5,0.0,1.0,0.0,1.0
SF-J1,SF-E27,4,4,0,0,4,4,0.0,1.0,0.0,1.0
SF-J1,SF-D27,7,11,0,0,7,11,0.0,1.0,0.0,1.0
SF-J1,SF-B28,2,1,1,0,1,1,0.5,0.5,0.0,1.0
SF-J1,SF-H0,56,55,40,44,16,11,0.7142857142857143,0.2857142857142857,0.8,0.2
SF-J1,SF-J3,119,79,94,29,25,50,0.7899159663865546,0.21008403361344538,0.3670886075949367,0.6329113924050633
SF-J1,SF-J5,168,107,102,30,66,77,0.6071428571428571,0.39285714285714285,0.2803738317757009,0.719626168224299
SF-J1,SF-G6,30,13,14,3,16,10,0.4666666666666667,0.5333333333333333,0.23076923076923078,0.7692307692307693
SF-J1,SF-G8,17,26,11,15,6,11,0.6470588235294118,0.35294117647058826,0.5769230769230769,0.4230769230769231
SF-J1,SF-G5,35,29,13,12,22,17,0.37142857142857144,0.6285714285714286,0.41379310344827586,0.5862068965517241
SF-J1,SF-G7,31,33,12,3,19,30,0.3870967741935484,0.6129032258064516,0.09090909090909091,0.9090909090909091
SF-J1,SF-F9,17,14,12,4,5,10,0.7058823529411765,0.29411764705882354,0.2857142857142857,0.7142857142857143
SF-J1,SF-K21,70,43,52,24,18,19,0.7428571428571429,0.2571428571428571,0.5581395348837209,0.4418604651162791
SF-J1,SF-K22-1,5,3,2,0,3,3,0.4,0.6,0.0,1.0
SF-J1,SF-J23-1,19,23,2,1,17,22,0.10526315789473684,0.8947368421052632,0.043478260869565216,0.9565217391304348
SF-J1,SF-J22-1,10,9,1,0,9,9,0.1,0.9,0.0,1.0
SF-J1,SF-J22-2,13,3,1,2,12,1,0.07692307692307693,0.9230769230769231,0.6666666666666666,0.3333333333333333
SF-J1,SF-J21,28,31,6,20,22,11,0.21428571428571427,0.7857142857142857,0.6451612903225806,0.3548387096774194
SF-J1,SF-I21,10,13,5,6,5,7,0.5,0.5,0.46153846153846156,0.5384615384615384
SF-J1,SF-I22,8,1,3,0,5,1,0.375,0.625,0.0,1.0
SF-J1,SF-I23-2,7,5,0,2,7,3,0.0,1.0,0.4,0.6
SF-J1,SF-I24,6,1,4,0,2,1,0.6666666666666666,0.3333333333333333,0.0,1.0
SF-J1,SF-I23-1,5,2,3,1,2,1,0.6,0.4,0.5,0.5
SF-J1,SF-F26,4,3,1,0,3,3,0.25,0.75,0.0,1.0
SF-J1,SF-M13,138,85,79,19,59,66,0.572463768115942,0.427536231884058,0.2235294117647059,0.7764705882352941
SF-J1,SF-M15,76,58,42,10,34,48,0.5526315789473685,0.4473684210526316,0.1724137931034483,0.8275862068965517
SF-J1,SF-L19,28,8,7,2,21,6,0.25,0.75,0.25,0.75
SF-J1,SF-L20,19,13,5,2,14,11,0.2631578947368421,0.7368421052631579,0.15384615384615385,0.8461538461538461
SF-J1,SF-N20-1,12,2,1,0,11,2,0.08333333333333333,0.9166666666666666,0.0,1.0
SF-J1,SF-M20,39,20,19,5,20,15,0.48717948717948717,0.5128205128205128,0.25,0.75
SF-J1,SF-K17-2,25,19,16,6,9,13,0.64,0.36,0.3157894736842105,0.6842105263157895
SF-J1,SF-K20,53,17,28,6,25,11,0.5283018867924528,0.4716981132075472,0.35294117647058826,0.6470588235294118
SF-J1,SF-K15-,461,238,229,107,232,131,0.4967462039045553,0.5032537960954447,0.4495798319327731,0.5504201680672269
SF-J1,SF-K19,71,65,38,21,33,44,0.5352112676056338,0.4647887323943662,0.3230769230769231,0.676923076923077
SF-J1,SF-K18,130,92,94,45,36,47,0.7230769230769231,0.27692307692307694,0.4891304347826087,0.5108695652173914
SF-J1,SF-K17,180,83,123,29,57,54,0.6833333333333333,0.31666666666666665,0.3493975903614458,0.6506024096385542
SF-J1,SF-J16,73,49,28,10,45,39,0.3835616438356164,0.6164383561643836,0.20408163265306123,0.7959183673469388
SF-J1,SF-J18,70,50,34,25,36,25,0.4857142857142857,0.5142857142857142,0.5,0.5
SF-J1,SF-J20,10,10,2,1,8,9,0.2,0.8,0.1,0.9
SF-J1,SF-J19,41,21,10,5,31,16,0.24390243902439024,0.7560975609756098,0.23809523809523808,0.7619047619047619
SF-J1,SF-M12,84,42,70,19,14,23,0.8333333333333334,0.16666666666666666,0.4523809523809524,0.5476190476190477
SF-J1,SF-M10,78,91,48,57,30,34,0.6153846153846154,0.38461538461538464,0.6263736263736264,0.37362637362637363
SF-J1,SF-M11,115,46,65,12,50,34,0.5652173913043478,0.43478260869565216,0.2608695652173913,0.7391304347826086
SF-J1,SF-R19,8,1,4,0,4,1,0.5,0.5,0.0,1.0
SF-J1,SF-R20,2,2,1,0,1,2,0.5,0.5,0.0,1.0
SF-J1,SF-Q21-2,3,1,1,0,2,1,0.3333333333333333,0.6666666666666666,0.0,1.0
SF-J1,SF-Q21-1,6,3,2,2,4,1,0.3333333333333333,0.6666666666666666,0.6666666666666666,0.3333333333333333
SF-J1,SF-P21,3,8,0,0,3,8,0.0,1.0,0.0,1.0
SF-J1,SF-O18,19,5,3,0,16,5,0.15789473684210525,0.8421052631578947,0.0,1.0
SF-J1,SF-O19,30,28,12,22,18,6,0.4,0.6,0.7857142857142857,0.21428571428571427
SF-J1,SF-O21,22,7,6,1,16,6,0.2727272727272727,0.7272727272727273,0.14285714285714285,0.8571428571428571
SF-J1,SF-O22,12,7,1,2,11,5,0.08333333333333333,0.9166666666666666,0.2857142857142857,0.7142857142857143
SF-J1,SF-N21,12,3,9,1,3,2,0.75,0.25,0.3333333333333333,0.6666666666666666
SF-J1,SF-N20-2,12,7,2,3,10,4,0.16666666666666666,0.8333333333333334,0.42857142857142855,0.5714285714285714
SF-J1,SF-M21,4,6,2,4,2,2,0.5,0.5,0.6666666666666666,0.3333333333333333
SF-J1,SF-L21,27,6,7,0,20,6,0.25925925925925924,0.7407407407407407,0.0,1.0
SF-J1,SF-S30,1,1,0,0,1,1,0.0,1.0,0.0,1.0
SF-J1,SF-O30,5,1,1,0,4,1,0.2,0.8,0.0,1.0
SF-J1,SF-L30-1,1,1,0,0,1,1,0.0,1.0,0.0,1.0
SF-J1,SF-L29,3,3,0,0,3,3,0.0,1.0,0.0,1.0
SF-J1,SF-I30,3,2,0,1,3,1,0.0,1.0,0.5,0.5
SF-J1,SF-H28,2,7,0,0,2,7,0.0,1.0,0.0,1.0
SF-J1,SF-R24,7,2,3,0,4,2,0.42857142857142855,0.5714285714285714,0.0,1.0
SF-J1,SF-P26,11,11,0,3,11,8,0.0,1.0,0.2727272727272727,0.7272727272727273
SF-J1,SF-O25-2,1,2,0,1,1,1,0.0,1.0,0.5,0.5
SF-J1,SF-T22,1,1,0,0,1,1,0.0,1.0,0.0,1.0
SF-J1,SF-Q23-3,1,4,0,1,1,3,0.0,1.0,0.25,0.75
SF-J1,SF-Q22-1,6,5,2,2,4,3,0.3333333333333333,0.6666666666666666,0.4,0.6
SF-J1,SF-Q22-2,10,2,6,0,4,2,0.6,0.4,0.0,1.0
SF-J1,SF-P22,10,2,4,0,6,2,0.4,0.6,0.0,1.0
SF-J1,SF-T20,6,1,1,0,5,1,0.16666666666666666,0.8333333333333334,0.0,1.0
SF-J1,SF-Z6,4,9,3,8,1,1,0.75,0.25,0.8888888888888888,0.1111111111111111
SF-J1,SF-W8,17,19,14,17,3,2,0.8235294117647058,0.17647058823529413,0.8947368421052632,0.10526315789473684
SF-J1,SF-Y14,1,2,0,2,1,0,0.0,1.0,1.0,0.0
SF-H0,SF-M30,3,1,0,0,3,1,0.0,1.0,0.0,1.0
SF-H0,SF-J28-2,2,2,0,0,2,2,0.0,1.0,0.0,1.0
SF-H0,SF-K25,1,1,0,0,1,1,0.0,1.0,0.0,1.0
SF-H0,SF-J25,1,1,0,0,1,1,0.0,1.0,0.0,1.0
SF-H0,SF-G27,1,2,0,0,1,2,0.0,1.0,0.0,1.0
SF-H0,SF-M22-2,4,5,3,0,1,5,0.75,0.25,0.0,1.0
SF-H0,SF-N22-2,1,4,0,0,1,4,0.0,1.0,0.0,1.0
SF-H0,SF-K22-2,4,1,2,1,2,0,0.5,0.5,1.0,0.0
SF-H0,SF-J23-2,1,2,0,1,1,1,0.0,1.0,0.5,0.5
SF-H0,SF-E23,6,6,1,1,5,5,0.16666666666666666,0.8333333333333334,0.16666666666666666,0.8333333333333334
SF-H0,SF-C22,1,1,0,0,1,1,0.0,1.0,0.0,1.0
SF-H0,SF-B22,4,1,2,0,2,1,0.5,0.5,0.0,1.0
SF-H0,SF-J17,13,15,2,0,11,15,0.15384615384615385,0.8461538461538461,0.0,1.0
SF-H0,SF-I19,2,1,0,0,2,1,0.0,1.0,0.0,1.0
SF-H0,SF-H16,4,1,0,0,4,1,0.0,1.0,0.0,1.0
SF-H0,SF-H19,1,2,0,0,1,2,0.0,1.0,0.0,1.0
SF-H0,SF-H20,5,2,4,0,1,2,0.8,0.2,0.0,1.0
SF-H0,SF-G19,2,3,2,0,0,3,1.0,0.0,0.0,1.0
SF-H0,SF-G17,7,7,2,0,5,7,0.2857142857142857,0.7142857142857143,0.0,1.0
SF-H0,SF-G18,1,2,1,0,0,2,1.0,0.0,0.0,1.0
SF-H0,SF-G20,18,12,15,12,3,0,0.8333333333333334,0.16666666666666666,1.0,0.0
SF-H0,SF-F19,1,1,0,1,1,0,0.0,1.0,1.0,0.0
SF-H0,SF-E18,4,3,0,0,4,3,0.0,1.0,0.0,1.0
SF-H0,SF-E20,5,3,2,0,3,3,0.4,0.6,0.0,1.0
SF-H0,SF-H30,1,1,0,0,1,1,0.0,1.0,0.0,1.0
SF-H0,SF-E29-2,2,2,0,1,2,1,0.0,1.0,0.5,0.5
SF-H0,SF-D29,2,1,0,0,2,1,0.0,1.0,0.0,1.0
SF-H0,SF-J10,28,11,12,4,16,7,0.42857142857142855,0.5714285714285714,0.36363636363636365,0.6363636363636364
SF-H0,SF-J12,36,37,18,11,18,26,0.5,0.5,0.2972972972972973,0.7027027027027027
SF-H0,SF-J13,11,12,9,3,2,9,0.8181818181818182,0.18181818181818182,0.25,0.75
SF-H0,SF-J15,7,12,6,1,1,11,0.8571428571428571,0.14285714285714285,0.08333333333333333,0.9166666666666666
SF-H0,SF-J14,1,1,0,0,1,1,0.0,1.0,0.0,1.0
SF-H0,SF-H13,31,25,1,0,30,25,0.03225806451612903,0.967741935483871,0.0,1.0
SF-H0,SF-I16,4,2,0,0,4,2,0.0,1.0,0.0,1.0
SF-H0,SF-H12,11,11,4,2,7,9,0.36363636363636365,0.6363636363636364,0.18181818181818182,0.8181818181818182
SF-H0,SF-G10-2,8,5,4,0,4,5,0.5,0.5,0.0,1.0
SF-H0,SF-H15,1,2,0,0,1,2,0.0,1.0,0.0,1.0
SF-H0,SF-G9,7,2,3,1,4,1,0.42857142857142855,0.5714285714285714,0.5,0.5
SF-H0,SF-H14,1,2,1,0,0,2,1.0,0.0,0.0,1.0
SF-H0,SF-G13,3,4,3,0,0,4,1.0,0.0,0.0,1.0
SF-H0,SF-G11,4,3,2,0,2,3,0.5,0.5,0.0,1.0
SF-H0,SF-G12,7,5,7,4,0,1,1.0,0.0,0.8,0.2
SF-H0,SF-G10-1,9,6,4,1,5,5,0.4444444444444444,0.5555555555555556,0.16666666666666666,0.8333333333333334
SF-H0,SF-F16,8,5,5,2,3,3,0.625,0.375,0.4,0.6
SF-H0,SF-C20,2,3,0,0,2,3,0.0,1.0,0.0,1.0
SF-H0,SF-A20,3,2,0,0,3,2,0.0,1.0,0.0,1.0
SF-H0,SF-C25,3,3,0,0,3,3,0.0,1.0,0.0,1.0
SF-H0,SF-B25,3,1,0,0,3,1,0.0,1.0,0.0,1.0
SF-H0,SF-B28,1,2,0,0,1,2,0.0,1.0,0.0,1.0
SF-H0,SF-J1,55,56,44,40,11,16,0.8,0.2,0.7142857142857143,0.2857142857142857
SF-H0,SF-J3,34,21,26,13,8,8,0.7647058823529411,0.23529411764705882,0.6190476190476191,0.38095238095238093
SF-H0,SF-J5,24,16,14,3,10,13,0.5833333333333334,0.4166666666666667,0.1875,0.8125
SF-H0,SF-G6,7,1,3,0,4,1,0.42857142857142855,0.5714285714285714,0.0,1.0
SF-H0,SF-G8,2,9,1,2,1,7,0.5,0.5,0.2222222222222222,0.7777777777777778
SF-H0,SF-G5,16,15,5,1,11,14,0.3125,0.6875,0.06666666666666667,0.9333333333333333
SF-H0,SF-G7,13,14,3,1,10,13,0.23076923076923078,0.7692307692307693,0.07142857142857142,0.9285714285714286
SF-H0,SF-F9,5,2,5,0,0,2,1.0,0.0,0.0,1.0
SF-H0,SF-G26,3,1,2,0,1,1,0.6666666666666666,0.3333333333333333,0.0,1.0
SF-H0,SF-K21,4,8,2,0,2,8,0.5,0.5,0.0,1.0
SF-H0,SF-J23-1,2,3,0,1,2,2,0.0,1.0,0.3333333333333333,0.6666666666666666
SF-H0,SF-J22-1,1,2,0,1,1,1,0.0,1.0,0.5,0.5
SF-H0,SF-J22-2,5,1,0,0,5,1,0.0,1.0,0.0,1.0
SF-H0,SF-J21,3,2,1,0,2,2,0.3333333333333333,0.6666666666666666,0.0,1.0
SF-H0,SF-F26,1,2,0,0,1,2,0.0,1.0,0.0,1.0
SF-H0,SF-M13,18,5,5,2,13,3,0.2777777777777778,0.7222222222222222,0.4,0.6
SF-H0,SF-M15,19,9,14,0,5,9,0.7368421052631579,0.2631578947368421,0.0,1.0
SF-H0,SF-M20,8,7,4,1,4,6,0.5,0.5,0.14285714285714285,0.8571428571428571
SF-H0,SF-K17-2,7,10,1,2,6,8,0.14285714285714285,0.8571428571428571,0.2,0.8
SF-H0,SF-K20,7,6,2,1,5,5,0.2857142857142857,0.7142857142857143,0.16666666666666666,0.8333333333333334
SF-H0,SF-K15-,105,55,58,24,47,31,0.5523809523809524,0.44761904761904764,0.43636363636363634,0.5636363636363636
SF-H0,SF-K19,19,12,9,2,10,10,0.47368421052631576,0.5263157894736842,0.16666666666666666,0.8333333333333334
SF-H0,SF-K18,22,24,16,11,6,13,0.7272727272727273,0.2727272727272727,0.4583333333333333,0.5416666666666666
SF-H0,SF-K17,31,21,22,6,9,15,0.7096774193548387,0.2903225806451613,0.2857142857142857,0.7142857142857143
SF-H0,SF-J16,8,5,4,0,4,5,0.5,0.5,0.0,1.0
SF-H0,SF-J18,19,7,8,5,11,2,0.42105263157894735,0.5789473684210527,0.7142857142857143,0.2857142857142857
SF-H0,SF-J19,3,4,1,1,2,3,0.3333333333333333,0.6666666666666666,0.25,0.75
SF-H0,SF-O12,4,1,1,0,3,1,0.25,0.75,0.0,1.0
SF-H0,SF-M12,16,10,7,9,9,1,0.4375,0.5625,0.9,0.1
SF-H0,SF-M10,14,27,12,16,2,11,0.8571428571428571,0.14285714285714285,0.5925925925925926,0.4074074074074074
SF-H0,SF-M11,19,13,11,3,8,10,0.5789473684210527,0.42105263157894735,0.23076923076923078,0.7692307692307693
SF-H0,SF-R19,2,1,1,0,1,1,0.5,0.5,0.0,1.0
SF-H0,SF-Q21-1,1,1,0,0,1,1,0.0,1.0,0.0,1.0
SF-H0,SF-P21,3,1,0,0,3,1,0.0,1.0,0.0,1.0
SF-H0,SF-O19,7,9,2,2,5,7,0.2857142857142857,0.7142857142857143,0.2222222222222222,0.7777777777777778
SF-H0,SF-O21,6,6,0,0,6,6,0.0,1.0,0.0,1.0
SF-H0,SF-N21,4,1,3,0,1,1,0.75,0.25,0.0,1.0
SF-H0,SF-M21,2,2,0,1,2,1,0.0,1.0,0.5,0.5
SF-H0,SF-L21,5,9,1,4,4,5,0.2,0.8,0.4444444444444444,0.5555555555555556
SF-H0,SF-H28,1,2,1,0,0,2,1.0,0.0,0.0,1.0
SF-H0,SF-R24,2,3,2,2,0,1,1.0,0.0,0.6666666666666666,0.3333333333333333
SF-H0,SF-N26,2,1,0,0,2,1,0.0,1.0,0.0,1.0
SF-H0,SF-Q22-1,2,3,0,0,2,3,0.0,1.0,0.0,1.0
SF-H0,SF-P22,4,4,0,1,4,3,0.0,1.0,0.25,0.75
SF-H0,SF-Z7,1,1,1,1,0,0,1.0,0.0,1.0,0.0
SF-H0,SF-Z6,5,4,3,2,2,2,0.6,0.4,0.5,0.5
SF-H0,SF-W8,5,5,3,3,2,2,0.6,0.4,0.6,0.4
SF-J3,SF-M30,2,1,1,0,1,1,0.5,0.5,0.0,1.0
SF-J3,SF-M28,1,1,0,0,1,1,0.0,1.0,0.0,1.0
SF-J3,SF-F28-2,2,1,0,1,2,0,0.0,1.0,1.0,0.0
SF-J3,SF-G27,3,2,0,0,3,2,0.0,1.0,0.0,1.0
SF-J3,SF-M22-2,3,5,2,4,1,1,0.6666666666666666,0.3333333333333333,0.8,0.2
SF-J3,SF-N22-2,3,4,1,0,2,4,0.3333333333333333,0.6666666666666666,0.0,1.0
SF-J3,SF-M22-1,1,1,0,0,1,1,0.0,1.0,0.0,1.0
SF-J3,SF-K22-2,1,2,1,2,0,0,1.0,0.0,1.0,0.0
SF-J3,SF-G24,1,9,0,0,1,9,0.0,1.0,0.0,1.0
SF-J3,SF-G25,4,3,0,0,4,3,0.0,1.0,0.0,1.0
SF-J3,SF-E23,3,3,0,1,3,2,0.0,1.0,0.3333333333333333,0.6666666666666666
SF-J3,SF-J17,12,6,1,0,11,6,0.08333333333333333,0.9166666666666666,0.0,1.0
SF-J3,SF-I19,2,3,2,1,0,2,1.0,0.0,0.3333333333333333,0.6666666666666666
SF-J3,SF-H16,12,4,3,1,9,3,0.25,0.75,0.25,0.75
SF-J3,SF-H20,1,1,1,1,0,0,1.0,0.0,1.0,0.0
SF-J3,SF-H17,1,1,1,1,0,0,1.0,0.0,1.0,0.0
SF-J3,SF-G20,2,7,2,4,0,3,1.0,0.0,0.5714285714285714,0.42857142857142855
SF-J3,SF-F19,2,4,2,3,0,1,1.0,0.0,0.75,0.25
SF-J3,SF-E20,2,2,0,0,2,2,0.0,1.0,0.0,1.0
SF-J3,SF-E29-2,3,2,0,1,3,1,0.0,1.0,0.5,0.5
SF-J3,SF-D28,1,1,0,0,1,1,0.0,1.0,0.0,1.0
SF-J3,SF-E29-3,4,2,0,0,4,2,0.0,1.0,0.0,1.0
SF-J3,SF-F28-1,9,2,0,0,9,2,0.0,1.0,0.0,1.0
SF-J3,SF-J10,36,21,32,13,4,8,0.8888888888888888,0.1111111111111111,0.6190476190476191,0.38095238095238093
SF-J3,SF-J12,34,29,14,11,20,18,0.4117647058823529,0.5882352941176471,0.3793103448275862,0.6206896551724138
SF-J3,SF-J13,15,14,7,1,8,13,0.4666666666666667,0.5333333333333333,0.07142857142857142,0.9285714285714286
SF-J3,SF-J15,10,2,3,0,7,2,0.3,0.7,0.0,1.0
SF-J3,SF-J14,6,2,4,2,2,0,0.6666666666666666,0.3333333333333333,1.0,0.0
SF-J3,SF-H13,9,6,9,1,0,5,1.0,0.0,0.16666666666666666,0.8333333333333334
SF-J3,SF-I16,3,1,3,0,0,1,1.0,0.0,0.0,1.0
SF-J3,SF-H12,11,5,4,2,7,3,0.36363636363636365,0.6363636363636364,0.4,0.6
SF-J3,SF-G10-2,17,10,3,3,14,7,0.17647058823529413,0.8235294117647058,0.3,0.7
SF-J3,SF-H15,9,8,2,0,7,8,0.2222222222222222,0.7777777777777778,0.0,1.0
SF-J3,SF-G9,2,5,1,3,1,2,0.5,0.5,0.6,0.4
SF-J3,SF-H14,3,7,1,2,2,5,0.3333333333333333,0.6666666666666666,0.2857142857142857,0.7142857142857143
SF-J3,SF-G13,13,5,5,4,8,1,0.38461538461538464,0.6153846153846154,0.8,0.2
SF-J3,SF-G11,8,2,5,2,3,0,0.625,0.375,1.0,0.0
SF-J3,SF-G12,20,25,4,16,16,9,0.2,0.8,0.64,0.36
SF-J3,SF-G10-1,2,13,2,7,0,6,1.0,0.0,0.5384615384615384,0.46153846153846156
SF-J3,SF-F15,4,5,0,2,4,3,0.0,1.0,0.4,0.6
SF-J3,SF-F16,4,3,1,0,3,3,0.25,0.75,0.0,1.0
SF-J3,SF-B19,1,4,0,2,1,2,0.0,1.0,0.5,0.5
SF-J3,SF-C26,3,4,0,0,3,4,0.0,1.0,0.0,1.0
SF-J3,SF-C25,1,1,0,1,1,0,0.0,1.0,1.0,0.0
SF-J3,SF-J1,79,119,29,94,50,25,0.3670886075949367,0.6329113924050633,0.7899159663865546,0.21008403361344538
SF-J3,SF-H0,21,34,13,26,8,8,0.6190476190476191,0.38095238095238093,0.7647058823529411,0.23529411764705882
SF-J3,SF-J5,42,46,32,28,10,18,0.7619047619047619,0.23809523809523808,0.6086956521739131,0.391304347826087
SF-J3,SF-G6,14,12,6,5,8,7,0.42857142857142855,0.5714285714285714,0.4166666666666667,0.5833333333333334
SF-J3,SF-G8,13,20,8,9,5,11,0.6153846153846154,0.38461538461538464,0.45,0.55
SF-J3,SF-G5,18,12,7,8,11,4,0.3888888888888889,0.6111111111111112,0.6666666666666666,0.3333333333333333
SF-J3,SF-G7,12,17,6,8,6,9,0.5,0.5,0.47058823529411764,0.5294117647058824
SF-J3,SF-F9,4,3,0,1,4,2,0.0,1.0,0.3333333333333333,0.6666666666666666
SF-J3,SF-K21,4,5,3,0,1,5,0.75,0.25,0.0,1.0
SF-J3,SF-J22-1,5,5,1,1,4,4,0.2,0.8,0.2,0.8
SF-J3,SF-J22-2,4,1,0,0,4,1,0.0,1.0,0.0,1.0
SF-J3,SF-I22,10,17,9,15,1,2,0.9,0.1,0.8823529411764706,0.11764705882352941
SF-J3,SF-I23-1,5,2,0,0,5,2,0.0,1.0,0.0,1.0
SF-J3,SF-M13,95,23,43,1,52,22,0.45263157894736844,0.5473684210526316,0.043478260869565216,0.9565217391304348
SF-J3,SF-M15,14,7,8,0,6,7,0.5714285714285714,0.42857142857142855,0.0,1.0
SF-J3,SF-L19,9,4,3,0,6,4,0.3333333333333333,0.6666666666666666,0.0,1.0
SF-J3,SF-L20,3,3,1,3,2,0,0.3333333333333333,0.6666666666666666,1.0,0.0
SF-J3,SF-M20,9,8,7,6,2,2,0.7777777777777778,0.2222222222222222,0.75,0.25
SF-J3,SF-K17-2,3,7,1,0,2,7,0.3333333333333333,0.6666666666666666,0.0,1.0
SF-J3,SF-K20,10,6,5,3,5,3,0.5,0.5,0.5,0.5
SF-J3,SF-K15-,62,27,42,14,20,13,0.6774193548387096,0.3225806451612903,0.5185185185185185,0.48148148148148145
SF-J3,SF-K19,8,7,4,2,4,5,0.5,0.5,0.2857142857142857,0.7142857142857143
SF-J3,SF-K18,24,14,17,4,7,10,0.7083333333333334,0.2916666666666667,0.2857142857142857,0.7142857142857143
SF-J3,SF-K17,34,16,14,5,20,11,0.4117647058823529,0.5882352941176471,0.3125,0.6875
SF-J3,SF-J16,5,6,2,0,3,6,0.4,0.6,0.0,1.0
SF-J3,SF-J18,14,12,9,2,5,10,0.6428571428571429,0.35714285714285715,0.16666666666666666,0.8333333333333334
SF-J3,SF-J20,3,1,2,1,1,0,0.6666666666666666,0.3333333333333333,1.0,0.0
SF-J3,SF-J19,3,5,1,0,2,5,0.3333333333333333,0.6666666666666666,0.0,1.0
SF-J3,SF-O12,1,3,1,0,0,3,1.0,0.0,0.0,1.0
SF-J3,SF-M12,11,8,5,2,6,6,0.45454545454545453,0.5454545454545454,0.25,0.75
SF-J3,SF-M10,14,14,9,5,5,9,0.6428571428571429,0.35714285714285715,0.35714285714285715,0.6428571428571429
SF-J3,SF-M11,18,25,10,23,8,2,0.5555555555555556,0.4444444444444444,0.92,0.08
SF-J3,SF-O18,2,1,0,1,2,0,0.0,1.0,1.0,0.0
SF-J3,SF-O21,5,4,3,2,2,2,0.6,0.4,0.5,0.5
SF-J3,SF-O22,2,2,1,1,1,1,0.5,0.5,0.5,0.5
SF-J3,SF-N21,1,10,0,0,1,10,0.0,1.0,0.0,1.0
SF-J3,SF-N20-2,1,2,0,2,1,0,0.0,1.0,1.0,0.0
SF-J3,SF-L21,7,2,0,2,7,0,0.0,1.0,1.0,0.0
SF-J3,SF-O30,1,1,0,0,1,1,0.0,1.0,0.0,1.0
SF-J3,SF-Q22-2,2,1,1,0,1,1,0.5,0.5,0.0,1.0
SF-J5,SF-J29,4,1,0,0,4,1,0.0,1.0,0.0,1.0
SF-J5,SF-I25,1,4,0,2,1,2,0.0,1.0,0.5,0.5
SF-J5,SF-H27-1,1,4,0,0,1,4,0.0,1.0,0.0,1.0
SF-J5,SF-L22,1,2,1,0,0,2,1.0,0.0,0.0,1.0
SF-J5,SF-F27,3,2,0,0,3,2,0.0,1.0,0.0,1.0
SF-J5,SF-M22-1,4,3,1,1,3,2,0.25,0.75,0.3333333333333333,0.6666666666666666
SF-J5,SF-G23,2,1,0,0,2,1,0.0,1.0,0.0,1.0
SF-J5,SF-G24,4,3,0,0,4,3,0.0,1.0,0.0,1.0
SF-J5,SF-G25,3,3,0,0,3,3,0.0,1.0,0.0,1.0
SF-J5,SF-E23,3,5,1,0,2,5,0.3333333333333333,0.6666666666666666,0.0,1.0
SF-J5,SF-D24,3,1,0,0,3,1,0.0,1.0,0.0,1.0
SF-J5,SF-B22,1,2,0,1,1,1,0.0,1.0,0.5,0.5
SF-J5,SF-J17,8,5,6,2,2,3,0.75,0.25,0.4,0.6
SF-J5,SF-I19,4,4,3,3,1,1,0.75,0.25,0.75,0.25
SF-J5,SF-H16,6,3,3,0,3,3,0.5,0.5,0.0,1.0
SF-J5,SF-H20,3,3,1,1,2,2,0.3333333333333333,0.6666666666666666,0.3333333333333333,0.6666666666666666
SF-J5,SF-G18,5,1,0,0,5,1,0.0,1.0,0.0,1.0
SF-J5,SF-G20,11,15,1,1,10,14,0.09090909090909091,0.9090909090909091,0.06666666666666667,0.9333333333333333
SF-J5,SF-F19,2,4,1,0,1,4,0.5,0.5,0.0,1.0
SF-J5,SF-E18,3,2,2,0,1,2,0.6666666666666666,0.3333333333333333,0.0,1.0
SF-J5,SF-E20,2,4,0,1,2,3,0.0,1.0,0.25,0.75
SF-J5,SF-E29-1,1,1,0,0,1,1,0.0,1.0,0.0,1.0
SF-J5,SF-D28,1,1,1,0,0,1,1.0,0.0,0.0,1.0
SF-J5,SF-G29-3,1,1,0,0,1,1,0.0,1.0,0.0,1.0
SF-J5,SF-F28-1,58,66,0,0,58,66,0.0,1.0,0.0,1.0
SF-J5,SF-E28,1,5,1,1,0,4,1.0,0.0,0.2,0.8
SF-J5,SF-J10,33,21,14,12,19,9,0.42424242424242425,0.5757575757575758,0.5714285714285714,0.42857142857142855
SF-J5,SF-J12,37,25,24,13,13,12,0.6486486486486487,0.35135135135135137,0.52,0.48
SF-J5,SF-J13,18,18,7,8,11,10,0.3888888888888889,0.6111111111111112,0.4444444444444444,0.5555555555555556
SF-J5,SF-J15,6,1,5,0,1,1,0.8333333333333334,0.16666666666666666,0.0,1.0
SF-J5,SF-H13,6,5,5,3,1,2,0.8333333333333334,0.16666666666666666,0.6,0.4
SF-J5,SF-I16,4,6,0,0,4,6,0.0,1.0,0.0,1.0
SF-J5,SF-H12,15,3,4,1,11,2,0.26666666666666666,0.7333333333333333,0.3333333333333333,0.6666666666666666
SF-J5,SF-G10-2,13,10,9,6,4,4,0.6923076923076923,0.3076923076923077,0.6,0.4
SF-J5,SF-H15,2,4,2,1,0,3,1.0,0.0,0.25,0.75
SF-J5,SF-G9,6,19,1,6,5,13,0.16666666666666666,0.8333333333333334,0.3157894736842105,0.6842105263157895
SF-J5,SF-H14,4,3,0,1,4,2,0.0,1.0,0.3333333333333333,0.6666666666666666
SF-J5,SF-G13,11,6,5,1,6,5,0.45454545454545453,0.5454545454545454,0.16666666666666666,0.8333333333333334
SF-J5,SF-G11,4,3,2,1,2,2,0.5,0.5,0.3333333333333333,0.6666666666666666
SF-J5,SF-G12,18,22,1,4,17,18,0.05555555555555555,0.9444444444444444,0.18181818181818182,0.8181818181818182
SF-J5,SF-G10-1,8,3,5,2,3,1,0.625,0.375,0.6666666666666666,0.3333333333333333
SF-J5,SF-F16,2,3,1,1,1,2,0.5,0.5,0.3333333333333333,0.6666666666666666
SF-J5,SF-C20,2,5,1,2,1,3,0.5,0.5,0.4,0.6
SF-J5,SF-A20,2,3,0,1,2,2,0.0,1.0,0.3333333333333333,0.6666666666666666
SF-J5,SF-C25,2,2,0,1,2,1,0.0,1.0,0.5,0.5
SF-J5,SF-J1,107,168,30,102,77,66,0.2803738317757009,0.719626168224299,0.6071428571428571,0.39285714285714285
SF-J5,SF-H0,16,24,3,14,13,10,0.1875,0.8125,0.5833333333333334,0.4166666666666667
SF-J5,SF-J3,46,42,28,32,18,10,0.6086956521739131,0.391304347826087,0.7619047619047619,0.23809523809523808
SF-J5,SF-G6,25,28,4,10,21,18,0.16,0.84,0.35714285714285715,0.6428571428571429
SF-J5,SF-G8,11,20,5,9,6,11,0.45454545454545453,0.5454545454545454,0.45,0.55
SF-J5,SF-G5,22,22,6,9,16,13,0.2727272727272727,0.7272727272727273,0.4090909090909091,0.5909090909090909
SF-J5,SF-G7,15,20,9,9,6,11,0.6,0.4,0.45,0.55
SF-J5,SF-F9,4,1,2,0,2,1,0.5,0.5,0.0,1.0
SF-J5,SF-K21,4,5,3,1,1,4,0.75,0.25,0.2,0.8
SF-J5,SF-J22-1,2,4,0,2,2,2,0.0,1.0,0.5,0.5
SF-J5,SF-J22-2,1,2,0,0,1,2,0.0,1.0,0.0,1.0
SF-J5,SF-J21,5,3,3,0,2,3,0.6,0.4,0.0,1.0
SF-J5,SF-I21,3,2,1,0,2,2,0.3333333333333333,0.6666666666666666,0.0,1.0
SF-J5,SF-I23-2,1,3,0,0,1,3,0.0,1.0,0.0,1.0
SF-J5,SF-I23-1,1,1,1,1,0,0,1.0,0.0,1.0,0.0
SF-J5,SF-M13,10,8,9,4,1,4,0.9,0.1,0.5,0.5
SF-J5,SF-M15,18,5,5,0,13,5,0.2777777777777778,0.7222222222222222,0.0,1.0
SF-J5,SF-L19,3,2,1,0,2,2,0.3333333333333333,0.6666666666666666,0.0,1.0
SF-J5,SF-L20,2,4,0,1,2,3,0.0,1.0,0.25,0.75
SF-J5,SF-M20,4,3,2,1,2,2,0.5,0.5,0.3333333333333333,0.6666666666666666
SF-J5,SF-K17-2,5,8,1,4,4,4,0.2,0.8,0.5,0.5
SF-J5,SF-K20,11,2,4,0,7,2,0.36363636363636365,0.6363636363636364,0.0,1.0
SF-J5,SF-K15-,51,22,28,7,23,15,0.5490196078431373,0.45098039215686275,0.3181818181818182,0.6818181818181818
SF-J5,SF-K19,8,6,6,2,2,4,0.75,0.25,0.3333333333333333,0.6666666666666666
SF-J5,SF-K18,16,14,7,6,9,8,0.4375,0.5625,0.42857142857142855,0.5714285714285714
SF-J5,SF-K17,18,13,9,0,9,13,0.5,0.5,0.0,1.0
SF-J5,SF-J16,10,3,4,0,6,3,0.4,0.6,0.0,1.0
SF-J5,SF-J18,13,8,4,1,9,7,0.3076923076923077,0.6923076923076923,0.125,0.875
SF-J5,SF-M12,28,18,8,4,20,14,0.2857142857142857,0.7142857142857143,0.2222222222222222,0.7777777777777778
SF-J5,SF-M10,20,12,12,7,8,5,0.6,0.4,0.5833333333333334,0.4166666666666667
SF-J5,SF-M11,16,20,3,7,13,13,0.1875,0.8125,0.35,0.65
SF-J5,SF-Q21-2,2,1,0,0,2,1,0.0,1.0,0.0,1.0
SF-J5,SF-Q21-1,2,1,1,0,1,1,0.5,0.5,0.0,1.0
SF-J5,SF-O18,2,3,1,0,1,3,0.5,0.5,0.0,1.0
SF-J5,SF-O19,5,6,0,4,5,2,0.0,1.0,0.6666666666666666,0.3333333333333333
SF-J5,SF-O21,4,1,2,0,2,1,0.5,0.5,0.0,1.0
SF-J5,SF-O22,2,5,0,1,2,4,0.0,1.0,0.2,0.8
SF-J5,SF-N21,5,7,3,0,2,7,0.6,0.4,0.0,1.0
SF-J5,SF-N20-2,5,3,0,1,5,2,0.0,1.0,0.3333333333333333,0.6666666666666666
SF-J5,SF-M21,1,1,0,0,1,1,0.0,1.0,0.0,1.0
SF-J5,SF-L21,4,3,3,1,1,2,0.75,0.25,0.3333333333333333,0.6666666666666666
SF-G6,SF-F27,1,1,0,1,1,0,0.0,1.0,1.0,0.0
SF-G6,SF-G23,1,1,0,0,1,1,0.0,1.0,0.0,1.0
SF-G6,SF-G24,7,1,0,0,7,1,0.0,1.0,0.0,1.0
SF-G6,SF-G25,1,1,0,0,1,1,0.0,1.0,0.0,1.0
SF-G6,SF-E23,3,4,1,0,2,4,0.3333333333333333,0.6666666666666666,0.0,1.0
SF-G6,SF-J17,4,3,1,0,3,3,0.25,0.75,0.0,1.0
SF-G6,SF-I19,1,1,1,1,0,0,1.0,0.0,1.0,0.0
SF-G6,SF-H16,3,2,1,1,2,1,0.3333333333333333,0.6666666666666666,0.5,0.5
SF-G6,SF-G18,1,2,1,1,0,1,1.0,0.0,0.5,0.5
SF-G6,SF-G20,3,4,2,2,1,2,0.6666666666666666,0.3333333333333333,0.5,0.5
SF-G6,SF-E28,2,1,2,0,0,1,1.0,0.0,0.0,1.0
SF-G6,SF-J10,6,6,2,3,4,3,0.3333333333333333,0.6666666666666666,0.5,0.5
SF-G6,SF-J12,34,19,10,5,24,14,0.29411764705882354,0.7058823529411765,0.2631578947368421,0.7368421052631579
SF-G6,SF-J13,24,14,8,5,16,9,0.3333333333333333,0.6666666666666666,0.35714285714285715,0.6428571428571429
SF-G6,SF-H13,7,3,3,1,4,2,0.42857142857142855,0.5714285714285714,0.3333333333333333,0.6666666666666666
SF-G6,SF-I16,2,3,2,0,0,3,1.0,0.0,0.0,1.0
SF-G6,SF-H12,7,12,1,5,6,7,0.14285714285714285,0.8571428571428571,0.4166666666666667,0.5833333333333334
SF-G6,SF-G10-2,17,20,8,4,9,16,0.47058823529411764,0.5294117647058824,0.2,0.8
SF-G6,SF-G9,9,13,6,11,3,2,0.6666666666666666,0.3333333333333333,0.8461538461538461,0.15384615384615385
SF-G6,SF-G13,6,10,3,6,3,4,0.5,0.5,0.6,0.4
SF-G6,SF-G11,5,5,4,2,1,3,0.8,0.2,0.4,0.6
SF-G6,SF-G12,12,10,4,2,8,8,0.3333333333333333,0.6666666666666666,0.2,0.8
SF-G6,SF-G10-1,15,5,5,4,10,1,0.3333333333333333,0.6666666666666666,0.8,0.2
SF-G6,SF-F15,7,6,3,3,4,3,0.42857142857142855,0.5714285714285714,0.5,0.5
SF-G6,SF-F16,2,1,1,0,1,1,0.5,0.5,0.0,1.0
SF-G6,SF-B19,2,1,0,0,2,1,0.0,1.0,0.0,1.0
SF-G6,SF-A20,10,11,1,3,9,8,0.1,0.9,0.2727272727272727,0.7272727272727273
SF-G6,SF-J1,13,30,3,14,10,16,0.23076923076923078,0.7692307692307693,0.4666666666666667,0.5333333333333333
SF-G6,SF-H0,1,7,0,3,1,4,0.0,1.0,0.42857142857142855,0.5714285714285714
SF-G6,SF-J3,12,14,5,6,7,8,0.4166666666666667,0.5833333333333334,0.42857142857142855,0.5714285714285714
SF-G6,SF-J5,28,25,10,4,18,21,0.35714285714285715,0.6428571428571429,0.16,0.84
SF-G6,SF-G8,13,14,6,9,7,5,0.46153846153846156,0.5384615384615384,0.6428571428571429,0.35714285714285715
SF-G6,SF-G5,14,19,5,9,9,10,0.35714285714285715,0.6428571428571429,0.47368421052631576,0.5263157894736842
SF-G6,SF-G7,8,12,4,7,4,5,0.5,0.5,0.5833333333333334,0.4166666666666667
SF-G6,SF-F9,1,13,0,13,1,0,0.0,1.0,1.0,0.0
SF-G6,SF-K21,3,1,1,1,2,0,0.3333333333333333,0.6666666666666666,1.0,0.0
SF-G6,SF-J21,4,3,0,1,4,2,0.0,1.0,0.3333333333333333,0.6666666666666666
SF-G6,SF-M13,53,52,3,3,50,49,0.05660377358490566,0.9433962264150944,0.057692307692307696,0.9423076923076923
SF-G6,SF-N20-1,1,1,0,0,1,1,0.0,1.0,0.0,1.0
SF-G6,SF-K20,3,1,1,0,2,1,0.3333333333333333,0.6666666666666666,0.0,1.0
SF-G6,SF-K15-,24,8,8,6,16,2,0.3333333333333333,0.6666666666666666,0.75,0.25
SF-G6,SF-K19,2,2,1,0,1,2,0.5,0.5,0.0,1.0
SF-G6,SF-K18,5,1,3,0,2,1,0.6,0.4,0.0,1.0
SF-G6,SF-K17,2,1,2,0,0,1,1.0,0.0,0.0,1.0
SF-G6,SF-J16,2,1,0,0,2,1,0.0,1.0,0.0,1.0
SF-G6,SF-J18,14,3,5,0,9,3,0.35714285714285715,0.6428571428571429,0.0,1.0
SF-G6,SF-M10,4,7,3,5,1,2,0.75,0.25,0.7142857142857143,0.2857142857142857
SF-G6,SF-M11,7,3,4,1,3,2,0.5714285714285714,0.42857142857142855,0.3333333333333333,0.6666666666666666
SF-G6,SF-O22,5,3,0,2,5,1,0.0,1.0,0.6666666666666666,0.3333333333333333
SF-G6,SF-L21,3,1,0,0,3,1,0.0,1.0,0.0,1.0
SF-G8,SF-K26,1,2,0,0,1,2,0.0,1.0,0.0,1.0
SF-G8,SF-J26-2,2,1,0,0,2,1,0.0,1.0,0.0,1.0
SF-G8,SF-J28-2,1,1,0,0,1,1,0.0,1.0,0.0,1.0
SF-G8,SF-J25,1,2,1,1,0,1,1.0,0.0,0.5,0.5
SF-G8,SF-I25,2,2,0,2,2,0,0.0,1.0,1.0,0.0
SF-G8,SF-H26,4,1,1,1,3,0,0.25,0.75,1.0,0.0
SF-G8,SF-F28-2,1,1,0,1,1,0,0.0,1.0,1.0,0.0
SF-G8,SF-M22-2,2,3,0,0,2,3,0.0,1.0,0.0,1.0
SF-G8,SF-J23-2,1,1,0,0,1,1,0.0,1.0,0.0,1.0
SF-G8,SF-E23,5,9,3,6,2,3,0.6,0.4,0.6666666666666666,0.3333333333333333
SF-G8,SF-D24,1,2,0,0,1,2,0.0,1.0,0.0,1.0
SF-G8,SF-C22,2,6,0,0,2,6,0.0,1.0,0.0,1.0
SF-G8,SF-B22,3,3,1,0,2,3,0.3333333333333333,0.6666666666666666,0.0,1.0
SF-G8,SF-J17,6,6,1,0,5,6,0.16666666666666666,0.8333333333333334,0.0,1.0
SF-G8,SF-I19,1,2,0,0,1,2,0.0,1.0,0.0,1.0
SF-G8,SF-H16,11,11,6,3,5,8,0.5454545454545454,0.45454545454545453,0.2727272727272727,0.7272727272727273
SF-G8,SF-G19,2,1,1,1,1,0,0.5,0.5,1.0,0.0
SF-G8,SF-G20,1,3,0,2,1,1,0.0,1.0,0.6666666666666666,0.3333333333333333
SF-G8,SF-F19,1,8,0,1,1,7,0.0,1.0,0.125,0.875
SF-G8,SF-E18,5,4,1,1,4,3,0.2,0.8,0.25,0.75
SF-G8,SF-E20,1,4,0,0,1,4,0.0,1.0,0.0,1.0
SF-G8,SF-E29-2,2,1,0,0,2,1,0.0,1.0,0.0,1.0
SF-G8,SF-G30-1,1,1,1,0,0,1,1.0,0.0,0.0,1.0
SF-G8,SF-F28-1,1,2,1,2,0,0,1.0,0.0,1.0,0.0
SF-G8,SF-J10,19,20,12,8,7,12,0.631578947368421,0.3684210526315789,0.4,0.6
SF-G8,SF-J12,33,26,20,12,13,14,0.6060606060606061,0.3939393939393939,0.46153846153846156,0.5384615384615384
SF-G8,SF-J13,16,6,13,3,3,3,0.8125,0.1875,0.5,0.5
SF-G8,SF-H13,9,6,4,3,5,3,0.4444444444444444,0.5555555555555556,0.5,0.5
SF-G8,SF-I16,3,2,2,0,1,2,0.6666666666666666,0.3333333333333333,0.0,1.0
SF-G8,SF-H12,27,34,16,21,11,13,0.5925925925925926,0.4074074074074074,0.6176470588235294,0.38235294117647056
SF-G8,SF-G10-2,9,19,8,12,1,7,0.8888888888888888,0.1111111111111111,0.631578947368421,0.3684210526315789
SF-G8,SF-H15,7,16,2,3,5,13,0.2857142857142857,0.7142857142857143,0.1875,0.8125
SF-G8,SF-G9,7,10,5,3,2,7,0.7142857142857143,0.2857142857142857,0.3,0.7
SF-G8,SF-H14,2,4,1,0,1,4,0.5,0.5,0.0,1.0
SF-G8,SF-G13,11,13,2,5,9,8,0.18181818181818182,0.8181818181818182,0.38461538461538464,0.6153846153846154
SF-G8,SF-G11,13,4,7,1,6,3,0.5384615384615384,0.46153846153846156,0.25,0.75
SF-G8,SF-G12,17,17,6,10,11,7,0.35294117647058826,0.6470588235294118,0.5882352941176471,0.4117647058823529
SF-G8,SF-G10-1,10,8,6,5,4,3,0.6,0.4,0.625,0.375
SF-G8,SF-F15,8,8,3,5,5,3,0.375,0.625,0.625,0.375
SF-G8,SF-A20,2,2,0,2,2,0,0.0,1.0,1.0,0.0
SF-G8,SF-C25,5,6,0,0,5,6,0.0,1.0,0.0,1.0
SF-G8,SF-B25,1,1,0,0,1,1,0.0,1.0,0.0,1.0
SF-G8,SF-J1,26,17,15,11,11,6,0.5769230769230769,0.4230769230769231,0.6470588235294118,0.35294117647058826
SF-G8,SF-H0,9,2,2,1,7,1,0.2222222222222222,0.7777777777777778,0.5,0.5
SF-G8,SF-J3,20,13,9,8,11,5,0.45,0.55,0.6153846153846154,0.38461538461538464
SF-G8,SF-J5,20,11,9,5,11,6,0.45,0.55,0.45454545454545453,0.5454545454545454
SF-G8,SF-G6,14,13,9,6,5,7,0.6428571428571429,0.35714285714285715,0.46153846153846156,0.5384615384615384
SF-G8,SF-G5,24,18,12,7,12,11,0.5,0.5,0.3888888888888889,0.6111111111111112
SF-G8,SF-G7,43,26,28,12,15,14,0.6511627906976745,0.3488372093023256,0.46153846153846156,0.5384615384615384
SF-G8,SF-F9,8,5,3,5,5,0,0.375,0.625,1.0,0.0
SF-G8,SF-K21,4,4,2,1,2,3,0.5,0.5,0.25,0.75
SF-G8,SF-J23-1,24,21,1,1,23,20,0.041666666666666664,0.9583333333333334,0.047619047619047616,0.9523809523809523
SF-G8,SF-J22-1,1,3,0,0,1,3,0.0,1.0,0.0,1.0
SF-G8,SF-J22-2,3,2,0,0,3,2,0.0,1.0,0.0,1.0
SF-G8,SF-I23-2,4,2,0,0,4,2,0.0,1.0,0.0,1.0
SF-G8,SF-I24,1,1,1,1,0,0,1.0,0.0,1.0,0.0
SF-G8,SF-M13,59,31,35,21,24,10,0.5932203389830508,0.4067796610169492,0.6774193548387096,0.3225806451612903
SF-G8,SF-M15,7,4,3,2,4,2,0.42857142857142855,0.5714285714285714,0.5,0.5
SF-G8,SF-L20,1,4,0,1,1,3,0.0,1.0,0.25,0.75
SF-G8,SF-N20-1,1,20,1,19,0,1,1.0,0.0,0.95,0.05
SF-G8,SF-M20,55,46,47,44,8,2,0.8545454545454545,0.14545454545454545,0.9565217391304348,0.043478260869565216
SF-G8,SF-K17-2,1,4,0,1,1,3,0.0,1.0,0.25,0.75
SF-G8,SF-K20,10,8,5,2,5,6,0.5,0.5,0.25,0.75
SF-G8,SF-K15-,25,19,7,7,18,12,0.28,0.72,0.3684210526315789,0.631578947368421
SF-G8,SF-K19,4,4,1,2,3,2,0.25,0.75,0.5,0.5
SF-G8,SF-K18,8,6,4,3,4,3,0.5,0.5,0.5,0.5
SF-G8,SF-K17,6,6,4,3,2,3,0.6666666666666666,0.3333333333333333,0.5,0.5
SF-G8,SF-J16,10,6,1,0,9,6,0.1,0.9,0.0,1.0
SF-G8,SF-J18,6,4,2,0,4,4,0.3333333333333333,0.6666666666666666,0.0,1.0
SF-G8,SF-M12,8,5,6,3,2,2,0.75,0.25,0.6,0.4
SF-G8,SF-M10,8,23,2,6,6,17,0.25,0.75,0.2608695652173913,0.7391304347826086
SF-G8,SF-M11,7,6,5,3,2,3,0.7142857142857143,0.2857142857142857,0.5,0.5
SF-G8,SF-O22,2,1,0,0,2,1,0.0,1.0,0.0,1.0
SF-G8,SF-L21,4,4,0,0,4,4,0.0,1.0,0.0,1.0
SF-G8,SF I29-1,16,10,0,0,16,10,0.0,1.0,0.0,1.0
SF-G8,SF-T22,2,3,0,1,2,2,0.0,1.0,0.3333333333333333,0.6666666666666666
SF-G8,SF-S22-1,2,2,0,0,2,2,0.0,1.0,0.0,1.0
SF-G8,SF-Q22-2,2,5,0,0,2,5,0.0,1.0,0.0,1.0
SF-G8,SF-P22,3,2,0,0,3,2,0.0,1.0,0.0,1.0
SF-G5,SF-L25,2,4,0,1,2,3,0.0,1.0,0.25,0.75
SF-G5,SF-O23,2,1,0,0,2,1,0.0,1.0,0.0,1.0
SF-G5,SF-F28-2,2,5,0,0,2,5,0.0,1.0,0.0,1.0
SF-G5,SF-F27,3,4,0,0,3,4,0.0,1.0,0.0,1.0
SF-G5,SF-K24,1,3,0,2,1,1,0.0,1.0,0.6666666666666666,0.3333333333333333
SF-G5,SF-G24,9,4,2,2,7,2,0.2222222222222222,0.7777777777777778,0.5,0.5
SF-G5,SF-G25,4,2,4,0,0,2,1.0,0.0,0.0,1.0
SF-G5,SF-E23,5,4,4,0,1,4,0.8,0.2,0.0,1.0
SF-G5,SF-D24,16,28,0,0,16,28,0.0,1.0,0.0,1.0
SF-G5,SF-C22,10,2,1,1,9,1,0.1,0.9,0.5,0.5
SF-G5,SF-B22,20,6,5,3,15,3,0.25,0.75,0.5,0.5
SF-G5,SF-J17,13,8,2,0,11,8,0.15384615384615385,0.8461538461538461,0.0,1.0
SF-G5,SF-H16,10,27,0,1,10,26,0.0,1.0,0.037037037037037035,0.9629629629629629
SF-G5,SF-G19,3,9,2,1,1,8,0.6666666666666666,0.3333333333333333,0.1111111111111111,0.8888888888888888
SF-G5,SF-G17,4,6,2,2,2,4,0.5,0.5,0.3333333333333333,0.6666666666666666
SF-G5,SF-G18,5,3,2,0,3,3,0.4,0.6,0.0,1.0
SF-G5,SF-G20,2,3,1,0,1,3,0.5,0.5,0.0,1.0
SF-G5,SF-F19,14,11,5,1,9,10,0.35714285714285715,0.6428571428571429,0.09090909090909091,0.9090909090909091
SF-G5,SF-E18,14,10,4,1,10,9,0.2857142857142857,0.7142857142857143,0.1,0.9
SF-G5,SF-E20,24,9,5,4,19,5,0.20833333333333334,0.7916666666666666,0.4444444444444444,0.5555555555555556
SF-G5,SF-G30-2,2,2,0,0,2,2,0.0,1.0,0.0,1.0
SF-G5,SF-E29-2,3,2,0,0,3,2,0.0,1.0,0.0,1.0
SF-G5,SF-A27,1,5,0,0,1,5,0.0,1.0,0.0,1.0
SF-G5,SF-J10,7,10,3,7,4,3,0.42857142857142855,0.5714285714285714,0.7,0.3
SF-G5,SF-J12,25,19,4,11,21,8,0.16,0.84,0.5789473684210527,0.42105263157894735
SF-G5,SF-J13,21,35,13,23,8,12,0.6190476190476191,0.38095238095238093,0.6571428571428571,0.34285714285714286
SF-G5,SF-J14,2,3,1,2,1,1,0.5,0.5,0.6666666666666666,0.3333333333333333
SF-G5,SF-H13,12,9,5,5,7,4,0.4166666666666667,0.5833333333333334,0.5555555555555556,0.4444444444444444
SF-G5,SF-I16,6,8,2,0,4,8,0.3333333333333333,0.6666666666666666,0.0,1.0
SF-G5,SF-H12,15,14,7,4,8,10,0.4666666666666667,0.5333333333333333,0.2857142857142857,0.7142857142857143
SF-G5,SF-G10-2,11,13,5,6,6,7,0.45454545454545453,0.5454545454545454,0.46153846153846156,0.5384615384615384
SF-G5,SF-H15,4,3,1,0,3,3,0.25,0.75,0.0,1.0
SF-G5,SF-G9,18,19,10,9,8,10,0.5555555555555556,0.4444444444444444,0.47368421052631576,0.5263157894736842
SF-G5,SF-H14,2,1,0,0,2,1,0.0,1.0,0.0,1.0
SF-G5,SF-G13,14,22,3,8,11,14,0.21428571428571427,0.7857142857142857,0.36363636363636365,0.6363636363636364
SF-G5,SF-G11,12,18,5,9,7,9,0.4166666666666667,0.5833333333333334,0.5,0.5
SF-G5,SF-G12,48,41,12,15,36,26,0.25,0.75,0.36585365853658536,0.6341463414634146
SF-G5,SF-G10-1,33,18,15,11,18,7,0.45454545454545453,0.5454545454545454,0.6111111111111112,0.3888888888888889
SF-G5,SF-F15,27,37,11,9,16,28,0.4074074074074074,0.5925925925925926,0.24324324324324326,0.7567567567567568
SF-G5,SF-F16,21,10,8,2,13,8,0.38095238095238093,0.6190476190476191,0.2,0.8
SF-G5,SF-C21,7,2,1,0,6,2,0.14285714285714285,0.8571428571428571,0.0,1.0
SF-G5,SF-C20,2,7,0,3,2,4,0.0,1.0,0.42857142857142855,0.5714285714285714
SF-G5,SF-B19,1,19,0,12,1,7,0.0,1.0,0.631578947368421,0.3684210526315789
SF-G5,SF-A20,19,9,5,8,14,1,0.2631578947368421,0.7368421052631579,0.8888888888888888,0.1111111111111111
SF-G5,SF-A19,7,4,3,1,4,3,0.42857142857142855,0.5714285714285714,0.25,0.75
SF-G5,SF-C25,9,1,0,0,9,1,0.0,1.0,0.0,1.0
SF-G5,SF-B25,6,8,1,0,5,8,0.16666666666666666,0.8333333333333334,0.0,1.0
SF-G5,SF-J1,29,35,12,13,17,22,0.41379310344827586,0.5862068965517241,0.37142857142857144,0.6285714285714286
SF-G5,SF-H0,15,16,1,5,14,11,0.06666666666666667,0.9333333333333333,0.3125,0.6875
SF-G5,SF-J3,12,18,8,7,4,11,0.6666666666666666,0.3333333333333333,0.3888888888888889,0.6111111111111112
SF-G5,SF-J5,22,22,9,6,13,16,0.4090909090909091,0.5909090909090909,0.2727272727272727,0.7272727272727273
SF-G5,SF-G6,19,14,9,5,10,9,0.47368421052631576,0.5263157894736842,0.35714285714285715,0.6428571428571429
SF-G5,SF-G8,18,24,7,12,11,12,0.3888888888888889,0.6111111111111112,0.5,0.5
SF-G5,SF-G7,35,78,16,40,19,38,0.45714285714285713,0.5428571428571428,0.5128205128205128,0.48717948717948717
SF-G5,SF-F9,23,26,17,20,6,6,0.7391304347826086,0.2608695652173913,0.7692307692307693,0.23076923076923078
SF-G5,SF-K21,4,4,2,0,2,4,0.5,0.5,0.0,1.0
SF-G5,SF-J23-1,2,1,0,1,2,0,0.0,1.0,1.0,0.0
SF-G5,SF-J22-1,4,6,0,0,4,6,0.0,1.0,0.0,1.0
SF-G5,SF-J21,7,7,4,5,3,2,0.5714285714285714,0.42857142857142855,0.7142857142857143,0.2857142857142857
SF-G5,SF-I22,1,1,0,1,1,0,0.0,1.0,1.0,0.0
SF-G5,SF-F26,3,2,0,0,3,2,0.0,1.0,0.0,1.0
SF-G5,SF-M13,10,17,3,2,7,15,0.3,0.7,0.11764705882352941,0.8823529411764706
SF-G5,SF-M15,8,12,3,2,5,10,0.375,0.625,0.16666666666666666,0.8333333333333334
SF-G5,SF-L19,7,3,1,0,6,3,0.14285714285714285,0.8571428571428571,0.0,1.0
SF-G5,SF-M20,6,2,4,0,2,2,0.6666666666666666,0.3333333333333333,0.0,1.0
SF-G5,SF-K20,5,6,1,3,4,3,0.2,0.8,0.5,0.5
SF-G5,SF-K15-,20,26,8,5,12,21,0.4,0.6,0.19230769230769232,0.8076923076923077
SF-G5,SF-K19,7,7,2,0,5,7,0.2857142857142857,0.7142857142857143,0.0,1.0
SF-G5,SF-K18,9,6,2,0,7,6,0.2222222222222222,0.7777777777777778,0.0,1.0
SF-G5,SF-K17,16,9,9,3,7,6,0.5625,0.4375,0.3333333333333333,0.6666666666666666
SF-G5,SF-J16,3,1,2,0,1,1,0.6666666666666666,0.3333333333333333,0.0,1.0
SF-G5,SF-J18,9,6,2,0,7,6,0.2222222222222222,0.7777777777777778,0.0,1.0
SF-G5,SF-J19,9,4,4,2,5,2,0.4444444444444444,0.5555555555555556,0.5,0.5
SF-G5,SF-M12,16,4,10,1,6,3,0.625,0.375,0.25,0.75
SF-G5,SF-M10,3,14,2,7,1,7,0.6666666666666666,0.3333333333333333,0.5,0.5
SF-G5,SF-M11,15,14,5,7,10,7,0.3333333333333333,0.6666666666666666,0.5,0.5
SF-G5,SF-R19,2,2,0,0,2,2,0.0,1.0,0.0,1.0
SF-G5,SF-P21,1,3,0,0,1,3,0.0,1.0,0.0,1.0
SF-G5,SF-O18,4,2,0,0,4,2,0.0,1.0,0.0,1.0
SF-G5,SF-O19,2,5,0,3,2,2,0.0,1.0,0.6,0.4
SF-G5,SF-O21,2,2,0,0,2,2,0.0,1.0,0.0,1.0
SF-G5,SF-O22,4,2,0,1,4,1,0.0,1.0,0.5,0.5
SF-G5,SF-N21,2,1,0,0,2,1,0.0,1.0,0.0,1.0
SF-G5,SF-L21,1,4,0,0,1,4,0.0,1.0,0.0,1.0
SF-G5,SF-N27,3,1,0,0,3,1,0.0,1.0,0.0,1.0
SF-G5,SF-N29,3,4,0,0,3,4,0.0,1.0,0.0,1.0
SF-G5,SF-L30-1,1,1,0,0,1,1,0.0,1.0,0.0,1.0
SF-G5,SF-L29,2,4,0,0,2,4,0.0,1.0,0.0,1.0
SF-G5,SF-S24,1,1,0,1,1,0,0.0,1.0,1.0,0.0
SF-G5,SF-R24,1,1,0,0,1,1,0.0,1.0,0.0,1.0
SF-G5,SF-P26,6,1,0,0,6,1,0.0,1.0,0.0,1.0
SF-G5,SF-Q22-2,2,2,0,0,2,2,0.0,1.0,0.0,1.0
SF-G7,SF-M26-2,1,2,0,0,1,2,0.0,1.0,0.0,1.0
SF-G7,SF-J29,3,1,1,1,2,0,0.3333333333333333,0.6666666666666666,1.0,0.0
SF-G7,SF-L25,1,1,1,0,0,1,1.0,0.0,0.0,1.0
SF-G7,SF-M24,4,1,1,1,3,0,0.25,0.75,1.0,0.0
SF-G7,SF-K29-1,2,2,2,0,0,2,1.0,0.0,0.0,1.0
SF-G7,SF-K25,1,5,0,4,1,1,0.0,1.0,0.8,0.2
SF-G7,SF-J24,2,1,0,0,2,1,0.0,1.0,0.0,1.0
SF-G7,SF-H26,2,1,0,0,2,1,0.0,1.0,0.0,1.0
SF-G7,SF-G27,1,2,0,0,1,2,0.0,1.0,0.0,1.0
SF-G7,SF-M22-2,9,2,1,0,8,2,0.1111111111111111,0.8888888888888888,0.0,1.0
SF-G7,SF-L22,3,2,1,1,2,1,0.3333333333333333,0.6666666666666666,0.5,0.5
SF-G7,SF-F27,3,3,0,0,3,3,0.0,1.0,0.0,1.0
SF-G7,SF-N22-2,3,8,0,1,3,7,0.0,1.0,0.125,0.875
SF-G7,SF-M22-1,2,3,0,1,2,2,0.0,1.0,0.3333333333333333,0.6666666666666666
SF-G7,SF-K24,4,1,0,1,4,0,0.0,1.0,1.0,0.0
SF-G7,SF-G23,5,4,0,0,5,4,0.0,1.0,0.0,1.0
SF-G7,SF-G24,9,10,4,2,5,8,0.4444444444444444,0.5555555555555556,0.2,0.8
SF-G7,SF-G25,8,1,0,0,8,1,0.0,1.0,0.0,1.0
SF-G7,SF-F23,3,5,0,0,3,5,0.0,1.0,0.0,1.0
SF-G7,SF-E23,12,16,0,2,12,14,0.0,1.0,0.125,0.875
SF-G7,SF-D24,6,10,0,0,6,10,0.0,1.0,0.0,1.0
SF-G7,SF-C22,5,2,0,0,5,2,0.0,1.0,0.0,1.0
SF-G7,SF-B22,4,1,2,1,2,0,0.5,0.5,1.0,0.0
SF-G7,SF-J17,10,6,2,2,8,4,0.2,0.8,0.3333333333333333,0.6666666666666666
SF-G7,SF-I19,2,4,2,3,0,1,1.0,0.0,0.75,0.25
SF-G7,SF-H16,25,33,0,5,25,28,0.0,1.0,0.15151515151515152,0.8484848484848485
SF-G7,SF-H19,1,3,1,3,0,0,1.0,0.0,1.0,0.0
SF-G7,SF-H20,4,1,0,1,4,0,0.0,1.0,1.0,0.0
SF-G7,SF-H18,1,1,0,1,1,0,0.0,1.0,1.0,0.0
SF-G7,SF-H17,2,2,0,1,2,1,0.0,1.0,0.5,0.5
SF-G7,SF-G19,4,6,0,1,4,5,0.0,1.0,0.16666666666666666,0.8333333333333334
SF-G7,SF-G17,7,3,7,0,0,3,1.0,0.0,0.0,1.0
SF-G7,SF-G18,5,3,2,1,3,2,0.4,0.6,0.3333333333333333,0.6666666666666666
SF-G7,SF-G20,14,8,3,0,11,8,0.21428571428571427,0.7857142857142857,0.0,1.0
SF-G7,SF-F19,14,22,5,9,9,13,0.35714285714285715,0.6428571428571429,0.4090909090909091,0.5909090909090909
SF-G7,SF-E18,22,15,8,1,14,14,0.36363636363636365,0.6363636363636364,0.06666666666666667,0.9333333333333333
SF-G7,SF-E20,33,52,0,1,33,51,0.0,1.0,0.019230769230769232,0.9807692307692307
SF-G7,SF-G30-2,4,1,2,0,2,1,0.5,0.5,0.0,1.0
SF-G7,SF-E29-1,3,3,0,0,3,3,0.0,1.0,0.0,1.0
SF-G7,SF-D28,4,4,2,0,2,4,0.5,0.5,0.0,1.0
SF-G7,SF-A27,1,1,0,0,1,1,0.0,1.0,0.0,1.0
SF-G7,SF-E28,9,5,0,0,9,5,0.0,1.0,0.0,1.0
SF-G7,SF-J10,26,35,17,22,9,13,0.6538461538461539,0.34615384615384615,0.6285714285714286,0.37142857142857144
SF-G7,SF-J12,55,37,16,10,39,27,0.2909090909090909,0.7090909090909091,0.2702702702702703,0.7297297297297297
SF-G7,SF-J13,73,30,61,11,12,19,0.8356164383561644,0.1643835616438356,0.36666666666666664,0.6333333333333333
SF-G7,SF-J15,6,17,0,0,6,17,0.0,1.0,0.0,1.0
SF-G7,SF-J14,3,4,2,4,1,0,0.6666666666666666,0.3333333333333333,1.0,0.0
SF-G7,SF-H13,19,8,10,4,9,4,0.5263157894736842,0.47368421052631576,0.5,0.5
SF-G7,SF-I16,5,4,2,0,3,4,0.4,0.6,0.0,1.0
SF-G7,SF-H12,8,14,3,8,5,6,0.375,0.625,0.5714285714285714,0.42857142857142855
SF-G7,SF-G10-2,27,18,11,5,16,13,0.4074074074074074,0.5925925925925926,0.2777777777777778,0.7222222222222222
SF-G7,SF-H15,6,10,3,5,3,5,0.5,0.5,0.5,0.5
SF-G7,SF-G9,26,27,14,15,12,12,0.5384615384615384,0.46153846153846156,0.5555555555555556,0.4444444444444444
SF-G7,SF-H14,6,6,2,1,4,5,0.3333333333333333,0.6666666666666666,0.16666666666666666,0.8333333333333334
SF-G7,SF-G13,42,59,15,29,27,30,0.35714285714285715,0.6428571428571429,0.4915254237288136,0.5084745762711864
SF-G7,SF-G11,35,42,22,16,13,26,0.6285714285714286,0.37142857142857144,0.38095238095238093,0.6190476190476191
SF-G7,SF-G12,60,82,34,32,26,50,0.5666666666666667,0.43333333333333335,0.3902439024390244,0.6097560975609756
SF-G7,SF-G10-1,37,48,24,17,13,31,0.6486486486486487,0.35135135135135137,0.3541666666666667,0.6458333333333334
SF-G7,SF-F15,34,18,17,9,17,9,0.5,0.5,0.5,0.5
SF-G7,SF-F16,10,14,5,8,5,6,0.5,0.5,0.5714285714285714,0.42857142857142855
SF-G7,SF-C20,7,2,0,0,7,2,0.0,1.0,0.0,1.0
SF-G7,SF-B21,1,2,0,0,1,2,0.0,1.0,0.0,1.0
SF-G7,SF-B19,6,8,2,1,4,7,0.3333333333333333,0.6666666666666666,0.125,0.875
SF-G7,SF-A20,8,5,5,1,3,4,0.625,0.375,0.2,0.8
SF-G7,SF-A19,7,3,0,0,7,3,0.0,1.0,0.0,1.0
SF-G7,SF-C26,5,8,0,0,5,8,0.0,1.0,0.0,1.0
SF-G7,SF-C25,15,12,0,0,15,12,0.0,1.0,0.0,1.0
SF-G7,SF-B25,1,10,0,1,1,9,0.0,1.0,0.1,0.9
SF-G7,SF-E27,2,2,0,0,2,2,0.0,1.0,0.0,1.0
SF-G7,SF-D27,1,2,0,0,1,2,0.0,1.0,0.0,1.0
SF-G7,SF-J1,33,31,3,12,30,19,0.09090909090909091,0.9090909090909091,0.3870967741935484,0.6129032258064516
SF-G7,SF-H0,14,13,1,3,13,10,0.07142857142857142,0.9285714285714286,0.23076923076923078,0.7692307692307693
SF-G7,SF-J3,17,12,8,6,9,6,0.47058823529411764,0.5294117647058824,0.5,0.5
SF-G7,SF-J5,20,15,9,9,11,6,0.45,0.55,0.6,0.4
SF-G7,SF-G6,12,8,7,4,5,4,0.5833333333333334,0.4166666666666667,0.5,0.5
SF-G7,SF-G8,26,43,12,28,14,15,0.46153846153846156,0.5384615384615384,0.6511627906976745,0.3488372093023256
SF-G7,SF-G5,78,35,40,16,38,19,0.5128205128205128,0.48717948717948717,0.45714285714285713,0.5428571428571428
SF-G7,SF-F9,41,41,29,28,12,13,0.7073170731707317,0.2926829268292683,0.6829268292682927,0.3170731707317073
SF-G7,SF-K21,10,5,0,0,10,5,0.0,1.0,0.0,1.0
SF-G7,SF-K22-1,2,3,1,1,1,2,0.5,0.5,0.3333333333333333,0.6666666666666666
SF-G7,SF-J23-1,6,8,1,2,5,6,0.16666666666666666,0.8333333333333334,0.25,0.75
SF-G7,SF-J22-1,11,12,0,0,11,12,0.0,1.0,0.0,1.0
SF-G7,SF-J22-2,4,4,1,0,3,4,0.25,0.75,0.0,1.0
SF-G7,SF-J21,15,15,0,2,15,13,0.0,1.0,0.13333333333333333,0.8666666666666667
SF-G7,SF-I21,5,2,0,0,5,2,0.0,1.0,0.0,1.0
SF-G7,SF-I23-1,2,3,0,0,2,3,0.0,1.0,0.0,1.0
SF-G7,SF-M13,39,39,4,1,35,38,0.10256410256410256,0.8974358974358975,0.02564102564102564,0.9743589743589743
SF-G7,SF-M15,20,8,2,0,18,8,0.1,0.9,0.0,1.0
SF-G7,SF-L19,17,17,0,2,17,15,0.0,1.0,0.11764705882352941,0.8823529411764706
SF-G7,SF-L20,5,3,2,1,3,2,0.4,0.6,0.3333333333333333,0.6666666666666666
SF-G7,SF-N20-1,1,1,0,0,1,1,0.0,1.0,0.0,1.0
SF-G7,SF-M20,4,7,3,4,1,3,0.75,0.25,0.5714285714285714,0.42857142857142855
SF-G7,SF-K17-2,1,7,1,2,0,5,1.0,0.0,0.2857142857142857,0.7142857142857143
SF-G7,SF-K20,10,6,3,1,7,5,0.3,0.7,0.16666666666666666,0.8333333333333334
SF-G7,SF-K15-,60,32,9,17,51,15,0.15,0.85,0.53125,0.46875
SF-G7,SF-K19,11,14,3,4,8,10,0.2727272727272727,0.7272727272727273,0.2857142857142857,0.7142857142857143
SF-G7,SF-K18,21,14,7,3,14,11,0.3333333333333333,0.6666666666666666,0.21428571428571427,0.7857142857142857
SF-G7,SF-K17,21,10,10,2,11,8,0.47619047619047616,0.5238095238095238,0.2,0.8
SF-G7,SF-J16,28,15,7,0,21,15,0.25,0.75,0.0,1.0
SF-G7,SF-J18,15,17,5,4,10,13,0.3333333333333333,0.6666666666666666,0.23529411764705882,0.7647058823529411
SF-G7,SF-J20,8,2,1,0,7,2,0.125,0.875,0.0,1.0
SF-G7,SF-J19,10,3,2,1,8,2,0.2,0.8,0.3333333333333333,0.6666666666666666
SF-G7,SF-M12,10,13,1,3,9,10,0.1,0.9,0.23076923076923078,0.7692307692307693
SF-G7,SF-M10,12,9,9,3,3,6,0.75,0.25,0.3333333333333333,0.6666666666666666
SF-G7,SF-M11,16,15,4,4,12,11,0.25,0.75,0.26666666666666666,0.7333333333333333
SF-G7,SF-R19,7,5,2,4,5,1,0.2857142857142857,0.7142857142857143,0.8,0.2
SF-G7,SF-R20,2,1,0,0,2,1,0.0,1.0,0.0,1.0
SF-G7,SF-P21,4,3,0,0,4,3,0.0,1.0,0.0,1.0
SF-G7,SF-O18,2,1,0,0,2,1,0.0,1.0,0.0,1.0
SF-G7,SF-O19,2,3,0,1,2,2,0.0,1.0,0.3333333333333333,0.6666666666666666
SF-G7,SF-O21,6,7,2,1,4,6,0.3333333333333333,0.6666666666666666,0.14285714285714285,0.8571428571428571
SF-G7,SF-O22,3,6,0,1,3,5,0.0,1.0,0.16666666666666666,0.8333333333333334
SF-G7,SF-M21,9,7,0,4,9,3,0.0,1.0,0.5714285714285714,0.42857142857142855
SF-G7,SF-L21,2,2,0,1,2,1,0.0,1.0,0.5,0.5
SF-G7,SF-N28,3,4,0,0,3,4,0.0,1.0,0.0,1.0
SF-G7,SF-I30-2,1,4,0,0,1,4,0.0,1.0,0.0,1.0
SF-G7,SF-R24,3,4,0,0,3,4,0.0,1.0,0.0,1.0
SF-G7,SF-N22-1B,2,3,0,1,2,2,0.0,1.0,0.3333333333333333,0.6666666666666666
SF-G7,SF-T22,2,3,0,0,2,3,0.0,1.0,0.0,1.0
SF-G7,SF-S22-1,3,2,0,0,3,2,0.0,1.0,0.0,1.0
SF-G7,SF-Q23-3,1,2,0,0,1,2,0.0,1.0,0.0,1.0
SF-G7,SF-Q22-1,4,2,0,1,4,1,0.0,1.0,0.5,0.5
SF-G7,SF-Q22-2,1,2,0,2,1,0,0.0,1.0,1.0,0.0
SF-G7,SF-T20,2,1,0,0,2,1,0.0,1.0,0.0,1.0
SF-F9,SF-M24,1,1,0,0,1,1,0.0,1.0,0.0,1.0
SF-F9,SF-J25,1,1,0,0,1,1,0.0,1.0,0.0,1.0
SF-F9,SF-J24,4,1,0,0,4,1,0.0,1.0,0.0,1.0
SF-F9,SF-F28-2,1,1,0,1,1,0,0.0,1.0,1.0,0.0
SF-F9,SF-M22-2,2,1,0,0,2,1,0.0,1.0,0.0,1.0
SF-F9,SF-L22,1,1,0,0,1,1,0.0,1.0,0.0,1.0
SF-F9,SF-N22-2,1,3,0,0,1,3,0.0,1.0,0.0,1.0
SF-F9,SF-K22-2,2,2,2,1,0,1,1.0,0.0,0.5,0.5
SF-F9,SF-J23-2,3,7,1,7,2,0,0.3333333333333333,0.6666666666666666,1.0,0.0
SF-F9,SF-G23,7,1,0,0,7,1,0.0,1.0,0.0,1.0
SF-F9,SF-G24,3,4,1,0,2,4,0.3333333333333333,0.6666666666666666,0.0,1.0
SF-F9,SF-F23,6,3,0,0,6,3,0.0,1.0,0.0,1.0
SF-F9,SF-E23,9,7,3,2,6,5,0.3333333333333333,0.6666666666666666,0.2857142857142857,0.7142857142857143
SF-F9,SF-D24,2,2,0,0,2,2,0.0,1.0,0.0,1.0
SF-F9,SF-B22,5,5,3,1,2,4,0.6,0.4,0.2,0.8
SF-F9,SF-J17,8,3,0,1,8,2,0.0,1.0,0.3333333333333333,0.6666666666666666
SF-F9,SF-I19,3,2,1,0,2,2,0.3333333333333333,0.6666666666666666,0.0,1.0
SF-F9,SF-H16,9,4,4,1,5,3,0.4444444444444444,0.5555555555555556,0.25,0.75
SF-F9,SF-H20,6,4,0,0,6,4,0.0,1.0,0.0,1.0
SF-F9,SF-H18,1,2,0,0,1,2,0.0,1.0,0.0,1.0
SF-F9,SF-G19,6,1,1,1,5,0,0.16666666666666666,0.8333333333333334,1.0,0.0
SF-F9,SF-G17,4,1,0,0,4,1,0.0,1.0,0.0,1.0
SF-F9,SF-G18,10,4,2,2,8,2,0.2,0.8,0.5,0.5
SF-F9,SF-G20,4,1,2,1,2,0,0.5,0.5,1.0,0.0
SF-F9,SF-F19,14,14,2,7,12,7,0.14285714285714285,0.8571428571428571,0.5,0.5
SF-F9,SF-E18,17,21,6,3,11,18,0.35294117647058826,0.6470588235294118,0.14285714285714285,0.8571428571428571
SF-F9,SF-E20,52,44,4,1,48,43,0.07692307692307693,0.9230769230769231,0.022727272727272728,0.9772727272727273
SF-F9,SF-G30-2,1,1,0,0,1,1,0.0,1.0,0.0,1.0
SF-F9,SF-E29-2,1,2,0,1,1,1,0.0,1.0,0.5,0.5
SF-F9,SF-E29-1,3,2,3,0,0,2,1.0,0.0,0.0,1.0
SF-F9,SF-J10,26,8,16,2,10,6,0.6153846153846154,0.38461538461538464,0.25,0.75
SF-F9,SF-J12,46,43,8,9,38,34,0.17391304347826086,0.8260869565217391,0.20930232558139536,0.7906976744186046
SF-F9,SF-J13,14,16,13,14,1,2,0.9285714285714286,0.07142857142857142,0.875,0.125
SF-F9,SF-J15,5,33,0,0,5,33,0.0,1.0,0.0,1.0
SF-F9,SF-J14,3,2,0,0,3,2,0.0,1.0,0.0,1.0
SF-F9,SF-H13,4,5,4,2,0,3,1.0,0.0,0.4,0.6
SF-F9,SF-H12,11,16,1,8,10,8,0.09090909090909091,0.9090909090909091,0.5,0.5
SF-F9,SF-G10-2,16,18,8,13,8,5,0.5,0.5,0.7222222222222222,0.2777777777777778
SF-F9,SF-H15,4,1,0,1,4,0,0.0,1.0,1.0,0.0
SF-F9,SF-G9,25,44,11,30,14,14,0.44,0.56,0.6818181818181818,0.3181818181818182
SF-F9,SF-H14,3,3,2,3,1,0,0.6666666666666666,0.3333333333333333,1.0,0.0
SF-F9,SF-G13,13,14,9,9,4,5,0.6923076923076923,0.3076923076923077,0.6428571428571429,0.35714285714285715
SF-F9,SF-G11,8,18,3,15,5,3,0.375,0.625,0.8333333333333334,0.16666666666666666
SF-F9,SF-G12,34,39,18,22,16,17,0.5294117647058824,0.47058823529411764,0.5641025641025641,0.4358974358974359
SF-F9,SF-G10-1,8,20,5,12,3,8,0.625,0.375,0.6,0.4
SF-F9,SF-F15,27,15,15,5,12,10,0.5555555555555556,0.4444444444444444,0.3333333333333333,0.6666666666666666
SF-F9,SF-F16,14,8,7,4,7,4,0.5,0.5,0.5,0.5
SF-F9,SF-C20,5,8,0,5,5,3,0.0,1.0,0.625,0.375
SF-F9,SF-B21,3,4,2,3,1,1,0.6666666666666666,0.3333333333333333,0.75,0.25
SF-F9,SF-B19,10,18,4,11,6,7,0.4,0.6,0.6111111111111112,0.3888888888888889
SF-F9,SF-A20,23,10,9,6,14,4,0.391304347826087,0.6086956521739131,0.6,0.4
SF-F9,SF-A19,4,7,0,5,4,2,0.0,1.0,0.7142857142857143,0.2857142857142857
SF-F9,SF-C25,5,4,0,0,5,4,0.0,1.0,0.0,1.0
SF-F9,SF-B25,10,5,2,0,8,5,0.2,0.8,0.0,1.0
SF-F9,SF-E27,2,8,0,0,2,8,0.0,1.0,0.0,1.0
SF-F9,SF-J1,14,17,4,12,10,5,0.2857142857142857,0.7142857142857143,0.7058823529411765,0.29411764705882354
SF-F9,SF-H0,2,5,0,5,2,0,0.0,1.0,1.0,0.0
SF-F9,SF-J3,3,4,1,0,2,4,0.3333333333333333,0.6666666666666666,0.0,1.0
SF-F9,SF-J5,1,4,0,2,1,2,0.0,1.0,0.5,0.5
SF-F9,SF-G6,13,1,13,0,0,1,1.0,0.0,0.0,1.0
SF-F9,SF-G8,5,8,5,3,0,5,1.0,0.0,0.375,0.625
SF-F9,SF-G5,26,23,20,17,6,6,0.7692307692307693,0.23076923076923078,0.7391304347826086,0.2608695652173913
SF-F9,SF-G7,41,41,28,29,13,12,0.6829268292682927,0.3170731707317073,0.7073170731707317,0.2926829268292683
SF-F9,SF-K21,2,1,0,0,2,1,0.0,1.0,0.0,1.0
SF-F9,SF-J23-1,4,1,1,0,3,1,0.25,0.75,0.0,1.0
SF-F9,SF-J22-1,2,4,0,0,2,4,0.0,1.0,0.0,1.0
SF-F9,SF-J22-2,6,1,1,0,5,1,0.16666666666666666,0.8333333333333334,0.0,1.0
SF-F9,SF-J21,2,10,0,1,2,9,0.0,1.0,0.1,0.9
SF-F9,SF-I21,2,4,1,1,1,3,0.5,0.5,0.25,0.75
SF-F9,SF-I23-1,6,1,1,0,5,1,0.16666666666666666,0.8333333333333334,0.0,1.0
SF-F9,SF-F26,2,3,2,2,0,1,1.0,0.0,0.6666666666666666,0.3333333333333333
SF-F9,SF-M13,36,30,14,4,22,26,0.3888888888888889,0.6111111111111112,0.13333333333333333,0.8666666666666667
SF-F9,SF-M15,6,7,3,0,3,7,0.5,0.5,0.0,1.0
SF-F9,SF-L19,2,2,1,2,1,0,0.5,0.5,1.0,0.0
SF-F9,SF-M20,4,3,2,0,2,3,0.5,0.5,0.0,1.0
SF-F9,SF-K15-,41,17,18,2,23,15,0.43902439024390244,0.5609756097560976,0.11764705882352941,0.8823529411764706
SF-F9,SF-K19,6,6,3,3,3,3,0.5,0.5,0.5,0.5
SF-F9,SF-K18,10,7,5,0,5,7,0.5,0.5,0.0,1.0
SF-F9,SF-K17,7,2,4,1,3,1,0.5714285714285714,0.42857142857142855,0.5,0.5
SF-F9,SF-J16,10,4,0,0,10,4,0.0,1.0,0.0,1.0
SF-F9,SF-J18,5,6,3,5,2,1,0.6,0.4,0.8333333333333334,0.16666666666666666
SF-F9,SF-J20,3,1,0,1,3,0,0.0,1.0,1.0,0.0
SF-F9,SF-J19,2,2,0,0,2,2,0.0,1.0,0.0,1.0
SF-F9,SF-O12,2,3,2,0,0,3,1.0,0.0,0.0,1.0
SF-F9,SF-M12,15,7,6,1,9,6,0.4,0.6,0.14285714285714285,0.8571428571428571
SF-F9,SF-M10,6,9,2,6,4,3,0.3333333333333333,0.6666666666666666,0.6666666666666666,0.3333333333333333
SF-F9,SF-M11,11,8,3,3,8,5,0.2727272727272727,0.7272727272727273,0.375,0.625
SF-F9,SF-P21,1,1,0,0,1,1,0.0,1.0,0.0,1.0
SF-F9,SF-O18,5,7,0,0,5,7,0.0,1.0,0.0,1.0
SF-F9,SF-O21,5,4,0,2,5,2,0.0,1.0,0.5,0.5
SF-F9,SF-O22,3,3,0,0,3,3,0.0,1.0,0.0,1.0
SF-F9,SF-N20-2,1,1,1,1,0,0,1.0,0.0,1.0,0.0
SF-F9,SF-M21,6,2,0,0,6,2,0.0,1.0,0.0,1.0
SF-F9,SF-L21,4,3,1,1,3,2,0.25,0.75,0.3333333333333333,0.6666666666666666
SF-F9,SF-L30-1,3,12,0,0,3,12,0.0,1.0,0.0,1.0
SF-F9,SF-K30-2,2,1,2,0,0,1,1.0,0.0,0.0,1.0
SF-H25,SF-M26,1,1,1,0,0,1,1.0,0.0,0.0,1.0
SF-H25,SF-M25,5,2,1,1,4,1,0.2,0.8,0.5,0.5
SF-H25,SF-L27,1,1,0,0,1,1,0.0,1.0,0.0,1.0
SF-H25,SF-K26,4,9,2,3,2,6,0.5,0.5,0.3333333333333333,0.6666666666666666
SF-H25,SF-J27,4,31,0,21,4,10,0.0,1.0,0.6774193548387096,0.3225806451612903
SF-H25,SF-M30,2,5,2,3,0,2,1.0,0.0,0.6,0.4
SF-H25,SF-L27-2,5,4,0,1,5,3,0.0,1.0,0.25,0.75
SF-H25,SF-J29-3,2,3,0,2,2,1,0.0,1.0,0.6666666666666666,0.3333333333333333
SF-H25,SF-J29,16,13,0,3,16,10,0.0,1.0,0.23076923076923078,0.7692307692307693
SF-H25,SF-L26,1,1,0,0,1,1,0.0,1.0,0.0,1.0
SF-H25,SF-L25,2,2,0,1,2,1,0.0,1.0,0.5,0.5
SF-H25,SF-M24,19,4,4,3,15,1,0.21052631578947367,0.7894736842105263,0.75,0.25
SF-H25,SF-L24,6,1,4,0,2,1,0.6666666666666666,0.3333333333333333,0.0,1.0
SF-H25,SF-N23,2,3,0,2,2,1,0.0,1.0,0.6666666666666666,0.3333333333333333
SF-H25,SF-N24-2,3,2,0,2,3,0,0.0,1.0,1.0,0.0
SF-H25,SF-K27-2,5,1,2,1,3,0,0.4,0.6,1.0,0.0
SF-H25,SF-J26-2,14,5,3,1,11,4,0.21428571428571427,0.7857142857142857,0.2,0.8
SF-H25,SF-L28,1,3,0,0,1,3,0.0,1.0,0.0,1.0
SF-H25,SF-K28,2,1,1,1,1,0,0.5,0.5,1.0,0.0
SF-H25,SF-K29-1,7,2,1,1,6,1,0.14285714285714285,0.8571428571428571,0.5,0.5
SF-H25,SF-K27,6,3,3,1,3,2,0.5,0.5,0.3333333333333333,0.6666666666666666
SF-H25,SF-K25,5,2,4,0,1,2,0.8,0.2,0.0,1.0
SF-H25,SF-J25,3,12,2,3,1,9,0.6666666666666666,0.3333333333333333,0.25,0.75
SF-H25,SF-H26-2,13,8,10,5,3,3,0.7692307692307693,0.23076923076923078,0.625,0.375
SF-H25,SF-P24,33,34,32,33,1,1,0.9696969696969697,0.030303030303030304,0.9705882352941176,0.029411764705882353
SF-H25,SF-N22-1A,3,1,0,1,3,0,0.0,1.0,1.0,0.0
SF-H25,SF-J24,8,12,1,0,7,12,0.125,0.875,0.0,1.0
SF-H25,SF-O24,1,4,0,0,1,4,0.0,1.0,0.0,1.0
SF-H25,SF-J26,6,5,1,0,5,5,0.16666666666666666,0.8333333333333334,0.0,1.0
SF-H25,SF-I26-,14,7,7,4,7,3,0.5,0.5,0.5714285714285714,0.42857142857142855
SF-H25,SF-I25,14,17,6,7,8,10,0.42857142857142855,0.5714285714285714,0.4117647058823529,0.5882352941176471
SF-H25,SF-K23,2,2,2,2,0,0,1.0,0.0,1.0,0.0
SF-H25,SF-H26,34,18,21,13,13,5,0.6176470588235294,0.38235294117647056,0.7222222222222222,0.2777777777777778
SF-H25,SF-O23,4,4,3,3,1,1,0.75,0.25,0.75,0.25
SF-H25,SF-H27-1,37,7,15,1,22,6,0.40540540540540543,0.5945945945945946,0.14285714285714285,0.8571428571428571
SF-H25,SF-F28-2,16,8,7,1,9,7,0.4375,0.5625,0.125,0.875
SF-H25,SF-G27,51,60,30,45,21,15,0.5882352941176471,0.4117647058823529,0.75,0.25
SF-H25,SF-M22-2,188,244,171,222,17,22,0.9095744680851063,0.09042553191489362,0.9098360655737705,0.09016393442622951
SF-H25,SF-L22,12,4,9,1,3,3,0.75,0.25,0.25,0.75
SF-H25,SF-F27,31,11,23,6,8,5,0.7419354838709677,0.25806451612903225,0.5454545454545454,0.45454545454545453
SF-H25,SF-N22-2,14,10,4,5,10,5,0.2857142857142857,0.7142857142857143,0.5,0.5
SF-H25,SF-G28-2,1,1,1,1,0,0,1.0,0.0,1.0,0.0
SF-H25,SF-M22-1,14,3,0,0,14,3,0.0,1.0,0.0,1.0
SF-H25,SF-K22-2,11,3,9,0,2,3,0.8181818181818182,0.18181818181818182,0.0,1.0
SF-H25,SF-K24,3,5,2,5,1,0,0.6666666666666666,0.3333333333333333,1.0,0.0
SF-H25,SF-J23-2,11,8,10,7,1,1,0.9090909090909091,0.09090909090909091,0.875,0.125
SF-H25,SF-G23,14,17,9,8,5,9,0.6428571428571429,0.35714285714285715,0.47058823529411764,0.5294117647058824
SF-H25,SF-G24,24,10,11,1,13,9,0.4583333333333333,0.5416666666666666,0.1,0.9
SF-H25,SF-G25,14,8,10,0,4,8,0.7142857142857143,0.2857142857142857,0.0,1.0
SF-H25,SF-F23,6,5,1,1,5,4,0.16666666666666666,0.8333333333333334,0.2,0.8
SF-H25,SF-E23,9,3,2,1,7,2,0.2222222222222222,0.7777777777777778,0.3333333333333333,0.6666666666666666
SF-H25,SF-D24,4,1,3,0,1,1,0.75,0.25,0.0,1.0
SF-H25,SF-J17,2,4,0,0,2,4,0.0,1.0,0.0,1.0
SF-H25,SF-I19,6,2,5,1,1,1,0.8333333333333334,0.16666666666666666,0.5,0.5
SF-H25,SF-I20,8,2,3,1,5,1,0.375,0.625,0.5,0.5
SF-H25,SF-H20,12,11,5,5,7,6,0.4166666666666667,0.5833333333333334,0.45454545454545453,0.5454545454545454
SF-H25,SF-H17,1,2,0,1,1,1,0.0,1.0,0.5,0.5
SF-H25,SF-G19,1,1,1,1,0,0,1.0,0.0,1.0,0.0
SF-H25,SF-G18,7,1,7,0,0,1,1.0,0.0,0.0,1.0
SF-H25,SF-G20,8,3,3,2,5,1,0.375,0.625,0.6666666666666666,0.3333333333333333
SF-H25,SF-E18,1,1,1,0,0,1,1.0,0.0,0.0,1.0
SF-H25,SF-H30,1,4,0,1,1,3,0.0,1.0,0.25,0.75
SF-H25,SF-G30-2,2,3,1,0,1,3,0.5,0.5,0.0,1.0
SF-H25,SF-F30-1,2,1,1,1,1,0,0.5,0.5,1.0,0.0
SF-H25,SF-E29-2,11,14,6,11,5,3,0.5454545454545454,0.45454545454545453,0.7857142857142857,0.21428571428571427
SF-H25,SF-E29-1,9,13,6,5,3,8,0.6666666666666666,0.3333333333333333,0.38461538461538464,0.6153846153846154
SF-H25,SF-D29,2,4,1,2,1,2,0.5,0.5,0.5,0.5
SF-H25,SF-D28,4,5,1,4,3,1,0.25,0.75,0.8,0.2
SF-H25,SF-A27,6,2,6,0,0,2,1.0,0.0,0.0,1.0
SF-H25,SF-G29-2,2,6,0,0,2,6,0.0,1.0,0.0,1.0
SF-H25,SF-G29-1,5,2,0,1,5,1,0.0,1.0,0.5,0.5
SF-H25,SF-G30-1,40,54,17,47,23,7,0.425,0.575,0.8703703703703703,0.12962962962962962
SF-H25,SF-F30-2,1,1,1,1,0,0,1.0,0.0,1.0,0.0
SF-H25,SF-E29-3,4,1,3,1,1,0,0.75,0.25,1.0,0.0
SF-H25,SF-F28-1,4,19,0,1,4,18,0.0,1.0,0.05263157894736842,0.9473684210526315
SF-H25,SF-E28-2,1,4,0,1,1,3,0.0,1.0,0.25,0.75
SF-H25,SF-E28,2,1,1,1,1,0,0.5,0.5,1.0,0.0
SF-H25,SF-J13,1,4,1,0,0,4,1.0,0.0,0.0,1.0
SF-H25,SF-A20,3,1,0,0,3,1,0.0,1.0,0.0,1.0
SF-H25,SF-C26,9,5,2,0,7,5,0.2222222222222222,0.7777777777777778,0.0,1.0
SF-H25,SF-C25,2,5,0,2,2,3,0.0,1.0,0.4,0.6
SF-H25,SF-B25,3,5,0,3,3,2,0.0,1.0,0.6,0.4
SF-H25,SF-E27,3,2,2,0,1,2,0.6666666666666666,0.3333333333333333,0.0,1.0
SF-H25,SF-D27,8,9,3,3,5,6,0.375,0.625,0.3333333333333333,0.6666666666666666
SF-H25,SF-C28-2,9,6,0,1,9,5,0.0,1.0,0.16666666666666666,0.8333333333333334
SF-H25,SF-B28,24,26,20,17,4,9,0.8333333333333334,0.16666666666666666,0.6538461538461539,0.34615384615384615
SF-H25,SF-G26,12,7,6,4,6,3,0.5,0.5,0.5714285714285714,0.42857142857142855
SF-H25,SF-K22-1,6,11,1,8,5,3,0.16666666666666666,0.8333333333333334,0.7272727272727273,0.2727272727272727
SF-H25,SF-J23-1,111,75,98,69,13,6,0.8828828828828829,0.11711711711711711,0.92,0.08
SF-H25,SF-J22-2,7,1,1,0,6,1,0.14285714285714285,0.8571428571428571,0.0,1.0
SF-H25,SF-J21,10,6,3,3,7,3,0.3,0.7,0.5,0.5
SF-H25,SF-I21,33,27,30,27,3,0,0.9090909090909091,0.09090909090909091,1.0,0.0
SF-H25,SF-I22,7,11,6,7,1,4,0.8571428571428571,0.14285714285714285,0.6363636363636364,0.36363636363636365
SF-H25,SF-I23-2,9,13,7,11,2,2,0.7777777777777778,0.2222222222222222,0.8461538461538461,0.15384615384615385
SF-H25,SF-I24,9,12,7,9,2,3,0.7777777777777778,0.2222222222222222,0.75,0.25
SF-H25,SF-I23-1,12,11,7,5,5,6,0.5833333333333334,0.4166666666666667,0.45454545454545453,0.5454545454545454
SF-H25,SF-F26,5,10,1,2,4,8,0.2,0.8,0.2,0.8
SF-H25,SF-L20,6,3,1,0,5,3,0.16666666666666666,0.8333333333333334,0.0,1.0
SF-H25,SF-M20,6,4,1,0,5,4,0.16666666666666666,0.8333333333333334,0.0,1.0
SF-H25,SF-K17-2,4,1,4,0,0,1,1.0,0.0,0.0,1.0
SF-H25,SF-K20,1,2,0,0,1,2,0.0,1.0,0.0,1.0
SF-H25,SF-K15-,15,6,4,3,11,3,0.26666666666666666,0.7333333333333333,0.5,0.5
SF-H25,SF-K19,1,4,0,2,1,2,0.0,1.0,0.5,0.5
SF-H25,SF-K18,12,3,6,2,6,1,0.5,0.5,0.6666666666666666,0.3333333333333333
SF-H25,SF-K17,4,6,4,3,0,3,1.0,0.0,0.5,0.5
SF-H25,SF-J20,4,7,4,4,0,3,1.0,0.0,0.5714285714285714,0.42857142857142855
SF-H25,SF-J19,5,6,4,1,1,5,0.8,0.2,0.16666666666666666,0.8333333333333334
SF-H25,SF-M12,1,3,0,1,1,2,0.0,1.0,0.3333333333333333,0.6666666666666666
SF-H25,SF-M10,2,1,0,0,2,1,0.0,1.0,0.0,1.0
SF-H25,SF-P21,3,2,0,0,3,2,0.0,1.0,0.0,1.0
SF-H25,SF-O19,2,1,1,0,1,1,0.5,0.5,0.0,1.0
SF-H25,SF-O21,7,12,2,2,5,10,0.2857142857142857,0.7142857142857143,0.16666666666666666,0.8333333333333334
SF-H25,SF-O22,14,29,5,19,9,10,0.35714285714285715,0.6428571428571429,0.6551724137931034,0.3448275862068966
SF-H25,SF-N20-2,2,4,1,1,1,3,0.5,0.5,0.25,0.75
SF-H25,SF-L21,79,18,19,3,60,15,0.24050632911392406,0.759493670886076,0.16666666666666666,0.8333333333333334
SF-H25,SF-S29,1,1,1,0,0,1,1.0,0.0,0.0,1.0
SF-H25,SF-S30,1,1,0,0,1,1,0.0,1.0,0.0,1.0
SF-H25,SF-Q30,1,4,0,2,1,2,0.0,1.0,0.5,0.5
SF-H25,SF-P30,2,6,0,0,2,6,0.0,1.0,0.0,1.0
SF-H25,SF-O30,5,2,1,1,4,1,0.2,0.8,0.5,0.5
SF-H25,SF-N27,4,4,0,2,4,2,0.0,1.0,0.5,0.5
SF-H25,SF-L30-1,2,3,0,1,2,2,0.0,1.0,0.3333333333333333,0.6666666666666666
SF-H25,SF-J29-1,3,6,1,2,2,4,0.3333333333333333,0.6666666666666666,0.3333333333333333,0.6666666666666666
SF-H25,SF-I30,1,15,1,13,0,2,1.0,0.0,0.8666666666666667,0.13333333333333333
SF-H25,SF-I27,7,3,4,2,3,1,0.5714285714285714,0.42857142857142855,0.6666666666666666,0.3333333333333333
SF-H25,SF-I28,3,11,3,10,0,1,1.0,0.0,0.9090909090909091,0.09090909090909091
SF-H25,SF-I30-2,2,5,0,1,2,4,0.0,1.0,0.2,0.8
SF-H25,SF I29-1,2,2,1,0,1,2,0.5,0.5,0.0,1.0
SF-H25,SF-H28,24,14,4,2,20,12,0.16666666666666666,0.8333333333333334,0.14285714285714285,0.8571428571428571
SF-H25,SF-P26,6,10,6,9,0,1,1.0,0.0,0.9,0.1
SF-H25,SF-N22-1B,5,4,3,3,2,1,0.6,0.4,0.75,0.25
SF-H25,SF-T21,3,2,0,0,3,2,0.0,1.0,0.0,1.0
SF-H25,SF-T22,5,4,0,0,5,4,0.0,1.0,0.0,1.0
SF-H25,SF-S22-2,11,5,0,0,11,5,0.0,1.0,0.0,1.0
SF-H25,SF-Q23-3,5,13,0,1,5,12,0.0,1.0,0.07692307692307693,0.9230769230769231
SF-H25,SF-Q22-1,6,13,2,5,4,8,0.3333333333333333,0.6666666666666666,0.38461538461538464,0.6153846153846154
SF-H25,SF-Q22-2,4,4,1,1,3,3,0.25,0.75,0.25,0.75
SF-H25,SF-P22,20,11,2,2,18,9,0.1,0.9,0.18181818181818182,0.8181818181818182
SF-H25,SF-T20,14,3,0,0,14,3,0.0,1.0,0.0,1.0
SF-H25,SF-V28,8,3,0,0,8,3,0.0,1.0,0.0,1.0
SF-G26,SF-M26-2,3,2,1,1,2,1,0.3333333333333333,0.6666666666666666,0.5,0.5
SF-G26,SF-K26,5,7,1,2,4,5,0.2,0.8,0.2857142857142857,0.7142857142857143
SF-G26,SF-J27,13,10,4,3,9,7,0.3076923076923077,0.6923076923076923,0.3,0.7
SF-G26,SF-M30,9,3,3,2,6,1,0.3333333333333333,0.6666666666666666,0.6666666666666666,0.3333333333333333
SF-G26,SF-L27-2,6,5,1,3,5,2,0.16666666666666666,0.8333333333333334,0.6,0.4
SF-G26,SF-J29-3,18,13,9,8,9,5,0.5,0.5,0.6153846153846154,0.38461538461538464
SF-G26,SF-J29,70,27,19,10,51,17,0.2714285714285714,0.7285714285714285,0.37037037037037035,0.6296296296296297
SF-G26,SF-L26,12,2,11,0,1,2,0.9166666666666666,0.08333333333333333,0.0,1.0
SF-G26,SF-M28,9,2,7,0,2,2,0.7777777777777778,0.2222222222222222,0.0,1.0
SF-G26,SF-L25,5,2,2,1,3,1,0.4,0.6,0.5,0.5
SF-G26,SF-M24,5,4,4,2,1,2,0.8,0.2,0.5,0.5
SF-G26,SF-L24,4,8,2,2,2,6,0.5,0.5,0.25,0.75
SF-G26,SF-N23,5,4,1,2,4,2,0.2,0.8,0.5,0.5
SF-G26,SF-N24-2,1,2,0,1,1,1,0.0,1.0,0.5,0.5
SF-G26,SF-K27-2,9,8,7,2,2,6,0.7777777777777778,0.2222222222222222,0.25,0.75
SF-G26,SF-J26-2,21,13,7,4,14,9,0.3333333333333333,0.6666666666666666,0.3076923076923077,0.6923076923076923
SF-G26,SF-K28,5,7,3,4,2,3,0.6,0.4,0.5714285714285714,0.42857142857142855
SF-G26,SF-K29-1,69,42,60,34,9,8,0.8695652173913043,0.13043478260869565,0.8095238095238095,0.19047619047619047
SF-G26,SF-J28-2,25,6,7,2,18,4,0.28,0.72,0.3333333333333333,0.6666666666666666
SF-G26,SF-K27,4,4,2,0,2,4,0.5,0.5,0.0,1.0
SF-G26,SF-K25,16,13,7,9,9,4,0.4375,0.5625,0.6923076923076923,0.3076923076923077
SF-G26,SF-J25,39,21,16,7,23,14,0.41025641025641024,0.5897435897435898,0.3333333333333333,0.6666666666666666
SF-G26,SF-H26-2,19,13,14,5,5,8,0.7368421052631579,0.2631578947368421,0.38461538461538464,0.6153846153846154
SF-G26,SF-P24,6,7,1,2,5,5,0.16666666666666666,0.8333333333333334,0.2857142857142857,0.7142857142857143
SF-G26,SF-J24,26,21,15,6,11,15,0.5769230769230769,0.4230769230769231,0.2857142857142857,0.7142857142857143
SF-G26,SF-O24,3,2,3,0,0,2,1.0,0.0,0.0,1.0
SF-G26,SF-J26,10,4,3,1,7,3,0.3,0.7,0.25,0.75
SF-G26,SF-I26-,14,20,4,17,10,3,0.2857142857142857,0.7142857142857143,0.85,0.15
SF-G26,SF-I25,25,33,12,25,13,8,0.48,0.52,0.7575757575757576,0.24242424242424243
SF-G26,SF-K23,3,1,3,1,0,0,1.0,0.0,1.0,0.0
SF-G26,SF-H26,44,57,33,37,11,20,0.75,0.25,0.6491228070175439,0.3508771929824561
SF-G26,SF-O23,6,7,2,3,4,4,0.3333333333333333,0.6666666666666666,0.42857142857142855,0.5714285714285714
SF-G26,SF-H27-1,7,9,4,1,3,8,0.5714285714285714,0.42857142857142855,0.1111111111111111,0.8888888888888888
SF-G26,SF-F28-2,21,30,13,25,8,5,0.6190476190476191,0.38095238095238093,0.8333333333333334,0.16666666666666666
SF-G26,SF-G27,69,44,49,27,20,17,0.7101449275362319,0.2898550724637681,0.6136363636363636,0.38636363636363635
SF-G26,SF-M22-2,12,20,6,7,6,13,0.5,0.5,0.35,0.65
SF-G26,SF-L22,18,13,5,3,13,10,0.2777777777777778,0.7222222222222222,0.23076923076923078,0.7692307692307693
SF-G26,SF-F27,47,27,27,19,20,8,0.574468085106383,0.425531914893617,0.7037037037037037,0.2962962962962963
SF-G26,SF-N22-2,6,19,4,5,2,14,0.6666666666666666,0.3333333333333333,0.2631578947368421,0.7368421052631579
SF-G26,SF-G28-2,2,3,2,0,0,3,1.0,0.0,0.0,1.0
SF-G26,SF-G28-1,6,3,5,2,1,1,0.8333333333333334,0.16666666666666666,0.6666666666666666,0.3333333333333333
SF-G26,SF-M22-1,5,5,3,2,2,3,0.6,0.4,0.4,0.6
SF-G26,SF-O25-1,1,1,1,1,0,0,1.0,0.0,1.0,0.0
SF-G26,SF-K22-2,10,5,3,0,7,5,0.3,0.7,0.0,1.0
SF-G26,SF-K24,7,6,5,3,2,3,0.7142857142857143,0.2857142857142857,0.5,0.5
SF-G26,SF-J23-2,12,12,4,5,8,7,0.3333333333333333,0.6666666666666666,0.4166666666666667,0.5833333333333334
SF-G26,SF-G23,19,7,8,4,11,3,0.42105263157894735,0.5789473684210527,0.5714285714285714,0.42857142857142855
SF-G26,SF-G24,43,44,23,7,20,37,0.5348837209302325,0.46511627906976744,0.1590909090909091,0.8409090909090909
SF-G26,SF-G25,21,25,14,10,7,15,0.6666666666666666,0.3333333333333333,0.4,0.6
SF-G26,SF-F23,18,18,8,5,10,13,0.4444444444444444,0.5555555555555556,0.2777777777777778,0.7222222222222222
SF-G26,SF-E23,23,18,5,3,18,15,0.21739130434782608,0.782608695652174,0.16666666666666666,0.8333333333333334
SF-G26,SF-D24,6,6,4,0,2,6,0.6666666666666666,0.3333333333333333,0.0,1.0
SF-G26,SF-C22,6,11,0,1,6,10,0.0,1.0,0.09090909090909091,0.9090909090909091
SF-G26,SF-B22,9,32,3,17,6,15,0.3333333333333333,0.6666666666666666,0.53125,0.46875
SF-G26,SF-J17,16,13,7,2,9,11,0.4375,0.5625,0.15384615384615385,0.8461538461538461
SF-G26,SF-I19,18,13,7,3,11,10,0.3888888888888889,0.6111111111111112,0.23076923076923078,0.7692307692307693
SF-G26,SF-I20,2,12,0,6,2,6,0.0,1.0,0.5,0.5
SF-G26,SF-H16,3,4,1,0,2,4,0.3333333333333333,0.6666666666666666,0.0,1.0
SF-G26,SF-H20,5,29,3,4,2,25,0.6,0.4,0.13793103448275862,0.8620689655172413
SF-G26,SF-H18,1,3,0,0,1,3,0.0,1.0,0.0,1.0
SF-G26,SF-G19,6,4,2,1,4,3,0.3333333333333333,0.6666666666666666,0.25,0.75
SF-G26,SF-G17,1,3,1,0,0,3,1.0,0.0,0.0,1.0
SF-G26,SF-G18,5,1,2,0,3,1,0.4,0.6,0.0,1.0
SF-G26,SF-G20,7,12,3,0,4,12,0.42857142857142855,0.5714285714285714,0.0,1.0
SF-G26,SF-F19,2,3,1,0,1,3,0.5,0.5,0.0,1.0
SF-G26,SF-E18,6,4,3,0,3,4,0.5,0.5,0.0,1.0
SF-G26,SF-E20,2,2,0,0,2,2,0.0,1.0,0.0,1.0
SF-G26,SF-H30,14,12,4,4,10,8,0.2857142857142857,0.7142857142857143,0.3333333333333333,0.6666666666666666
SF-G26,SF-G30-2,38,17,8,2,30,15,0.21052631578947367,0.7894736842105263,0.11764705882352941,0.8823529411764706
SF-G26,SF-F30-1,5,4,4,4,1,0,0.8,0.2,1.0,0.0
SF-G26,SF-E29-2,28,28,12,20,16,8,0.42857142857142855,0.5714285714285714,0.7142857142857143,0.2857142857142857
SF-G26,SF-E29-1,20,12,12,11,8,1,0.6,0.4,0.9166666666666666,0.08333333333333333
SF-G26,SF-D29,6,10,4,8,2,2,0.6666666666666666,0.3333333333333333,0.8,0.2
SF-G26,SF-D28,29,27,15,18,14,9,0.5172413793103449,0.4827586206896552,0.6666666666666666,0.3333333333333333
SF-G26,SF-A27,22,13,20,8,2,5,0.9090909090909091,0.09090909090909091,0.6153846153846154,0.38461538461538464
SF-G26,SF-G29-2,24,20,14,12,10,8,0.5833333333333334,0.4166666666666667,0.6,0.4
SF-G26,SF-G29-1,11,8,6,4,5,4,0.5454545454545454,0.45454545454545453,0.5,0.5
SF-G26,SF-G30-1,18,17,6,6,12,11,0.3333333333333333,0.6666666666666666,0.35294117647058826,0.6470588235294118
SF-G26,SF-G29-3,19,12,17,8,2,4,0.8947368421052632,0.10526315789473684,0.6666666666666666,0.3333333333333333
SF-G26,SF-F30-2,20,18,12,16,8,2,0.6,0.4,0.8888888888888888,0.1111111111111111
SF-G26,SF-F29,2,8,0,5,2,3,0.0,1.0,0.625,0.375
SF-G26,SF-E29-3,8,3,1,0,7,3,0.125,0.875,0.0,1.0
SF-G26,SF-F28-1,18,5,14,4,4,1,0.7777777777777778,0.2222222222222222,0.8,0.2
SF-G26,SF-E28-2,5,3,1,1,4,2,0.2,0.8,0.3333333333333333,0.6666666666666666
SF-G26,SF-E28,5,6,4,4,1,2,0.8,0.2,0.6666666666666666,0.3333333333333333
SF-G26,SF-J12,2,4,0,0,2,4,0.0,1.0,0.0,1.0
SF-G26,SF-J13,2,1,2,0,0,1,1.0,0.0,0.0,1.0
SF-G26,SF-H12,3,1,2,0,1,1,0.6666666666666666,0.3333333333333333,0.0,1.0
SF-G26,SF-H15,3,1,1,0,2,1,0.3333333333333333,0.6666666666666666,0.0,1.0
SF-G26,SF-G13,2,4,0,1,2,3,0.0,1.0,0.25,0.75
SF-G26,SF-G11,3,1,0,0,3,1,0.0,1.0,0.0,1.0
SF-G26,SF-F16,2,2,0,0,2,2,0.0,1.0,0.0,1.0
SF-G26,SF-C20,4,3,0,1,4,2,0.0,1.0,0.3333333333333333,0.6666666666666666
SF-G26,SF-B19,12,7,0,0,12,7,0.0,1.0,0.0,1.0
SF-G26,SF-A20,6,10,1,4,5,6,0.16666666666666666,0.8333333333333334,0.4,0.6
SF-G26,SF-C26,42,25,20,6,22,19,0.47619047619047616,0.5238095238095238,0.24,0.76
SF-G26,SF-C25,18,23,4,9,14,14,0.2222222222222222,0.7777777777777778,0.391304347826087,0.6086956521739131
SF-G26,SF-B25,7,17,3,6,4,11,0.42857142857142855,0.5714285714285714,0.35294117647058826,0.6470588235294118
SF-G26,SF-E27,6,4,2,3,4,1,0.3333333333333333,0.6666666666666666,0.75,0.25
SF-G26,SF-B28-2,2,1,1,1,1,0,0.5,0.5,1.0,0.0
SF-G26,SF-D27,10,24,8,13,2,11,0.8,0.2,0.5416666666666666,0.4583333333333333
SF-G26,SF-C28-2,3,1,1,0,2,1,0.3333333333333333,0.6666666666666666,0.0,1.0
SF-G26,SF-B28,4,11,4,8,0,3,1.0,0.0,0.7272727272727273,0.2727272727272727
SF-G26,SF-H0,1,3,0,2,1,1,0.0,1.0,0.6666666666666666,0.3333333333333333
SF-G26,SF-H25,7,12,4,6,3,6,0.5714285714285714,0.42857142857142855,0.5,0.5
SF-G26,SF-K21,70,49,43,5,27,44,0.6142857142857143,0.38571428571428573,0.10204081632653061,0.8979591836734694
SF-G26,SF-K22-1,18,15,15,5,3,10,0.8333333333333334,0.16666666666666666,0.3333333333333333,0.6666666666666666
SF-G26,SF-J23-1,67,69,37,36,30,33,0.5522388059701493,0.44776119402985076,0.5217391304347826,0.4782608695652174
SF-G26,SF-J22-1,13,8,5,2,8,6,0.38461538461538464,0.6153846153846154,0.25,0.75
SF-G26,SF-J22-2,24,24,5,6,19,18,0.20833333333333334,0.7916666666666666,0.25,0.75
SF-G26,SF-J21,19,11,9,4,10,7,0.47368421052631576,0.5263157894736842,0.36363636363636365,0.6363636363636364
SF-G26,SF-I21,8,7,2,1,6,6,0.25,0.75,0.14285714285714285,0.8571428571428571
SF-G26,SF-I22,12,12,3,2,9,10,0.25,0.75,0.16666666666666666,0.8333333333333334
SF-G26,SF-I23-2,13,10,6,4,7,6,0.46153846153846156,0.5384615384615384,0.4,0.6
SF-G26,SF-I24,5,6,3,2,2,4,0.6,0.4,0.3333333333333333,0.6666666666666666
SF-G26,SF-I23-1,9,13,5,9,4,4,0.5555555555555556,0.4444444444444444,0.6923076923076923,0.3076923076923077
SF-G26,SF-F26,59,61,26,25,33,36,0.4406779661016949,0.559322033898305,0.4098360655737705,0.5901639344262295
SF-G26,SF-M13,2,11,0,4,2,7,0.0,1.0,0.36363636363636365,0.6363636363636364
SF-G26,SF-M15,8,11,2,2,6,9,0.25,0.75,0.18181818181818182,0.8181818181818182
SF-G26,SF-L19,5,17,2,0,3,17,0.4,0.6,0.0,1.0
SF-G26,SF-L20,9,5,1,1,8,4,0.1111111111111111,0.8888888888888888,0.2,0.8
SF-G26,SF-N20-1,6,8,1,4,5,4,0.16666666666666666,0.8333333333333334,0.5,0.5
SF-G26,SF-M20,29,24,10,5,19,19,0.3448275862068966,0.6551724137931034,0.20833333333333334,0.7916666666666666
SF-G26,SF-K17-2,2,6,2,1,0,5,1.0,0.0,0.16666666666666666,0.8333333333333334
SF-G26,SF-K20,9,10,5,2,4,8,0.5555555555555556,0.4444444444444444,0.2,0.8
SF-G26,SF-K15-,5,14,0,0,5,14,0.0,1.0,0.0,1.0
SF-G26,SF-K19,5,9,4,1,1,8,0.8,0.2,0.1111111111111111,0.8888888888888888
SF-G26,SF-K18,8,7,3,0,5,7,0.375,0.625,0.0,1.0
SF-G26,SF-K17,10,3,3,2,7,1,0.3,0.7,0.6666666666666666,0.3333333333333333
SF-G26,SF-J16,6,10,0,0,6,10,0.0,1.0,0.0,1.0
SF-G26,SF-J18,13,9,5,1,8,8,0.38461538461538464,0.6153846153846154,0.1111111111111111,0.8888888888888888
SF-G26,SF-J20,12,11,8,8,4,3,0.6666666666666666,0.3333333333333333,0.7272727272727273,0.2727272727272727
SF-G26,SF-J19,16,23,8,6,8,17,0.5,0.5,0.2608695652173913,0.7391304347826086
SF-G26,SF-M12,5,2,2,2,3,0,0.4,0.6,1.0,0.0
SF-G26,SF-M10,76,4,0,0,76,4,0.0,1.0,0.0,1.0
SF-G26,SF-M11,11,6,0,0,11,6,0.0,1.0,0.0,1.0
SF-G26,SF-R19,1,17,0,13,1,4,0.0,1.0,0.7647058823529411,0.23529411764705882
SF-G26,SF-R20,55,28,1,7,54,21,0.01818181818181818,0.9818181818181818,0.25,0.75
SF-G26,SF-Q21-2,17,8,4,1,13,7,0.23529411764705882,0.7647058823529411,0.125,0.875
SF-G26,SF-Q21-1,21,11,4,4,17,7,0.19047619047619047,0.8095238095238095,0.36363636363636365,0.6363636363636364
SF-G26,SF-P21,14,5,2,0,12,5,0.14285714285714285,0.8571428571428571,0.0,1.0
SF-G26,SF-O18,5,6,2,3,3,3,0.4,0.6,0.5,0.5
SF-G26,SF-O19,19,10,11,0,8,10,0.5789473684210527,0.42105263157894735,0.0,1.0
SF-G26,SF-O21,15,21,7,10,8,11,0.4666666666666667,0.5333333333333333,0.47619047619047616,0.5238095238095238
SF-G26,SF-O22,14,25,3,8,11,17,0.21428571428571427,0.7857142857142857,0.32,0.68
SF-G26,SF-N21,6,7,0,5,6,2,0.0,1.0,0.7142857142857143,0.2857142857142857
SF-G26,SF-M21,6,14,1,5,5,9,0.16666666666666666,0.8333333333333334,0.35714285714285715,0.6428571428571429
SF-G26,SF-L21,126,34,34,4,92,30,0.2698412698412698,0.7301587301587301,0.11764705882352941,0.8823529411764706
SF-G26,SF-Q30,8,10,6,1,2,9,0.75,0.25,0.1,0.9
SF-G26,SF-P30,5,4,0,1,5,3,0.0,1.0,0.25,0.75
SF-G26,SF-O30-2,3,4,3,2,0,2,1.0,0.0,0.5,0.5
SF-G26,SF-O30,27,9,6,2,21,7,0.2222222222222222,0.7777777777777778,0.2222222222222222,0.7777777777777778
SF-G26,SF-N27,35,6,8,4,27,2,0.22857142857142856,0.7714285714285715,0.6666666666666666,0.3333333333333333
SF-G26,SF-N29,8,3,3,0,5,3,0.375,0.625,0.0,1.0
SF-G26,SF-N28,8,5,4,2,4,3,0.5,0.5,0.4,0.6
SF-G26,SF-L30-1,68,85,35,55,33,30,0.5147058823529411,0.4852941176470588,0.6470588235294118,0.35294117647058826
SF-G26,SF-L31-1,6,3,0,2,6,1,0.0,1.0,0.6666666666666666,0.3333333333333333
SF-G26,SF-K30-2,2,4,1,1,1,3,0.5,0.5,0.25,0.75
SF-G26,SF-L29,40,41,20,25,20,16,0.5,0.5,0.6097560975609756,0.3902439024390244
SF-G26,SF-J29-1,17,11,5,3,12,8,0.29411764705882354,0.7058823529411765,0.2727272727272727,0.7272727272727273
SF-G26,SF-I30,11,14,8,7,3,7,0.7272727272727273,0.2727272727272727,0.5,0.5
SF-G26,SF-I29-2,1,1,0,1,1,0,0.0,1.0,1.0,0.0
SF-G26,SF-I27,64,29,30,14,34,15,0.46875,0.53125,0.4827586206896552,0.5172413793103449
SF-G26,SF-I28,10,11,5,6,5,5,0.5,0.5,0.5454545454545454,0.45454545454545453
SF-G26,SF-I30-2,12,8,9,7,3,1,0.75,0.25,0.875,0.125
SF-G26,SF I29-1,7,5,4,2,3,3,0.5714285714285714,0.42857142857142855,0.4,0.6
SF-G26,SF-H28,13,20,8,16,5,4,0.6153846153846154,0.38461538461538464,0.8,0.2
SF-G26,SF-H29,1,2,1,1,0,1,1.0,0.0,0.5,0.5
SF-G26,SF-S24,4,7,2,2,2,5,0.5,0.5,0.2857142857142857,0.7142857142857143
SF-G26,SF-R24,11,21,5,8,6,13,0.45454545454545453,0.5454545454545454,0.38095238095238093,0.6190476190476191
SF-G26,SF-P26,5,6,0,4,5,2,0.0,1.0,0.6666666666666666,0.3333333333333333
SF-G26,SF-O25-2,6,4,3,1,3,3,0.5,0.5,0.25,0.75
SF-G26,SF-N22-1B,2,1,2,0,0,1,1.0,0.0,0.0,1.0
SF-G26,SF-T22,3,6,2,2,1,4,0.6666666666666666,0.3333333333333333,0.3333333333333333,0.6666666666666666
SF-G26,SF-S22-1,3,4,0,3,3,1,0.0,1.0,0.75,0.25
SF-G26,SF-Q23-3,2,6,2,3,0,3,1.0,0.0,0.5,0.5
SF-G26,SF-Q22-1,14,12,1,4,13,8,0.07142857142857142,0.9285714285714286,0.3333333333333333,0.6666666666666666
SF-G26,SF-Q22-2,7,6,3,1,4,5,0.42857142857142855,0.5714285714285714,0.16666666666666666,0.8333333333333334
SF-G26,SF-P22,11,11,1,7,10,4,0.09090909090909091,0.9090909090909091,0.6363636363636364,0.36363636363636365
SF-G26,SF-T20,9,13,3,4,6,9,0.3333333333333333,0.6666666666666666,0.3076923076923077,0.6923076923076923
SF-G26,SF-V28,1,1,0,1,1,0,0.0,1.0,1.0,0.0
SF-G26,SF-V30,5,2,0,0,5,2,0.0,1.0,0.0,1.0
SF-K21,SF-M25,13,8,0,3,13,5,0.0,1.0,0.375,0.625
SF-K21,SF-M26-2,49,128,1,105,48,23,0.02040816326530612,0.9795918367346939,0.8203125,0.1796875
SF-K21,SF-L27,1,2,0,0,1,2,0.0,1.0,0.0,1.0
SF-K21,SF-K26,10,41,1,12,9,29,0.1,0.9,0.2926829268292683,0.7073170731707317
SF-K21,SF-J27,7,38,1,5,6,33,0.14285714285714285,0.8571428571428571,0.13157894736842105,0.868421052631579
SF-K21,SF-M30,14,37,1,9,13,28,0.07142857142857142,0.9285714285714286,0.24324324324324326,0.7567567567567568
SF-K21,SF-L27-2,5,1,1,0,4,1,0.2,0.8,0.0,1.0
SF-K21,SF-J29-3,2,7,0,4,2,3,0.0,1.0,0.5714285714285714,0.42857142857142855
SF-K21,SF-J29,3,19,0,10,3,9,0.0,1.0,0.5263157894736842,0.47368421052631576
SF-K21,SF-L26,14,61,0,53,14,8,0.0,1.0,0.8688524590163934,0.13114754098360656
SF-K21,SF-M28,3,4,0,0,3,4,0.0,1.0,0.0,1.0
SF-K21,SF-L25,7,16,0,11,7,5,0.0,1.0,0.6875,0.3125
SF-K21,SF-M24,7,8,2,5,5,3,0.2857142857142857,0.7142857142857143,0.625,0.375
SF-K21,SF-L24,5,8,2,6,3,2,0.4,0.6,0.75,0.25
SF-K21,SF-N23,3,4,1,4,2,0,0.3333333333333333,0.6666666666666666,1.0,0.0
SF-K21,SF-N24-2,2,10,0,9,2,1,0.0,1.0,0.9,0.1
SF-K21,SF-K27-2,13,12,0,3,13,9,0.0,1.0,0.25,0.75
SF-K21,SF-J26-2,8,10,4,1,4,9,0.5,0.5,0.1,0.9
SF-K21,SF-K29-1,5,5,0,0,5,5,0.0,1.0,0.0,1.0
SF-K21,SF-J28-2,6,2,0,0,6,2,0.0,1.0,0.0,1.0
SF-K21,SF-K27,2,8,0,4,2,4,0.0,1.0,0.5,0.5
SF-K21,SF-K25,4,3,0,1,4,2,0.0,1.0,0.3333333333333333,0.6666666666666666
SF-K21,SF-J25,9,10,3,4,6,6,0.3333333333333333,0.6666666666666666,0.4,0.6
SF-K21,SF-H26-2,49,72,0,11,49,61,0.0,1.0,0.1527777777777778,0.8472222222222222
SF-K21,SF-P24,7,12,1,2,6,10,0.14285714285714285,0.8571428571428571,0.16666666666666666,0.8333333333333334
SF-K21,SF-N22-1A,2,3,0,1,2,2,0.0,1.0,0.3333333333333333,0.6666666666666666
SF-K21,SF-J24,3,5,1,2,2,3,0.3333333333333333,0.6666666666666666,0.4,0.6
SF-K21,SF-O24,1,3,0,2,1,1,0.0,1.0,0.6666666666666666,0.3333333333333333
SF-K21,SF-J26,5,10,0,3,5,7,0.0,1.0,0.3,0.7
SF-K21,SF-I26-,10,4,1,1,9,3,0.1,0.9,0.25,0.75
SF-K21,SF-I25,18,55,1,27,17,28,0.05555555555555555,0.9444444444444444,0.4909090909090909,0.509090909090909
SF-K21,SF-H26,32,49,2,28,30,21,0.0625,0.9375,0.5714285714285714,0.42857142857142855
SF-K21,SF-O23,4,6,0,2,4,4,0.0,1.0,0.3333333333333333,0.6666666666666666
SF-K21,SF-H27-1,2,6,0,1,2,5,0.0,1.0,0.16666666666666666,0.8333333333333334
SF-K21,SF-F28-2,12,26,0,5,12,21,0.0,1.0,0.19230769230769232,0.8076923076923077
SF-K21,SF-G27,31,70,11,43,20,27,0.3548387096774194,0.6451612903225806,0.6142857142857143,0.38571428571428573
SF-K21,SF-M22-2,18,21,3,6,15,15,0.16666666666666666,0.8333333333333334,0.2857142857142857,0.7142857142857143
SF-K21,SF-L22,11,10,0,1,11,9,0.0,1.0,0.1,0.9
SF-K21,SF-F27,5,15,0,6,5,9,0.0,1.0,0.4,0.6
SF-K21,SF-N22-2,27,24,6,8,21,16,0.2222222222222222,0.7777777777777778,0.3333333333333333,0.6666666666666666
SF-K21,SF-G28-2,1,5,0,1,1,4,0.0,1.0,0.2,0.8
SF-K21,SF-G28-1,1,1,0,0,1,1,0.0,1.0,0.0,1.0
SF-K21,SF-M22-1,6,13,0,3,6,10,0.0,1.0,0.23076923076923078,0.7692307692307693
SF-K21,SF-K22-2,12,14,1,11,11,3,0.08333333333333333,0.9166666666666666,0.7857142857142857,0.21428571428571427
SF-K21,SF-K24,10,5,2,4,8,1,0.2,0.8,0.8,0.2
SF-K21,SF-J23-2,6,17,2,13,4,4,0.3333333333333333,0.6666666666666666,0.7647058823529411,0.23529411764705882
SF-K21,SF-G23,7,8,3,2,4,6,0.42857142857142855,0.5714285714285714,0.25,0.75
SF-K21,SF-G24,15,21,1,0,14,21,0.06666666666666667,0.9333333333333333,0.0,1.0
SF-K21,SF-G25,4,8,2,0,2,8,0.5,0.5,0.0,1.0
SF-K21,SF-F23,19,18,0,2,19,16,0.0,1.0,0.1111111111111111,0.8888888888888888
SF-K21,SF-E23,13,11,1,2,12,9,0.07692307692307693,0.9230769230769231,0.18181818181818182,0.8181818181818182
SF-K21,SF-D24,5,4,1,1,4,3,0.2,0.8,0.25,0.75
SF-K21,SF-C22,6,10,0,1,6,9,0.0,1.0,0.1,0.9
SF-K21,SF-B22,6,25,0,3,6,22,0.0,1.0,0.12,0.88
SF-K21,SF-J17,20,9,6,1,14,8,0.3,0.7,0.1111111111111111,0.8888888888888888
SF-K21,SF-I19,5,4,0,1,5,3,0.0,1.0,0.25,0.75
SF-K21,SF-I20,1,4,0,2,1,2,0.0,1.0,0.5,0.5
SF-K21,SF-H16,21,12,7,0,14,12,0.3333333333333333,0.6666666666666666,0.0,1.0
SF-K21,SF-H19,1,2,0,1,1,1,0.0,1.0,0.5,0.5
SF-K21,SF-H20,18,21,5,13,13,8,0.2777777777777778,0.7222222222222222,0.6190476190476191,0.38095238095238093
SF-K21,SF-H18,2,3,1,1,1,2,0.5,0.5,0.3333333333333333,0.6666666666666666
SF-K21,SF-H17,8,4,1,0,7,4,0.125,0.875,0.0,1.0
SF-K21,SF-G19,3,20,1,17,2,3,0.3333333333333333,0.6666666666666666,0.85,0.15
SF-K21,SF-G17,11,9,4,0,7,9,0.36363636363636365,0.6363636363636364,0.0,1.0
SF-K21,SF-G18,18,15,1,4,17,11,0.05555555555555555,0.9444444444444444,0.26666666666666666,0.7333333333333333
SF-K21,SF-G20,52,50,2,17,50,33,0.038461538461538464,0.9615384615384616,0.34,0.66
SF-K21,SF-F19,13,29,3,10,10,19,0.23076923076923078,0.7692307692307693,0.3448275862068966,0.6551724137931034
SF-K21,SF-E18,13,10,2,4,11,6,0.15384615384615385,0.8461538461538461,0.4,0.6
SF-K21,SF-E20,12,14,5,2,7,12,0.4166666666666667,0.5833333333333334,0.14285714285714285,0.8571428571428571
SF-K21,SF-H30,1,1,0,0,1,1,0.0,1.0,0.0,1.0
SF-K21,SF-G30-2,9,15,1,5,8,10,0.1111111111111111,0.8888888888888888,0.3333333333333333,0.6666666666666666
SF-K21,SF-F30-1,1,7,0,2,1,5,0.0,1.0,0.2857142857142857,0.7142857142857143
SF-K21,SF-E29-2,12,31,2,8,10,23,0.16666666666666666,0.8333333333333334,0.25806451612903225,0.7419354838709677
SF-K21,SF-E29-1,19,30,1,6,18,24,0.05263157894736842,0.9473684210526315,0.2,0.8
SF-K21,SF-D29,4,2,0,2,4,0,0.0,1.0,1.0,0.0
SF-K21,SF-D28,2,12,0,1,2,11,0.0,1.0,0.08333333333333333,0.9166666666666666
SF-K21,SF-A27,6,4,0,0,6,4,0.0,1.0,0.0,1.0
SF-K21,SF-G29-2,6,5,1,2,5,3,0.16666666666666666,0.8333333333333334,0.4,0.6
SF-K21,SF-G29-1,8,9,0,1,8,8,0.0,1.0,0.1111111111111111,0.8888888888888888
SF-K21,SF-G30-1,3,3,0,0,3,3,0.0,1.0,0.0,1.0
SF-K21,SF-G29-3,2,3,0,1,2,2,0.0,1.0,0.3333333333333333,0.6666666666666666
SF-K21,SF-F30-2,2,8,0,1,2,7,0.0,1.0,0.125,0.875
SF-K21,SF-F29,2,9,0,3,2,6,0.0,1.0,0.3333333333333333,0.6666666666666666
SF-K21,SF-E29-3,5,6,2,2,3,4,0.4,0.6,0.3333333333333333,0.6666666666666666
SF-K21,SF-F28-1,6,9,0,2,6,7,0.0,1.0,0.2222222222222222,0.7777777777777778
SF-K21,SF-E28,3,6,0,2,3,4,0.0,1.0,0.3333333333333333,0.6666666666666666
SF-K21,SF-J10,7,16,5,9,2,7,0.7142857142857143,0.2857142857142857,0.5625,0.4375
SF-K21,SF-J12,51,34,8,4,43,30,0.1568627450980392,0.8431372549019608,0.11764705882352941,0.8823529411764706
SF-K21,SF-J13,12,6,2,0,10,6,0.16666666666666666,0.8333333333333334,0.0,1.0
SF-K21,SF-J15,1,4,0,0,1,4,0.0,1.0,0.0,1.0
SF-K21,SF-J14,3,1,2,1,1,0,0.6666666666666666,0.3333333333333333,1.0,0.0
SF-K21,SF-H13,6,3,1,1,5,2,0.16666666666666666,0.8333333333333334,0.3333333333333333,0.6666666666666666
SF-K21,SF-I16,6,3,2,0,4,3,0.3333333333333333,0.6666666666666666,0.0,1.0
SF-K21,SF-H12,18,15,9,4,9,11,0.5,0.5,0.26666666666666666,0.7333333333333333
SF-K21,SF-G10-2,3,3,0,0,3,3,0.0,1.0,0.0,1.0
SF-K21,SF-G13,10,5,2,0,8,5,0.2,0.8,0.0,1.0
SF-K21,SF-G11,12,19,1,2,11,17,0.08333333333333333,0.9166666666666666,0.10526315789473684,0.8947368421052632
SF-K21,SF-G12,12,6,0,1,12,5,0.0,1.0,0.16666666666666666,0.8333333333333334
SF-K21,SF-G10-1,2,1,0,1,2,0,0.0,1.0,1.0,0.0
SF-K21,SF-F15,1,1,0,0,1,1,0.0,1.0,0.0,1.0
SF-K21,SF-F16,13,18,2,0,11,18,0.15384615384615385,0.8461538461538461,0.0,1.0
SF-K21,SF-C21,2,4,0,0,2,4,0.0,1.0,0.0,1.0
SF-K21,SF-C20,5,10,0,2,5,8,0.0,1.0,0.2,0.8
SF-K21,SF-B21,2,7,0,0,2,7,0.0,1.0,0.0,1.0
SF-K21,SF-A20,7,4,0,1,7,3,0.0,1.0,0.25,0.75
SF-K21,SF-A19,2,2,0,0,2,2,0.0,1.0,0.0,1.0
SF-K21,SF-C26,3,16,0,0,3,16,0.0,1.0,0.0,1.0
SF-K21,SF-C25,9,14,0,1,9,13,0.0,1.0,0.07142857142857142,0.9285714285714286
SF-K21,SF-B25,2,2,2,0,0,2,1.0,0.0,0.0,1.0
SF-K21,SF-E27,7,6,0,1,7,5,0.0,1.0,0.16666666666666666,0.8333333333333334
SF-K21,SF-D27,5,3,1,0,4,3,0.2,0.8,0.0,1.0
SF-K21,SF-C28-2,3,5,0,0,3,5,0.0,1.0,0.0,1.0
SF-K21,SF-J1,43,70,24,52,19,18,0.5581395348837209,0.4418604651162791,0.7428571428571429,0.2571428571428571
SF-K21,SF-H0,8,4,0,2,8,2,0.0,1.0,0.5,0.5
SF-K21,SF-J3,5,4,0,3,5,1,0.0,1.0,0.75,0.25
SF-K21,SF-J5,5,4,1,3,4,1,0.2,0.8,0.75,0.25
SF-K21,SF-G6,1,3,1,1,0,2,1.0,0.0,0.3333333333333333,0.6666666666666666
SF-K21,SF-G8,4,4,1,2,3,2,0.25,0.75,0.5,0.5
SF-K21,SF-G5,4,4,0,2,4,2,0.0,1.0,0.5,0.5
SF-K21,SF-G7,5,10,0,0,5,10,0.0,1.0,0.0,1.0
SF-K21,SF-F9,1,2,0,0,1,2,0.0,1.0,0.0,1.0
SF-K21,SF-G26,49,70,5,43,44,27,0.10204081632653061,0.8979591836734694,0.6142857142857143,0.38571428571428573
SF-K21,SF-K22-1,13,17,3,12,10,5,0.23076923076923078,0.7692307692307693,0.7058823529411765,0.29411764705882354
SF-K21,SF-J23-1,31,78,5,42,26,36,0.16129032258064516,0.8387096774193549,0.5384615384615384,0.46153846153846156
SF-K21,SF-J22-1,32,72,15,44,17,28,0.46875,0.53125,0.6111111111111112,0.3888888888888889
SF-K21,SF-J22-2,13,18,3,12,10,6,0.23076923076923078,0.7692307692307693,0.6666666666666666,0.3333333333333333
SF-K21,SF-J21,40,45,19,25,21,20,0.475,0.525,0.5555555555555556,0.4444444444444444
SF-K21,SF-I21,1,11,0,9,1,2,0.0,1.0,0.8181818181818182,0.18181818181818182
SF-K21,SF-I22,2,5,0,0,2,5,0.0,1.0,0.0,1.0
SF-K21,SF-I23-2,3,15,2,8,1,7,0.6666666666666666,0.3333333333333333,0.5333333333333333,0.4666666666666667
SF-K21,SF-I24,6,20,3,11,3,9,0.5,0.5,0.55,0.45
SF-K21,SF-I23-1,9,39,3,6,6,33,0.3333333333333333,0.6666666666666666,0.15384615384615385,0.8461538461538461
SF-K21,SF-F26,22,28,0,5,22,23,0.0,1.0,0.17857142857142858,0.8214285714285714
SF-K21,SF-M13,73,48,40,23,33,25,0.547945205479452,0.4520547945205479,0.4791666666666667,0.5208333333333334
SF-K21,SF-M15,67,38,38,4,29,34,0.5671641791044776,0.43283582089552236,0.10526315789473684,0.8947368421052632
SF-K21,SF-L19,10,15,5,4,5,11,0.5,0.5,0.26666666666666666,0.7333333333333333
SF-K21,SF-L20,99,34,21,21,78,13,0.21212121212121213,0.7878787878787878,0.6176470588235294,0.38235294117647056
SF-K21,SF-N20-1,7,6,0,2,7,4,0.0,1.0,0.3333333333333333,0.6666666666666666
SF-K21,SF-M20,34,52,10,36,24,16,0.29411764705882354,0.7058823529411765,0.6923076923076923,0.3076923076923077
SF-K21,SF-K17-2,32,28,11,0,21,28,0.34375,0.65625,0.0,1.0
SF-K21,SF-K20,32,29,16,12,16,17,0.5,0.5,0.41379310344827586,0.5862068965517241
SF-K21,SF-K15-,79,68,31,22,48,46,0.3924050632911392,0.6075949367088608,0.3235294117647059,0.6764705882352942
SF-K21,SF-K19,100,120,51,74,49,46,0.51,0.49,0.6166666666666667,0.38333333333333336
SF-K21,SF-K18,62,47,23,19,39,28,0.3709677419354839,0.6290322580645161,0.40425531914893614,0.5957446808510638
SF-K21,SF-K17,40,33,21,10,19,23,0.525,0.475,0.30303030303030304,0.696969696969697
SF-K21,SF-J16,3,7,1,3,2,4,0.3333333333333333,0.6666666666666666,0.42857142857142855,0.5714285714285714
SF-K21,SF-J18,29,27,9,6,20,21,0.3103448275862069,0.6896551724137931,0.2222222222222222,0.7777777777777778
SF-K21,SF-J20,8,16,4,11,4,5,0.5,0.5,0.6875,0.3125
SF-K21,SF-J19,10,17,5,7,5,10,0.5,0.5,0.4117647058823529,0.5882352941176471
SF-K21,SF-M12,21,11,10,1,11,10,0.47619047619047616,0.5238095238095238,0.09090909090909091,0.9090909090909091
SF-K21,SF-M10,10,20,7,11,3,9,0.7,0.3,0.55,0.45
SF-K21,SF-M11,37,20,18,7,19,13,0.4864864864864865,0.5135135135135135,0.35,0.65
SF-K21,SF-R19,7,2,1,0,6,2,0.14285714285714285,0.8571428571428571,0.0,1.0
SF-K21,SF-R20,3,2,0,0,3,2,0.0,1.0,0.0,1.0
SF-K21,SF-Q21-2,3,9,0,1,3,8,0.0,1.0,0.1111111111111111,0.8888888888888888
SF-K21,SF-P21,8,7,0,6,8,1,0.0,1.0,0.8571428571428571,0.14285714285714285
SF-K21,SF-O18,7,9,0,3,7,6,0.0,1.0,0.3333333333333333,0.6666666666666666
SF-K21,SF-O19,13,8,0,3,13,5,0.0,1.0,0.375,0.625
SF-K21,SF-O21,32,60,3,30,29,30,0.09375,0.90625,0.5,0.5
SF-K21,SF-O22,13,33,1,17,12,16,0.07692307692307693,0.9230769230769231,0.5151515151515151,0.48484848484848486
SF-K21,SF-N21,6,7,3,5,3,2,0.5,0.5,0.7142857142857143,0.2857142857142857
SF-K21,SF-N20-2,2,9,0,5,2,4,0.0,1.0,0.5555555555555556,0.4444444444444444
SF-K21,SF-M21,6,11,0,2,6,9,0.0,1.0,0.18181818181818182,0.8181818181818182
SF-K21,SF-L21,46,46,6,31,40,15,0.13043478260869565,0.8695652173913043,0.6739130434782609,0.32608695652173914
SF-K21,SF-S30,1,1,0,0,1,1,0.0,1.0,0.0,1.0
SF-K21,SF-Q30,3,11,0,0,3,11,0.0,1.0,0.0,1.0
SF-K21,SF-P30,1,1,0,0,1,1,0.0,1.0,0.0,1.0
SF-K21,SF-O30-2,2,4,0,1,2,3,0.0,1.0,0.25,0.75
SF-K21,SF-O30,10,11,1,7,9,4,0.1,0.9,0.6363636363636364,0.36363636363636365
SF-K21,SF-N27,5,9,1,2,4,7,0.2,0.8,0.2222222222222222,0.7777777777777778
SF-K21,SF-N29,5,6,0,2,5,4,0.0,1.0,0.3333333333333333,0.6666666666666666
SF-K21,SF-N28,7,10,0,0,7,10,0.0,1.0,0.0,1.0
SF-K21,SF-L30-1,12,14,2,4,10,10,0.16666666666666666,0.8333333333333334,0.2857142857142857,0.7142857142857143
SF-K21,SF-L29,6,11,3,3,3,8,0.5,0.5,0.2727272727272727,0.7272727272727273
SF-K21,SF-J29-1,4,2,1,0,3,2,0.25,0.75,0.0,1.0
SF-K21,SF-I30,7,5,1,1,6,4,0.14285714285714285,0.8571428571428571,0.2,0.8
SF-K21,SF-I29-2,2,6,2,1,0,5,1.0,0.0,0.16666666666666666,0.8333333333333334
SF-K21,SF-I27,3,6,0,1,3,5,0.0,1.0,0.16666666666666666,0.8333333333333334
SF-K21,SF-I28,3,3,1,0,2,3,0.3333333333333333,0.6666666666666666,0.0,1.0
SF-K21,SF-I30-2,2,1,0,0,2,1,0.0,1.0,0.0,1.0
SF-K21,SF-H28,2,5,0,2,2,3,0.0,1.0,0.4,0.6
SF-K21,SF-H29,1,3,0,2,1,1,0.0,1.0,0.6666666666666666,0.3333333333333333
SF-K21,SF-S24,3,8,0,2,3,6,0.0,1.0,0.25,0.75
SF-K21,SF-R24,8,8,0,6,8,2,0.0,1.0,0.75,0.25
SF-K21,SF-R26,10,5,0,0,10,5,0.0,1.0,0.0,1.0
SF-K21,SF-Q26,7,16,0,2,7,14,0.0,1.0,0.125,0.875
SF-K21,SF-P26,1,3,0,3,1,0,0.0,1.0,1.0,0.0
SF-K21,SF-O25-2,3,5,0,1,3,4,0.0,1.0,0.2,0.8
SF-K21,SF-N22-1B,3,8,1,5,2,3,0.3333333333333333,0.6666666666666666,0.625,0.375
SF-K21,SF-N26,1,3,0,2,1,1,0.0,1.0,0.6666666666666666,0.3333333333333333
SF-K21,SF-T21,3,1,0,0,3,1,0.0,1.0,0.0,1.0
SF-K21,SF-T22,4,9,3,4,1,5,0.75,0.25,0.4444444444444444,0.5555555555555556
SF-K21,SF-S22-2,1,1,0,0,1,1,0.0,1.0,0.0,1.0
SF-K21,SF-S22-1,3,14,0,3,3,11,0.0,1.0,0.21428571428571427,0.7857142857142857
SF-K21,SF-Q23-3,6,19,0,7,6,12,0.0,1.0,0.3684210526315789,0.631578947368421
SF-K21,SF-Q22-1,13,7,0,5,13,2,0.0,1.0,0.7142857142857143,0.2857142857142857
SF-K21,SF-Q22-2,14,13,2,7,12,6,0.14285714285714285,0.8571428571428571,0.5384615384615384,0.46153846153846156
SF-K21,SF-P22,8,12,1,3,7,9,0.125,0.875,0.25,0.75
SF-K21,SF-U21,2,1,0,0,2,1,0.0,1.0,0.0,1.0
SF-K21,SF-T20,1,6,0,0,1,6,0.0,1.0,0.0,1.0
SF-K21,SF-S21,2,2,0,0,2,2,0.0,1.0,0.0,1.0
SF-K21,SF-V30,1,1,0,0,1,1,0.0,1.0,0.0,1.0
SF-K22-1,SF-M25,19,10,9,4,10,6,0.47368421052631576,0.5263157894736842,0.4,0.6
SF-K22-1,SF-M26-2,6,4,0,2,6,2,0.0,1.0,0.5,0.5
SF-K22-1,SF-L27,6,5,4,1,2,4,0.6666666666666666,0.3333333333333333,0.2,0.8
SF-K22-1,SF-K26,11,11,6,7,5,4,0.5454545454545454,0.45454545454545453,0.6363636363636364,0.36363636363636365
SF-K22-1,SF-J27,8,6,2,2,6,4,0.25,0.75,0.3333333333333333,0.6666666666666666
SF-K22-1,SF-M30,5,3,1,2,4,1,0.2,0.8,0.6666666666666666,0.3333333333333333
SF-K22-1,SF-J29-3,4,2,2,1,2,1,0.5,0.5,0.5,0.5
SF-K22-1,SF-J29,9,22,4,8,5,14,0.4444444444444444,0.5555555555555556,0.36363636363636365,0.6363636363636364
SF-K22-1,SF-L26,90,43,54,22,36,21,0.6,0.4,0.5116279069767442,0.4883720930232558
SF-K22-1,SF-M28,5,7,0,2,5,5,0.0,1.0,0.2857142857142857,0.7142857142857143
SF-K22-1,SF-L25,38,49,31,46,7,3,0.8157894736842105,0.18421052631578946,0.9387755102040817,0.061224489795918366
SF-K22-1,SF-M24,2,6,1,5,1,1,0.5,0.5,0.8333333333333334,0.16666666666666666
SF-K22-1,SF-L24,50,31,20,14,30,17,0.4,0.6,0.45161290322580644,0.5483870967741935
SF-K22-1,SF-N23,9,11,4,8,5,3,0.4444444444444444,0.5555555555555556,0.7272727272727273,0.2727272727272727
SF-K22-1,SF-N24-2,8,5,5,5,3,0,0.625,0.375,1.0,0.0
SF-K22-1,SF-K27-2,10,3,8,0,2,3,0.8,0.2,0.0,1.0
SF-K22-1,SF-J26-2,17,16,10,14,7,2,0.5882352941176471,0.4117647058823529,0.875,0.125
SF-K22-1,SF-L28,1,3,0,3,1,0,0.0,1.0,1.0,0.0
SF-K22-1,SF-K28,4,1,1,0,3,1,0.25,0.75,0.0,1.0
SF-K22-1,SF-K29-1,19,11,7,5,12,6,0.3684210526315789,0.631578947368421,0.45454545454545453,0.5454545454545454
SF-K22-1,SF-J28-2,2,4,0,3,2,1,0.0,1.0,0.75,0.25
SF-K22-1,SF-K27,5,1,5,1,0,0,1.0,0.0,1.0,0.0
SF-K22-1,SF-K25,15,14,11,12,4,2,0.7333333333333333,0.26666666666666666,0.8571428571428571,0.14285714285714285
SF-K22-1,SF-J25,25,18,15,13,10,5,0.6,0.4,0.7222222222222222,0.2777777777777778
SF-K22-1,SF-H26-2,6,6,3,4,3,2,0.5,0.5,0.6666666666666666,0.3333333333333333
SF-K22-1,SF-P24,5,8,2,7,3,1,0.4,0.6,0.875,0.125
SF-K22-1,SF-J24,16,8,11,1,5,7,0.6875,0.3125,0.125,0.875
SF-K22-1,SF-J26,8,11,5,6,3,5,0.625,0.375,0.5454545454545454,0.45454545454545453
SF-K22-1,SF-I26-,8,1,5,0,3,1,0.625,0.375,0.0,1.0
SF-K22-1,SF-I25,69,27,51,20,18,7,0.7391304347826086,0.2608695652173913,0.7407407407407407,0.25925925925925924
SF-K22-1,SF-K23,6,3,5,3,1,0,0.8333333333333334,0.16666666666666666,1.0,0.0
SF-K22-1,SF-H26,134,71,84,45,50,26,0.6268656716417911,0.373134328358209,0.6338028169014085,0.36619718309859156
SF-K22-1,SF-O23,10,12,8,8,2,4,0.8,0.2,0.6666666666666666,0.3333333333333333
SF-K22-1,SF-H27-1,8,2,7,1,1,1,0.875,0.125,0.5,0.5
SF-K22-1,SF-F28-2,40,28,31,24,9,4,0.775,0.225,0.8571428571428571,0.14285714285714285
SF-K22-1,SF-G27,129,108,75,89,54,19,0.5813953488372093,0.4186046511627907,0.8240740740740741,0.17592592592592593
SF-K22-1,SF-M22-2,42,65,33,49,9,16,0.7857142857142857,0.21428571428571427,0.7538461538461538,0.24615384615384617
SF-K22-1,SF-L22,15,6,12,6,3,0,0.8,0.2,1.0,0.0
SF-K22-1,SF-F27,50,38,28,18,22,20,0.56,0.44,0.47368421052631576,0.5263157894736842
SF-K22-1,SF-N22-2,31,41,25,32,6,9,0.8064516129032258,0.1935483870967742,0.7804878048780488,0.21951219512195122
SF-K22-1,SF-G28-2,3,1,2,0,1,1,0.6666666666666666,0.3333333333333333,0.0,1.0
SF-K22-1,SF-G28-1,7,3,5,3,2,0,0.7142857142857143,0.2857142857142857,1.0,0.0
SF-K22-1,SF-M22-1,2,4,1,3,1,1,0.5,0.5,0.75,0.25
SF-K22-1,SF-O25-1,6,3,1,1,5,2,0.16666666666666666,0.8333333333333334,0.3333333333333333,0.6666666666666666
SF-K22-1,SF-K22-2,12,13,9,11,3,2,0.75,0.25,0.8461538461538461,0.15384615384615385
SF-K22-1,SF-K24,19,12,17,11,2,1,0.8947368421052632,0.10526315789473684,0.9166666666666666,0.08333333333333333
SF-K22-1,SF-J23-2,31,18,29,16,2,2,0.9354838709677419,0.06451612903225806,0.8888888888888888,0.1111111111111111
SF-K22-1,SF-G23,22,6,9,2,13,4,0.4090909090909091,0.5909090909090909,0.3333333333333333,0.6666666666666666
SF-K22-1,SF-G24,25,22,12,5,13,17,0.48,0.52,0.22727272727272727,0.7727272727272727
SF-K22-1,SF-G25,31,7,15,3,16,4,0.4838709677419355,0.5161290322580645,0.42857142857142855,0.5714285714285714
SF-K22-1,SF-F23,30,12,15,6,15,6,0.5,0.5,0.5,0.5
SF-K22-1,SF-E23,18,12,9,6,9,6,0.5,0.5,0.5,0.5
SF-K22-1,SF-D24,1,3,0,2,1,1,0.0,1.0,0.6666666666666666,0.3333333333333333
SF-K22-1,SF-C22,14,10,4,2,10,8,0.2857142857142857,0.7142857142857143,0.2,0.8
SF-K22-1,SF-B22,3,6,2,3,1,3,0.6666666666666666,0.3333333333333333,0.5,0.5
SF-K22-1,SF-J17,3,17,0,1,3,16,0.0,1.0,0.058823529411764705,0.9411764705882353
SF-K22-1,SF-I19,4,4,2,1,2,3,0.5,0.5,0.25,0.75
SF-K22-1,SF-I20,17,17,16,15,1,2,0.9411764705882353,0.058823529411764705,0.8823529411764706,0.11764705882352941
SF-K22-1,SF-H20,7,6,3,4,4,2,0.42857142857142855,0.5714285714285714,0.6666666666666666,0.3333333333333333
SF-K22-1,SF-G19,2,3,1,0,1,3,0.5,0.5,0.0,1.0
SF-K22-1,SF-G18,6,2,2,1,4,1,0.3333333333333333,0.6666666666666666,0.5,0.5
SF-K22-1,SF-G20,2,38,2,2,0,36,1.0,0.0,0.05263157894736842,0.9473684210526315
SF-K22-1,SF-F19,13,13,12,11,1,2,0.9230769230769231,0.07692307692307693,0.8461538461538461,0.15384615384615385
SF-K22-1,SF-E18,10,11,0,0,10,11,0.0,1.0,0.0,1.0
SF-K22-1,SF-E20,2,1,0,0,2,1,0.0,1.0,0.0,1.0
SF-K22-1,SF-G30-2,20,19,1,9,19,10,0.05,0.95,0.47368421052631576,0.5263157894736842
SF-K22-1,SF-F30-1,8,5,6,4,2,1,0.75,0.25,0.8,0.2
SF-K22-1,SF-E29-2,106,53,73,37,33,16,0.6886792452830188,0.3113207547169811,0.6981132075471698,0.3018867924528302
SF-K22-1,SF-E29-1,71,88,51,76,20,12,0.7183098591549296,0.28169014084507044,0.8636363636363636,0.13636363636363635
SF-K22-1,SF-D29,6,7,2,5,4,2,0.3333333333333333,0.6666666666666666,0.7142857142857143,0.2857142857142857
SF-K22-1,SF-D28,22,8,11,5,11,3,0.5,0.5,0.625,0.375
SF-K22-1,SF-A27,14,8,10,8,4,0,0.7142857142857143,0.2857142857142857,1.0,0.0
SF-K22-1,SF-G29-2,17,5,8,2,9,3,0.47058823529411764,0.5294117647058824,0.4,0.6
SF-K22-1,SF-G29-1,22,16,16,13,6,3,0.7272727272727273,0.2727272727272727,0.8125,0.1875
SF-K22-1,SF-G30-1,6,5,2,3,4,2,0.3333333333333333,0.6666666666666666,0.6,0.4
SF-K22-1,SF-G29-3,9,2,7,2,2,0,0.7777777777777778,0.2222222222222222,1.0,0.0
SF-K22-1,SF-F30-2,3,5,0,3,3,2,0.0,1.0,0.6,0.4
SF-K22-1,SF-F29,1,1,0,0,1,1,0.0,1.0,0.0,1.0
SF-K22-1,SF-E29-3,8,6,6,4,2,2,0.75,0.25,0.6666666666666666,0.3333333333333333
SF-K22-1,SF-F28-1,40,27,33,23,7,4,0.825,0.175,0.8518518518518519,0.14814814814814814
SF-K22-1,SF-E28-2,3,2,2,1,1,1,0.6666666666666666,0.3333333333333333,0.5,0.5
SF-K22-1,SF-E28,10,9,6,6,4,3,0.6,0.4,0.6666666666666666,0.3333333333333333
SF-K22-1,SF-J10,1,4,0,2,1,2,0.0,1.0,0.5,0.5
SF-K22-1,SF-J12,35,16,12,1,23,15,0.34285714285714286,0.6571428571428571,0.0625,0.9375
SF-K22-1,SF-J13,2,3,1,0,1,3,0.5,0.5,0.0,1.0
SF-K22-1,SF-I16,1,1,1,0,0,1,1.0,0.0,0.0,1.0
SF-K22-1,SF-H12,4,1,0,0,4,1,0.0,1.0,0.0,1.0
SF-K22-1,SF-G11,2,2,1,0,1,2,0.5,0.5,0.0,1.0
SF-K22-1,SF-G10-1,4,5,0,0,4,5,0.0,1.0,0.0,1.0
SF-K22-1,SF-B21,10,2,2,0,8,2,0.2,0.8,0.0,1.0
SF-K22-1,SF-B19,3,3,1,0,2,3,0.3333333333333333,0.6666666666666666,0.0,1.0
SF-K22-1,SF-A20,4,1,0,1,4,0,0.0,1.0,1.0,0.0
SF-K22-1,SF-A19,2,2,1,2,1,0,0.5,0.5,1.0,0.0
SF-K22-1,SF-C26,22,5,11,2,11,3,0.5,0.5,0.4,0.6
SF-K22-1,SF-C25,12,2,7,2,5,0,0.5833333333333334,0.4166666666666667,1.0,0.0
SF-K22-1,SF-B25,12,11,10,8,2,3,0.8333333333333334,0.16666666666666666,0.7272727272727273,0.2727272727272727
SF-K22-1,SF-B28-2,4,4,1,0,3,4,0.25,0.75,0.0,1.0
SF-K22-1,SF-D27,17,5,13,3,4,2,0.7647058823529411,0.23529411764705882,0.6,0.4
SF-K22-1,SF-C28-2,1,3,1,2,0,1,1.0,0.0,0.6666666666666666,0.3333333333333333
SF-K22-1,SF-C28-1,17,4,11,1,6,3,0.6470588235294118,0.35294117647058826,0.25,0.75
SF-K22-1,SF-B28,2,1,1,1,1,0,0.5,0.5,1.0,0.0
SF-K22-1,SF-J1,3,5,0,2,3,3,0.0,1.0,0.4,0.6
SF-K22-1,SF-G7,3,2,1,1,2,1,0.3333333333333333,0.6666666666666666,0.5,0.5
SF-K22-1,SF-H25,11,6,8,1,3,5,0.7272727272727273,0.2727272727272727,0.16666666666666666,0.8333333333333334
SF-K22-1,SF-G26,15,18,5,15,10,3,0.3333333333333333,0.6666666666666666,0.8333333333333334,0.16666666666666666
SF-K22-1,SF-K21,17,13,12,3,5,10,0.7058823529411765,0.29411764705882354,0.23076923076923078,0.7692307692307693
SF-K22-1,SF-J23-1,156,99,134,84,22,15,0.8589743589743589,0.14102564102564102,0.8484848484848485,0.15151515151515152
SF-K22-1,SF-J22-1,6,14,4,8,2,6,0.6666666666666666,0.3333333333333333,0.5714285714285714,0.42857142857142855
SF-K22-1,SF-J22-2,4,7,4,6,0,1,1.0,0.0,0.8571428571428571,0.14285714285714285
SF-K22-1,SF-J21,10,17,6,14,4,3,0.6,0.4,0.8235294117647058,0.17647058823529413
SF-K22-1,SF-I22,14,8,12,7,2,1,0.8571428571428571,0.14285714285714285,0.875,0.125
SF-K22-1,SF-I23-2,20,15,16,10,4,5,0.8,0.2,0.6666666666666666,0.3333333333333333
SF-K22-1,SF-I24,35,23,29,21,6,2,0.8285714285714286,0.17142857142857143,0.9130434782608695,0.08695652173913043
SF-K22-1,SF-I23-1,25,20,16,13,9,7,0.64,0.36,0.65,0.35
SF-K22-1,SF-F26,40,19,27,9,13,10,0.675,0.325,0.47368421052631576,0.5263157894736842
SF-K22-1,SF-M13,9,8,4,1,5,7,0.4444444444444444,0.5555555555555556,0.125,0.875
SF-K22-1,SF-M15,32,11,14,2,18,9,0.4375,0.5625,0.18181818181818182,0.8181818181818182
SF-K22-1,SF-L19,21,26,17,6,4,20,0.8095238095238095,0.19047619047619047,0.23076923076923078,0.7692307692307693
SF-K22-1,SF-L20,72,66,55,34,17,32,0.7638888888888888,0.2361111111111111,0.5151515151515151,0.48484848484848486
SF-K22-1,SF-N20-1,7,17,1,11,6,6,0.14285714285714285,0.8571428571428571,0.6470588235294118,0.35294117647058826
SF-K22-1,SF-M20,28,99,13,30,15,69,0.4642857142857143,0.5357142857142857,0.30303030303030304,0.696969696969697
SF-K22-1,SF-K17-2,9,13,4,6,5,7,0.4444444444444444,0.5555555555555556,0.46153846153846156,0.5384615384615384
SF-K22-1,SF-K20,18,23,7,7,11,16,0.3888888888888889,0.6111111111111112,0.30434782608695654,0.6956521739130435
SF-K22-1,SF-K15-,18,31,9,15,9,16,0.5,0.5,0.4838709677419355,0.5161290322580645
SF-K22-1,SF-K19,23,16,12,9,11,7,0.5217391304347826,0.4782608695652174,0.5625,0.4375
SF-K22-1,SF-K18,10,18,7,2,3,16,0.7,0.3,0.1111111111111111,0.8888888888888888
SF-K22-1,SF-K17,8,13,5,6,3,7,0.625,0.375,0.46153846153846156,0.5384615384615384
SF-K22-1,SF-J16,8,15,1,1,7,14,0.125,0.875,0.06666666666666667,0.9333333333333333
SF-K22-1,SF-J18,14,6,2,1,12,5,0.14285714285714285,0.8571428571428571,0.16666666666666666,0.8333333333333334
SF-K22-1,SF-J20,3,3,1,1,2,2,0.3333333333333333,0.6666666666666666,0.3333333333333333,0.6666666666666666
SF-K22-1,SF-J19,6,8,3,3,3,5,0.5,0.5,0.375,0.625
SF-K22-1,SF-M12,5,7,0,2,5,5,0.0,1.0,0.2857142857142857,0.7142857142857143
SF-K22-1,SF-M10,3,3,1,0,2,3,0.3333333333333333,0.6666666666666666,0.0,1.0
SF-K22-1,SF-M11,11,7,9,1,2,6,0.8181818181818182,0.18181818181818182,0.14285714285714285,0.8571428571428571
SF-K22-1,SF-R19,5,10,2,0,3,10,0.4,0.6,0.0,1.0
SF-K22-1,SF-R20,9,3,3,1,6,2,0.3333333333333333,0.6666666666666666,0.3333333333333333,0.6666666666666666
SF-K22-1,SF-Q21-2,18,12,7,1,11,11,0.3888888888888889,0.6111111111111112,0.08333333333333333,0.9166666666666666
SF-K22-1,SF-Q21-1,4,2,2,2,2,0,0.5,0.5,1.0,0.0
SF-K22-1,SF-P21,7,11,1,8,6,3,0.14285714285714285,0.8571428571428571,0.7272727272727273,0.2727272727272727
SF-K22-1,SF-O18,30,29,6,11,24,18,0.2,0.8,0.3793103448275862,0.6206896551724138
SF-K22-1,SF-O19,31,27,16,9,15,18,0.5161290322580645,0.4838709677419355,0.3333333333333333,0.6666666666666666
SF-K22-1,SF-O21,29,64,10,35,19,29,0.3448275862068966,0.6551724137931034,0.546875,0.453125
SF-K22-1,SF-O22,9,61,6,39,3,22,0.6666666666666666,0.3333333333333333,0.639344262295082,0.36065573770491804
SF-K22-1,SF-N21,4,11,3,7,1,4,0.75,0.25,0.6363636363636364,0.36363636363636365
SF-K22-1,SF-N20-2,9,12,5,3,4,9,0.5555555555555556,0.4444444444444444,0.25,0.75
SF-K22-1,SF-M21,7,5,3,4,4,1,0.42857142857142855,0.5714285714285714,0.8,0.2
SF-K22-1,SF-L21,47,148,30,79,17,69,0.6382978723404256,0.3617021276595745,0.5337837837837838,0.46621621621621623
SF-K22-1,SF-S29,1,2,1,2,0,0,1.0,0.0,1.0,0.0
SF-K22-1,SF-Q30,3,2,0,1,3,1,0.0,1.0,0.5,0.5
SF-K22-1,SF-P30,5,7,2,3,3,4,0.4,0.6,0.42857142857142855,0.5714285714285714
SF-K22-1,SF-O30-2,3,2,2,2,1,0,0.6666666666666666,0.3333333333333333,1.0,0.0
SF-K22-1,SF-O30,11,9,5,2,6,7,0.45454545454545453,0.5454545454545454,0.2222222222222222,0.7777777777777778
SF-K22-1,SF-N27,8,7,7,6,1,1,0.875,0.125,0.8571428571428571,0.14285714285714285
SF-K22-1,SF-N29,8,6,7,6,1,0,0.875,0.125,1.0,0.0
SF-K22-1,SF-N28,3,4,0,1,3,3,0.0,1.0,0.25,0.75
SF-K22-1,SF-L30-1,118,157,71,98,47,59,0.6016949152542372,0.3983050847457627,0.6242038216560509,0.37579617834394907
SF-K22-1,SF-K30-2,21,8,11,4,10,4,0.5238095238095238,0.47619047619047616,0.5,0.5
SF-K22-1,SF-L29,13,6,3,2,10,4,0.23076923076923078,0.7692307692307693,0.3333333333333333,0.6666666666666666
SF-K22-1,SF-J29-1,6,7,3,3,3,4,0.5,0.5,0.42857142857142855,0.5714285714285714
SF-K22-1,SF-I30,2,2,0,0,2,2,0.0,1.0,0.0,1.0
SF-K22-1,SF-I29-2,3,4,0,3,3,1,0.0,1.0,0.75,0.25
SF-K22-1,SF-I27,13,3,5,1,8,2,0.38461538461538464,0.6153846153846154,0.3333333333333333,0.6666666666666666
SF-K22-1,SF-I28,2,7,0,3,2,4,0.0,1.0,0.42857142857142855,0.5714285714285714
SF-K22-1,SF-I30-2,3,5,2,4,1,1,0.6666666666666666,0.3333333333333333,0.8,0.2
SF-K22-1,SF I29-1,5,2,2,0,3,2,0.4,0.6,0.0,1.0
SF-K22-1,SF-H28,11,11,2,7,9,4,0.18181818181818182,0.8181818181818182,0.6363636363636364,0.36363636363636365
SF-K22-1,SF-H29,1,3,0,1,1,2,0.0,1.0,0.3333333333333333,0.6666666666666666
SF-K22-1,SF-S24,3,1,2,1,1,0,0.6666666666666666,0.3333333333333333,1.0,0.0
SF-K22-1,SF-R24,5,7,2,5,3,2,0.4,0.6,0.7142857142857143,0.2857142857142857
SF-K22-1,SF-P26,4,4,0,0,4,4,0.0,1.0,0.0,1.0
SF-K22-1,SF-O25-2,6,11,0,2,6,9,0.0,1.0,0.18181818181818182,0.8181818181818182
SF-K22-1,SF-N22-1B,2,4,2,4,0,0,1.0,0.0,1.0,0.0
SF-K22-1,SF-N25,1,2,0,2,1,0,0.0,1.0,1.0,0.0
SF-K22-1,SF-T21,2,2,0,1,2,1,0.0,1.0,0.5,0.5
SF-K22-1,SF-T22,8,17,6,7,2,10,0.75,0.25,0.4117647058823529,0.5882352941176471
SF-K22-1,SF-S22-2,2,7,0,3,2,4,0.0,1.0,0.42857142857142855,0.5714285714285714
SF-K22-1,SF-S22-1,4,5,2,5,2,0,0.5,0.5,1.0,0.0
SF-K22-1,SF-Q23-3,7,9,2,1,5,8,0.2857142857142857,0.7142857142857143,0.1111111111111111,0.8888888888888888
SF-K22-1,SF-Q22-1,7,14,4,7,3,7,0.5714285714285714,0.42857142857142855,0.5,0.5
SF-K22-1,SF-Q22-2,10,18,8,12,2,6,0.8,0.2,0.6666666666666666,0.3333333333333333
SF-K22-1,SF-P22,24,25,17,8,7,17,0.7083333333333334,0.2916666666666667,0.32,0.68
SF-K22-1,SF-U21,2,1,2,0,0,1,1.0,0.0,0.0,1.0
SF-K22-1,SF-T20,11,21,10,5,1,16,0.9090909090909091,0.09090909090909091,0.23809523809523808,0.7619047619047619
SF-K22-1,SF-S21,5,5,3,4,2,1,0.6,0.4,0.8,0.2
SF-K22-1,SF-W14,2,2,0,0,2,2,0.0,1.0,0.0,1.0
SF-J23-1,SF-M26,5,9,3,5,2,4,0.6,0.4,0.5555555555555556,0.4444444444444444
SF-J23-1,SF-M25,39,33,17,15,22,18,0.4358974358974359,0.5641025641025641,0.45454545454545453,0.5454545454545454
SF-J23-1,SF-M26-2,43,74,10,17,33,57,0.23255813953488372,0.7674418604651163,0.22972972972972974,0.7702702702702703
SF-J23-1,SF-L27,6,8,2,6,4,2,0.3333333333333333,0.6666666666666666,0.75,0.25
SF-J23-1,SF-K26,45,106,21,52,24,54,0.4666666666666667,0.5333333333333333,0.49056603773584906,0.5094339622641509
SF-J23-1,SF-J27,33,28,19,16,14,12,0.5757575757575758,0.42424242424242425,0.5714285714285714,0.42857142857142855
SF-J23-1,SF-M30,26,23,12,13,14,10,0.46153846153846156,0.5384615384615384,0.5652173913043478,0.43478260869565216
SF-J23-1,SF-L27-2,11,11,7,7,4,4,0.6363636363636364,0.36363636363636365,0.6363636363636364,0.36363636363636365
SF-J23-1,SF-J29-3,12,35,5,15,7,20,0.4166666666666667,0.5833333333333334,0.42857142857142855,0.5714285714285714
SF-J23-1,SF-J29,100,112,22,27,78,85,0.22,0.78,0.24107142857142858,0.7589285714285714
SF-J23-1,SF-L26,161,163,36,69,125,94,0.2236024844720497,0.7763975155279503,0.4233128834355828,0.5766871165644172
SF-J23-1,SF-M28,7,23,5,8,2,15,0.7142857142857143,0.2857142857142857,0.34782608695652173,0.6521739130434783
SF-J23-1,SF-M27,3,3,0,1,3,2,0.0,1.0,0.3333333333333333,0.6666666666666666
SF-J23-1,SF-L25,72,70,43,57,29,13,0.5972222222222222,0.4027777777777778,0.8142857142857143,0.18571428571428572
SF-J23-1,SF-M24,31,39,25,32,6,7,0.8064516129032258,0.1935483870967742,0.8205128205128205,0.1794871794871795
SF-J23-1,SF-L24,72,60,39,32,33,28,0.5416666666666666,0.4583333333333333,0.5333333333333333,0.4666666666666667
SF-J23-1,SF-N23,18,13,15,9,3,4,0.8333333333333334,0.16666666666666666,0.6923076923076923,0.3076923076923077
SF-J23-1,SF-N24-2,12,32,6,19,6,13,0.5,0.5,0.59375,0.40625
SF-J23-1,SF-K27-2,34,47,12,28,22,19,0.35294117647058826,0.6470588235294118,0.5957446808510638,0.40425531914893614
SF-J23-1,SF-J26-2,37,39,17,22,20,17,0.4594594594594595,0.5405405405405406,0.5641025641025641,0.4358974358974359
SF-J23-1,SF-L28,6,9,3,6,3,3,0.5,0.5,0.6666666666666666,0.3333333333333333
SF-J23-1,SF-K28,16,11,9,5,7,6,0.5625,0.4375,0.45454545454545453,0.5454545454545454
SF-J23-1,SF-K29-1,37,57,17,23,20,34,0.4594594594594595,0.5405405405405406,0.40350877192982454,0.5964912280701754
SF-J23-1,SF-J28-2,22,19,11,14,11,5,0.5,0.5,0.7368421052631579,0.2631578947368421
SF-J23-1,SF-K27,14,4,7,1,7,3,0.5,0.5,0.25,0.75
SF-J23-1,SF-K25,61,28,51,21,10,7,0.8360655737704918,0.16393442622950818,0.75,0.25
SF-J23-1,SF-J25,164,139,96,91,68,48,0.5853658536585366,0.4146341463414634,0.6546762589928058,0.34532374100719426
SF-J23-1,SF-H26-2,37,35,19,17,18,18,0.5135135135135135,0.4864864864864865,0.4857142857142857,0.5142857142857142
SF-J23-1,SF-P24,23,31,9,17,14,14,0.391304347826087,0.6086956521739131,0.5483870967741935,0.45161290322580644
SF-J23-1,SF-N22-1A,6,5,3,5,3,0,0.5,0.5,1.0,0.0
SF-J23-1,SF-J24,39,66,19,37,20,29,0.48717948717948717,0.5128205128205128,0.5606060606060606,0.4393939393939394
SF-J23-1,SF-O24,37,21,29,14,8,7,0.7837837837837838,0.21621621621621623,0.6666666666666666,0.3333333333333333
SF-J23-1,SF-J26,22,55,12,33,10,22,0.5454545454545454,0.45454545454545453,0.6,0.4
SF-J23-1,SF-I26-,26,13,11,7,15,6,0.4230769230769231,0.5769230769230769,0.5384615384615384,0.46153846153846156
SF-J23-1,SF-I25,289,227,219,174,70,53,0.7577854671280276,0.2422145328719723,0.7665198237885462,0.23348017621145375
SF-J23-1,SF-K23,11,9,8,7,3,2,0.7272727272727273,0.2727272727272727,0.7777777777777778,0.2222222222222222
SF-J23-1,SF-H26,335,369,224,231,111,138,0.6686567164179105,0.33134328358208953,0.6260162601626016,0.37398373983739835
SF-J23-1,SF-O23,31,31,6,15,25,16,0.1935483870967742,0.8064516129032258,0.4838709677419355,0.5161290322580645
SF-J23-1,SF-H27-1,18,35,6,19,12,16,0.3333333333333333,0.6666666666666666,0.5428571428571428,0.45714285714285713
SF-J23-1,SF-F28-2,97,139,47,70,50,69,0.4845360824742268,0.5154639175257731,0.5035971223021583,0.49640287769784175
SF-J23-1,SF-G27,360,478,203,316,157,162,0.5638888888888889,0.4361111111111111,0.6610878661087866,0.3389121338912134
SF-J23-1,SF-M22-2,143,114,76,50,67,64,0.5314685314685315,0.46853146853146854,0.43859649122807015,0.5614035087719298
SF-J23-1,SF-L22,66,46,33,17,33,29,0.5,0.5,0.3695652173913043,0.6304347826086957
SF-J23-1,SF-F27,91,125,34,61,57,64,0.37362637362637363,0.6263736263736264,0.488,0.512
SF-J23-1,SF-N22-2,129,150,63,88,66,62,0.4883720930232558,0.5116279069767442,0.5866666666666667,0.41333333333333333
SF-J23-1,SF-G28-2,17,14,14,10,3,4,0.8235294117647058,0.17647058823529413,0.7142857142857143,0.2857142857142857
SF-J23-1,SF-G28-1,6,18,1,10,5,8,0.16666666666666666,0.8333333333333334,0.5555555555555556,0.4444444444444444
SF-J23-1,SF-M22-1,35,31,13,12,22,19,0.37142857142857144,0.6285714285714286,0.3870967741935484,0.6129032258064516
SF-J23-1,SF-O25-1,13,8,1,1,12,7,0.07692307692307693,0.9230769230769231,0.125,0.875
SF-J23-1,SF-K22-2,68,53,45,37,23,16,0.6617647058823529,0.3382352941176471,0.6981132075471698,0.3018867924528302
SF-J23-1,SF-K24,67,34,41,13,26,21,0.6119402985074627,0.3880597014925373,0.38235294117647056,0.6176470588235294
SF-J23-1,SF-J23-2,67,36,44,26,23,10,0.6567164179104478,0.34328358208955223,0.7222222222222222,0.2777777777777778
SF-J23-1,SF-G23,60,32,30,6,30,26,0.5,0.5,0.1875,0.8125
SF-J23-1,SF-G24,192,153,98,29,94,124,0.5104166666666666,0.4895833333333333,0.1895424836601307,0.8104575163398693
SF-J23-1,SF-G25,108,57,39,14,69,43,0.3611111111111111,0.6388888888888888,0.24561403508771928,0.7543859649122807
SF-J23-1,SF-F23,102,67,49,11,53,56,0.4803921568627451,0.5196078431372549,0.16417910447761194,0.835820895522388
SF-J23-1,SF-E23,86,89,46,27,40,62,0.5348837209302325,0.46511627906976744,0.30337078651685395,0.6966292134831461
SF-J23-1,SF-D24,13,39,7,20,6,19,0.5384615384615384,0.46153846153846156,0.5128205128205128,0.48717948717948717
SF-J23-1,SF-C22,11,29,1,6,10,23,0.09090909090909091,0.9090909090909091,0.20689655172413793,0.7931034482758621
SF-J23-1,SF-B22,28,45,13,15,15,30,0.4642857142857143,0.5357142857142857,0.3333333333333333,0.6666666666666666
SF-J23-1,SF-J17,22,33,7,2,15,31,0.3181818181818182,0.6818181818181818,0.06060606060606061,0.9393939393939394
SF-J23-1,SF-I19,9,9,2,1,7,8,0.2222222222222222,0.7777777777777778,0.1111111111111111,0.8888888888888888
SF-J23-1,SF-I20,33,13,14,7,19,6,0.42424242424242425,0.5757575757575758,0.5384615384615384,0.46153846153846156
SF-J23-1,SF-H16,10,5,1,0,9,5,0.1,0.9,0.0,1.0
SF-J23-1,SF-H19,7,1,7,0,0,1,1.0,0.0,0.0,1.0
SF-J23-1,SF-H20,21,32,10,15,11,17,0.47619047619047616,0.5238095238095238,0.46875,0.53125
SF-J23-1,SF-H18,3,2,1,0,2,2,0.3333333333333333,0.6666666666666666,0.0,1.0
SF-J23-1,SF-H17,3,2,1,1,2,1,0.3333333333333333,0.6666666666666666,0.5,0.5
SF-J23-1,SF-G19,49,36,14,5,35,31,0.2857142857142857,0.7142857142857143,0.1388888888888889,0.8611111111111112
SF-J23-1,SF-G17,15,19,7,0,8,19,0.4666666666666667,0.5333333333333333,0.0,1.0
SF-J23-1,SF-G18,38,18,7,5,31,13,0.18421052631578946,0.8157894736842105,0.2777777777777778,0.7222222222222222
SF-J23-1,SF-G20,41,25,18,5,23,20,0.43902439024390244,0.5609756097560976,0.2,0.8
SF-J23-1,SF-F19,8,14,2,0,6,14,0.25,0.75,0.0,1.0
SF-J23-1,SF-E18,14,12,7,1,7,11,0.5,0.5,0.08333333333333333,0.9166666666666666
SF-J23-1,SF-E20,13,13,3,0,10,13,0.23076923076923078,0.7692307692307693,0.0,1.0
SF-J23-1,SF-H30,14,26,7,13,7,13,0.5,0.5,0.5,0.5
SF-J23-1,SF-G30-2,41,61,3,27,38,34,0.07317073170731707,0.926829268292683,0.4426229508196721,0.5573770491803278
SF-J23-1,SF-F30-1,3,20,1,7,2,13,0.3333333333333333,0.6666666666666666,0.35,0.65
SF-J23-1,SF-E29-2,172,215,71,144,101,71,0.4127906976744186,0.5872093023255814,0.6697674418604651,0.3302325581395349
SF-J23-1,SF-E29-1,81,126,35,79,46,47,0.43209876543209874,0.5679012345679012,0.626984126984127,0.373015873015873
SF-J23-1,SF-D29,25,25,12,15,13,10,0.48,0.52,0.6,0.4
SF-J23-1,SF-D28,21,23,10,12,11,11,0.47619047619047616,0.5238095238095238,0.5217391304347826,0.4782608695652174
SF-J23-1,SF-A27,15,19,10,14,5,5,0.6666666666666666,0.3333333333333333,0.7368421052631579,0.2631578947368421
SF-J23-1,SF-G29-2,62,60,25,25,37,35,0.4032258064516129,0.5967741935483871,0.4166666666666667,0.5833333333333334
SF-J23-1,SF-G29-1,42,44,9,13,33,31,0.21428571428571427,0.7857142857142857,0.29545454545454547,0.7045454545454546
SF-J23-1,SF-G30-1,18,30,5,8,13,22,0.2777777777777778,0.7222222222222222,0.26666666666666666,0.7333333333333333
SF-J23-1,SF-G29-3,33,48,11,23,22,25,0.3333333333333333,0.6666666666666666,0.4791666666666667,0.5208333333333334
SF-J23-1,SF-F30-2,8,28,1,10,7,18,0.125,0.875,0.35714285714285715,0.6428571428571429
SF-J23-1,SF-F29,7,16,5,9,2,7,0.7142857142857143,0.2857142857142857,0.5625,0.4375
SF-J23-1,SF-E29-3,42,52,15,27,27,25,0.35714285714285715,0.6428571428571429,0.5192307692307693,0.4807692307692308
SF-J23-1,SF-F28-1,114,60,51,36,63,24,0.4473684210526316,0.5526315789473685,0.6,0.4
SF-J23-1,SF-E28-2,16,16,3,8,13,8,0.1875,0.8125,0.5,0.5
SF-J23-1,SF-E28,30,39,10,21,20,18,0.3333333333333333,0.6666666666666666,0.5384615384615384,0.46153846153846156
SF-J23-1,SF-J10,10,7,10,0,0,7,1.0,0.0,0.0,1.0
SF-J23-1,SF-J12,23,15,14,6,9,9,0.6086956521739131,0.391304347826087,0.4,0.6
SF-J23-1,SF-J13,8,8,1,1,7,7,0.125,0.875,0.125,0.875
SF-J23-1,SF-J14,2,3,1,0,1,3,0.5,0.5,0.0,1.0
SF-J23-1,SF-H13,4,2,0,0,4,2,0.0,1.0,0.0,1.0
SF-J23-1,SF-I16,2,2,1,0,1,2,0.5,0.5,0.0,1.0
SF-J23-1,SF-H12,16,19,0,3,16,16,0.0,1.0,0.15789473684210525,0.8421052631578947
SF-J23-1,SF-G10-2,2,1,1,1,1,0,0.5,0.5,1.0,0.0
SF-J23-1,SF-H15,7,7,0,0,7,7,0.0,1.0,0.0,1.0
SF-J23-1,SF-G9,4,4,0,0,4,4,0.0,1.0,0.0,1.0
SF-J23-1,SF-G13,6,8,0,2,6,6,0.0,1.0,0.25,0.75
SF-J23-1,SF-G11,3,3,2,1,1,2,0.6666666666666666,0.3333333333333333,0.3333333333333333,0.6666666666666666
SF-J23-1,SF-G12,2,1,2,0,0,1,1.0,0.0,0.0,1.0
SF-J23-1,SF-G10-1,5,2,0,0,5,2,0.0,1.0,0.0,1.0
SF-J23-1,SF-F15,49,23,5,0,44,23,0.10204081632653061,0.8979591836734694,0.0,1.0
SF-J23-1,SF-F16,17,8,1,2,16,6,0.058823529411764705,0.9411764705882353,0.25,0.75
SF-J23-1,SF-C21,5,1,1,0,4,1,0.2,0.8,0.0,1.0
SF-J23-1,SF-C20,30,20,1,2,29,18,0.03333333333333333,0.9666666666666667,0.1,0.9
SF-J23-1,SF-B21,3,6,1,3,2,3,0.3333333333333333,0.6666666666666666,0.5,0.5
SF-J23-1,SF-B19,11,21,0,4,11,17,0.0,1.0,0.19047619047619047,0.8095238095238095
SF-J23-1,SF-A20,19,12,0,6,19,6,0.0,1.0,0.5,0.5
SF-J23-1,SF-A19,2,6,0,2,2,4,0.0,1.0,0.3333333333333333,0.6666666666666666
SF-J23-1,SF-C26,30,28,7,4,23,24,0.23333333333333334,0.7666666666666667,0.14285714285714285,0.8571428571428571
SF-J23-1,SF-C25,18,30,5,6,13,24,0.2777777777777778,0.7222222222222222,0.2,0.8
SF-J23-1,SF-B25,20,22,3,13,17,9,0.15,0.85,0.5909090909090909,0.4090909090909091
SF-J23-1,SF-E27,25,19,11,12,14,7,0.44,0.56,0.631578947368421,0.3684210526315789
SF-J23-1,SF-B28-2,31,24,11,8,20,16,0.3548387096774194,0.6451612903225806,0.3333333333333333,0.6666666666666666
SF-J23-1,SF-D27,51,58,20,27,31,31,0.39215686274509803,0.6078431372549019,0.46551724137931033,0.5344827586206896
SF-J23-1,SF-C28-2,17,17,1,7,16,10,0.058823529411764705,0.9411764705882353,0.4117647058823529,0.5882352941176471
SF-J23-1,SF-C28-1,11,12,6,6,5,6,0.5454545454545454,0.45454545454545453,0.5,0.5
SF-J23-1,SF-B28,18,28,8,17,10,11,0.4444444444444444,0.5555555555555556,0.6071428571428571,0.39285714285714285
SF-J23-1,SF-J1,23,19,1,2,22,17,0.043478260869565216,0.9565217391304348,0.10526315789473684,0.8947368421052632
SF-J23-1,SF-H0,3,2,1,0,2,2,0.3333333333333333,0.6666666666666666,0.0,1.0
SF-J23-1,SF-G8,21,24,1,1,20,23,0.047619047619047616,0.9523809523809523,0.041666666666666664,0.9583333333333334
SF-J23-1,SF-G5,1,2,1,0,0,2,1.0,0.0,0.0,1.0
SF-J23-1,SF-G7,8,6,2,1,6,5,0.25,0.75,0.16666666666666666,0.8333333333333334
SF-J23-1,SF-F9,1,4,0,1,1,3,0.0,1.0,0.25,0.75
SF-J23-1,SF-H25,75,111,69,98,6,13,0.92,0.08,0.8828828828828829,0.11711711711711711
SF-J23-1,SF-G26,69,67,36,37,33,30,0.5217391304347826,0.4782608695652174,0.5522388059701493,0.44776119402985076
SF-J23-1,SF-K21,78,31,42,5,36,26,0.5384615384615384,0.46153846153846156,0.16129032258064516,0.8387096774193549
SF-J23-1,SF-K22-1,99,156,84,134,15,22,0.8484848484848485,0.15151515151515152,0.8589743589743589,0.14102564102564102
SF-J23-1,SF-J22-1,51,42,32,22,19,20,0.6274509803921569,0.37254901960784315,0.5238095238095238,0.47619047619047616
SF-J23-1,SF-J22-2,28,41,18,25,10,16,0.6428571428571429,0.35714285714285715,0.6097560975609756,0.3902439024390244
SF-J23-1,SF-J21,96,98,56,54,40,44,0.5833333333333334,0.4166666666666667,0.5510204081632653,0.4489795918367347
SF-J23-1,SF-I21,17,10,12,7,5,3,0.7058823529411765,0.29411764705882354,0.7,0.3
SF-J23-1,SF-I22,22,15,9,9,13,6,0.4090909090909091,0.5909090909090909,0.6,0.4
SF-J23-1,SF-I23-2,53,77,38,57,15,20,0.7169811320754716,0.2830188679245283,0.7402597402597403,0.2597402597402597
SF-J23-1,SF-I24,18,19,13,15,5,4,0.7222222222222222,0.2777777777777778,0.7894736842105263,0.21052631578947367
SF-J23-1,SF-I23-1,76,75,55,42,21,33,0.7236842105263158,0.27631578947368424,0.56,0.44
SF-J23-1,SF-F26,152,134,51,40,101,94,0.3355263157894737,0.6644736842105263,0.29850746268656714,0.7014925373134329
SF-J23-1,SF-M13,30,26,7,5,23,21,0.23333333333333334,0.7666666666666667,0.19230769230769232,0.8076923076923077
SF-J23-1,SF-M15,44,41,9,5,35,36,0.20454545454545456,0.7954545454545454,0.12195121951219512,0.8780487804878049
SF-J23-1,SF-L19,47,34,23,8,24,26,0.48936170212765956,0.5106382978723404,0.23529411764705882,0.7647058823529411
SF-J23-1,SF-L20,52,48,28,10,24,38,0.5384615384615384,0.46153846153846156,0.20833333333333334,0.7916666666666666
SF-J23-1,SF-N20-1,44,46,13,13,31,33,0.29545454545454547,0.7045454545454546,0.2826086956521739,0.717391304347826
SF-J23-1,SF-M20,169,196,49,50,120,146,0.28994082840236685,0.7100591715976331,0.25510204081632654,0.7448979591836735
SF-J23-1,SF-K17-2,39,20,21,2,18,18,0.5384615384615384,0.46153846153846156,0.1,0.9
SF-J23-1,SF-K20,49,51,18,13,31,38,0.3673469387755102,0.6326530612244898,0.2549019607843137,0.7450980392156863
SF-J23-1,SF-K15-,86,69,31,20,55,49,0.36046511627906974,0.6395348837209303,0.2898550724637681,0.7101449275362319
SF-J23-1,SF-K19,117,92,36,16,81,76,0.3076923076923077,0.6923076923076923,0.17391304347826086,0.8260869565217391
SF-J23-1,SF-K18,61,31,20,9,41,22,0.32786885245901637,0.6721311475409836,0.2903225806451613,0.7096774193548387
SF-J23-1,SF-K17,38,31,14,16,24,15,0.3684210526315789,0.631578947368421,0.5161290322580645,0.4838709677419355
SF-J23-1,SF-J16,14,16,1,0,13,16,0.07142857142857142,0.9285714285714286,0.0,1.0
SF-J23-1,SF-J18,35,27,4,0,31,27,0.11428571428571428,0.8857142857142857,0.0,1.0
SF-J23-1,SF-J20,18,17,14,13,4,4,0.7777777777777778,0.2222222222222222,0.7647058823529411,0.23529411764705882
SF-J23-1,SF-J19,33,36,20,16,13,20,0.6060606060606061,0.3939393939393939,0.4444444444444444,0.5555555555555556
SF-J23-1,SF-M12,10,9,4,1,6,8,0.4,0.6,0.1111111111111111,0.8888888888888888
SF-J23-1,SF-M10,25,9,20,1,5,8,0.8,0.2,0.1111111111111111,0.8888888888888888
SF-J23-1,SF-M11,46,24,29,3,17,21,0.6304347826086957,0.3695652173913043,0.125,0.875
SF-J23-1,SF-R19,9,11,4,0,5,11,0.4444444444444444,0.5555555555555556,0.0,1.0
SF-J23-1,SF-R20,14,6,1,0,13,6,0.07142857142857142,0.9285714285714286,0.0,1.0
SF-J23-1,SF-Q21-2,84,49,18,3,66,46,0.21428571428571427,0.7857142857142857,0.061224489795918366,0.9387755102040817
SF-J23-1,SF-Q21-1,13,9,6,5,7,4,0.46153846153846156,0.5384615384615384,0.5555555555555556,0.4444444444444444
SF-J23-1,SF-P21,28,27,6,3,22,24,0.21428571428571427,0.7857142857142857,0.1111111111111111,0.8888888888888888
SF-J23-1,SF-O18,38,39,8,14,30,25,0.21052631578947367,0.7894736842105263,0.358974358974359,0.6410256410256411
SF-J23-1,SF-O19,47,49,10,10,37,39,0.2127659574468085,0.7872340425531915,0.20408163265306123,0.7959183673469388
SF-J23-1,SF-O21,94,130,34,67,60,63,0.3617021276595745,0.6382978723404256,0.5153846153846153,0.4846153846153846
SF-J23-1,SF-O22,89,125,34,63,55,62,0.38202247191011235,0.6179775280898876,0.504,0.496
SF-J23-1,SF-N21,31,31,12,10,19,21,0.3870967741935484,0.6129032258064516,0.3225806451612903,0.6774193548387096
SF-J23-1,SF-N20-2,15,20,3,9,12,11,0.2,0.8,0.45,0.55
SF-J23-1,SF-M21,30,28,6,6,24,22,0.2,0.8,0.21428571428571427,0.7857142857142857
SF-J23-1,SF-L21,439,410,239,153,200,257,0.5444191343963554,0.45558086560364464,0.37317073170731707,0.6268292682926829
SF-J23-1,SF-S29,6,5,1,2,5,3,0.16666666666666666,0.8333333333333334,0.4,0.6
SF-J23-1,SF-S30,6,6,1,1,5,5,0.16666666666666666,0.8333333333333334,0.16666666666666666,0.8333333333333334
SF-J23-1,SF-Q30,67,17,3,6,64,11,0.04477611940298507,0.9552238805970149,0.35294117647058826,0.6470588235294118
SF-J23-1,SF-P30,15,42,2,7,13,35,0.13333333333333333,0.8666666666666667,0.16666666666666666,0.8333333333333334
SF-J23-1,SF-O30-2,16,6,7,4,9,2,0.4375,0.5625,0.6666666666666666,0.3333333333333333
SF-J23-1,SF-O30,23,18,5,7,18,11,0.21739130434782608,0.782608695652174,0.3888888888888889,0.6111111111111112
SF-J23-1,SF-N27,19,29,4,17,15,12,0.21052631578947367,0.7894736842105263,0.5862068965517241,0.41379310344827586
SF-J23-1,SF-N29,6,15,1,7,5,8,0.16666666666666666,0.8333333333333334,0.4666666666666667,0.5333333333333333
SF-J23-1,SF-N28,10,11,6,7,4,4,0.6,0.4,0.6363636363636364,0.36363636363636365
SF-J23-1,SF-L30-1,38,35,16,16,22,19,0.42105263157894735,0.5789473684210527,0.45714285714285713,0.5428571428571428
SF-J23-1,SF-L31-1,7,5,4,4,3,1,0.5714285714285714,0.42857142857142855,0.8,0.2
SF-J23-1,SF-K30-2,8,9,6,1,2,8,0.75,0.25,0.1111111111111111,0.8888888888888888
SF-J23-1,SF-L29,16,29,6,11,10,18,0.375,0.625,0.3793103448275862,0.6206896551724138
SF-J23-1,SF-J29-1,9,9,4,0,5,9,0.4444444444444444,0.5555555555555556,0.0,1.0
SF-J23-1,SF-I30,7,8,3,2,4,6,0.42857142857142855,0.5714285714285714,0.25,0.75
SF-J23-1,SF-I29-2,25,23,0,2,25,21,0.0,1.0,0.08695652173913043,0.9130434782608695
SF-J23-1,SF-I27,43,41,10,16,33,25,0.23255813953488372,0.7674418604651163,0.3902439024390244,0.6097560975609756
SF-J23-1,SF-I28,35,23,8,12,27,11,0.22857142857142856,0.7714285714285715,0.5217391304347826,0.4782608695652174
SF-J23-1,SF-I30-2,8,14,3,9,5,5,0.375,0.625,0.6428571428571429,0.35714285714285715
SF-J23-1,SF I29-1,39,18,10,1,29,17,0.2564102564102564,0.7435897435897436,0.05555555555555555,0.9444444444444444
SF-J23-1,SF-H28,68,73,33,59,35,14,0.4852941176470588,0.5147058823529411,0.8082191780821918,0.1917808219178082
SF-J23-1,SF-H29,5,11,1,5,4,6,0.2,0.8,0.45454545454545453,0.5454545454545454
SF-J23-1,SF-S24,12,14,4,5,8,9,0.3333333333333333,0.6666666666666666,0.35714285714285715,0.6428571428571429
SF-J23-1,SF-R24,64,67,39,45,25,22,0.609375,0.390625,0.6716417910447762,0.3283582089552239
SF-J23-1,SF-R26,2,4,0,1,2,3,0.0,1.0,0.25,0.75
SF-J23-1,SF-Q26,7,19,3,10,4,9,0.42857142857142855,0.5714285714285714,0.5263157894736842,0.47368421052631576
SF-J23-1,SF-P26,19,22,6,4,13,18,0.3157894736842105,0.6842105263157895,0.18181818181818182,0.8181818181818182
SF-J23-1,SF-O25-2,7,7,2,1,5,6,0.2857142857142857,0.7142857142857143,0.14285714285714285,0.8571428571428571
SF-J23-1,SF-N22-1B,14,17,7,13,7,4,0.5,0.5,0.7647058823529411,0.23529411764705882
SF-J23-1,SF-N26,8,9,0,1,8,8,0.0,1.0,0.1111111111111111,0.8888888888888888
SF-J23-1,SF-N25,3,7,2,1,1,6,0.6666666666666666,0.3333333333333333,0.14285714285714285,0.8571428571428571
SF-J23-1,SF-T21,4,5,1,0,3,5,0.25,0.75,0.0,1.0
SF-J23-1,SF-T22,43,30,8,7,35,23,0.18604651162790697,0.813953488372093,0.23333333333333334,0.7666666666666667
SF-J23-1,SF-S22-2,9,9,1,0,8,9,0.1111111111111111,0.8888888888888888,0.0,1.0
SF-J23-1,SF-S22-1,38,32,16,9,22,23,0.42105263157894735,0.5789473684210527,0.28125,0.71875
SF-J23-1,SF-Q23-3,21,30,5,9,16,21,0.23809523809523808,0.7619047619047619,0.3,0.7
SF-J23-1,SF-Q22-1,36,40,23,24,13,16,0.6388888888888888,0.3611111111111111,0.6,0.4
SF-J23-1,SF-Q22-2,74,71,26,21,48,50,0.35135135135135137,0.6486486486486487,0.29577464788732394,0.704225352112676
SF-J23-1,SF-P22,49,38,16,22,33,16,0.32653061224489793,0.673469387755102,0.5789473684210527,0.42105263157894735
SF-J23-1,SF-W19,4,2,1,1,3,1,0.25,0.75,0.5,0.5
SF-J23-1,SF-W19-2,2,3,0,1,2,2,0.0,1.0,0.3333333333333333,0.6666666666666666
SF-J23-1,SF-U21,22,19,4,3,18,16,0.18181818181818182,0.8181818181818182,0.15789473684210525,0.8421052631578947
SF-J23-1,SF-T20,14,12,5,1,9,11,0.35714285714285715,0.6428571428571429,0.08333333333333333,0.9166666666666666
SF-J23-1,SF-S21,59,85,52,75,7,10,0.8813559322033898,0.11864406779661017,0.8823529411764706,0.11764705882352941
SF-J23-1,SF-V28,2,2,0,0,2,2,0.0,1.0,0.0,1.0
SF-J23-1,SF-W14,3,1,0,0,3,1,0.0,1.0,0.0,1.0
SF-J23-1,SF-AA15,1,2,1,2,0,0,1.0,0.0,1.0,0.0
SF-J22-1,SF-M26,1,3,0,1,1,2,0.0,1.0,0.3333333333333333,0.6666666666666666
SF-J22-1,SF-M25,14,12,8,8,6,4,0.5714285714285714,0.42857142857142855,0.6666666666666666,0.3333333333333333
SF-J22-1,SF-M26-2,52,13,36,6,16,7,0.6923076923076923,0.3076923076923077,0.46153846153846156,0.5384615384615384
SF-J22-1,SF-L27,5,2,1,0,4,2,0.2,0.8,0.0,1.0
SF-J22-1,SF-K26,35,47,13,14,22,33,0.37142857142857144,0.6285714285714286,0.2978723404255319,0.7021276595744681
SF-J22-1,SF-J27,4,6,4,1,0,5,1.0,0.0,0.16666666666666666,0.8333333333333334
SF-J22-1,SF-M30,9,4,4,2,5,2,0.4444444444444444,0.5555555555555556,0.5,0.5
SF-J22-1,SF-J29-3,3,5,0,0,3,5,0.0,1.0,0.0,1.0
SF-J22-1,SF-J29,18,36,8,11,10,25,0.4444444444444444,0.5555555555555556,0.3055555555555556,0.6944444444444444
SF-J22-1,SF-L26,22,17,15,7,7,10,0.6818181818181818,0.3181818181818182,0.4117647058823529,0.5882352941176471
SF-J22-1,SF-M28,7,5,0,1,7,4,0.0,1.0,0.2,0.8
SF-J22-1,SF-L25,20,11,14,6,6,5,0.7,0.3,0.5454545454545454,0.45454545454545453
SF-J22-1,SF-M24,2,5,1,2,1,3,0.5,0.5,0.4,0.6
SF-J22-1,SF-L24,14,12,6,9,8,3,0.42857142857142855,0.5714285714285714,0.75,0.25
SF-J22-1,SF-N23,1,8,0,5,1,3,0.0,1.0,0.625,0.375
SF-J22-1,SF-N24-2,11,19,8,15,3,4,0.7272727272727273,0.2727272727272727,0.7894736842105263,0.21052631578947367
SF-J22-1,SF-K27-2,21,17,3,3,18,14,0.14285714285714285,0.8571428571428571,0.17647058823529413,0.8235294117647058
SF-J22-1,SF-J26-2,8,11,4,2,4,9,0.5,0.5,0.18181818181818182,0.8181818181818182
SF-J22-1,SF-K28-3,3,2,1,0,2,2,0.3333333333333333,0.6666666666666666,0.0,1.0
SF-J22-1,SF-L28,6,6,3,4,3,2,0.5,0.5,0.6666666666666666,0.3333333333333333
SF-J22-1,SF-K28,4,3,3,2,1,1,0.75,0.25,0.6666666666666666,0.3333333333333333
SF-J22-1,SF-K29-1,10,7,4,2,6,5,0.4,0.6,0.2857142857142857,0.7142857142857143
SF-J22-1,SF-J28-2,3,4,0,2,3,2,0.0,1.0,0.5,0.5
SF-J22-1,SF-K27,9,2,1,1,8,1,0.1111111111111111,0.8888888888888888,0.5,0.5
SF-J22-1,SF-K25,14,7,4,3,10,4,0.2857142857142857,0.7142857142857143,0.42857142857142855,0.5714285714285714
SF-J22-1,SF-J25,7,3,3,1,4,2,0.42857142857142855,0.5714285714285714,0.3333333333333333,0.6666666666666666
SF-J22-1,SF-H26-2,9,19,5,3,4,16,0.5555555555555556,0.4444444444444444,0.15789473684210525,0.8421052631578947
SF-J22-1,SF-P24,11,12,6,4,5,8,0.5454545454545454,0.45454545454545453,0.3333333333333333,0.6666666666666666
SF-J22-1,SF-J24,7,2,3,1,4,1,0.42857142857142855,0.5714285714285714,0.5,0.5
SF-J22-1,SF-O24,8,6,4,4,4,2,0.5,0.5,0.6666666666666666,0.3333333333333333
SF-J22-1,SF-J26,4,3,0,0,4,3,0.0,1.0,0.0,1.0
SF-J22-1,SF-I26-,4,3,2,2,2,1,0.5,0.5,0.6666666666666666,0.3333333333333333
SF-J22-1,SF-I25,41,46,25,36,16,10,0.6097560975609756,0.3902439024390244,0.782608695652174,0.21739130434782608
SF-J22-1,SF-K23,13,19,8,13,5,6,0.6153846153846154,0.38461538461538464,0.6842105263157895,0.3157894736842105
SF-J22-1,SF-H26,82,56,41,31,41,25,0.5,0.5,0.5535714285714286,0.44642857142857145
SF-J22-1,SF-O23,12,9,6,3,6,6,0.5,0.5,0.3333333333333333,0.6666666666666666
SF-J22-1,SF-H27-1,5,4,3,2,2,2,0.6,0.4,0.5,0.5
SF-J22-1,SF-F28-2,41,31,6,14,35,17,0.14634146341463414,0.8536585365853658,0.45161290322580644,0.5483870967741935
SF-J22-1,SF-G27,66,67,28,24,38,43,0.42424242424242425,0.5757575757575758,0.3582089552238806,0.6417910447761194
SF-J22-1,SF-M22-2,41,46,16,20,25,26,0.3902439024390244,0.6097560975609756,0.43478260869565216,0.5652173913043478
SF-J22-1,SF-L22,13,17,5,6,8,11,0.38461538461538464,0.6153846153846154,0.35294117647058826,0.6470588235294118
SF-J22-1,SF-F27,16,11,5,4,11,7,0.3125,0.6875,0.36363636363636365,0.6363636363636364
SF-J22-1,SF-N22-2,50,36,22,15,28,21,0.44,0.56,0.4166666666666667,0.5833333333333334
SF-J22-1,SF-G28-2,1,1,0,0,1,1,0.0,1.0,0.0,1.0
SF-J22-1,SF-G28-1,4,3,3,1,1,2,0.75,0.25,0.3333333333333333,0.6666666666666666
SF-J22-1,SF-M22-1,17,5,1,2,16,3,0.058823529411764705,0.9411764705882353,0.4,0.6
SF-J22-1,SF-O25-1,4,9,1,2,3,7,0.25,0.75,0.2222222222222222,0.7777777777777778
SF-J22-1,SF-K22-2,10,12,4,6,6,6,0.4,0.6,0.5,0.5
SF-J22-1,SF-K24,12,4,9,1,3,3,0.75,0.25,0.25,0.75
SF-J22-1,SF-J23-2,17,4,13,1,4,3,0.7647058823529411,0.23529411764705882,0.25,0.75
SF-J22-1,SF-G23,10,4,3,1,7,3,0.3,0.7,0.25,0.75
SF-J22-1,SF-G24,16,17,8,3,8,14,0.5,0.5,0.17647058823529413,0.8235294117647058
SF-J22-1,SF-G25,7,9,4,1,3,8,0.5714285714285714,0.42857142857142855,0.1111111111111111,0.8888888888888888
SF-J22-1,SF-F23,17,29,11,5,6,24,0.6470588235294118,0.35294117647058826,0.1724137931034483,0.8275862068965517
SF-J22-1,SF-E23,5,19,3,6,2,13,0.6,0.4,0.3157894736842105,0.6842105263157895
SF-J22-1,SF-D24,2,5,2,0,0,5,1.0,0.0,0.0,1.0
SF-J22-1,SF-C22,10,10,4,1,6,9,0.4,0.6,0.1,0.9
SF-J22-1,SF-B22,4,13,0,2,4,11,0.0,1.0,0.15384615384615385,0.8461538461538461
SF-J22-1,SF-J17,10,11,5,1,5,10,0.5,0.5,0.09090909090909091,0.9090909090909091
SF-J22-1,SF-I19,2,1,0,0,2,1,0.0,1.0,0.0,1.0
SF-J22-1,SF-I20,11,19,5,6,6,13,0.45454545454545453,0.5454545454545454,0.3157894736842105,0.6842105263157895
SF-J22-1,SF-H16,2,2,0,0,2,2,0.0,1.0,0.0,1.0
SF-J22-1,SF-H19,1,3,0,2,1,1,0.0,1.0,0.6666666666666666,0.3333333333333333
SF-J22-1,SF-H20,13,16,5,4,8,12,0.38461538461538464,0.6153846153846154,0.25,0.75
SF-J22-1,SF-H18,3,3,1,1,2,2,0.3333333333333333,0.6666666666666666,0.3333333333333333,0.6666666666666666
SF-J22-1,SF-G19,6,6,0,3,6,3,0.0,1.0,0.5,0.5
SF-J22-1,SF-G18,9,11,1,2,8,9,0.1111111111111111,0.8888888888888888,0.18181818181818182,0.8181818181818182
SF-J22-1,SF-G20,42,46,6,8,36,38,0.14285714285714285,0.8571428571428571,0.17391304347826086,0.8260869565217391
SF-J22-1,SF-F19,55,56,5,7,50,49,0.09090909090909091,0.9090909090909091,0.125,0.875
SF-J22-1,SF-E18,4,7,0,0,4,7,0.0,1.0,0.0,1.0
SF-J22-1,SF-E20,15,10,3,0,12,10,0.2,0.8,0.0,1.0
SF-J22-1,SF-G30-2,14,19,3,6,11,13,0.21428571428571427,0.7857142857142857,0.3157894736842105,0.6842105263157895
SF-J22-1,SF-F30-1,2,1,0,0,2,1,0.0,1.0,0.0,1.0
SF-J22-1,SF-E29-2,24,52,9,29,15,23,0.375,0.625,0.5576923076923077,0.4423076923076923
SF-J22-1,SF-E29-1,31,32,22,19,9,13,0.7096774193548387,0.2903225806451613,0.59375,0.40625
SF-J22-1,SF-D28,1,14,0,1,1,13,0.0,1.0,0.07142857142857142,0.9285714285714286
SF-J22-1,SF-A27,4,5,3,2,1,3,0.75,0.25,0.4,0.6
SF-J22-1,SF-G29-2,9,12,6,8,3,4,0.6666666666666666,0.3333333333333333,0.6666666666666666,0.3333333333333333
SF-J22-1,SF-G29-1,6,3,3,1,3,2,0.5,0.5,0.3333333333333333,0.6666666666666666
SF-J22-1,SF-G30-1,7,4,4,1,3,3,0.5714285714285714,0.42857142857142855,0.25,0.75
SF-J22-1,SF-G29-3,9,4,7,1,2,3,0.7777777777777778,0.2222222222222222,0.25,0.75
SF-J22-1,SF-F30-2,2,2,0,0,2,2,0.0,1.0,0.0,1.0
SF-J22-1,SF-F29,3,3,0,1,3,2,0.0,1.0,0.3333333333333333,0.6666666666666666
SF-J22-1,SF-E29-3,8,3,2,0,6,3,0.25,0.75,0.0,1.0
SF-J22-1,SF-F28-1,21,10,9,4,12,6,0.42857142857142855,0.5714285714285714,0.4,0.6
SF-J22-1,SF-E28,2,3,1,1,1,2,0.5,0.5,0.3333333333333333,0.6666666666666666
SF-J22-1,SF-J10,11,6,9,1,2,5,0.8181818181818182,0.18181818181818182,0.16666666666666666,0.8333333333333334
SF-J22-1,SF-J12,31,19,9,0,22,19,0.2903225806451613,0.7096774193548387,0.0,1.0
SF-J22-1,SF-J13,3,4,1,0,2,4,0.3333333333333333,0.6666666666666666,0.0,1.0
SF-J22-1,SF-J14,2,3,1,0,1,3,0.5,0.5,0.0,1.0
SF-J22-1,SF-H12,9,5,1,0,8,5,0.1111111111111111,0.8888888888888888,0.0,1.0
SF-J22-1,SF-H15,2,2,2,0,0,2,1.0,0.0,0.0,1.0
SF-J22-1,SF-G9,3,4,3,0,0,4,1.0,0.0,0.0,1.0
SF-J22-1,SF-H14,2,1,2,0,0,1,1.0,0.0,0.0,1.0
SF-J22-1,SF-G13,5,7,0,0,5,7,0.0,1.0,0.0,1.0
SF-J22-1,SF-G11,3,2,0,0,3,2,0.0,1.0,0.0,1.0
SF-J22-1,SF-G12,48,5,45,0,3,5,0.9375,0.0625,0.0,1.0
SF-J22-1,SF-G10-1,2,1,0,0,2,1,0.0,1.0,0.0,1.0
SF-J22-1,SF-F15,1,2,0,1,1,1,0.0,1.0,0.5,0.5
SF-J22-1,SF-F16,5,3,1,0,4,3,0.2,0.8,0.0,1.0
SF-J22-1,SF-C20,3,7,1,1,2,6,0.3333333333333333,0.6666666666666666,0.14285714285714285,0.8571428571428571
SF-J22-1,SF-A20,7,9,4,2,3,7,0.5714285714285714,0.42857142857142855,0.2222222222222222,0.7777777777777778
SF-J22-1,SF-C26,69,50,3,2,66,48,0.043478260869565216,0.9565217391304348,0.04,0.96
SF-J22-1,SF-C25,7,8,0,1,7,7,0.0,1.0,0.125,0.875
SF-J22-1,SF-B25,6,10,1,0,5,10,0.16666666666666666,0.8333333333333334,0.0,1.0
SF-J22-1,SF-E27,4,3,0,0,4,3,0.0,1.0,0.0,1.0
SF-J22-1,SF-B28-2,3,4,1,1,2,3,0.3333333333333333,0.6666666666666666,0.25,0.75
SF-J22-1,SF-D27,11,8,4,1,7,7,0.36363636363636365,0.6363636363636364,0.125,0.875
SF-J22-1,SF-C28-2,8,15,4,3,4,12,0.5,0.5,0.2,0.8
SF-J22-1,SF-B28,6,7,4,6,2,1,0.6666666666666666,0.3333333333333333,0.8571428571428571,0.14285714285714285
SF-J22-1,SF-J1,9,10,0,1,9,9,0.0,1.0,0.1,0.9
SF-J22-1,SF-H0,2,1,1,0,1,1,0.5,0.5,0.0,1.0
SF-J22-1,SF-J3,5,5,1,1,4,4,0.2,0.8,0.2,0.8
SF-J22-1,SF-J5,4,2,2,0,2,2,0.5,0.5,0.0,1.0
SF-J22-1,SF-G8,3,1,0,0,3,1,0.0,1.0,0.0,1.0
SF-J22-1,SF-G5,6,4,0,0,6,4,0.0,1.0,0.0,1.0
SF-J22-1,SF-G7,12,11,0,0,12,11,0.0,1.0,0.0,1.0
SF-J22-1,SF-F9,4,2,0,0,4,2,0.0,1.0,0.0,1.0
SF-J22-1,SF-G26,8,13,2,5,6,8,0.25,0.75,0.38461538461538464,0.6153846153846154
SF-J22-1,SF-K21,72,32,44,15,28,17,0.6111111111111112,0.3888888888888889,0.46875,0.53125
SF-J22-1,SF-K22-1,14,6,8,4,6,2,0.5714285714285714,0.42857142857142855,0.6666666666666666,0.3333333333333333
SF-J22-1,SF-J23-1,42,51,22,32,20,19,0.5238095238095238,0.47619047619047616,0.6274509803921569,0.37254901960784315
SF-J22-1,SF-J22-2,6,6,3,3,3,3,0.5,0.5,0.5,0.5
SF-J22-1,SF-J21,20,25,10,12,10,13,0.5,0.5,0.48,0.52
SF-J22-1,SF-I21,5,9,3,4,2,5,0.6,0.4,0.4444444444444444,0.5555555555555556
SF-J22-1,SF-I22,12,4,10,1,2,3,0.8333333333333334,0.16666666666666666,0.25,0.75
SF-J22-1,SF-I23-2,7,8,6,5,1,3,0.8571428571428571,0.14285714285714285,0.625,0.375
SF-J22-1,SF-I24,17,11,8,4,9,7,0.47058823529411764,0.5294117647058824,0.36363636363636365,0.6363636363636364
SF-J22-1,SF-I23-1,7,12,1,6,6,6,0.14285714285714285,0.8571428571428571,0.5,0.5
SF-J22-1,SF-F26,27,26,4,3,23,23,0.14814814814814814,0.8518518518518519,0.11538461538461539,0.8846153846153846
SF-J22-1,SF-M13,18,16,9,4,9,12,0.5,0.5,0.25,0.75
SF-J22-1,SF-M15,52,37,15,6,37,31,0.28846153846153844,0.7115384615384616,0.16216216216216217,0.8378378378378378
SF-J22-1,SF-L19,69,12,18,4,51,8,0.2608695652173913,0.7391304347826086,0.3333333333333333,0.6666666666666666
SF-J22-1,SF-L20,9,8,2,0,7,8,0.2222222222222222,0.7777777777777778,0.0,1.0
SF-J22-1,SF-N20-1,13,4,4,1,9,3,0.3076923076923077,0.6923076923076923,0.25,0.75
SF-J22-1,SF-M20,25,34,6,9,19,25,0.24,0.76,0.2647058823529412,0.7352941176470589
SF-J22-1,SF-K17-2,24,20,10,4,14,16,0.4166666666666667,0.5833333333333334,0.2,0.8
SF-J22-1,SF-K20,15,18,8,3,7,15,0.5333333333333333,0.4666666666666667,0.16666666666666666,0.8333333333333334
SF-J22-1,SF-K15-,37,30,13,7,24,23,0.35135135135135137,0.6486486486486487,0.23333333333333334,0.7666666666666667
SF-J22-1,SF-K19,48,38,25,6,23,32,0.5208333333333334,0.4791666666666667,0.15789473684210525,0.8421052631578947
SF-J22-1,SF-K18,30,18,13,2,17,16,0.43333333333333335,0.5666666666666667,0.1111111111111111,0.8888888888888888
SF-J22-1,SF-K17,24,27,11,4,13,23,0.4583333333333333,0.5416666666666666,0.14814814814814814,0.8518518518518519
SF-J22-1,SF-J16,34,25,6,1,28,24,0.17647058823529413,0.8235294117647058,0.04,0.96
SF-J22-1,SF-J18,18,24,5,1,13,23,0.2777777777777778,0.7222222222222222,0.041666666666666664,0.9583333333333334
SF-J22-1,SF-J20,3,7,2,3,1,4,0.6666666666666666,0.3333333333333333,0.42857142857142855,0.5714285714285714
SF-J22-1,SF-J19,13,22,6,5,7,17,0.46153846153846156,0.5384615384615384,0.22727272727272727,0.7727272727272727
SF-J22-1,SF-O12,1,1,1,0,0,1,1.0,0.0,0.0,1.0
SF-J22-1,SF-M12,13,13,1,1,12,12,0.07692307692307693,0.9230769230769231,0.07692307692307693,0.9230769230769231
SF-J22-1,SF-M10,8,12,0,1,8,11,0.0,1.0,0.08333333333333333,0.9166666666666666
SF-J22-1,SF-M11,19,7,4,0,15,7,0.21052631578947367,0.7894736842105263,0.0,1.0
SF-J22-1,SF-R19,11,7,4,0,7,7,0.36363636363636365,0.6363636363636364,0.0,1.0
SF-J22-1,SF-R20,12,2,2,0,10,2,0.16666666666666666,0.8333333333333334,0.0,1.0
SF-J22-1,SF-Q21-2,19,16,1,1,18,15,0.05263157894736842,0.9473684210526315,0.0625,0.9375
SF-J22-1,SF-Q21-1,5,5,1,1,4,4,0.2,0.8,0.2,0.8
SF-J22-1,SF-P21,14,3,2,1,12,2,0.14285714285714285,0.8571428571428571,0.3333333333333333,0.6666666666666666
SF-J22-1,SF-O18,21,17,9,5,12,12,0.42857142857142855,0.5714285714285714,0.29411764705882354,0.7058823529411765
SF-J22-1,SF-O19,18,16,2,2,16,14,0.1111111111111111,0.8888888888888888,0.125,0.875
SF-J22-1,SF-O21,28,48,5,16,23,32,0.17857142857142858,0.8214285714285714,0.3333333333333333,0.6666666666666666
SF-J22-1,SF-O22,45,58,6,30,39,28,0.13333333333333333,0.8666666666666667,0.5172413793103449,0.4827586206896552
SF-J22-1,SF-N21,8,7,3,4,5,3,0.375,0.625,0.5714285714285714,0.42857142857142855
SF-J22-1,SF-N20-2,9,9,4,3,5,6,0.4444444444444444,0.5555555555555556,0.3333333333333333,0.6666666666666666
SF-J22-1,SF-M21,9,12,1,2,8,10,0.1111111111111111,0.8888888888888888,0.16666666666666666,0.8333333333333334
SF-J22-1,SF-L21,40,73,8,25,32,48,0.2,0.8,0.3424657534246575,0.6575342465753424
SF-J22-1,SF-Q30,18,9,1,5,17,4,0.05555555555555555,0.9444444444444444,0.5555555555555556,0.4444444444444444
SF-J22-1,SF-P30,1,1,0,1,1,0,0.0,1.0,1.0,0.0
SF-J22-1,SF-O30-2,2,1,0,0,2,1,0.0,1.0,0.0,1.0
SF-J22-1,SF-O30,11,7,3,1,8,6,0.2727272727272727,0.7272727272727273,0.14285714285714285,0.8571428571428571
SF-J22-1,SF-N27,6,3,1,0,5,3,0.16666666666666666,0.8333333333333334,0.0,1.0
SF-J22-1,SF-N29,3,2,1,2,2,0,0.3333333333333333,0.6666666666666666,1.0,0.0
SF-J22-1,SF-N28,2,4,0,1,2,3,0.0,1.0,0.25,0.75
SF-J22-1,SF-L30-1,97,128,15,10,82,118,0.15463917525773196,0.845360824742268,0.078125,0.921875
SF-J22-1,SF-L31-1,7,8,0,3,7,5,0.0,1.0,0.375,0.625
SF-J22-1,SF-K30-2,9,1,0,0,9,1,0.0,1.0,0.0,1.0
SF-J22-1,SF-L29,9,7,2,0,7,7,0.2222222222222222,0.7777777777777778,0.0,1.0
SF-J22-1,SF-J29-1,6,5,2,2,4,3,0.3333333333333333,0.6666666666666666,0.4,0.6
SF-J22-1,SF-I30,2,5,1,1,1,4,0.5,0.5,0.2,0.8
SF-J22-1,SF-I27,10,6,1,0,9,6,0.1,0.9,0.0,1.0
SF-J22-1,SF-I28,7,2,0,0,7,2,0.0,1.0,0.0,1.0
SF-J22-1,SF-I30-2,1,1,1,0,0,1,1.0,0.0,0.0,1.0
SF-J22-1,SF-H28,4,4,2,0,2,4,0.5,0.5,0.0,1.0
SF-J22-1,SF-H29,2,1,0,1,2,0,0.0,1.0,1.0,0.0
SF-J22-1,SF-S24,18,8,6,1,12,7,0.3333333333333333,0.6666666666666666,0.125,0.875
SF-J22-1,SF-R24,27,31,4,6,23,25,0.14814814814814814,0.8518518518518519,0.1935483870967742,0.8064516129032258
SF-J22-1,SF-R26,4,1,2,1,2,0,0.5,0.5,1.0,0.0
SF-J22-1,SF-Q26,10,3,4,1,6,2,0.4,0.6,0.3333333333333333,0.6666666666666666
SF-J22-1,SF-P26,4,4,1,0,3,4,0.25,0.75,0.0,1.0
SF-J22-1,SF-O25-2,11,18,4,0,7,18,0.36363636363636365,0.6363636363636364,0.0,1.0
SF-J22-1,SF-N22-1B,3,4,1,3,2,1,0.3333333333333333,0.6666666666666666,0.75,0.25
SF-J22-1,SF-N26,1,2,1,1,0,1,1.0,0.0,0.5,0.5
SF-J22-1,SF-N25,1,4,0,1,1,3,0.0,1.0,0.25,0.75
SF-J22-1,SF-T22,10,12,6,2,4,10,0.6,0.4,0.16666666666666666,0.8333333333333334
SF-J22-1,SF-S22-2,12,3,3,1,9,2,0.25,0.75,0.3333333333333333,0.6666666666666666
SF-J22-1,SF-S22-1,21,8,12,4,9,4,0.5714285714285714,0.42857142857142855,0.5,0.5
SF-J22-1,SF-Q23-3,20,13,3,6,17,7,0.15,0.85,0.46153846153846156,0.5384615384615384
SF-J22-1,SF-Q22-1,28,40,4,11,24,29,0.14285714285714285,0.8571428571428571,0.275,0.725
SF-J22-1,SF-Q22-2,36,20,13,5,23,15,0.3611111111111111,0.6388888888888888,0.25,0.75
SF-J22-1,SF-P22,37,47,11,17,26,30,0.2972972972972973,0.7027027027027027,0.3617021276595745,0.6382978723404256
SF-J22-1,SF-W19-2,2,1,0,0,2,1,0.0,1.0,0.0,1.0
SF-J22-1,SF-U21,10,2,0,1,10,1,0.0,1.0,0.5,0.5
SF-J22-1,SF-T20,152,70,130,62,22,8,0.8552631578947368,0.14473684210526316,0.8857142857142857,0.11428571428571428
SF-J22-1,SF-S21,6,7,3,2,3,5,0.5,0.5,0.2857142857142857,0.7142857142857143
SF-J22-1,SF-W14,1,1,0,0,1,1,0.0,1.0,0.0,1.0
SF-J22-2,SF-M26,1,1,0,1,1,0,0.0,1.0,1.0,0.0
SF-J22-2,SF-M25,13,10,6,5,7,5,0.46153846153846156,0.5384615384615384,0.5,0.5
SF-J22-2,SF-M26-2,23,10,3,2,20,8,0.13043478260869565,0.8695652173913043,0.2,0.8
SF-J22-2,SF-L27,5,4,3,1,2,3,0.6,0.4,0.25,0.75
SF-J22-2,SF-K26,16,23,5,15,11,8,0.3125,0.6875,0.6521739130434783,0.34782608695652173
SF-J22-2,SF-J27,4,6,1,3,3,3,0.25,0.75,0.5,0.5
SF-J22-2,SF-M30,10,19,2,1,8,18,0.2,0.8,0.05263157894736842,0.9473684210526315
SF-J22-2,SF-J29-3,3,3,1,1,2,2,0.3333333333333333,0.6666666666666666,0.3333333333333333,0.6666666666666666
SF-J22-2,SF-J29,12,11,5,3,7,8,0.4166666666666667,0.5833333333333334,0.2727272727272727,0.7272727272727273
SF-J22-2,SF-L26,12,12,7,2,5,10,0.5833333333333334,0.4166666666666667,0.16666666666666666,0.8333333333333334
SF-J22-2,SF-M28,9,13,3,4,6,9,0.3333333333333333,0.6666666666666666,0.3076923076923077,0.6923076923076923
SF-J22-2,SF-L25,5,12,4,4,1,8,0.8,0.2,0.3333333333333333,0.6666666666666666
SF-J22-2,SF-M24,5,4,1,0,4,4,0.2,0.8,0.0,1.0
SF-J22-2,SF-L24,2,12,1,3,1,9,0.5,0.5,0.25,0.75
SF-J22-2,SF-N23,4,13,1,6,3,7,0.25,0.75,0.46153846153846156,0.5384615384615384
SF-J22-2,SF-N24-2,1,11,0,7,1,4,0.0,1.0,0.6363636363636364,0.36363636363636365
SF-J22-2,SF-K27-2,20,14,11,9,9,5,0.55,0.45,0.6428571428571429,0.35714285714285715
SF-J22-2,SF-J26-2,13,11,6,7,7,4,0.46153846153846156,0.5384615384615384,0.6363636363636364,0.36363636363636365
SF-J22-2,SF-L28,4,7,2,5,2,2,0.5,0.5,0.7142857142857143,0.2857142857142857
SF-J22-2,SF-K28,2,2,0,2,2,0,0.0,1.0,1.0,0.0
SF-J22-2,SF-K29-1,5,5,2,2,3,3,0.4,0.6,0.4,0.6
SF-J22-2,SF-J28-2,7,6,3,4,4,2,0.42857142857142855,0.5714285714285714,0.6666666666666666,0.3333333333333333
SF-J22-2,SF-K27,7,10,3,5,4,5,0.42857142857142855,0.5714285714285714,0.5,0.5
SF-J22-2,SF-K25,25,4,15,2,10,2,0.6,0.4,0.5,0.5
SF-J22-2,SF-J25,22,24,13,16,9,8,0.5909090909090909,0.4090909090909091,0.6666666666666666,0.3333333333333333
SF-J22-2,SF-H26-2,10,6,3,4,7,2,0.3,0.7,0.6666666666666666,0.3333333333333333
SF-J22-2,SF-P24,13,18,5,5,8,13,0.38461538461538464,0.6153846153846154,0.2777777777777778,0.7222222222222222
SF-J22-2,SF-J24,15,22,3,14,12,8,0.2,0.8,0.6363636363636364,0.36363636363636365
SF-J22-2,SF-O24,8,7,1,3,7,4,0.125,0.875,0.42857142857142855,0.5714285714285714
SF-J22-2,SF-J26,9,8,2,2,7,6,0.2222222222222222,0.7777777777777778,0.25,0.75
SF-J22-2,SF-I26-,11,19,3,4,8,15,0.2727272727272727,0.7272727272727273,0.21052631578947367,0.7894736842105263
SF-J22-2,SF-I25,37,28,29,15,8,13,0.7837837837837838,0.21621621621621623,0.5357142857142857,0.4642857142857143
SF-J22-2,SF-K23,7,1,2,1,5,0,0.2857142857142857,0.7142857142857143,1.0,0.0
SF-J22-2,SF-H26,61,38,24,15,37,23,0.39344262295081966,0.6065573770491803,0.39473684210526316,0.6052631578947368
SF-J22-2,SF-O23,5,2,0,1,5,1,0.0,1.0,0.5,0.5
SF-J22-2,SF-H27-1,9,5,2,4,7,1,0.2222222222222222,0.7777777777777778,0.8,0.2
SF-J22-2,SF-F28-2,51,16,5,8,46,8,0.09803921568627451,0.9019607843137255,0.5,0.5
SF-J22-2,SF-G27,97,81,50,46,47,35,0.5154639175257731,0.4845360824742268,0.5679012345679012,0.43209876543209874
SF-J22-2,SF-M22-2,22,20,7,11,15,9,0.3181818181818182,0.6818181818181818,0.55,0.45
SF-J22-2,SF-L22,15,10,4,5,11,5,0.26666666666666666,0.7333333333333333,0.5,0.5
SF-J22-2,SF-F27,33,43,14,11,19,32,0.42424242424242425,0.5757575757575758,0.2558139534883721,0.7441860465116279
SF-J22-2,SF-N22-2,23,19,11,12,12,7,0.4782608695652174,0.5217391304347826,0.631578947368421,0.3684210526315789
SF-J22-2,SF-G28-2,4,1,1,0,3,1,0.25,0.75,0.0,1.0
SF-J22-2,SF-G28-1,13,14,9,8,4,6,0.6923076923076923,0.3076923076923077,0.5714285714285714,0.42857142857142855
SF-J22-2,SF-M22-1,4,7,1,1,3,6,0.25,0.75,0.14285714285714285,0.8571428571428571
SF-J22-2,SF-K22-2,1,5,1,2,0,3,1.0,0.0,0.4,0.6
SF-J22-2,SF-K24,5,4,4,2,1,2,0.8,0.2,0.5,0.5
SF-J22-2,SF-J23-2,31,33,24,23,7,10,0.7741935483870968,0.22580645161290322,0.696969696969697,0.30303030303030304
SF-J22-2,SF-G23,28,15,16,5,12,10,0.5714285714285714,0.42857142857142855,0.3333333333333333,0.6666666666666666
SF-J22-2,SF-G24,60,27,35,10,25,17,0.5833333333333334,0.4166666666666667,0.37037037037037035,0.6296296296296297
SF-J22-2,SF-G25,50,28,9,2,41,26,0.18,0.82,0.07142857142857142,0.9285714285714286
SF-J22-2,SF-F23,35,28,20,7,15,21,0.5714285714285714,0.42857142857142855,0.25,0.75
SF-J22-2,SF-E23,46,32,25,8,21,24,0.5434782608695652,0.45652173913043476,0.25,0.75
SF-J22-2,SF-D24,11,5,2,0,9,5,0.18181818181818182,0.8181818181818182,0.0,1.0
SF-J22-2,SF-C22,14,12,1,4,13,8,0.07142857142857142,0.9285714285714286,0.3333333333333333,0.6666666666666666
SF-J22-2,SF-B22,18,25,1,8,17,17,0.05555555555555555,0.9444444444444444,0.32,0.68
SF-J22-2,SF-J17,16,14,8,0,8,14,0.5,0.5,0.0,1.0
SF-J22-2,SF-I19,6,9,6,4,0,5,1.0,0.0,0.4444444444444444,0.5555555555555556
SF-J22-2,SF-I20,9,9,6,3,3,6,0.6666666666666666,0.3333333333333333,0.3333333333333333,0.6666666666666666
SF-J22-2,SF-H20,45,52,24,20,21,32,0.5333333333333333,0.4666666666666667,0.38461538461538464,0.6153846153846154
SF-J22-2,SF-H18,2,3,1,0,1,3,0.5,0.5,0.0,1.0
SF-J22-2,SF-H17,2,3,1,2,1,1,0.5,0.5,0.6666666666666666,0.3333333333333333
SF-J22-2,SF-G19,14,13,7,3,7,10,0.5,0.5,0.23076923076923078,0.7692307692307693
SF-J22-2,SF-G17,16,17,0,2,16,15,0.0,1.0,0.11764705882352941,0.8823529411764706
SF-J22-2,SF-G18,15,9,2,1,13,8,0.13333333333333333,0.8666666666666667,0.1111111111111111,0.8888888888888888
SF-J22-2,SF-G20,28,24,16,6,12,18,0.5714285714285714,0.42857142857142855,0.25,0.75
SF-J22-2,SF-F19,12,18,6,1,6,17,0.5,0.5,0.05555555555555555,0.9444444444444444
SF-J22-2,SF-E18,13,23,4,2,9,21,0.3076923076923077,0.6923076923076923,0.08695652173913043,0.9130434782608695
SF-J22-2,SF-E20,11,8,6,1,5,7,0.5454545454545454,0.45454545454545453,0.125,0.875
SF-J22-2,SF-G30-2,12,6,4,2,8,4,0.3333333333333333,0.6666666666666666,0.3333333333333333,0.6666666666666666
SF-J22-2,SF-F30-1,2,5,0,1,2,4,0.0,1.0,0.2,0.8
SF-J22-2,SF-E29-2,39,39,15,20,24,19,0.38461538461538464,0.6153846153846154,0.5128205128205128,0.48717948717948717
SF-J22-2,SF-E29-1,16,10,7,7,9,3,0.4375,0.5625,0.7,0.3
SF-J22-2,SF-D29,3,3,2,0,1,3,0.6666666666666666,0.3333333333333333,0.0,1.0
SF-J22-2,SF-D28,10,9,2,2,8,7,0.2,0.8,0.2222222222222222,0.7777777777777778
SF-J22-2,SF-A27,3,6,3,6,0,0,1.0,0.0,1.0,0.0
SF-J22-2,SF-G29-2,19,7,6,4,13,3,0.3157894736842105,0.6842105263157895,0.5714285714285714,0.42857142857142855
SF-J22-2,SF-G29-1,6,4,2,1,4,3,0.3333333333333333,0.6666666666666666,0.25,0.75
SF-J22-2,SF-G30-1,6,3,4,2,2,1,0.6666666666666666,0.3333333333333333,0.6666666666666666,0.3333333333333333
SF-J22-2,SF-G29-3,13,12,7,6,6,6,0.5384615384615384,0.46153846153846156,0.5,0.5
SF-J22-2,SF-F30-2,2,1,1,1,1,0,0.5,0.5,1.0,0.0
SF-J22-2,SF-F29,3,6,1,4,2,2,0.3333333333333333,0.6666666666666666,0.6666666666666666,0.3333333333333333
SF-J22-2,SF-E29-3,25,2,4,1,21,1,0.16,0.84,0.5,0.5
SF-J22-2,SF-F28-1,41,34,1,2,40,32,0.024390243902439025,0.975609756097561,0.058823529411764705,0.9411764705882353
SF-J22-2,SF-E28-2,2,1,0,1,2,0,0.0,1.0,1.0,0.0
SF-J22-2,SF-E28,5,3,1,1,4,2,0.2,0.8,0.3333333333333333,0.6666666666666666
SF-J22-2,SF-J10,1,11,0,2,1,9,0.0,1.0,0.18181818181818182,0.8181818181818182
SF-J22-2,SF-J12,5,11,2,0,3,11,0.4,0.6,0.0,1.0
SF-J22-2,SF-J13,3,6,0,1,3,5,0.0,1.0,0.16666666666666666,0.8333333333333334
SF-J22-2,SF-J15,1,2,1,0,0,2,1.0,0.0,0.0,1.0
SF-J22-2,SF-H13,1,4,0,0,1,4,0.0,1.0,0.0,1.0
SF-J22-2,SF-I16,2,5,0,2,2,3,0.0,1.0,0.4,0.6
SF-J22-2,SF-H12,4,6,0,0,4,6,0.0,1.0,0.0,1.0
SF-J22-2,SF-G9,2,1,1,0,1,1,0.5,0.5,0.0,1.0
SF-J22-2,SF-G13,7,9,0,2,7,7,0.0,1.0,0.2222222222222222,0.7777777777777778
SF-J22-2,SF-G12,8,4,3,1,5,3,0.375,0.625,0.25,0.75
SF-J22-2,SF-F15,3,3,1,1,2,2,0.3333333333333333,0.6666666666666666,0.3333333333333333,0.6666666666666666
SF-J22-2,SF-C21,2,6,1,2,1,4,0.5,0.5,0.3333333333333333,0.6666666666666666
SF-J22-2,SF-C20,12,4,2,1,10,3,0.16666666666666666,0.8333333333333334,0.25,0.75
SF-J22-2,SF-B21,11,13,3,3,8,10,0.2727272727272727,0.7272727272727273,0.23076923076923078,0.7692307692307693
SF-J22-2,SF-B19,5,23,0,13,5,10,0.0,1.0,0.5652173913043478,0.43478260869565216
SF-J22-2,SF-A20,5,10,0,1,5,9,0.0,1.0,0.1,0.9
SF-J22-2,SF-A19,2,4,1,1,1,3,0.5,0.5,0.25,0.75
SF-J22-2,SF-C26,2,9,1,1,1,8,0.5,0.5,0.1111111111111111,0.8888888888888888
SF-J22-2,SF-C25,24,6,6,1,18,5,0.25,0.75,0.16666666666666666,0.8333333333333334
SF-J22-2,SF-B25,9,14,1,1,8,13,0.1111111111111111,0.8888888888888888,0.07142857142857142,0.9285714285714286
SF-J22-2,SF-E27,4,2,0,0,4,2,0.0,1.0,0.0,1.0
SF-J22-2,SF-D27,4,5,1,0,3,5,0.25,0.75,0.0,1.0
SF-J22-2,SF-B28,7,7,3,3,4,4,0.42857142857142855,0.5714285714285714,0.42857142857142855,0.5714285714285714
SF-J22-2,SF-J1,3,13,2,1,1,12,0.6666666666666666,0.3333333333333333,0.07692307692307693,0.9230769230769231
SF-J22-2,SF-H0,1,5,0,0,1,5,0.0,1.0,0.0,1.0
SF-J22-2,SF-J3,1,4,0,0,1,4,0.0,1.0,0.0,1.0
SF-J22-2,SF-J5,2,1,0,0,2,1,0.0,1.0,0.0,1.0
SF-J22-2,SF-G8,2,3,0,0,2,3,0.0,1.0,0.0,1.0
SF-J22-2,SF-G7,4,4,0,1,4,3,0.0,1.0,0.25,0.75
SF-J22-2,SF-F9,1,6,0,1,1,5,0.0,1.0,0.16666666666666666,0.8333333333333334
SF-J22-2,SF-H25,1,7,0,1,1,6,0.0,1.0,0.14285714285714285,0.8571428571428571
SF-J22-2,SF-G26,24,24,6,5,18,19,0.25,0.75,0.20833333333333334,0.7916666666666666
SF-J22-2,SF-K21,18,13,12,3,6,10,0.6666666666666666,0.3333333333333333,0.23076923076923078,0.7692307692307693
SF-J22-2,SF-K22-1,7,4,6,4,1,0,0.8571428571428571,0.14285714285714285,1.0,0.0
SF-J22-2,SF-J23-1,41,28,25,18,16,10,0.6097560975609756,0.3902439024390244,0.6428571428571429,0.35714285714285715
SF-J22-2,SF-J22-1,6,6,3,3,3,3,0.5,0.5,0.5,0.5
SF-J22-2,SF-J21,43,35,27,21,16,14,0.627906976744186,0.37209302325581395,0.6,0.4
SF-J22-2,SF-I21,11,16,9,9,2,7,0.8181818181818182,0.18181818181818182,0.5625,0.4375
SF-J22-2,SF-I22,21,6,11,3,10,3,0.5238095238095238,0.47619047619047616,0.5,0.5
SF-J22-2,SF-I23-2,50,26,37,23,13,3,0.74,0.26,0.8846153846153846,0.11538461538461539
SF-J22-2,SF-I24,50,30,30,22,20,8,0.6,0.4,0.7333333333333333,0.26666666666666666
SF-J22-2,SF-I23-1,34,23,22,14,12,9,0.6470588235294118,0.35294117647058826,0.6086956521739131,0.391304347826087
SF-J22-2,SF-F26,52,39,13,8,39,31,0.25,0.75,0.20512820512820512,0.7948717948717948
SF-J22-2,SF-M13,9,12,5,0,4,12,0.5555555555555556,0.4444444444444444,0.0,1.0
SF-J22-2,SF-M15,12,13,9,0,3,13,0.75,0.25,0.0,1.0
SF-J22-2,SF-L19,31,29,15,20,16,9,0.4838709677419355,0.5161290322580645,0.6896551724137931,0.3103448275862069
SF-J22-2,SF-L20,14,11,3,1,11,10,0.21428571428571427,0.7857142857142857,0.09090909090909091,0.9090909090909091
SF-J22-2,SF-N20-1,5,7,2,4,3,3,0.4,0.6,0.5714285714285714,0.42857142857142855
SF-J22-2,SF-M20,19,28,6,4,13,24,0.3157894736842105,0.6842105263157895,0.14285714285714285,0.8571428571428571
SF-J22-2,SF-K17-2,3,3,0,0,3,3,0.0,1.0,0.0,1.0
SF-J22-2,SF-K20,5,6,3,3,2,3,0.6,0.4,0.5,0.5
SF-J22-2,SF-K15-,18,42,5,4,13,38,0.2777777777777778,0.7222222222222222,0.09523809523809523,0.9047619047619048
SF-J22-2,SF-K19,8,11,5,0,3,11,0.625,0.375,0.0,1.0
SF-J22-2,SF-K18,9,31,3,0,6,31,0.3333333333333333,0.6666666666666666,0.0,1.0
SF-J22-2,SF-K17,14,19,6,3,8,16,0.42857142857142855,0.5714285714285714,0.15789473684210525,0.8421052631578947
SF-J22-2,SF-J16,11,15,2,0,9,15,0.18181818181818182,0.8181818181818182,0.0,1.0
SF-J22-2,SF-J18,30,29,11,2,19,27,0.36666666666666664,0.6333333333333333,0.06896551724137931,0.9310344827586207
SF-J22-2,SF-J20,34,32,23,19,11,13,0.6764705882352942,0.3235294117647059,0.59375,0.40625
SF-J22-2,SF-J19,19,10,15,1,4,9,0.7894736842105263,0.21052631578947367,0.1,0.9
SF-J22-2,SF-M12,9,8,3,1,6,7,0.3333333333333333,0.6666666666666666,0.125,0.875
SF-J22-2,SF-M10,5,3,1,3,4,0,0.2,0.8,1.0,0.0
SF-J22-2,SF-M11,7,6,4,1,3,5,0.5714285714285714,0.42857142857142855,0.16666666666666666,0.8333333333333334
SF-J22-2,SF-R19,3,10,0,0,3,10,0.0,1.0,0.0,1.0
SF-J22-2,SF-R20,1,1,0,0,1,1,0.0,1.0,0.0,1.0
SF-J22-2,SF-Q21-2,1,3,0,0,1,3,0.0,1.0,0.0,1.0
SF-J22-2,SF-Q21-1,1,2,0,0,1,2,0.0,1.0,0.0,1.0
SF-J22-2,SF-P21,3,4,2,2,1,2,0.6666666666666666,0.3333333333333333,0.5,0.5
SF-J22-2,SF-O18,28,8,2,1,26,7,0.07142857142857142,0.9285714285714286,0.125,0.875
SF-J22-2,SF-O19,7,7,2,1,5,6,0.2857142857142857,0.7142857142857143,0.14285714285714285,0.8571428571428571
SF-J22-2,SF-O21,22,27,8,9,14,18,0.36363636363636365,0.6363636363636364,0.3333333333333333,0.6666666666666666
SF-J22-2,SF-O22,17,29,8,11,9,18,0.47058823529411764,0.5294117647058824,0.3793103448275862,0.6206896551724138
SF-J22-2,SF-N21,7,1,1,0,6,1,0.14285714285714285,0.8571428571428571,0.0,1.0
SF-J22-2,SF-N20-2,3,5,0,0,3,5,0.0,1.0,0.0,1.0
SF-J22-2,SF-M21,15,23,2,4,13,19,0.13333333333333333,0.8666666666666667,0.17391304347826086,0.8260869565217391
SF-J22-2,SF-L21,55,82,10,26,45,56,0.18181818181818182,0.8181818181818182,0.3170731707317073,0.6829268292682927
SF-J22-2,SF-S29,2,1,0,0,2,1,0.0,1.0,0.0,1.0
SF-J22-2,SF-Q30,2,2,0,1,2,1,0.0,1.0,0.5,0.5
SF-J22-2,SF-P30,4,2,2,1,2,1,0.5,0.5,0.5,0.5
SF-J22-2,SF-O30-2,1,7,0,3,1,4,0.0,1.0,0.42857142857142855,0.5714285714285714
SF-J22-2,SF-O30,23,9,3,4,20,5,0.13043478260869565,0.8695652173913043,0.4444444444444444,0.5555555555555556
SF-J22-2,SF-N27,4,3,2,0,2,3,0.5,0.5,0.0,1.0
SF-J22-2,SF-N29,3,8,0,2,3,6,0.0,1.0,0.25,0.75
SF-J22-2,SF-N28,8,5,2,2,6,3,0.25,0.75,0.4,0.6
SF-J22-2,SF-L30-1,55,54,7,19,48,35,0.12727272727272726,0.8727272727272727,0.35185185185185186,0.6481481481481481
SF-J22-2,SF-L31-1,1,2,0,1,1,1,0.0,1.0,0.5,0.5
SF-J22-2,SF-K30-2,9,4,3,2,6,2,0.3333333333333333,0.6666666666666666,0.5,0.5
SF-J22-2,SF-L29,13,8,3,2,10,6,0.23076923076923078,0.7692307692307693,0.25,0.75
SF-J22-2,SF-J29-1,13,2,4,1,9,1,0.3076923076923077,0.6923076923076923,0.5,0.5
SF-J22-2,SF-I30,1,2,1,2,0,0,1.0,0.0,1.0,0.0
SF-J22-2,SF-I29-2,1,2,1,0,0,2,1.0,0.0,0.0,1.0
SF-J22-2,SF-I27,5,6,2,4,3,2,0.4,0.6,0.6666666666666666,0.3333333333333333
SF-J22-2,SF-I28,2,4,0,3,2,1,0.0,1.0,0.75,0.25
SF-J22-2,SF-I30-2,5,5,4,2,1,3,0.8,0.2,0.4,0.6
SF-J22-2,SF I29-1,4,9,2,5,2,4,0.5,0.5,0.5555555555555556,0.4444444444444444
SF-J22-2,SF-H28,13,11,6,8,7,3,0.46153846153846156,0.5384615384615384,0.7272727272727273,0.2727272727272727
SF-J22-2,SF-H29,2,1,2,0,0,1,1.0,0.0,0.0,1.0
SF-J22-2,SF-S24,3,3,0,2,3,1,0.0,1.0,0.6666666666666666,0.3333333333333333
SF-J22-2,SF-R24,9,1,4,1,5,0,0.4444444444444444,0.5555555555555556,1.0,0.0
SF-J22-2,SF-O25-2,2,2,1,0,1,2,0.5,0.5,0.0,1.0
SF-J22-2,SF-N22-1B,3,5,3,4,0,1,1.0,0.0,0.8,0.2
SF-J22-2,SF-N25,3,4,0,2,3,2,0.0,1.0,0.5,0.5
SF-J22-2,SF-S22-2,1,1,0,0,1,1,0.0,1.0,0.0,1.0
SF-J22-2,SF-S22-1,8,7,2,2,6,5,0.25,0.75,0.2857142857142857,0.7142857142857143
SF-J22-2,SF-Q23-3,1,8,0,2,1,6,0.0,1.0,0.25,0.75
SF-J22-2,SF-Q22-1,7,9,1,1,6,8,0.14285714285714285,0.8571428571428571,0.1111111111111111,0.8888888888888888
SF-J22-2,SF-Q22-2,8,15,3,6,5,9,0.375,0.625,0.4,0.6
SF-J22-2,SF-P22,6,18,1,4,5,14,0.16666666666666666,0.8333333333333334,0.2222222222222222,0.7777777777777778
SF-J22-2,SF-T20,3,2,1,1,2,1,0.3333333333333333,0.6666666666666666,0.5,0.5
SF-J22-2,SF-S21,3,2,1,1,2,1,0.3333333333333333,0.6666666666666666,0.5,0.5
SF-J22-2,SF-X19,4,2,0,1,4,1,0.0,1.0,0.5,0.5
SF-J21,SF-M26,2,1,1,1,1,0,0.5,0.5,1.0,0.0
SF-J21,SF-M25,7,6,5,3,2,3,0.7142857142857143,0.2857142857142857,0.5,0.5
SF-J21,SF-M26-2,7,7,3,2,4,5,0.42857142857142855,0.5714285714285714,0.2857142857142857,0.7142857142857143
SF-J21,SF-L27,1,2,0,2,1,0,0.0,1.0,1.0,0.0
SF-J21,SF-K26,24,29,13,20,11,9,0.5416666666666666,0.4583333333333333,0.6896551724137931,0.3103448275862069
SF-J21,SF-J27,17,13,4,3,13,10,0.23529411764705882,0.7647058823529411,0.23076923076923078,0.7692307692307693
SF-J21,SF-M30,6,8,2,2,4,6,0.3333333333333333,0.6666666666666666,0.25,0.75
SF-J21,SF-L27-2,1,3,0,1,1,2,0.0,1.0,0.3333333333333333,0.6666666666666666
SF-J21,SF-J29-3,1,6,0,3,1,3,0.0,1.0,0.5,0.5
SF-J21,SF-J29,12,19,2,9,10,10,0.16666666666666666,0.8333333333333334,0.47368421052631576,0.5263157894736842
SF-J21,SF-L26,66,45,13,13,53,32,0.19696969696969696,0.803030303030303,0.28888888888888886,0.7111111111111111
SF-J21,SF-M28,6,6,1,1,5,5,0.16666666666666666,0.8333333333333334,0.16666666666666666,0.8333333333333334
SF-J21,SF-L25,30,28,14,19,16,9,0.4666666666666667,0.5333333333333333,0.6785714285714286,0.32142857142857145
SF-J21,SF-M24,1,5,0,3,1,2,0.0,1.0,0.6,0.4
SF-J21,SF-L24,7,13,3,6,4,7,0.42857142857142855,0.5714285714285714,0.46153846153846156,0.5384615384615384
SF-J21,SF-N23,5,7,2,5,3,2,0.4,0.6,0.7142857142857143,0.2857142857142857
SF-J21,SF-N24-2,5,4,1,3,4,1,0.2,0.8,0.75,0.25
SF-J21,SF-K27-2,23,29,7,16,16,13,0.30434782608695654,0.6956521739130435,0.5517241379310345,0.4482758620689655
SF-J21,SF-J26-2,21,33,10,20,11,13,0.47619047619047616,0.5238095238095238,0.6060606060606061,0.3939393939393939
SF-J21,SF-K28-3,1,2,0,0,1,2,0.0,1.0,0.0,1.0
SF-J21,SF-L28,12,6,6,4,6,2,0.5,0.5,0.6666666666666666,0.3333333333333333
SF-J21,SF-K28,3,1,3,0,0,1,1.0,0.0,0.0,1.0
SF-J21,SF-K29-1,9,7,3,1,6,6,0.3333333333333333,0.6666666666666666,0.14285714285714285,0.8571428571428571
SF-J21,SF-J28-2,2,1,1,0,1,1,0.5,0.5,0.0,1.0
SF-J21,SF-K27,24,29,3,14,21,15,0.125,0.875,0.4827586206896552,0.5172413793103449
SF-J21,SF-K25,17,12,8,6,9,6,0.47058823529411764,0.5294117647058824,0.5,0.5
SF-J21,SF-J25,42,26,36,16,6,10,0.8571428571428571,0.14285714285714285,0.6153846153846154,0.38461538461538464
SF-J21,SF-H26-2,40,88,15,59,25,29,0.375,0.625,0.6704545454545454,0.32954545454545453
SF-J21,SF-P24,14,8,7,5,7,3,0.5,0.5,0.625,0.375
SF-J21,SF-J24,23,21,12,14,11,7,0.5217391304347826,0.4782608695652174,0.6666666666666666,0.3333333333333333
SF-J21,SF-O24,5,4,3,1,2,3,0.6,0.4,0.25,0.75
SF-J21,SF-J26,7,14,7,10,0,4,1.0,0.0,0.7142857142857143,0.2857142857142857
SF-J21,SF-I26-,8,5,1,1,7,4,0.125,0.875,0.2,0.8
SF-J21,SF-I25,57,38,37,25,20,13,0.6491228070175439,0.3508771929824561,0.6578947368421053,0.34210526315789475
SF-J21,SF-K23,10,8,6,7,4,1,0.6,0.4,0.875,0.125
SF-J21,SF-H26,71,58,39,31,32,27,0.5492957746478874,0.4507042253521127,0.5344827586206896,0.46551724137931033
SF-J21,SF-O23,6,5,2,1,4,4,0.3333333333333333,0.6666666666666666,0.2,0.8
SF-J21,SF-H27-1,9,8,3,6,6,2,0.3333333333333333,0.6666666666666666,0.75,0.25
SF-J21,SF-F28-2,19,23,8,6,11,17,0.42105263157894735,0.5789473684210527,0.2608695652173913,0.7391304347826086
SF-J21,SF-G27,142,144,60,60,82,84,0.4225352112676056,0.5774647887323944,0.4166666666666667,0.5833333333333334
SF-J21,SF-M22-2,37,36,12,16,25,20,0.32432432432432434,0.6756756756756757,0.4444444444444444,0.5555555555555556
SF-J21,SF-L22,23,18,7,6,16,12,0.30434782608695654,0.6956521739130435,0.3333333333333333,0.6666666666666666
SF-J21,SF-F27,74,58,15,18,59,40,0.20270270270270271,0.7972972972972973,0.3103448275862069,0.6896551724137931
SF-J21,SF-N22-2,32,37,6,13,26,24,0.1875,0.8125,0.35135135135135137,0.6486486486486487
SF-J21,SF-G28-2,7,5,2,2,5,3,0.2857142857142857,0.7142857142857143,0.4,0.6
SF-J21,SF-G28-1,7,4,5,1,2,3,0.7142857142857143,0.2857142857142857,0.25,0.75
SF-J21,SF-M22-1,19,14,5,5,14,9,0.2631578947368421,0.7368421052631579,0.35714285714285715,0.6428571428571429
SF-J21,SF-O25-1,7,8,4,6,3,2,0.5714285714285714,0.42857142857142855,0.75,0.25
SF-J21,SF-K22-2,19,5,13,3,6,2,0.6842105263157895,0.3157894736842105,0.6,0.4
SF-J21,SF-K24,11,7,5,6,6,1,0.45454545454545453,0.5454545454545454,0.8571428571428571,0.14285714285714285
SF-J21,SF-J23-2,10,12,5,5,5,7,0.5,0.5,0.4166666666666667,0.5833333333333334
SF-J21,SF-G23,23,23,12,2,11,21,0.5217391304347826,0.4782608695652174,0.08695652173913043,0.9130434782608695
SF-J21,SF-G24,13,32,6,6,7,26,0.46153846153846156,0.5384615384615384,0.1875,0.8125
SF-J21,SF-G25,52,23,29,9,23,14,0.5576923076923077,0.4423076923076923,0.391304347826087,0.6086956521739131
SF-J21,SF-F23,57,37,36,6,21,31,0.631578947368421,0.3684210526315789,0.16216216216216217,0.8378378378378378
SF-J21,SF-E23,185,119,145,83,40,36,0.7837837837837838,0.21621621621621623,0.6974789915966386,0.3025210084033613
SF-J21,SF-D24,15,14,9,0,6,14,0.6,0.4,0.0,1.0
SF-J21,SF-C22,21,9,3,5,18,4,0.14285714285714285,0.8571428571428571,0.5555555555555556,0.4444444444444444
SF-J21,SF-B22,18,27,0,3,18,24,0.0,1.0,0.1111111111111111,0.8888888888888888
SF-J21,SF-J17,40,47,13,1,27,46,0.325,0.675,0.02127659574468085,0.9787234042553191
SF-J21,SF-I19,15,13,10,2,5,11,0.6666666666666666,0.3333333333333333,0.15384615384615385,0.8461538461538461
SF-J21,SF-I20,27,17,16,10,11,7,0.5925925925925926,0.4074074074074074,0.5882352941176471,0.4117647058823529
SF-J21,SF-H16,11,17,3,0,8,17,0.2727272727272727,0.7272727272727273,0.0,1.0
SF-J21,SF-H19,13,12,7,4,6,8,0.5384615384615384,0.46153846153846156,0.3333333333333333,0.6666666666666666
SF-J21,SF-H20,73,69,55,50,18,19,0.7534246575342466,0.2465753424657534,0.7246376811594203,0.2753623188405797
SF-J21,SF-H18,10,10,3,2,7,8,0.3,0.7,0.2,0.8
SF-J21,SF-H17,2,13,0,0,2,13,0.0,1.0,0.0,1.0
SF-J21,SF-G19,28,28,13,17,15,11,0.4642857142857143,0.5357142857142857,0.6071428571428571,0.39285714285714285
SF-J21,SF-G17,14,7,3,1,11,6,0.21428571428571427,0.7857142857142857,0.14285714285714285,0.8571428571428571
SF-J21,SF-G18,25,10,10,1,15,9,0.4,0.6,0.1,0.9
SF-J21,SF-G20,42,39,22,20,20,19,0.5238095238095238,0.47619047619047616,0.5128205128205128,0.48717948717948717
SF-J21,SF-F19,37,47,11,15,26,32,0.2972972972972973,0.7027027027027027,0.3191489361702128,0.6808510638297872
SF-J21,SF-E18,20,15,2,4,18,11,0.1,0.9,0.26666666666666666,0.7333333333333333
SF-J21,SF-E20,39,25,11,4,28,21,0.28205128205128205,0.717948717948718,0.16,0.84
SF-J21,SF-H30,7,3,1,3,6,0,0.14285714285714285,0.8571428571428571,1.0,0.0
SF-J21,SF-G30-2,20,26,8,17,12,9,0.4,0.6,0.6538461538461539,0.34615384615384615
SF-J21,SF-F30-1,5,4,0,2,5,2,0.0,1.0,0.5,0.5
SF-J21,SF-E29-2,58,68,11,20,47,48,0.1896551724137931,0.8103448275862069,0.29411764705882354,0.7058823529411765
SF-J21,SF-E29-1,23,12,16,7,7,5,0.6956521739130435,0.30434782608695654,0.5833333333333334,0.4166666666666667
SF-J21,SF-D29,13,14,1,0,12,14,0.07692307692307693,0.9230769230769231,0.0,1.0
SF-J21,SF-D28,22,38,14,14,8,24,0.6363636363636364,0.36363636363636365,0.3684210526315789,0.631578947368421
SF-J21,SF-G29-2,17,12,6,4,11,8,0.35294117647058826,0.6470588235294118,0.3333333333333333,0.6666666666666666
SF-J21,SF-G29-1,67,75,44,61,23,14,0.6567164179104478,0.34328358208955223,0.8133333333333334,0.18666666666666668
SF-J21,SF-G30-1,16,15,7,7,9,8,0.4375,0.5625,0.4666666666666667,0.5333333333333333
SF-J21,SF-G29-3,6,11,2,6,4,5,0.3333333333333333,0.6666666666666666,0.5454545454545454,0.45454545454545453
SF-J21,SF-F30-2,3,8,2,4,1,4,0.6666666666666666,0.3333333333333333,0.5,0.5
SF-J21,SF-F29,4,7,4,5,0,2,1.0,0.0,0.7142857142857143,0.2857142857142857
SF-J21,SF-E29-3,6,3,4,2,2,1,0.6666666666666666,0.3333333333333333,0.6666666666666666,0.3333333333333333
SF-J21,SF-F28-1,21,15,12,9,9,6,0.5714285714285714,0.42857142857142855,0.6,0.4
SF-J21,SF-E28-2,3,3,0,1,3,2,0.0,1.0,0.3333333333333333,0.6666666666666666
SF-J21,SF-E28,7,4,2,2,5,2,0.2857142857142857,0.7142857142857143,0.5,0.5
SF-J21,SF-J10,10,8,5,1,5,7,0.5,0.5,0.125,0.875
SF-J21,SF-J12,10,14,1,6,9,8,0.1,0.9,0.42857142857142855,0.5714285714285714
SF-J21,SF-J13,10,8,0,0,10,8,0.0,1.0,0.0,1.0
SF-J21,SF-J15,5,1,5,1,0,0,1.0,0.0,1.0,0.0
SF-J21,SF-H13,4,6,0,3,4,3,0.0,1.0,0.5,0.5
SF-J21,SF-I16,8,3,8,1,0,2,1.0,0.0,0.3333333333333333,0.6666666666666666
SF-J21,SF-H12,20,26,2,1,18,25,0.1,0.9,0.038461538461538464,0.9615384615384616
SF-J21,SF-G10-2,3,1,0,0,3,1,0.0,1.0,0.0,1.0
SF-J21,SF-H15,9,7,1,0,8,7,0.1111111111111111,0.8888888888888888,0.0,1.0
SF-J21,SF-G9,1,9,0,2,1,7,0.0,1.0,0.2222222222222222,0.7777777777777778
SF-J21,SF-H14,4,4,3,2,1,2,0.75,0.25,0.5,0.5
SF-J21,SF-G13,17,14,3,1,14,13,0.17647058823529413,0.8235294117647058,0.07142857142857142,0.9285714285714286
SF-J21,SF-G11,3,1,1,0,2,1,0.3333333333333333,0.6666666666666666,0.0,1.0
SF-J21,SF-G12,15,10,1,1,14,9,0.06666666666666667,0.9333333333333333,0.1,0.9
SF-J21,SF-G10-1,3,3,0,0,3,3,0.0,1.0,0.0,1.0
SF-J21,SF-F15,4,5,3,1,1,4,0.75,0.25,0.2,0.8
SF-J21,SF-F16,6,7,3,0,3,7,0.5,0.5,0.0,1.0
SF-J21,SF-C21,8,4,4,0,4,4,0.5,0.5,0.0,1.0
SF-J21,SF-C20,7,19,0,0,7,19,0.0,1.0,0.0,1.0
SF-J21,SF-B21,8,4,1,0,7,4,0.125,0.875,0.0,1.0
SF-J21,SF-B19,5,10,1,6,4,4,0.2,0.8,0.6,0.4
SF-J21,SF-A20,11,4,0,0,11,4,0.0,1.0,0.0,1.0
SF-J21,SF-C26,11,8,3,1,8,7,0.2727272727272727,0.7272727272727273,0.125,0.875
SF-J21,SF-C25,20,26,5,4,15,22,0.25,0.75,0.15384615384615385,0.8461538461538461
SF-J21,SF-B25,11,53,3,3,8,50,0.2727272727272727,0.7272727272727273,0.05660377358490566,0.9433962264150944
SF-J21,SF-E27,3,2,1,1,2,1,0.3333333333333333,0.6666666666666666,0.5,0.5
SF-J21,SF-B28-2,3,4,1,1,2,3,0.3333333333333333,0.6666666666666666,0.25,0.75
SF-J21,SF-D27,11,13,6,9,5,4,0.5454545454545454,0.45454545454545453,0.6923076923076923,0.3076923076923077
SF-J21,SF-J1,31,28,20,6,11,22,0.6451612903225806,0.3548387096774194,0.21428571428571427,0.7857142857142857
SF-J21,SF-H0,2,3,0,1,2,2,0.0,1.0,0.3333333333333333,0.6666666666666666
SF-J21,SF-J5,3,5,0,3,3,2,0.0,1.0,0.6,0.4
SF-J21,SF-G6,3,4,1,0,2,4,0.3333333333333333,0.6666666666666666,0.0,1.0
SF-J21,SF-G5,7,7,5,4,2,3,0.7142857142857143,0.2857142857142857,0.5714285714285714,0.42857142857142855
SF-J21,SF-G7,15,15,2,0,13,15,0.13333333333333333,0.8666666666666667,0.0,1.0
SF-J21,SF-F9,10,2,1,0,9,2,0.1,0.9,0.0,1.0
SF-J21,SF-H25,6,10,3,3,3,7,0.5,0.5,0.3,0.7
SF-J21,SF-G26,11,19,4,9,7,10,0.36363636363636365,0.6363636363636364,0.47368421052631576,0.5263157894736842
SF-J21,SF-K21,45,40,25,19,20,21,0.5555555555555556,0.4444444444444444,0.475,0.525
SF-J21,SF-K22-1,17,10,14,6,3,4,0.8235294117647058,0.17647058823529413,0.6,0.4
SF-J21,SF-J23-1,98,96,54,56,44,40,0.5510204081632653,0.4489795918367347,0.5833333333333334,0.4166666666666667
SF-J21,SF-J22-1,25,20,12,10,13,10,0.48,0.52,0.5,0.5
SF-J21,SF-J22-2,35,43,21,27,14,16,0.6,0.4,0.627906976744186,0.37209302325581395
SF-J21,SF-I21,21,34,14,28,7,6,0.6666666666666666,0.3333333333333333,0.8235294117647058,0.17647058823529413
SF-J21,SF-I22,17,18,9,12,8,6,0.5294117647058824,0.47058823529411764,0.6666666666666666,0.3333333333333333
SF-J21,SF-I23-2,63,36,41,24,22,12,0.6507936507936508,0.3492063492063492,0.6666666666666666,0.3333333333333333
SF-J21,SF-I24,22,17,17,14,5,3,0.7727272727272727,0.22727272727272727,0.8235294117647058,0.17647058823529413
SF-J21,SF-I23-1,39,37,26,20,13,17,0.6666666666666666,0.3333333333333333,0.5405405405405406,0.4594594594594595
SF-J21,SF-F26,26,23,6,9,20,14,0.23076923076923078,0.7692307692307693,0.391304347826087,0.6086956521739131
SF-J21,SF-M13,38,24,8,1,30,23,0.21052631578947367,0.7894736842105263,0.041666666666666664,0.9583333333333334
SF-J21,SF-M15,85,49,22,3,63,46,0.25882352941176473,0.7411764705882353,0.061224489795918366,0.9387755102040817
SF-J21,SF-L19,51,26,13,2,38,24,0.2549019607843137,0.7450980392156863,0.07692307692307693,0.9230769230769231
SF-J21,SF-L20,40,40,18,4,22,36,0.45,0.55,0.1,0.9
SF-J21,SF-N20-1,16,10,4,4,12,6,0.25,0.75,0.4,0.6
SF-J21,SF-M20,42,47,6,8,36,39,0.14285714285714285,0.8571428571428571,0.1702127659574468,0.8297872340425532
SF-J21,SF-K17-2,45,29,20,1,25,28,0.4444444444444444,0.5555555555555556,0.034482758620689655,0.9655172413793104
SF-J21,SF-K20,28,25,14,5,14,20,0.5,0.5,0.2,0.8
SF-J21,SF-K15-,53,77,19,28,34,49,0.3584905660377358,0.6415094339622641,0.36363636363636365,0.6363636363636364
SF-J21,SF-K19,73,59,33,11,40,48,0.4520547945205479,0.547945205479452,0.1864406779661017,0.8135593220338984
SF-J21,SF-K18,44,47,13,4,31,43,0.29545454545454547,0.7045454545454546,0.0851063829787234,0.9148936170212766
SF-J21,SF-K17,55,34,17,6,38,28,0.3090909090909091,0.6909090909090909,0.17647058823529413,0.8235294117647058
SF-J21,SF-J16,53,36,4,0,49,36,0.07547169811320754,0.9245283018867925,0.0,1.0
SF-J21,SF-J18,89,54,36,6,53,48,0.4044943820224719,0.5955056179775281,0.1111111111111111,0.8888888888888888
SF-J21,SF-J20,31,36,21,18,10,18,0.6774193548387096,0.3225806451612903,0.5,0.5
SF-J21,SF-J19,59,48,39,17,20,31,0.6610169491525424,0.3389830508474576,0.3541666666666667,0.6458333333333334
SF-J21,SF-O12,3,1,3,1,0,0,1.0,0.0,1.0,0.0
SF-J21,SF-M12,14,14,6,1,8,13,0.42857142857142855,0.5714285714285714,0.07142857142857142,0.9285714285714286
SF-J21,SF-M10,9,3,9,0,0,3,1.0,0.0,0.0,1.0
SF-J21,SF-M11,15,9,4,1,11,8,0.26666666666666666,0.7333333333333333,0.1111111111111111,0.8888888888888888
SF-J21,SF-R19,7,10,1,0,6,10,0.14285714285714285,0.8571428571428571,0.0,1.0
SF-J21,SF-R20,5,1,2,0,3,1,0.4,0.6,0.0,1.0
SF-J21,SF-Q21-2,16,11,3,0,13,11,0.1875,0.8125,0.0,1.0
SF-J21,SF-Q21-1,8,7,0,0,8,7,0.0,1.0,0.0,1.0
SF-J21,SF-P21,5,5,4,0,1,5,0.8,0.2,0.0,1.0
SF-J21,SF-O18,17,20,2,5,15,15,0.11764705882352941,0.8823529411764706,0.25,0.75
SF-J21,SF-O19,12,25,1,7,11,18,0.08333333333333333,0.9166666666666666,0.28,0.72
SF-J21,SF-O21,56,30,16,15,40,15,0.2857142857142857,0.7142857142857143,0.5,0.5
SF-J21,SF-O22,24,44,6,19,18,25,0.25,0.75,0.4318181818181818,0.5681818181818182
SF-J21,SF-N21,20,10,5,5,15,5,0.25,0.75,0.5,0.5
SF-J21,SF-N20-2,8,11,3,5,5,6,0.375,0.625,0.45454545454545453,0.5454545454545454
SF-J21,SF-M21,13,18,3,3,10,15,0.23076923076923078,0.7692307692307693,0.16666666666666666,0.8333333333333334
SF-J21,SF-L21,80,105,24,44,56,61,0.3,0.7,0.41904761904761906,0.580952380952381
SF-J21,SF-Q30,3,9,0,0,3,9,0.0,1.0,0.0,1.0
SF-J21,SF-P30,2,2,1,0,1,2,0.5,0.5,0.0,1.0
SF-J21,SF-O30-2,3,3,0,1,3,2,0.0,1.0,0.3333333333333333,0.6666666666666666
SF-J21,SF-O30,14,15,3,5,11,10,0.21428571428571427,0.7857142857142857,0.3333333333333333,0.6666666666666666
SF-J21,SF-N27,6,11,3,4,3,7,0.5,0.5,0.36363636363636365,0.6363636363636364
SF-J21,SF-N29,6,3,3,2,3,1,0.5,0.5,0.6666666666666666,0.3333333333333333
SF-J21,SF-N28,7,10,4,6,3,4,0.5714285714285714,0.42857142857142855,0.6,0.4
SF-J21,SF-L30-1,15,31,4,7,11,24,0.26666666666666666,0.7333333333333333,0.22580645161290322,0.7741935483870968
SF-J21,SF-L31-1,10,4,0,0,10,4,0.0,1.0,0.0,1.0
SF-J21,SF-K30-2,5,3,2,1,3,2,0.4,0.6,0.3333333333333333,0.6666666666666666
SF-J21,SF-L29,17,16,2,3,15,13,0.11764705882352941,0.8823529411764706,0.1875,0.8125
SF-J21,SF-J29-1,5,7,0,1,5,6,0.0,1.0,0.14285714285714285,0.8571428571428571
SF-J21,SF-I30,5,9,4,4,1,5,0.8,0.2,0.4444444444444444,0.5555555555555556
SF-J21,SF-I27,7,12,6,6,1,6,0.8571428571428571,0.14285714285714285,0.5,0.5
SF-J21,SF-I28,6,6,3,3,3,3,0.5,0.5,0.5,0.5
SF-J21,SF-I30-2,5,3,1,2,4,1,0.2,0.8,0.6666666666666666,0.3333333333333333
SF-J21,SF I29-1,9,2,5,1,4,1,0.5555555555555556,0.4444444444444444,0.5,0.5
SF-J21,SF-H28,8,4,4,2,4,2,0.5,0.5,0.5,0.5
SF-J21,SF-H29,1,2,0,1,1,1,0.0,1.0,0.5,0.5
SF-J21,SF-S24,8,4,1,2,7,2,0.125,0.875,0.5,0.5
SF-J21,SF-R24,15,14,11,5,4,9,0.7333333333333333,0.26666666666666666,0.35714285714285715,0.6428571428571429
SF-J21,SF-Q26,5,3,1,2,4,1,0.2,0.8,0.6666666666666666,0.3333333333333333
SF-J21,SF-P26,2,3,2,2,0,1,1.0,0.0,0.6666666666666666,0.3333333333333333
SF-J21,SF-O25-2,9,10,7,2,2,8,0.7777777777777778,0.2222222222222222,0.2,0.8
SF-J21,SF-N22-1B,4,3,2,2,2,1,0.5,0.5,0.6666666666666666,0.3333333333333333
SF-J21,SF-N26,4,3,3,0,1,3,0.75,0.25,0.0,1.0
SF-J21,SF-N25,3,3,0,1,3,2,0.0,1.0,0.3333333333333333,0.6666666666666666
SF-J21,SF-T21,3,2,1,0,2,2,0.3333333333333333,0.6666666666666666,0.0,1.0
SF-J21,SF-T22,9,19,8,5,1,14,0.8888888888888888,0.1111111111111111,0.2631578947368421,0.7368421052631579
SF-J21,SF-S22-2,5,8,1,1,4,7,0.2,0.8,0.125,0.875
SF-J21,SF-S22-1,16,25,8,11,8,14,0.5,0.5,0.44,0.56
SF-J21,SF-Q23-3,9,10,5,1,4,9,0.5555555555555556,0.4444444444444444,0.1,0.9
SF-J21,SF-Q22-1,16,16,6,6,10,10,0.375,0.625,0.375,0.625
SF-J21,SF-Q22-2,16,25,4,11,12,14,0.25,0.75,0.44,0.56
SF-J21,SF-P22,15,16,4,4,11,12,0.26666666666666666,0.7333333333333333,0.25,0.75
SF-J21,SF-T20,10,4,1,0,9,4,0.1,0.9,0.0,1.0
SF-J21,SF-S21,9,19,1,3,8,16,0.1111111111111111,0.8888888888888888,0.15789473684210525,0.8421052631578947
SF-I21,SF-M25,1,2,0,1,1,1,0.0,1.0,0.5,0.5
SF-I21,SF-M26-2,1,1,0,0,1,1,0.0,1.0,0.0,1.0
SF-I21,SF-K26,1,4,0,2,1,2,0.0,1.0,0.5,0.5
SF-I21,SF-M30,6,5,5,1,1,4,0.8333333333333334,0.16666666666666666,0.2,0.8
SF-I21,SF-J29,8,2,2,0,6,2,0.25,0.75,0.0,1.0
SF-I21,SF-L26,11,19,9,10,2,9,0.8181818181818182,0.18181818181818182,0.5263157894736842,0.47368421052631576
SF-I21,SF-L25,3,11,3,7,0,4,1.0,0.0,0.6363636363636364,0.36363636363636365
SF-I21,SF-J26-2,5,1,2,0,3,1,0.4,0.6,0.0,1.0
SF-I21,SF-L28,3,1,2,1,1,0,0.6666666666666666,0.3333333333333333,1.0,0.0
SF-I21,SF-K28,3,1,3,1,0,0,1.0,0.0,1.0,0.0
SF-I21,SF-K29-1,8,5,2,4,6,1,0.25,0.75,0.8,0.2
SF-I21,SF-J28-2,2,1,1,0,1,1,0.5,0.5,0.0,1.0
SF-I21,SF-K25,1,5,0,3,1,2,0.0,1.0,0.6,0.4
SF-I21,SF-J25,5,4,4,3,1,1,0.8,0.2,0.75,0.25
SF-I21,SF-P24,3,2,1,0,2,2,0.3333333333333333,0.6666666666666666,0.0,1.0
SF-I21,SF-J24,5,3,5,2,0,1,1.0,0.0,0.6666666666666666,0.3333333333333333
SF-I21,SF-J26,2,3,1,2,1,1,0.5,0.5,0.6666666666666666,0.3333333333333333
SF-I21,SF-I25,13,16,11,16,2,0,0.8461538461538461,0.15384615384615385,1.0,0.0
SF-I21,SF-H26,19,26,12,17,7,9,0.631578947368421,0.3684210526315789,0.6538461538461539,0.34615384615384615
SF-I21,SF-O23,3,1,3,1,0,0,1.0,0.0,1.0,0.0
SF-I21,SF-H27-1,1,2,1,0,0,2,1.0,0.0,0.0,1.0
SF-I21,SF-F28-2,6,16,2,4,4,12,0.3333333333333333,0.6666666666666666,0.25,0.75
SF-I21,SF-G27,18,12,7,6,11,6,0.3888888888888889,0.6111111111111112,0.5,0.5
SF-I21,SF-M22-2,9,11,4,5,5,6,0.4444444444444444,0.5555555555555556,0.45454545454545453,0.5454545454545454
SF-I21,SF-L22,4,1,4,1,0,0,1.0,0.0,1.0,0.0
SF-I21,SF-F27,25,44,0,7,25,37,0.0,1.0,0.1590909090909091,0.8409090909090909
SF-I21,SF-N22-2,6,5,2,3,4,2,0.3333333333333333,0.6666666666666666,0.6,0.4
SF-I21,SF-G28-1,2,1,1,1,1,0,0.5,0.5,1.0,0.0
SF-I21,SF-M22-1,1,1,0,0,1,1,0.0,1.0,0.0,1.0
SF-I21,SF-K22-2,1,3,1,2,0,1,1.0,0.0,0.6666666666666666,0.3333333333333333
SF-I21,SF-K24,1,1,1,1,0,0,1.0,0.0,1.0,0.0
SF-I21,SF-J23-2,3,2,3,2,0,0,1.0,0.0,1.0,0.0
SF-I21,SF-G23,3,7,1,5,2,2,0.3333333333333333,0.6666666666666666,0.7142857142857143,0.2857142857142857
SF-I21,SF-G24,8,10,0,2,8,8,0.0,1.0,0.2,0.8
SF-I21,SF-G25,10,4,4,1,6,3,0.4,0.6,0.25,0.75
SF-I21,SF-F23,5,8,2,3,3,5,0.4,0.6,0.375,0.625
SF-I21,SF-E23,12,11,2,3,10,8,0.16666666666666666,0.8333333333333334,0.2727272727272727,0.7272727272727273
SF-I21,SF-C22,4,4,2,1,2,3,0.5,0.5,0.25,0.75
SF-I21,SF-B22,5,7,1,1,4,6,0.2,0.8,0.14285714285714285,0.8571428571428571
SF-I21,SF-J17,10,8,5,2,5,6,0.5,0.5,0.25,0.75
SF-I21,SF-I19,9,5,6,1,3,4,0.6666666666666666,0.3333333333333333,0.2,0.8
SF-I21,SF-I20,12,14,10,9,2,5,0.8333333333333334,0.16666666666666666,0.6428571428571429,0.35714285714285715
SF-I21,SF-H16,4,9,1,0,3,9,0.25,0.75,0.0,1.0
SF-I21,SF-H19,4,1,3,0,1,1,0.75,0.25,0.0,1.0
SF-I21,SF-H20,40,31,21,19,19,12,0.525,0.475,0.6129032258064516,0.3870967741935484
SF-I21,SF-H18,5,2,3,0,2,2,0.6,0.4,0.0,1.0
SF-I21,SF-H17,4,3,0,0,4,3,0.0,1.0,0.0,1.0
SF-I21,SF-G19,13,13,10,3,3,10,0.7692307692307693,0.23076923076923078,0.23076923076923078,0.7692307692307693
SF-I21,SF-G17,3,4,0,0,3,4,0.0,1.0,0.0,1.0
SF-I21,SF-G18,13,6,8,0,5,6,0.6153846153846154,0.38461538461538464,0.0,1.0
SF-I21,SF-G20,14,17,4,10,10,7,0.2857142857142857,0.7142857142857143,0.5882352941176471,0.4117647058823529
SF-I21,SF-F19,70,39,33,16,37,23,0.4714285714285714,0.5285714285714286,0.41025641025641024,0.5897435897435898
SF-I21,SF-E18,2,2,0,0,2,2,0.0,1.0,0.0,1.0
SF-I21,SF-E20,17,13,6,3,11,10,0.35294117647058826,0.6470588235294118,0.23076923076923078,0.7692307692307693
SF-I21,SF-G30-2,4,1,4,0,0,1,1.0,0.0,0.0,1.0
SF-I21,SF-E29-2,8,17,0,5,8,12,0.0,1.0,0.29411764705882354,0.7058823529411765
SF-I21,SF-E29-1,5,5,3,1,2,4,0.6,0.4,0.2,0.8
SF-I21,SF-D29,2,1,1,1,1,0,0.5,0.5,1.0,0.0
SF-I21,SF-D28,1,6,1,3,0,3,1.0,0.0,0.5,0.5
SF-I21,SF-A27,3,1,2,1,1,0,0.6666666666666666,0.3333333333333333,1.0,0.0
SF-I21,SF-G29-2,19,17,14,14,5,3,0.7368421052631579,0.2631578947368421,0.8235294117647058,0.17647058823529413
SF-I21,SF-G29-1,6,5,1,4,5,1,0.16666666666666666,0.8333333333333334,0.8,0.2
SF-I21,SF-G29-3,4,3,1,2,3,1,0.25,0.75,0.6666666666666666,0.3333333333333333
SF-I21,SF-F29,1,1,1,1,0,0,1.0,0.0,1.0,0.0
SF-I21,SF-F28-1,1,2,0,0,1,2,0.0,1.0,0.0,1.0
SF-I21,SF-J10,9,2,4,0,5,2,0.4444444444444444,0.5555555555555556,0.0,1.0
SF-I21,SF-J12,2,6,2,0,0,6,1.0,0.0,0.0,1.0
SF-I21,SF-J13,1,2,0,0,1,2,0.0,1.0,0.0,1.0
SF-I21,SF-J15,2,2,1,1,1,1,0.5,0.5,0.5,0.5
SF-I21,SF-I16,3,2,2,0,1,2,0.6666666666666666,0.3333333333333333,0.0,1.0
SF-I21,SF-G13,9,4,1,0,8,4,0.1111111111111111,0.8888888888888888,0.0,1.0
SF-I21,SF-G11,2,2,0,0,2,2,0.0,1.0,0.0,1.0
SF-I21,SF-G12,3,1,1,0,2,1,0.3333333333333333,0.6666666666666666,0.0,1.0
SF-I21,SF-F15,5,3,0,0,5,3,0.0,1.0,0.0,1.0
SF-I21,SF-F16,5,3,2,3,3,0,0.4,0.6,1.0,0.0
SF-I21,SF-C21,1,1,1,0,0,1,1.0,0.0,0.0,1.0
SF-I21,SF-C20,2,2,1,0,1,2,0.5,0.5,0.0,1.0
SF-I21,SF-B21,2,3,0,0,2,3,0.0,1.0,0.0,1.0
SF-I21,SF-B19,2,3,0,1,2,2,0.0,1.0,0.3333333333333333,0.6666666666666666
SF-I21,SF-A20,4,6,2,0,2,6,0.5,0.5,0.0,1.0
SF-I21,SF-A19,2,3,0,3,2,0,0.0,1.0,1.0,0.0
SF-I21,SF-C26,4,7,0,0,4,7,0.0,1.0,0.0,1.0
SF-I21,SF-C25,1,4,0,3,1,1,0.0,1.0,0.75,0.25
SF-I21,SF-E27,5,2,0,0,5,2,0.0,1.0,0.0,1.0
SF-I21,SF-D27,3,3,1,2,2,1,0.3333333333333333,0.6666666666666666,0.6666666666666666,0.3333333333333333
SF-I21,SF-J1,13,10,6,5,7,5,0.46153846153846156,0.5384615384615384,0.5,0.5
SF-I21,SF-J5,2,3,0,1,2,2,0.0,1.0,0.3333333333333333,0.6666666666666666
SF-I21,SF-G7,2,5,0,0,2,5,0.0,1.0,0.0,1.0
SF-I21,SF-F9,4,2,1,1,3,1,0.25,0.75,0.5,0.5
SF-I21,SF-H25,27,33,27,30,0,3,1.0,0.0,0.9090909090909091,0.09090909090909091
SF-I21,SF-G26,7,8,1,2,6,6,0.14285714285714285,0.8571428571428571,0.25,0.75
SF-I21,SF-K21,11,1,9,0,2,1,0.8181818181818182,0.18181818181818182,0.0,1.0
SF-I21,SF-J23-1,10,17,7,12,3,5,0.7,0.3,0.7058823529411765,0.29411764705882354
SF-I21,SF-J22-1,9,5,4,3,5,2,0.4444444444444444,0.5555555555555556,0.6,0.4
SF-I21,SF-J22-2,16,11,9,9,7,2,0.5625,0.4375,0.8181818181818182,0.18181818181818182
SF-I21,SF-J21,34,21,28,14,6,7,0.8235294117647058,0.17647058823529413,0.6666666666666666,0.3333333333333333
SF-I21,SF-I22,13,11,12,9,1,2,0.9230769230769231,0.07692307692307693,0.8181818181818182,0.18181818181818182
SF-I21,SF-I23-2,12,10,11,8,1,2,0.9166666666666666,0.08333333333333333,0.8,0.2
SF-I21,SF-I24,12,22,10,12,2,10,0.8333333333333334,0.16666666666666666,0.5454545454545454,0.45454545454545453
SF-I21,SF-I23-1,1,6,0,5,1,1,0.0,1.0,0.8333333333333334,0.16666666666666666
SF-I21,SF-F26,11,3,5,2,6,1,0.45454545454545453,0.5454545454545454,0.6666666666666666,0.3333333333333333
SF-I21,SF-M13,2,3,0,1,2,2,0.0,1.0,0.3333333333333333,0.6666666666666666
SF-I21,SF-M15,7,3,3,1,4,2,0.42857142857142855,0.5714285714285714,0.3333333333333333,0.6666666666666666
SF-I21,SF-L19,1,2,1,0,0,2,1.0,0.0,0.0,1.0
SF-I21,SF-L20,15,17,1,3,14,14,0.06666666666666667,0.9333333333333333,0.17647058823529413,0.8235294117647058
SF-I21,SF-M20,6,8,1,2,5,6,0.16666666666666666,0.8333333333333334,0.25,0.75
SF-I21,SF-K20,4,3,2,1,2,2,0.5,0.5,0.3333333333333333,0.6666666666666666
SF-I21,SF-K15-,35,13,5,3,30,10,0.14285714285714285,0.8571428571428571,0.23076923076923078,0.7692307692307693
SF-I21,SF-K19,1,4,1,1,0,3,1.0,0.0,0.25,0.75
SF-I21,SF-K18,7,8,1,1,6,7,0.14285714285714285,0.8571428571428571,0.125,0.875
SF-I21,SF-K17,4,2,2,0,2,2,0.5,0.5,0.0,1.0
SF-I21,SF-J16,21,13,12,5,9,8,0.5714285714285714,0.42857142857142855,0.38461538461538464,0.6153846153846154
SF-I21,SF-J18,17,10,5,0,12,10,0.29411764705882354,0.7058823529411765,0.0,1.0
SF-I21,SF-J20,12,11,9,8,3,3,0.75,0.25,0.7272727272727273,0.2727272727272727
SF-I21,SF-J19,40,20,29,15,11,5,0.725,0.275,0.75,0.25
SF-I21,SF-R19,1,1,0,0,1,1,0.0,1.0,0.0,1.0
SF-I21,SF-R20,2,2,0,1,2,1,0.0,1.0,0.5,0.5
SF-I21,SF-Q21-1,5,1,1,0,4,1,0.2,0.8,0.0,1.0
SF-I21,SF-P21,2,4,1,2,1,2,0.5,0.5,0.5,0.5
SF-I21,SF-O18,1,2,0,0,1,2,0.0,1.0,0.0,1.0
SF-I21,SF-O19,1,2,0,1,1,1,0.0,1.0,0.5,0.5
SF-I21,SF-O21,5,7,2,4,3,3,0.4,0.6,0.5714285714285714,0.42857142857142855
SF-I21,SF-O22,4,6,1,6,3,0,0.25,0.75,1.0,0.0
SF-I21,SF-N21,1,1,0,1,1,0,0.0,1.0,1.0,0.0
SF-I21,SF-N20-2,2,1,1,1,1,0,0.5,0.5,1.0,0.0
SF-I21,SF-M21,1,3,0,0,1,3,0.0,1.0,0.0,1.0
SF-I21,SF-L21,16,10,5,4,11,6,0.3125,0.6875,0.4,0.6
SF-I21,SF-O30,3,2,1,1,2,1,0.3333333333333333,0.6666666666666666,0.5,0.5
SF-I21,SF-N29,1,3,0,0,1,3,0.0,1.0,0.0,1.0
SF-I21,SF-N28,3,1,2,0,1,1,0.6666666666666666,0.3333333333333333,0.0,1.0
SF-I21,SF-L30-1,4,4,4,3,0,1,1.0,0.0,0.75,0.25
SF-I21,SF-L29,3,6,2,3,1,3,0.6666666666666666,0.3333333333333333,0.5,0.5
SF-I21,SF-J29-1,3,2,2,2,1,0,0.6666666666666666,0.3333333333333333,1.0,0.0
SF-I21,SF-I29-2,1,1,0,0,1,1,0.0,1.0,0.0,1.0
SF-I21,SF-I28,3,2,0,1,3,1,0.0,1.0,0.5,0.5
SF-I21,SF-I30-2,3,5,1,0,2,5,0.3333333333333333,0.6666666666666666,0.0,1.0
SF-I21,SF-H28,1,1,0,1,1,0,0.0,1.0,1.0,0.0
SF-I21,SF-P26,1,1,0,0,1,1,0.0,1.0,0.0,1.0
SF-I21,SF-O25-2,3,1,3,1,0,0,1.0,0.0,1.0,0.0
SF-I21,SF-N22-1B,4,1,1,0,3,1,0.25,0.75,0.0,1.0
SF-I21,SF-N25,1,3,0,1,1,2,0.0,1.0,0.3333333333333333,0.6666666666666666
SF-I21,SF-S22-1,3,2,2,0,1,2,0.6666666666666666,0.3333333333333333,0.0,1.0
SF-I21,SF-Q23-3,2,2,2,1,0,1,1.0,0.0,0.5,0.5
SF-I21,SF-Q22-1,1,4,0,2,1,2,0.0,1.0,0.5,0.5
SF-I21,SF-Q22-2,1,1,1,1,0,0,1.0,0.0,1.0,0.0
SF-I21,SF-P22,1,2,1,1,0,1,1.0,0.0,0.5,0.5
SF-I22,SF-M25,3,5,0,1,3,4,0.0,1.0,0.2,0.8
SF-I22,SF-K26,4,5,4,1,0,4,1.0,0.0,0.2,0.8
SF-I22,SF-J27,4,11,3,4,1,7,0.75,0.25,0.36363636363636365,0.6363636363636364
SF-I22,SF-M30,65,101,6,13,59,88,0.09230769230769231,0.9076923076923077,0.12871287128712872,0.8712871287128713
SF-I22,SF-L27-2,1,1,1,1,0,0,1.0,0.0,1.0,0.0
SF-I22,SF-J29,5,2,2,0,3,2,0.4,0.6,0.0,1.0
SF-I22,SF-L26,7,14,1,10,6,4,0.14285714285714285,0.8571428571428571,0.7142857142857143,0.2857142857142857
SF-I22,SF-L25,5,5,4,5,1,0,0.8,0.2,1.0,0.0
SF-I22,SF-L24,18,19,2,5,16,14,0.1111111111111111,0.8888888888888888,0.2631578947368421,0.7368421052631579
SF-I22,SF-K27-2,9,6,5,3,4,3,0.5555555555555556,0.4444444444444444,0.5,0.5
SF-I22,SF-J26-2,15,19,0,3,15,16,0.0,1.0,0.15789473684210525,0.8421052631578947
SF-I22,SF-L28,1,4,0,3,1,1,0.0,1.0,0.75,0.25
SF-I22,SF-K29-1,2,1,1,0,1,1,0.5,0.5,0.0,1.0
SF-I22,SF-J28-2,7,4,1,1,6,3,0.14285714285714285,0.8571428571428571,0.25,0.75
SF-I22,SF-K25,5,11,2,6,3,5,0.4,0.6,0.5454545454545454,0.45454545454545453
SF-I22,SF-J25,12,5,4,3,8,2,0.3333333333333333,0.6666666666666666,0.6,0.4
SF-I22,SF-H26-2,3,13,3,6,0,7,1.0,0.0,0.46153846153846156,0.5384615384615384
SF-I22,SF-P24,1,3,0,0,1,3,0.0,1.0,0.0,1.0
SF-I22,SF-J24,7,11,2,7,5,4,0.2857142857142857,0.7142857142857143,0.6363636363636364,0.36363636363636365
SF-I22,SF-J26,1,1,0,0,1,1,0.0,1.0,0.0,1.0
SF-I22,SF-I25,17,13,10,11,7,2,0.5882352941176471,0.4117647058823529,0.8461538461538461,0.15384615384615385
SF-I22,SF-H26,30,40,11,12,19,28,0.36666666666666664,0.6333333333333333,0.3,0.7
SF-I22,SF-O23,3,9,0,4,3,5,0.0,1.0,0.4444444444444444,0.5555555555555556
SF-I22,SF-F28-2,27,14,5,7,22,7,0.18518518518518517,0.8148148148148148,0.5,0.5
SF-I22,SF-G27,17,72,6,30,11,42,0.35294117647058826,0.6470588235294118,0.4166666666666667,0.5833333333333334
SF-I22,SF-M22-2,5,5,2,3,3,2,0.4,0.6,0.6,0.4
SF-I22,SF-L22,20,24,1,6,19,18,0.05,0.95,0.25,0.75
SF-I22,SF-F27,9,5,1,4,8,1,0.1111111111111111,0.8888888888888888,0.8,0.2
SF-I22,SF-N22-2,14,10,5,7,9,3,0.35714285714285715,0.6428571428571429,0.7,0.3
SF-I22,SF-G28-2,4,1,0,1,4,0,0.0,1.0,1.0,0.0
SF-I22,SF-M22-1,6,9,3,0,3,9,0.5,0.5,0.0,1.0
SF-I22,SF-K22-2,7,3,1,3,6,0,0.14285714285714285,0.8571428571428571,1.0,0.0
SF-I22,SF-K24,6,3,3,3,3,0,0.5,0.5,1.0,0.0
SF-I22,SF-J23-2,7,4,5,3,2,1,0.7142857142857143,0.2857142857142857,0.75,0.25
SF-I22,SF-G23,7,4,5,2,2,2,0.7142857142857143,0.2857142857142857,0.5,0.5
SF-I22,SF-G24,10,6,4,2,6,4,0.4,0.6,0.3333333333333333,0.6666666666666666
SF-I22,SF-G25,38,21,13,5,25,16,0.34210526315789475,0.6578947368421053,0.23809523809523808,0.7619047619047619
SF-I22,SF-F23,7,10,1,6,6,4,0.14285714285714285,0.8571428571428571,0.6,0.4
SF-I22,SF-E23,11,15,7,2,4,13,0.6363636363636364,0.36363636363636365,0.13333333333333333,0.8666666666666667
SF-I22,SF-D24,1,5,1,0,0,5,1.0,0.0,0.0,1.0
SF-I22,SF-C22,3,7,2,2,1,5,0.6666666666666666,0.3333333333333333,0.2857142857142857,0.7142857142857143
SF-I22,SF-B22,5,10,0,5,5,5,0.0,1.0,0.5,0.5
SF-I22,SF-J17,5,7,0,0,5,7,0.0,1.0,0.0,1.0
SF-I22,SF-I19,66,22,63,3,3,19,0.9545454545454546,0.045454545454545456,0.13636363636363635,0.8636363636363636
SF-I22,SF-I20,13,8,9,0,4,8,0.6923076923076923,0.3076923076923077,0.0,1.0
SF-I22,SF-H16,2,2,1,0,1,2,0.5,0.5,0.0,1.0
SF-I22,SF-H19,4,3,1,2,3,1,0.25,0.75,0.6666666666666666,0.3333333333333333
SF-I22,SF-H20,21,21,12,7,9,14,0.5714285714285714,0.42857142857142855,0.3333333333333333,0.6666666666666666
SF-I22,SF-H18,4,6,3,1,1,5,0.75,0.25,0.16666666666666666,0.8333333333333334
SF-I22,SF-H17,1,5,0,0,1,5,0.0,1.0,0.0,1.0
SF-I22,SF-G19,11,9,6,3,5,6,0.5454545454545454,0.45454545454545453,0.3333333333333333,0.6666666666666666
SF-I22,SF-G17,4,4,2,1,2,3,0.5,0.5,0.25,0.75
SF-I22,SF-G18,39,27,4,11,35,16,0.10256410256410256,0.8974358974358975,0.4074074074074074,0.5925925925925926
SF-I22,SF-G20,14,14,4,4,10,10,0.2857142857142857,0.7142857142857143,0.2857142857142857,0.7142857142857143
SF-I22,SF-F19,5,6,2,2,3,4,0.4,0.6,0.3333333333333333,0.6666666666666666
SF-I22,SF-E18,1,2,1,0,0,2,1.0,0.0,0.0,1.0
SF-I22,SF-H30,2,3,0,0,2,3,0.0,1.0,0.0,1.0
SF-I22,SF-G30-2,5,3,0,2,5,1,0.0,1.0,0.6666666666666666,0.3333333333333333
SF-I22,SF-E29-2,6,9,4,5,2,4,0.6666666666666666,0.3333333333333333,0.5555555555555556,0.4444444444444444
SF-I22,SF-E29-1,5,9,3,9,2,0,0.6,0.4,1.0,0.0
SF-I22,SF-G29-2,8,8,1,3,7,5,0.125,0.875,0.375,0.625
SF-I22,SF-G29-1,11,24,4,18,7,6,0.36363636363636365,0.6363636363636364,0.75,0.25
SF-I22,SF-G30-1,4,2,3,2,1,0,0.75,0.25,1.0,0.0
SF-I22,SF-G29-3,1,1,1,1,0,0,1.0,0.0,1.0,0.0
SF-I22,SF-F30-2,2,3,0,1,2,2,0.0,1.0,0.3333333333333333,0.6666666666666666
SF-I22,SF-E28,2,2,0,0,2,2,0.0,1.0,0.0,1.0
SF-I22,SF-J12,3,2,2,0,1,2,0.6666666666666666,0.3333333333333333,0.0,1.0
SF-I22,SF-J13,4,7,0,0,4,7,0.0,1.0,0.0,1.0
SF-I22,SF-I16,1,2,0,1,1,1,0.0,1.0,0.5,0.5
SF-I22,SF-H12,5,2,1,0,4,2,0.2,0.8,0.0,1.0
SF-I22,SF-G10-2,1,1,0,0,1,1,0.0,1.0,0.0,1.0
SF-I22,SF-H15,5,2,3,0,2,2,0.6,0.4,0.0,1.0
SF-I22,SF-F15,2,3,0,0,2,3,0.0,1.0,0.0,1.0
SF-I22,SF-C20,6,3,0,0,6,3,0.0,1.0,0.0,1.0
SF-I22,SF-B21,2,1,0,0,2,1,0.0,1.0,0.0,1.0
SF-I22,SF-B19,3,2,1,1,2,1,0.3333333333333333,0.6666666666666666,0.5,0.5
SF-I22,SF-A20,13,15,2,4,11,11,0.15384615384615385,0.8461538461538461,0.26666666666666666,0.7333333333333333
SF-I22,SF-C26,1,3,1,2,0,1,1.0,0.0,0.6666666666666666,0.3333333333333333
SF-I22,SF-C25,4,9,2,2,2,7,0.5,0.5,0.2222222222222222,0.7777777777777778
SF-I22,SF-E27,1,2,1,2,0,0,1.0,0.0,1.0,0.0
SF-I22,SF-D27,2,3,0,1,2,2,0.0,1.0,0.3333333333333333,0.6666666666666666
SF-I22,SF-J1,1,8,0,3,1,5,0.0,1.0,0.375,0.625
SF-I22,SF-J3,17,10,15,9,2,1,0.8823529411764706,0.11764705882352941,0.9,0.1
SF-I22,SF-G5,1,1,1,0,0,1,1.0,0.0,0.0,1.0
SF-I22,SF-H25,11,7,7,6,4,1,0.6363636363636364,0.36363636363636365,0.8571428571428571,0.14285714285714285
SF-I22,SF-G26,12,12,2,3,10,9,0.16666666666666666,0.8333333333333334,0.25,0.75
SF-I22,SF-K21,5,2,0,0,5,2,0.0,1.0,0.0,1.0
SF-I22,SF-K22-1,8,14,7,12,1,2,0.875,0.125,0.8571428571428571,0.14285714285714285
SF-I22,SF-J23-1,15,22,9,9,6,13,0.6,0.4,0.4090909090909091,0.5909090909090909
SF-I22,SF-J22-1,4,12,1,10,3,2,0.25,0.75,0.8333333333333334,0.16666666666666666
SF-I22,SF-J22-2,6,21,3,11,3,10,0.5,0.5,0.5238095238095238,0.47619047619047616
SF-I22,SF-J21,18,17,12,9,6,8,0.6666666666666666,0.3333333333333333,0.5294117647058824,0.47058823529411764
SF-I22,SF-I21,11,13,9,12,2,1,0.8181818181818182,0.18181818181818182,0.9230769230769231,0.07692307692307693
SF-I22,SF-I23-2,9,20,8,15,1,5,0.8888888888888888,0.1111111111111111,0.75,0.25
SF-I22,SF-I24,10,31,7,21,3,10,0.7,0.3,0.6774193548387096,0.3225806451612903
SF-I22,SF-I23-1,37,67,20,43,17,24,0.5405405405405406,0.4594594594594595,0.6417910447761194,0.3582089552238806
SF-I22,SF-F26,12,15,4,3,8,12,0.3333333333333333,0.6666666666666666,0.2,0.8
SF-I22,SF-M13,5,2,0,0,5,2,0.0,1.0,0.0,1.0
SF-I22,SF-M15,5,8,0,0,5,8,0.0,1.0,0.0,1.0
SF-I22,SF-L19,16,5,5,3,11,2,0.3125,0.6875,0.6,0.4
SF-I22,SF-L20,5,5,2,2,3,3,0.4,0.6,0.4,0.6
SF-I22,SF-N20-1,3,4,1,2,2,2,0.3333333333333333,0.6666666666666666,0.5,0.5
SF-I22,SF-M20,12,17,2,4,10,13,0.16666666666666666,0.8333333333333334,0.23529411764705882,0.7647058823529411
SF-I22,SF-K17-2,5,9,2,1,3,8,0.4,0.6,0.1111111111111111,0.8888888888888888
SF-I22,SF-K20,6,5,3,2,3,3,0.5,0.5,0.4,0.6
SF-I22,SF-K15-,5,17,1,4,4,13,0.2,0.8,0.23529411764705882,0.7647058823529411
SF-I22,SF-K19,3,6,0,3,3,3,0.0,1.0,0.5,0.5
SF-I22,SF-K18,11,12,3,3,8,9,0.2727272727272727,0.7272727272727273,0.25,0.75
SF-I22,SF-K17,12,7,3,0,9,7,0.25,0.75,0.0,1.0
SF-I22,SF-J16,3,3,0,1,3,2,0.0,1.0,0.3333333333333333,0.6666666666666666
SF-I22,SF-J18,81,7,19,0,62,7,0.2345679012345679,0.7654320987654321,0.0,1.0
SF-I22,SF-J20,8,11,5,8,3,3,0.625,0.375,0.7272727272727273,0.2727272727272727
SF-I22,SF-J19,13,31,7,19,6,12,0.5384615384615384,0.46153846153846156,0.6129032258064516,0.3870967741935484
SF-I22,SF-M12,5,2,0,0,5,2,0.0,1.0,0.0,1.0
SF-I22,SF-M10,2,2,1,0,1,2,0.5,0.5,0.0,1.0
SF-I22,SF-M11,8,2,2,0,6,2,0.25,0.75,0.0,1.0
SF-I22,SF-Q21-2,2,2,0,0,2,2,0.0,1.0,0.0,1.0
SF-I22,SF-P21,1,2,1,1,0,1,1.0,0.0,0.5,0.5
SF-I22,SF-O18,7,9,0,0,7,9,0.0,1.0,0.0,1.0
SF-I22,SF-O19,1,6,0,1,1,5,0.0,1.0,0.16666666666666666,0.8333333333333334
SF-I22,SF-O21,27,31,5,11,22,20,0.18518518518518517,0.8148148148148148,0.3548387096774194,0.6451612903225806
SF-I22,SF-O22,6,7,2,5,4,2,0.3333333333333333,0.6666666666666666,0.7142857142857143,0.2857142857142857
SF-I22,SF-N21,4,9,0,1,4,8,0.0,1.0,0.1111111111111111,0.8888888888888888
SF-I22,SF-M21,3,5,1,1,2,4,0.3333333333333333,0.6666666666666666,0.2,0.8
SF-I22,SF-L21,20,36,3,6,17,30,0.15,0.85,0.16666666666666666,0.8333333333333334
SF-I22,SF-O30,2,2,0,1,2,1,0.0,1.0,0.5,0.5
SF-I22,SF-N27,7,1,1,0,6,1,0.14285714285714285,0.8571428571428571,0.0,1.0
SF-I22,SF-N29,1,2,0,1,1,1,0.0,1.0,0.5,0.5
SF-I22,SF-N28,6,6,3,3,3,3,0.5,0.5,0.5,0.5
SF-I22,SF-L30-1,15,27,0,23,15,4,0.0,1.0,0.8518518518518519,0.14814814814814814
SF-I22,SF-L31-1,1,1,1,1,0,0,1.0,0.0,1.0,0.0
SF-I22,SF-L29,8,8,1,4,7,4,0.125,0.875,0.5,0.5
SF-I22,SF-I30,53,23,0,2,53,21,0.0,1.0,0.08695652173913043,0.9130434782608695
SF-I22,SF-I27,4,5,2,4,2,1,0.5,0.5,0.8,0.2
SF-I22,SF-I30-2,32,2,0,0,32,2,0.0,1.0,0.0,1.0
SF-I22,SF I29-1,7,1,0,0,7,1,0.0,1.0,0.0,1.0
SF-I22,SF-H28,2,4,1,3,1,1,0.5,0.5,0.75,0.25
SF-I22,SF-H29,1,1,0,0,1,1,0.0,1.0,0.0,1.0
SF-I22,SF-S24,1,4,0,1,1,3,0.0,1.0,0.25,0.75
SF-I22,SF-R24,1,10,0,0,1,10,0.0,1.0,0.0,1.0
SF-I22,SF-P26,28,30,16,6,12,24,0.5714285714285714,0.42857142857142855,0.2,0.8
SF-I22,SF-O25-2,8,6,0,0,8,6,0.0,1.0,0.0,1.0
SF-I22,SF-N22-1B,1,5,0,3,1,2,0.0,1.0,0.6,0.4
SF-I22,SF-T22,1,1,0,0,1,1,0.0,1.0,0.0,1.0
SF-I22,SF-S22-2,3,2,1,0,2,2,0.3333333333333333,0.6666666666666666,0.0,1.0
SF-I22,SF-S22-1,2,2,1,0,1,2,0.5,0.5,0.0,1.0
SF-I22,SF-Q23-3,3,2,2,2,1,0,0.6666666666666666,0.3333333333333333,1.0,0.0
SF-I22,SF-Q22-1,3,3,0,1,3,2,0.0,1.0,0.3333333333333333,0.6666666666666666
SF-I22,SF-Q22-2,7,5,3,3,4,2,0.42857142857142855,0.5714285714285714,0.6,0.4
SF-I22,SF-P22,6,4,2,0,4,4,0.3333333333333333,0.6666666666666666,0.0,1.0
SF-I22,SF-T20,1,1,0,1,1,0,0.0,1.0,1.0,0.0
SF-I22,SF-Y14,1,1,0,0,1,1,0.0,1.0,0.0,1.0
SF-I23-2,SF-M25,3,5,3,1,0,4,1.0,0.0,0.2,0.8
SF-I23-2,SF-M26-2,9,6,1,3,8,3,0.1111111111111111,0.8888888888888888,0.5,0.5
SF-I23-2,SF-L27,1,2,1,2,0,0,1.0,0.0,1.0,0.0
SF-I23-2,SF-K26,9,15,4,10,5,5,0.4444444444444444,0.5555555555555556,0.6666666666666666,0.3333333333333333
SF-I23-2,SF-J27,1,1,1,1,0,0,1.0,0.0,1.0,0.0
SF-I23-2,SF-M30,10,7,5,5,5,2,0.5,0.5,0.7142857142857143,0.2857142857142857
SF-I23-2,SF-L27-2,1,4,0,4,1,0,0.0,1.0,1.0,0.0
SF-I23-2,SF-J29-3,2,2,2,1,0,1,1.0,0.0,0.5,0.5
SF-I23-2,SF-J29,5,8,1,6,4,2,0.2,0.8,0.75,0.25
SF-I23-2,SF-L26,6,20,0,5,6,15,0.0,1.0,0.25,0.75
SF-I23-2,SF-M28,3,3,0,1,3,2,0.0,1.0,0.3333333333333333,0.6666666666666666
SF-I23-2,SF-L25,6,6,4,5,2,1,0.6666666666666666,0.3333333333333333,0.8333333333333334,0.16666666666666666
SF-I23-2,SF-M24,12,4,8,3,4,1,0.6666666666666666,0.3333333333333333,0.75,0.25
SF-I23-2,SF-L24,9,7,6,3,3,4,0.6666666666666666,0.3333333333333333,0.42857142857142855,0.5714285714285714
SF-I23-2,SF-N23,8,4,7,4,1,0,0.875,0.125,1.0,0.0
SF-I23-2,SF-N24-2,2,2,0,1,2,1,0.0,1.0,0.5,0.5
SF-I23-2,SF-K27-2,8,5,3,2,5,3,0.375,0.625,0.4,0.6
SF-I23-2,SF-J26-2,1,3,0,2,1,1,0.0,1.0,0.6666666666666666,0.3333333333333333
SF-I23-2,SF-K28,1,1,0,1,1,0,0.0,1.0,1.0,0.0
SF-I23-2,SF-K29-1,11,5,2,3,9,2,0.18181818181818182,0.8181818181818182,0.6,0.4
SF-I23-2,SF-J28-2,1,2,1,1,0,1,1.0,0.0,0.5,0.5
SF-I23-2,SF-K27,2,2,2,0,0,2,1.0,0.0,0.0,1.0
SF-I23-2,SF-K25,6,8,3,4,3,4,0.5,0.5,0.5,0.5
SF-I23-2,SF-J25,18,14,9,10,9,4,0.5,0.5,0.7142857142857143,0.2857142857142857
SF-I23-2,SF-H26-2,13,5,6,1,7,4,0.46153846153846156,0.5384615384615384,0.2,0.8
SF-I23-2,SF-P24,7,5,5,4,2,1,0.7142857142857143,0.2857142857142857,0.8,0.2
SF-I23-2,SF-N22-1A,1,5,1,5,0,0,1.0,0.0,1.0,0.0
SF-I23-2,SF-J24,15,8,5,3,10,5,0.3333333333333333,0.6666666666666666,0.375,0.625
SF-I23-2,SF-O24,1,4,0,3,1,1,0.0,1.0,0.75,0.25
SF-I23-2,SF-J26,1,4,1,1,0,3,1.0,0.0,0.25,0.75
SF-I23-2,SF-I25,36,20,27,15,9,5,0.75,0.25,0.75,0.25
SF-I23-2,SF-K23,2,3,1,2,1,1,0.5,0.5,0.6666666666666666,0.3333333333333333
SF-I23-2,SF-H26,36,34,30,28,6,6,0.8333333333333334,0.16666666666666666,0.8235294117647058,0.17647058823529413
SF-I23-2,SF-O23,4,4,3,1,1,3,0.75,0.25,0.25,0.75
SF-I23-2,SF-H27-1,6,2,4,1,2,1,0.6666666666666666,0.3333333333333333,0.5,0.5
SF-I23-2,SF-F28-2,7,10,3,8,4,2,0.42857142857142855,0.5714285714285714,0.8,0.2
SF-I23-2,SF-G27,46,46,26,32,20,14,0.5652173913043478,0.43478260869565216,0.6956521739130435,0.30434782608695654
SF-I23-2,SF-M22-2,15,24,11,17,4,7,0.7333333333333333,0.26666666666666666,0.7083333333333334,0.2916666666666667
SF-I23-2,SF-L22,14,9,11,8,3,1,0.7857142857142857,0.21428571428571427,0.8888888888888888,0.1111111111111111
SF-I23-2,SF-F27,9,7,2,3,7,4,0.2222222222222222,0.7777777777777778,0.42857142857142855,0.5714285714285714
SF-I23-2,SF-N22-2,17,11,9,5,8,6,0.5294117647058824,0.47058823529411764,0.45454545454545453,0.5454545454545454
SF-I23-2,SF-G28-2,1,3,1,1,0,2,1.0,0.0,0.3333333333333333,0.6666666666666666
SF-I23-2,SF-G28-1,1,2,1,2,0,0,1.0,0.0,1.0,0.0
SF-I23-2,SF-M22-1,4,3,1,1,3,2,0.25,0.75,0.3333333333333333,0.6666666666666666
SF-I23-2,SF-K22-2,8,9,6,9,2,0,0.75,0.25,1.0,0.0
SF-I23-2,SF-K24,12,8,7,5,5,3,0.5833333333333334,0.4166666666666667,0.625,0.375
SF-I23-2,SF-J23-2,17,12,15,10,2,2,0.8823529411764706,0.11764705882352941,0.8333333333333334,0.16666666666666666
SF-I23-2,SF-G23,26,33,19,18,7,15,0.7307692307692307,0.2692307692307692,0.5454545454545454,0.45454545454545453
SF-I23-2,SF-G24,44,52,25,16,19,36,0.5681818181818182,0.4318181818181818,0.3076923076923077,0.6923076923076923
SF-I23-2,SF-G25,26,29,12,14,14,15,0.46153846153846156,0.5384615384615384,0.4827586206896552,0.5172413793103449
SF-I23-2,SF-F23,66,38,48,25,18,13,0.7272727272727273,0.2727272727272727,0.6578947368421053,0.34210526315789475
SF-I23-2,SF-E23,55,51,46,25,9,26,0.8363636363636363,0.16363636363636364,0.49019607843137253,0.5098039215686274
SF-I23-2,SF-D24,34,18,21,4,13,14,0.6176470588235294,0.38235294117647056,0.2222222222222222,0.7777777777777778
SF-I23-2,SF-C22,25,23,10,6,15,17,0.4,0.6,0.2608695652173913,0.7391304347826086
SF-I23-2,SF-B22,48,38,5,5,43,33,0.10416666666666667,0.8958333333333334,0.13157894736842105,0.868421052631579
SF-I23-2,SF-J17,18,13,7,0,11,13,0.3888888888888889,0.6111111111111112,0.0,1.0
SF-I23-2,SF-I19,7,6,3,2,4,4,0.42857142857142855,0.5714285714285714,0.3333333333333333,0.6666666666666666
SF-I23-2,SF-I20,14,8,9,4,5,4,0.6428571428571429,0.35714285714285715,0.5,0.5
SF-I23-2,SF-H16,2,5,0,0,2,5,0.0,1.0,0.0,1.0
SF-I23-2,SF-H19,1,1,1,0,0,1,1.0,0.0,0.0,1.0
SF-I23-2,SF-H20,25,32,12,22,13,10,0.48,0.52,0.6875,0.3125
SF-I23-2,SF-H18,2,1,0,0,2,1,0.0,1.0,0.0,1.0
SF-I23-2,SF-G19,15,14,11,6,4,8,0.7333333333333333,0.26666666666666666,0.42857142857142855,0.5714285714285714
SF-I23-2,SF-G17,3,1,1,0,2,1,0.3333333333333333,0.6666666666666666,0.0,1.0
SF-I23-2,SF-G18,23,11,13,5,10,6,0.5652173913043478,0.43478260869565216,0.45454545454545453,0.5454545454545454
SF-I23-2,SF-G20,13,15,7,5,6,10,0.5384615384615384,0.46153846153846156,0.3333333333333333,0.6666666666666666
SF-I23-2,SF-F19,25,14,15,5,10,9,0.6,0.4,0.35714285714285715,0.6428571428571429
SF-I23-2,SF-E18,5,4,0,1,5,3,0.0,1.0,0.25,0.75
SF-I23-2,SF-E20,4,6,0,1,4,5,0.0,1.0,0.16666666666666666,0.8333333333333334
SF-I23-2,SF-H30,4,8,4,2,0,6,1.0,0.0,0.25,0.75
SF-I23-2,SF-G30-2,14,6,8,2,6,4,0.5714285714285714,0.42857142857142855,0.3333333333333333,0.6666666666666666
SF-I23-2,SF-F30-1,2,4,1,4,1,0,0.5,0.5,1.0,0.0
SF-I23-2,SF-E29-2,21,22,12,14,9,8,0.5714285714285714,0.42857142857142855,0.6363636363636364,0.36363636363636365
SF-I23-2,SF-E29-1,16,18,13,15,3,3,0.8125,0.1875,0.8333333333333334,0.16666666666666666
SF-I23-2,SF-D29,5,6,5,5,0,1,1.0,0.0,0.8333333333333334,0.16666666666666666
SF-I23-2,SF-D28,5,5,4,5,1,0,0.8,0.2,1.0,0.0
SF-I23-2,SF-A27,2,3,2,3,0,0,1.0,0.0,1.0,0.0
SF-I23-2,SF-G29-2,2,7,0,3,2,4,0.0,1.0,0.42857142857142855,0.5714285714285714
SF-I23-2,SF-G29-1,5,2,2,0,3,2,0.4,0.6,0.0,1.0
SF-I23-2,SF-G30-1,3,1,1,1,2,0,0.3333333333333333,0.6666666666666666,1.0,0.0
SF-I23-2,SF-F30-2,3,4,3,1,0,3,1.0,0.0,0.25,0.75
SF-I23-2,SF-F29,2,4,1,3,1,1,0.5,0.5,0.75,0.25
SF-I23-2,SF-E29-3,10,9,2,7,8,2,0.2,0.8,0.7777777777777778,0.2222222222222222
SF-I23-2,SF-F28-1,7,4,7,4,0,0,1.0,0.0,1.0,0.0
SF-I23-2,SF-E28-2,2,1,0,0,2,1,0.0,1.0,0.0,1.0
SF-I23-2,SF-E28,4,3,3,0,1,3,0.75,0.25,0.0,1.0
SF-I23-2,SF-J10,3,4,0,1,3,3,0.0,1.0,0.25,0.75
SF-I23-2,SF-J12,1,2,0,1,1,1,0.0,1.0,0.5,0.5
SF-I23-2,SF-J13,1,1,0,0,1,1,0.0,1.0,0.0,1.0
SF-I23-2,SF-J15,9,2,6,1,3,1,0.6666666666666666,0.3333333333333333,0.5,0.5
SF-I23-2,SF-I16,4,1,1,0,3,1,0.25,0.75,0.0,1.0
SF-I23-2,SF-G13,3,3,1,1,2,2,0.3333333333333333,0.6666666666666666,0.3333333333333333,0.6666666666666666
SF-I23-2,SF-G12,1,1,1,1,0,0,1.0,0.0,1.0,0.0
SF-I23-2,SF-F15,2,1,1,0,1,1,0.5,0.5,0.0,1.0
SF-I23-2,SF-F16,9,3,2,0,7,3,0.2222222222222222,0.7777777777777778,0.0,1.0
SF-I23-2,SF-C21,3,4,0,1,3,3,0.0,1.0,0.25,0.75
SF-I23-2,SF-C20,10,13,1,5,9,8,0.1,0.9,0.38461538461538464,0.6153846153846154
SF-I23-2,SF-B19,10,9,1,3,9,6,0.1,0.9,0.3333333333333333,0.6666666666666666
SF-I23-2,SF-A20,15,11,4,5,11,6,0.26666666666666666,0.7333333333333333,0.45454545454545453,0.5454545454545454
SF-I23-2,SF-A19,4,3,2,2,2,1,0.5,0.5,0.6666666666666666,0.3333333333333333
SF-I23-2,SF-C26,3,5,0,0,3,5,0.0,1.0,0.0,1.0
SF-I23-2,SF-C25,21,25,1,4,20,21,0.047619047619047616,0.9523809523809523,0.16,0.84
SF-I23-2,SF-B25,3,4,1,2,2,2,0.3333333333333333,0.6666666666666666,0.5,0.5
SF-I23-2,SF-E27,3,1,2,1,1,0,0.6666666666666666,0.3333333333333333,1.0,0.0
SF-I23-2,SF-B28-2,3,1,1,1,2,0,0.3333333333333333,0.6666666666666666,1.0,0.0
SF-I23-2,SF-D27,4,9,1,6,3,3,0.25,0.75,0.6666666666666666,0.3333333333333333
SF-I23-2,SF-B28,12,5,8,3,4,2,0.6666666666666666,0.3333333333333333,0.6,0.4
SF-I23-2,SF-J1,5,7,2,0,3,7,0.4,0.6,0.0,1.0
SF-I23-2,SF-J5,3,1,0,0,3,1,0.0,1.0,0.0,1.0
SF-I23-2,SF-G8,2,4,0,0,2,4,0.0,1.0,0.0,1.0
SF-I23-2,SF-H25,13,9,11,7,2,2,0.8461538461538461,0.15384615384615385,0.7777777777777778,0.2222222222222222
SF-I23-2,SF-G26,10,13,4,6,6,7,0.4,0.6,0.46153846153846156,0.5384615384615384
SF-I23-2,SF-K21,15,3,8,2,7,1,0.5333333333333333,0.4666666666666667,0.6666666666666666,0.3333333333333333
SF-I23-2,SF-K22-1,15,20,10,16,5,4,0.6666666666666666,0.3333333333333333,0.8,0.2
SF-I23-2,SF-J23-1,77,53,57,38,20,15,0.7402597402597403,0.2597402597402597,0.7169811320754716,0.2830188679245283
SF-I23-2,SF-J22-1,8,7,5,6,3,1,0.625,0.375,0.8571428571428571,0.14285714285714285
SF-I23-2,SF-J22-2,26,50,23,37,3,13,0.8846153846153846,0.11538461538461539,0.74,0.26
SF-I23-2,SF-J21,36,63,24,41,12,22,0.6666666666666666,0.3333333333333333,0.6507936507936508,0.3492063492063492
SF-I23-2,SF-I21,10,12,8,11,2,1,0.8,0.2,0.9166666666666666,0.08333333333333333
SF-I23-2,SF-I22,20,9,15,8,5,1,0.75,0.25,0.8888888888888888,0.1111111111111111
SF-I23-2,SF-I24,29,12,26,11,3,1,0.896551724137931,0.10344827586206896,0.9166666666666666,0.08333333333333333
SF-I23-2,SF-I23-1,44,78,36,53,8,25,0.8181818181818182,0.18181818181818182,0.6794871794871795,0.32051282051282054
SF-I23-2,SF-F26,20,26,12,16,8,10,0.6,0.4,0.6153846153846154,0.38461538461538464
SF-I23-2,SF-M13,9,7,3,1,6,6,0.3333333333333333,0.6666666666666666,0.14285714285714285,0.8571428571428571
SF-I23-2,SF-M15,18,10,13,4,5,6,0.7222222222222222,0.2777777777777778,0.4,0.6
SF-I23-2,SF-L19,4,6,2,1,2,5,0.5,0.5,0.16666666666666666,0.8333333333333334
SF-I23-2,SF-L20,9,5,3,2,6,3,0.3333333333333333,0.6666666666666666,0.4,0.6
SF-I23-2,SF-N20-1,6,5,1,0,5,5,0.16666666666666666,0.8333333333333334,0.0,1.0
SF-I23-2,SF-M20,19,18,5,5,14,13,0.2631578947368421,0.7368421052631579,0.2777777777777778,0.7222222222222222
SF-I23-2,SF-K17-2,6,4,3,1,3,3,0.5,0.5,0.25,0.75
SF-I23-2,SF-K20,21,7,12,2,9,5,0.5714285714285714,0.42857142857142855,0.2857142857142857,0.7142857142857143
SF-I23-2,SF-K15-,15,16,8,8,7,8,0.5333333333333333,0.4666666666666667,0.5,0.5
SF-I23-2,SF-K19,9,7,5,2,4,5,0.5555555555555556,0.4444444444444444,0.2857142857142857,0.7142857142857143
SF-I23-2,SF-K18,22,11,11,2,11,9,0.5,0.5,0.18181818181818182,0.8181818181818182
SF-I23-2,SF-K17,13,12,3,1,10,11,0.23076923076923078,0.7692307692307693,0.08333333333333333,0.9166666666666666
SF-I23-2,SF-J16,8,8,2,1,6,7,0.25,0.75,0.125,0.875
SF-I23-2,SF-J18,24,20,6,3,18,17,0.25,0.75,0.15,0.85
SF-I23-2,SF-J20,21,31,12,15,9,16,0.5714285714285714,0.42857142857142855,0.4838709677419355,0.5161290322580645
SF-I23-2,SF-J19,25,24,19,15,6,9,0.76,0.24,0.625,0.375
SF-I23-2,SF-M12,4,3,2,1,2,2,0.5,0.5,0.3333333333333333,0.6666666666666666
SF-I23-2,SF-M10,2,5,1,5,1,0,0.5,0.5,1.0,0.0
SF-I23-2,SF-M11,4,5,1,2,3,3,0.25,0.75,0.4,0.6
SF-I23-2,SF-R19,22,24,22,24,0,0,1.0,0.0,1.0,0.0
SF-I23-2,SF-Q21-2,3,2,1,1,2,1,0.3333333333333333,0.6666666666666666,0.5,0.5
SF-I23-2,SF-P21,18,8,1,2,17,6,0.05555555555555555,0.9444444444444444,0.25,0.75
SF-I23-2,SF-O18,2,6,0,4,2,2,0.0,1.0,0.6666666666666666,0.3333333333333333
SF-I23-2,SF-O19,8,10,1,3,7,7,0.125,0.875,0.3,0.7
SF-I23-2,SF-O21,25,16,8,6,17,10,0.32,0.68,0.375,0.625
SF-I23-2,SF-O22,19,28,6,24,13,4,0.3157894736842105,0.6842105263157895,0.8571428571428571,0.14285714285714285
SF-I23-2,SF-N21,8,12,1,1,7,11,0.125,0.875,0.08333333333333333,0.9166666666666666
SF-I23-2,SF-N20-2,3,1,2,1,1,0,0.6666666666666666,0.3333333333333333,1.0,0.0
SF-I23-2,SF-M21,5,5,2,2,3,3,0.4,0.6,0.4,0.6
SF-I23-2,SF-L21,37,46,21,19,16,27,0.5675675675675675,0.43243243243243246,0.41304347826086957,0.5869565217391305
SF-I23-2,SF-S29,1,1,1,1,0,0,1.0,0.0,1.0,0.0
SF-I23-2,SF-P30,4,2,4,1,0,1,1.0,0.0,0.5,0.5
SF-I23-2,SF-O30-2,5,4,1,0,4,4,0.2,0.8,0.0,1.0
SF-I23-2,SF-O30,10,13,2,4,8,9,0.2,0.8,0.3076923076923077,0.6923076923076923
SF-I23-2,SF-N27,4,23,1,19,3,4,0.25,0.75,0.8260869565217391,0.17391304347826086
SF-I23-2,SF-N29,3,4,2,2,1,2,0.6666666666666666,0.3333333333333333,0.5,0.5
SF-I23-2,SF-N28,4,4,0,1,4,3,0.0,1.0,0.25,0.75
SF-I23-2,SF-L30-1,23,15,7,3,16,12,0.30434782608695654,0.6956521739130435,0.2,0.8
SF-I23-2,SF-K30-2,1,1,1,1,0,0,1.0,0.0,1.0,0.0
SF-I23-2,SF-L29,2,4,2,1,0,3,1.0,0.0,0.25,0.75
SF-I23-2,SF-J29-1,3,2,0,2,3,0,0.0,1.0,1.0,0.0
SF-I23-2,SF-I30,4,2,3,1,1,1,0.75,0.25,0.5,0.5
SF-I23-2,SF-I29-2,8,6,0,0,8,6,0.0,1.0,0.0,1.0
SF-I23-2,SF-I27,6,3,0,1,6,2,0.0,1.0,0.3333333333333333,0.6666666666666666
SF-I23-2,SF-I28,12,9,2,5,10,4,0.16666666666666666,0.8333333333333334,0.5555555555555556,0.4444444444444444
SF-I23-2,SF-I30-2,9,6,0,1,9,5,0.0,1.0,0.16666666666666666,0.8333333333333334
SF-I23-2,SF I29-1,19,4,0,1,19,3,0.0,1.0,0.25,0.75
SF-I23-2,SF-H28,5,3,2,1,3,2,0.4,0.6,0.3333333333333333,0.6666666666666666
SF-I23-2,SF-H29,3,2,1,1,2,1,0.3333333333333333,0.6666666666666666,0.5,0.5
SF-I23-2,SF-R24,6,11,4,5,2,6,0.6666666666666666,0.3333333333333333,0.45454545454545453,0.5454545454545454
SF-I23-2,SF-R26,1,1,0,0,1,1,0.0,1.0,0.0,1.0
SF-I23-2,SF-P26,3,4,1,1,2,3,0.3333333333333333,0.6666666666666666,0.25,0.75
SF-I23-2,SF-O25-2,4,8,3,5,1,3,0.75,0.25,0.625,0.375
SF-I23-2,SF-T21,7,2,5,0,2,2,0.7142857142857143,0.2857142857142857,0.0,1.0
SF-I23-2,SF-T22,7,12,4,5,3,7,0.5714285714285714,0.42857142857142855,0.4166666666666667,0.5833333333333334
SF-I23-2,SF-S22-2,4,1,2,0,2,1,0.5,0.5,0.0,1.0
SF-I23-2,SF-S22-1,9,5,5,5,4,0,0.5555555555555556,0.4444444444444444,1.0,0.0
SF-I23-2,SF-Q23-3,7,7,4,3,3,4,0.5714285714285714,0.42857142857142855,0.42857142857142855,0.5714285714285714
SF-I23-2,SF-Q22-1,5,10,2,6,3,4,0.4,0.6,0.6,0.4
SF-I23-2,SF-Q22-2,40,17,38,10,2,7,0.95,0.05,0.5882352941176471,0.4117647058823529
SF-I23-2,SF-P22,7,10,6,3,1,7,0.8571428571428571,0.14285714285714285,0.3,0.7
SF-I23-2,SF-T20,8,6,2,2,6,4,0.25,0.75,0.3333333333333333,0.6666666666666666
SF-I23-2,SF-W14,2,1,1,0,1,1,0.5,0.5,0.0,1.0
SF-I24,SF-M26,1,1,0,1,1,0,0.0,1.0,1.0,0.0
SF-I24,SF-M25,1,8,1,5,0,3,1.0,0.0,0.625,0.375
SF-I24,SF-M26-2,2,1,0,1,2,0,0.0,1.0,1.0,0.0
SF-I24,SF-L27,2,6,1,4,1,2,0.5,0.5,0.6666666666666666,0.3333333333333333
SF-I24,SF-K26,17,35,8,25,9,10,0.47058823529411764,0.5294117647058824,0.7142857142857143,0.2857142857142857
SF-I24,SF-J27,3,3,0,3,3,0,0.0,1.0,1.0,0.0
SF-I24,SF-M30,10,14,2,12,8,2,0.2,0.8,0.8571428571428571,0.14285714285714285
SF-I24,SF-L27-2,6,6,5,5,1,1,0.8333333333333334,0.16666666666666666,0.8333333333333334,0.16666666666666666
SF-I24,SF-J29-3,7,6,1,3,6,3,0.14285714285714285,0.8571428571428571,0.5,0.5
SF-I24,SF-J29,15,8,4,3,11,5,0.26666666666666666,0.7333333333333333,0.375,0.625
SF-I24,SF-L26,8,5,7,4,1,1,0.875,0.125,0.8,0.2
SF-I24,SF-M28,2,7,1,1,1,6,0.5,0.5,0.14285714285714285,0.8571428571428571
SF-I24,SF-M27,1,3,1,0,0,3,1.0,0.0,0.0,1.0
SF-I24,SF-L25,7,10,3,4,4,6,0.42857142857142855,0.5714285714285714,0.4,0.6
SF-I24,SF-M24,1,1,0,1,1,0,0.0,1.0,1.0,0.0
SF-I24,SF-L24,11,12,6,6,5,6,0.5454545454545454,0.45454545454545453,0.5,0.5
SF-I24,SF-N23,1,2,1,2,0,0,1.0,0.0,1.0,0.0
SF-I24,SF-N24-2,1,7,0,7,1,0,0.0,1.0,1.0,0.0
SF-I24,SF-K27-2,9,3,8,1,1,2,0.8888888888888888,0.1111111111111111,0.3333333333333333,0.6666666666666666
SF-I24,SF-J26-2,4,6,3,3,1,3,0.75,0.25,0.5,0.5
SF-I24,SF-L28,6,6,3,5,3,1,0.5,0.5,0.8333333333333334,0.16666666666666666
SF-I24,SF-K29-1,22,9,0,2,22,7,0.0,1.0,0.2222222222222222,0.7777777777777778
SF-I24,SF-J28-2,7,2,0,0,7,2,0.0,1.0,0.0,1.0
SF-I24,SF-K27,7,1,5,0,2,1,0.7142857142857143,0.2857142857142857,0.0,1.0
SF-I24,SF-K25,13,11,13,10,0,1,1.0,0.0,0.9090909090909091,0.09090909090909091
SF-I24,SF-J25,29,25,26,22,3,3,0.896551724137931,0.10344827586206896,0.88,0.12
SF-I24,SF-H26-2,4,3,2,1,2,2,0.5,0.5,0.3333333333333333,0.6666666666666666
SF-I24,SF-P24,2,3,1,3,1,0,0.5,0.5,1.0,0.0
SF-I24,SF-J24,14,17,9,15,5,2,0.6428571428571429,0.35714285714285715,0.8823529411764706,0.11764705882352941
SF-I24,SF-J26,9,1,5,0,4,1,0.5555555555555556,0.4444444444444444,0.0,1.0
SF-I24,SF-I26-,6,4,5,2,1,2,0.8333333333333334,0.16666666666666666,0.5,0.5
SF-I24,SF-I25,42,24,29,16,13,8,0.6904761904761905,0.30952380952380953,0.6666666666666666,0.3333333333333333
SF-I24,SF-K23,9,4,6,3,3,1,0.6666666666666666,0.3333333333333333,0.75,0.25
SF-I24,SF-H26,63,20,50,11,13,9,0.7936507936507936,0.20634920634920634,0.55,0.45
SF-I24,SF-F28-2,7,14,4,9,3,5,0.5714285714285714,0.42857142857142855,0.6428571428571429,0.35714285714285715
SF-I24,SF-G27,53,38,34,19,19,19,0.6415094339622641,0.3584905660377358,0.5,0.5
SF-I24,SF-M22-2,4,4,2,2,2,2,0.5,0.5,0.5,0.5
SF-I24,SF-L22,5,4,4,3,1,1,0.8,0.2,0.75,0.25
SF-I24,SF-F27,5,9,4,6,1,3,0.8,0.2,0.6666666666666666,0.3333333333333333
SF-I24,SF-N22-2,6,8,5,3,1,5,0.8333333333333334,0.16666666666666666,0.375,0.625
SF-I24,SF-G28-2,2,1,0,0,2,1,0.0,1.0,0.0,1.0
SF-I24,SF-G28-1,2,1,2,0,0,1,1.0,0.0,0.0,1.0
SF-I24,SF-M22-1,1,4,0,3,1,1,0.0,1.0,0.75,0.25
SF-I24,SF-K22-2,2,24,1,22,1,2,0.5,0.5,0.9166666666666666,0.08333333333333333
SF-I24,SF-K24,4,2,2,2,2,0,0.5,0.5,1.0,0.0
SF-I24,SF-J23-2,10,13,7,10,3,3,0.7,0.3,0.7692307692307693,0.23076923076923078
SF-I24,SF-G23,29,21,20,10,9,11,0.6896551724137931,0.3103448275862069,0.47619047619047616,0.5238095238095238
SF-I24,SF-G24,60,32,34,4,26,28,0.5666666666666667,0.43333333333333335,0.125,0.875
SF-I24,SF-G25,13,8,10,3,3,5,0.7692307692307693,0.23076923076923078,0.375,0.625
SF-I24,SF-F23,48,28,36,14,12,14,0.75,0.25,0.5,0.5
SF-I24,SF-E23,45,18,32,7,13,11,0.7111111111111111,0.28888888888888886,0.3888888888888889,0.6111111111111112
SF-I24,SF-D24,11,8,3,4,8,4,0.2727272727272727,0.7272727272727273,0.5,0.5
SF-I24,SF-C22,3,8,1,1,2,7,0.3333333333333333,0.6666666666666666,0.125,0.875
SF-I24,SF-B22,39,33,3,2,36,31,0.07692307692307693,0.9230769230769231,0.06060606060606061,0.9393939393939394
SF-I24,SF-J17,38,16,17,2,21,14,0.4473684210526316,0.5526315789473685,0.125,0.875
SF-I24,SF-I19,7,2,4,2,3,0,0.5714285714285714,0.42857142857142855,1.0,0.0
SF-I24,SF-I20,10,8,5,2,5,6,0.5,0.5,0.25,0.75
SF-I24,SF-H20,15,9,9,5,6,4,0.6,0.4,0.5555555555555556,0.4444444444444444
SF-I24,SF-H18,1,3,0,1,1,2,0.0,1.0,0.3333333333333333,0.6666666666666666
SF-I24,SF-G19,13,9,8,4,5,5,0.6153846153846154,0.38461538461538464,0.4444444444444444,0.5555555555555556
SF-I24,SF-G17,1,2,0,0,1,2,0.0,1.0,0.0,1.0
SF-I24,SF-G18,54,6,51,2,3,4,0.9444444444444444,0.05555555555555555,0.3333333333333333,0.6666666666666666
SF-I24,SF-G20,19,4,13,2,6,2,0.6842105263157895,0.3157894736842105,0.5,0.5
SF-I24,SF-F19,83,7,77,7,6,0,0.927710843373494,0.07228915662650602,1.0,0.0
SF-I24,SF-E18,1,5,1,1,0,4,1.0,0.0,0.2,0.8
SF-I24,SF-E20,2,2,0,0,2,2,0.0,1.0,0.0,1.0
SF-I24,SF-H30,2,3,0,1,2,2,0.0,1.0,0.3333333333333333,0.6666666666666666
SF-I24,SF-G30-2,10,17,6,8,4,9,0.6,0.4,0.47058823529411764,0.5294117647058824
SF-I24,SF-E29-2,16,13,14,7,2,6,0.875,0.125,0.5384615384615384,0.46153846153846156
SF-I24,SF-E29-1,26,5,16,3,10,2,0.6153846153846154,0.38461538461538464,0.6,0.4
SF-I24,SF-D29,1,6,0,4,1,2,0.0,1.0,0.6666666666666666,0.3333333333333333
SF-I24,SF-D28,10,4,7,4,3,0,0.7,0.3,1.0,0.0
SF-I24,SF-A27,6,5,4,4,2,1,0.6666666666666666,0.3333333333333333,0.8,0.2
SF-I24,SF-G29-2,7,1,3,1,4,0,0.42857142857142855,0.5714285714285714,1.0,0.0
SF-I24,SF-G29-1,6,5,2,2,4,3,0.3333333333333333,0.6666666666666666,0.4,0.6
SF-I24,SF-G30-1,2,7,2,2,0,5,1.0,0.0,0.2857142857142857,0.7142857142857143
SF-I24,SF-G29-3,14,3,3,2,11,1,0.21428571428571427,0.7857142857142857,0.6666666666666666,0.3333333333333333
SF-I24,SF-F29,5,2,3,2,2,0,0.6,0.4,1.0,0.0
SF-I24,SF-E29-3,1,2,1,2,0,0,1.0,0.0,1.0,0.0
SF-I24,SF-F28-1,6,8,3,3,3,5,0.5,0.5,0.375,0.625
SF-I24,SF-J10,6,5,1,4,5,1,0.16666666666666666,0.8333333333333334,0.8,0.2
SF-I24,SF-J12,1,1,0,0,1,1,0.0,1.0,0.0,1.0
SF-I24,SF-J13,1,3,0,2,1,1,0.0,1.0,0.6666666666666666,0.3333333333333333
SF-I24,SF-H13,1,1,0,0,1,1,0.0,1.0,0.0,1.0
SF-I24,SF-I16,7,1,6,0,1,1,0.8571428571428571,0.14285714285714285,0.0,1.0
SF-I24,SF-G12,1,2,1,0,0,2,1.0,0.0,0.0,1.0
SF-I24,SF-F15,3,5,3,3,0,2,1.0,0.0,0.6,0.4
SF-I24,SF-C20,2,8,0,2,2,6,0.0,1.0,0.25,0.75
SF-I24,SF-B21,4,3,1,2,3,1,0.25,0.75,0.6666666666666666,0.3333333333333333
SF-I24,SF-B19,1,4,0,3,1,1,0.0,1.0,0.75,0.25
SF-I24,SF-A20,1,4,0,0,1,4,0.0,1.0,0.0,1.0
SF-I24,SF-A19,1,1,0,1,1,0,0.0,1.0,1.0,0.0
SF-I24,SF-C26,12,3,3,0,9,3,0.25,0.75,0.0,1.0
SF-I24,SF-C25,6,12,2,1,4,11,0.3333333333333333,0.6666666666666666,0.08333333333333333,0.9166666666666666
SF-I24,SF-B25,5,5,2,3,3,2,0.4,0.6,0.6,0.4
SF-I24,SF-E27,3,4,1,1,2,3,0.3333333333333333,0.6666666666666666,0.25,0.75
SF-I24,SF-D27,18,14,4,7,14,7,0.2222222222222222,0.7777777777777778,0.5,0.5
SF-I24,SF-B28,2,1,1,1,1,0,0.5,0.5,1.0,0.0
SF-I24,SF-J1,1,6,0,4,1,2,0.0,1.0,0.6666666666666666,0.3333333333333333
SF-I24,SF-G8,1,1,1,1,0,0,1.0,0.0,1.0,0.0
SF-I24,SF-H25,12,9,9,7,3,2,0.75,0.25,0.7777777777777778,0.2222222222222222
SF-I24,SF-G26,6,5,2,3,4,2,0.3333333333333333,0.6666666666666666,0.6,0.4
SF-I24,SF-K21,20,6,11,3,9,3,0.55,0.45,0.5,0.5
SF-I24,SF-K22-1,23,35,21,29,2,6,0.9130434782608695,0.08695652173913043,0.8285714285714286,0.17142857142857143
SF-I24,SF-J23-1,19,18,15,13,4,5,0.7894736842105263,0.21052631578947367,0.7222222222222222,0.2777777777777778
SF-I24,SF-J22-1,11,17,4,8,7,9,0.36363636363636365,0.6363636363636364,0.47058823529411764,0.5294117647058824
SF-I24,SF-J22-2,30,50,22,30,8,20,0.7333333333333333,0.26666666666666666,0.6,0.4
SF-I24,SF-J21,17,22,14,17,3,5,0.8235294117647058,0.17647058823529413,0.7727272727272727,0.22727272727272727
SF-I24,SF-I21,22,12,12,10,10,2,0.5454545454545454,0.45454545454545453,0.8333333333333334,0.16666666666666666
SF-I24,SF-I22,31,10,21,7,10,3,0.6774193548387096,0.3225806451612903,0.7,0.3
SF-I24,SF-I23-2,12,29,11,26,1,3,0.9166666666666666,0.08333333333333333,0.896551724137931,0.10344827586206896
SF-I24,SF-I23-1,47,45,38,22,9,23,0.8085106382978723,0.19148936170212766,0.4888888888888889,0.5111111111111111
SF-I24,SF-F26,11,8,5,4,6,4,0.45454545454545453,0.5454545454545454,0.5,0.5
SF-I24,SF-M13,27,16,0,2,27,14,0.0,1.0,0.125,0.875
SF-I24,SF-M15,14,8,9,2,5,6,0.6428571428571429,0.35714285714285715,0.25,0.75
SF-I24,SF-L19,5,8,2,4,3,4,0.4,0.6,0.5,0.5
SF-I24,SF-L20,8,11,2,5,6,6,0.25,0.75,0.45454545454545453,0.5454545454545454
SF-I24,SF-N20-1,3,6,3,2,0,4,1.0,0.0,0.3333333333333333,0.6666666666666666
SF-I24,SF-M20,10,17,5,3,5,14,0.5,0.5,0.17647058823529413,0.8235294117647058
SF-I24,SF-K17-2,8,1,7,1,1,0,0.875,0.125,1.0,0.0
SF-I24,SF-K20,23,16,3,8,20,8,0.13043478260869565,0.8695652173913043,0.5,0.5
SF-I24,SF-K15-,13,13,7,4,6,9,0.5384615384615384,0.46153846153846156,0.3076923076923077,0.6923076923076923
SF-I24,SF-K19,7,10,2,3,5,7,0.2857142857142857,0.7142857142857143,0.3,0.7
SF-I24,SF-K18,10,9,4,1,6,8,0.4,0.6,0.1111111111111111,0.8888888888888888
SF-I24,SF-K17,14,13,9,5,5,8,0.6428571428571429,0.35714285714285715,0.38461538461538464,0.6153846153846154
SF-I24,SF-J16,23,14,8,3,15,11,0.34782608695652173,0.6521739130434783,0.21428571428571427,0.7857142857142857
SF-I24,SF-J18,20,11,12,2,8,9,0.6,0.4,0.18181818181818182,0.8181818181818182
SF-I24,SF-J20,55,31,27,18,28,13,0.4909090909090909,0.509090909090909,0.5806451612903226,0.41935483870967744
SF-I24,SF-J19,26,19,12,13,14,6,0.46153846153846156,0.5384615384615384,0.6842105263157895,0.3157894736842105
SF-I24,SF-M10,3,1,0,0,3,1,0.0,1.0,0.0,1.0
SF-I24,SF-M11,9,2,7,1,2,1,0.7777777777777778,0.2222222222222222,0.5,0.5
SF-I24,SF-R19,3,1,0,0,3,1,0.0,1.0,0.0,1.0
SF-I24,SF-Q21-1,1,3,1,1,0,2,1.0,0.0,0.3333333333333333,0.6666666666666666
SF-I24,SF-P21,1,5,1,0,0,5,1.0,0.0,0.0,1.0
SF-I24,SF-O18,5,7,1,5,4,2,0.2,0.8,0.7142857142857143,0.2857142857142857
SF-I24,SF-O19,3,10,1,2,2,8,0.3333333333333333,0.6666666666666666,0.2,0.8
SF-I24,SF-O21,6,21,1,7,5,14,0.16666666666666666,0.8333333333333334,0.3333333333333333,0.6666666666666666
SF-I24,SF-O22,7,16,4,11,3,5,0.5714285714285714,0.42857142857142855,0.6875,0.3125
SF-I24,SF-N21,2,4,1,1,1,3,0.5,0.5,0.25,0.75
SF-I24,SF-N20-2,2,2,1,1,1,1,0.5,0.5,0.5,0.5
SF-I24,SF-M21,4,2,0,2,4,0,0.0,1.0,1.0,0.0
SF-I24,SF-L21,47,46,33,20,14,26,0.7021276595744681,0.2978723404255319,0.43478260869565216,0.5652173913043478
SF-I24,SF-S30,3,2,3,1,0,1,1.0,0.0,0.5,0.5
SF-I24,SF-Q30,3,6,0,1,3,5,0.0,1.0,0.16666666666666666,0.8333333333333334
SF-I24,SF-P30,8,1,0,1,8,0,0.0,1.0,1.0,0.0
SF-I24,SF-O30,2,7,0,4,2,3,0.0,1.0,0.5714285714285714,0.42857142857142855
SF-I24,SF-N27,6,7,0,6,6,1,0.0,1.0,0.8571428571428571,0.14285714285714285
SF-I24,SF-N28,5,14,3,12,2,2,0.6,0.4,0.8571428571428571,0.14285714285714285
SF-I24,SF-L30-1,14,13,7,4,7,9,0.5,0.5,0.3076923076923077,0.6923076923076923
SF-I24,SF-K30-2,3,2,1,0,2,2,0.3333333333333333,0.6666666666666666,0.0,1.0
SF-I24,SF-L29,8,8,5,7,3,1,0.625,0.375,0.875,0.125
SF-I24,SF-J29-1,3,2,1,0,2,2,0.3333333333333333,0.6666666666666666,0.0,1.0
SF-I24,SF-I30,3,2,2,1,1,1,0.6666666666666666,0.3333333333333333,0.5,0.5
SF-I24,SF-I29-2,7,4,4,3,3,1,0.5714285714285714,0.42857142857142855,0.75,0.25
SF-I24,SF-I27,7,6,5,4,2,2,0.7142857142857143,0.2857142857142857,0.6666666666666666,0.3333333333333333
SF-I24,SF-I28,3,1,1,1,2,0,0.3333333333333333,0.6666666666666666,1.0,0.0
SF-I24,SF-I30-2,6,2,3,1,3,1,0.5,0.5,0.5,0.5
SF-I24,SF I29-1,4,3,0,1,4,2,0.0,1.0,0.3333333333333333,0.6666666666666666
SF-I24,SF-H28,6,6,6,4,0,2,1.0,0.0,0.6666666666666666,0.3333333333333333
SF-I24,SF-S24,3,8,1,2,2,6,0.3333333333333333,0.6666666666666666,0.25,0.75
SF-I24,SF-R24,8,7,4,3,4,4,0.5,0.5,0.42857142857142855,0.5714285714285714
SF-I24,SF-Q26,2,3,1,2,1,1,0.5,0.5,0.6666666666666666,0.3333333333333333
SF-I24,SF-P26,13,4,7,1,6,3,0.5384615384615384,0.46153846153846156,0.25,0.75
SF-I24,SF-N22-1B,2,4,2,1,0,3,1.0,0.0,0.25,0.75
SF-I24,SF-N25,4,1,1,0,3,1,0.25,0.75,0.0,1.0
SF-I24,SF-T22,4,2,0,0,4,2,0.0,1.0,0.0,1.0
SF-I24,SF-S22-2,4,2,0,0,4,2,0.0,1.0,0.0,1.0
SF-I24,SF-Q22-1,1,3,0,1,1,2,0.0,1.0,0.3333333333333333,0.6666666666666666
SF-I24,SF-Q22-2,6,3,6,2,0,1,1.0,0.0,0.6666666666666666,0.3333333333333333
SF-I24,SF-P22,4,6,3,3,1,3,0.75,0.25,0.5,0.5
SF-I24,SF-T20,3,11,1,1,2,10,0.3333333333333333,0.6666666666666666,0.09090909090909091,0.9090909090909091
SF-I24,SF-S21,4,2,1,1,3,1,0.25,0.75,0.5,0.5
SF-I23-1,SF-M26,13,21,0,1,13,20,0.0,1.0,0.047619047619047616,0.9523809523809523
SF-I23-1,SF-M25,5,4,4,4,1,0,0.8,0.2,1.0,0.0
SF-I23-1,SF-M26-2,3,1,0,0,3,1,0.0,1.0,0.0,1.0
SF-I23-1,SF-L27,29,57,1,23,28,34,0.034482758620689655,0.9655172413793104,0.40350877192982454,0.5964912280701754
SF-I23-1,SF-K26,31,7,4,5,27,2,0.12903225806451613,0.8709677419354839,0.7142857142857143,0.2857142857142857
SF-I23-1,SF-J27,7,10,1,4,6,6,0.14285714285714285,0.8571428571428571,0.4,0.6
SF-I23-1,SF-M30,5,31,1,6,4,25,0.2,0.8,0.1935483870967742,0.8064516129032258
SF-I23-1,SF-L27-2,7,5,5,5,2,0,0.7142857142857143,0.2857142857142857,1.0,0.0
SF-I23-1,SF-J29-3,8,2,1,1,7,1,0.125,0.875,0.5,0.5
SF-I23-1,SF-J29,14,11,1,4,13,7,0.07142857142857142,0.9285714285714286,0.36363636363636365,0.6363636363636364
SF-I23-1,SF-L26,7,13,3,9,4,4,0.42857142857142855,0.5714285714285714,0.6923076923076923,0.3076923076923077
SF-I23-1,SF-M28,3,3,2,0,1,3,0.6666666666666666,0.3333333333333333,0.0,1.0
SF-I23-1,SF-L25,10,10,2,6,8,4,0.2,0.8,0.6,0.4
SF-I23-1,SF-M24,14,4,9,2,5,2,0.6428571428571429,0.35714285714285715,0.5,0.5
SF-I23-1,SF-L24,31,16,23,11,8,5,0.7419354838709677,0.25806451612903225,0.6875,0.3125
SF-I23-1,SF-N23,10,10,9,9,1,1,0.9,0.1,0.9,0.1
SF-I23-1,SF-N24-2,1,5,1,4,0,1,1.0,0.0,0.8,0.2
SF-I23-1,SF-K27-2,10,8,5,4,5,4,0.5,0.5,0.5,0.5
SF-I23-1,SF-J26-2,5,5,4,3,1,2,0.8,0.2,0.6,0.4
SF-I23-1,SF-K28,1,4,0,4,1,0,0.0,1.0,1.0,0.0
SF-I23-1,SF-K29-1,9,6,2,2,7,4,0.2222222222222222,0.7777777777777778,0.3333333333333333,0.6666666666666666
SF-I23-1,SF-J28-2,6,10,3,1,3,9,0.5,0.5,0.1,0.9
SF-I23-1,SF-K27,4,2,3,0,1,2,0.75,0.25,0.0,1.0
SF-I23-1,SF-K25,25,37,17,18,8,19,0.68,0.32,0.4864864864864865,0.5135135135135135
SF-I23-1,SF-J25,15,16,9,8,6,8,0.6,0.4,0.5,0.5
SF-I23-1,SF-H26-2,7,10,5,7,2,3,0.7142857142857143,0.2857142857142857,0.7,0.3
SF-I23-1,SF-P24,14,2,13,2,1,0,0.9285714285714286,0.07142857142857142,1.0,0.0
SF-I23-1,SF-N22-1A,4,10,0,0,4,10,0.0,1.0,0.0,1.0
SF-I23-1,SF-J24,15,13,7,8,8,5,0.4666666666666667,0.5333333333333333,0.6153846153846154,0.38461538461538464
SF-I23-1,SF-O24,4,2,3,1,1,1,0.75,0.25,0.5,0.5
SF-I23-1,SF-I26-,11,16,7,9,4,7,0.6363636363636364,0.36363636363636365,0.5625,0.4375
SF-I23-1,SF-I25,34,33,27,29,7,4,0.7941176470588235,0.20588235294117646,0.8787878787878788,0.12121212121212122
SF-I23-1,SF-H26,55,41,36,26,19,15,0.6545454545454545,0.34545454545454546,0.6341463414634146,0.36585365853658536
SF-I23-1,SF-O23,7,4,5,2,2,2,0.7142857142857143,0.2857142857142857,0.5,0.5
SF-I23-1,SF-H27-1,11,11,3,7,8,4,0.2727272727272727,0.7272727272727273,0.6363636363636364,0.36363636363636365
SF-I23-1,SF-F28-2,19,27,13,15,6,12,0.6842105263157895,0.3157894736842105,0.5555555555555556,0.4444444444444444
SF-I23-1,SF-G27,58,124,31,106,27,18,0.5344827586206896,0.46551724137931033,0.8548387096774194,0.14516129032258066
SF-I23-1,SF-M22-2,40,25,25,17,15,8,0.625,0.375,0.68,0.32
SF-I23-1,SF-L22,40,60,28,50,12,10,0.7,0.3,0.8333333333333334,0.16666666666666666
SF-I23-1,SF-F27,57,11,31,4,26,7,0.543859649122807,0.45614035087719296,0.36363636363636365,0.6363636363636364
SF-I23-1,SF-N22-2,18,26,13,13,5,13,0.7222222222222222,0.2777777777777778,0.5,0.5
SF-I23-1,SF-G28-2,3,3,1,2,2,1,0.3333333333333333,0.6666666666666666,0.6666666666666666,0.3333333333333333
SF-I23-1,SF-G28-1,5,2,3,1,2,1,0.6,0.4,0.5,0.5
SF-I23-1,SF-M22-1,8,15,1,11,7,4,0.125,0.875,0.7333333333333333,0.26666666666666666
SF-I23-1,SF-O25-1,1,2,1,2,0,0,1.0,0.0,1.0,0.0
SF-I23-1,SF-K22-2,22,36,10,17,12,19,0.45454545454545453,0.5454545454545454,0.4722222222222222,0.5277777777777778
SF-I23-1,SF-K24,19,18,15,14,4,4,0.7894736842105263,0.21052631578947367,0.7777777777777778,0.2222222222222222
SF-I23-1,SF-J23-2,9,16,6,13,3,3,0.6666666666666666,0.3333333333333333,0.8125,0.1875
SF-I23-1,SF-G23,26,26,17,13,9,13,0.6538461538461539,0.34615384615384615,0.5,0.5
SF-I23-1,SF-G24,66,86,35,11,31,75,0.5303030303030303,0.4696969696969697,0.12790697674418605,0.872093023255814
SF-I23-1,SF-G25,15,7,10,0,5,7,0.6666666666666666,0.3333333333333333,0.0,1.0
SF-I23-1,SF-F23,106,64,77,20,29,44,0.7264150943396226,0.27358490566037735,0.3125,0.6875
SF-I23-1,SF-E23,92,46,82,23,10,23,0.8913043478260869,0.10869565217391304,0.5,0.5
SF-I23-1,SF-D24,11,13,7,1,4,12,0.6363636363636364,0.36363636363636365,0.07692307692307693,0.9230769230769231
SF-I23-1,SF-C22,4,9,0,1,4,8,0.0,1.0,0.1111111111111111,0.8888888888888888
SF-I23-1,SF-B22,16,31,3,13,13,18,0.1875,0.8125,0.41935483870967744,0.5806451612903226
SF-I23-1,SF-J17,30,26,7,0,23,26,0.23333333333333334,0.7666666666666667,0.0,1.0
SF-I23-1,SF-I19,17,11,7,2,10,9,0.4117647058823529,0.5882352941176471,0.18181818181818182,0.8181818181818182
SF-I23-1,SF-I20,32,31,12,16,20,15,0.375,0.625,0.5161290322580645,0.4838709677419355
SF-I23-1,SF-H16,12,2,0,0,12,2,0.0,1.0,0.0,1.0
SF-I23-1,SF-H19,1,3,1,2,0,1,1.0,0.0,0.6666666666666666,0.3333333333333333
SF-I23-1,SF-H20,18,28,7,6,11,22,0.3888888888888889,0.6111111111111112,0.21428571428571427,0.7857142857142857
SF-I23-1,SF-H18,9,5,4,1,5,4,0.4444444444444444,0.5555555555555556,0.2,0.8
SF-I23-1,SF-H17,5,1,2,0,3,1,0.4,0.6,0.0,1.0
SF-I23-1,SF-G19,14,9,3,1,11,8,0.21428571428571427,0.7857142857142857,0.1111111111111111,0.8888888888888888
SF-I23-1,SF-G17,2,2,0,0,2,2,0.0,1.0,0.0,1.0
SF-I23-1,SF-G18,62,51,57,35,5,16,0.9193548387096774,0.08064516129032258,0.6862745098039216,0.3137254901960784
SF-I23-1,SF-G20,11,18,5,6,6,12,0.45454545454545453,0.5454545454545454,0.3333333333333333,0.6666666666666666
SF-I23-1,SF-F19,3,3,2,2,1,1,0.6666666666666666,0.3333333333333333,0.6666666666666666,0.3333333333333333
SF-I23-1,SF-E18,4,4,3,1,1,3,0.75,0.25,0.25,0.75
SF-I23-1,SF-E20,1,9,1,3,0,6,1.0,0.0,0.3333333333333333,0.6666666666666666
SF-I23-1,SF-H30,3,3,0,2,3,1,0.0,1.0,0.6666666666666666,0.3333333333333333
SF-I23-1,SF-G30-2,21,14,16,5,5,9,0.7619047619047619,0.23809523809523808,0.35714285714285715,0.6428571428571429
SF-I23-1,SF-E29-2,15,15,9,10,6,5,0.6,0.4,0.6666666666666666,0.3333333333333333
SF-I23-1,SF-E29-1,8,12,7,8,1,4,0.875,0.125,0.6666666666666666,0.3333333333333333
SF-I23-1,SF-D29,2,3,1,3,1,0,0.5,0.5,1.0,0.0
SF-I23-1,SF-D28,3,3,2,2,1,1,0.6666666666666666,0.3333333333333333,0.6666666666666666,0.3333333333333333
SF-I23-1,SF-G29-2,8,4,4,1,4,3,0.5,0.5,0.25,0.75
SF-I23-1,SF-G29-1,5,3,3,3,2,0,0.6,0.4,1.0,0.0
SF-I23-1,SF-G30-1,4,12,4,12,0,0,1.0,0.0,1.0,0.0
SF-I23-1,SF-G29-3,9,9,5,3,4,6,0.5555555555555556,0.4444444444444444,0.3333333333333333,0.6666666666666666
SF-I23-1,SF-F30-2,2,26,2,1,0,25,1.0,0.0,0.038461538461538464,0.9615384615384616
SF-I23-1,SF-F29,5,4,5,4,0,0,1.0,0.0,1.0,0.0
SF-I23-1,SF-E29-3,7,20,3,6,4,14,0.42857142857142855,0.5714285714285714,0.3,0.7
SF-I23-1,SF-F28-1,11,5,9,1,2,4,0.8181818181818182,0.18181818181818182,0.2,0.8
SF-I23-1,SF-E28-2,2,1,2,0,0,1,1.0,0.0,0.0,1.0
SF-I23-1,SF-E28,16,5,15,5,1,0,0.9375,0.0625,1.0,0.0
SF-I23-1,SF-J10,4,1,1,1,3,0,0.25,0.75,1.0,0.0
SF-I23-1,SF-J12,3,2,0,1,3,1,0.0,1.0,0.5,0.5
SF-I23-1,SF-J13,2,1,0,0,2,1,0.0,1.0,0.0,1.0
SF-I23-1,SF-H13,2,2,0,2,2,0,0.0,1.0,1.0,0.0
SF-I23-1,SF-I16,4,3,1,2,3,1,0.25,0.75,0.6666666666666666,0.3333333333333333
SF-I23-1,SF-H12,8,4,0,0,8,4,0.0,1.0,0.0,1.0
SF-I23-1,SF-G13,4,2,0,0,4,2,0.0,1.0,0.0,1.0
SF-I23-1,SF-G12,1,3,1,1,0,2,1.0,0.0,0.3333333333333333,0.6666666666666666
SF-I23-1,SF-F16,1,1,0,0,1,1,0.0,1.0,0.0,1.0
SF-I23-1,SF-C20,4,13,0,2,4,11,0.0,1.0,0.15384615384615385,0.8461538461538461
SF-I23-1,SF-B21,3,5,0,2,3,3,0.0,1.0,0.4,0.6
SF-I23-1,SF-B19,2,14,0,1,2,13,0.0,1.0,0.07142857142857142,0.9285714285714286
SF-I23-1,SF-A20,3,6,3,1,0,5,1.0,0.0,0.16666666666666666,0.8333333333333334
SF-I23-1,SF-A19,1,4,0,1,1,3,0.0,1.0,0.25,0.75
SF-I23-1,SF-C26,8,11,0,1,8,10,0.0,1.0,0.09090909090909091,0.9090909090909091
SF-I23-1,SF-C25,21,11,3,0,18,11,0.14285714285714285,0.8571428571428571,0.0,1.0
SF-I23-1,SF-B25,1,12,1,5,0,7,1.0,0.0,0.4166666666666667,0.5833333333333334
SF-I23-1,SF-E27,11,1,11,1,0,0,1.0,0.0,1.0,0.0
SF-I23-1,SF-B28-2,1,3,1,1,0,2,1.0,0.0,0.3333333333333333,0.6666666666666666
SF-I23-1,SF-D27,6,2,0,0,6,2,0.0,1.0,0.0,1.0
SF-I23-1,SF-C28-2,1,1,1,1,0,0,1.0,0.0,1.0,0.0
SF-I23-1,SF-C28-1,4,1,4,1,0,0,1.0,0.0,1.0,0.0
SF-I23-1,SF-B28,4,3,2,2,2,1,0.5,0.5,0.6666666666666666,0.3333333333333333
SF-I23-1,SF-J1,2,5,1,3,1,2,0.5,0.5,0.6,0.4
SF-I23-1,SF-J3,2,5,0,0,2,5,0.0,1.0,0.0,1.0
SF-I23-1,SF-J5,1,1,1,1,0,0,1.0,0.0,1.0,0.0
SF-I23-1,SF-G7,3,2,0,0,3,2,0.0,1.0,0.0,1.0
SF-I23-1,SF-F9,1,6,0,1,1,5,0.0,1.0,0.16666666666666666,0.8333333333333334
SF-I23-1,SF-H25,11,12,5,7,6,5,0.45454545454545453,0.5454545454545454,0.5833333333333334,0.4166666666666667
SF-I23-1,SF-G26,13,9,9,5,4,4,0.6923076923076923,0.3076923076923077,0.5555555555555556,0.4444444444444444
SF-I23-1,SF-K21,39,9,6,3,33,6,0.15384615384615385,0.8461538461538461,0.3333333333333333,0.6666666666666666
SF-I23-1,SF-K22-1,20,25,13,16,7,9,0.65,0.35,0.64,0.36
SF-I23-1,SF-J23-1,75,76,42,55,33,21,0.56,0.44,0.7236842105263158,0.27631578947368424
SF-I23-1,SF-J22-1,12,7,6,1,6,6,0.5,0.5,0.14285714285714285,0.8571428571428571
SF-I23-1,SF-J22-2,23,34,14,22,9,12,0.6086956521739131,0.391304347826087,0.6470588235294118,0.35294117647058826
SF-I23-1,SF-J21,37,39,20,26,17,13,0.5405405405405406,0.4594594594594595,0.6666666666666666,0.3333333333333333
SF-I23-1,SF-I21,6,1,5,0,1,1,0.8333333333333334,0.16666666666666666,0.0,1.0
SF-I23-1,SF-I22,67,37,43,20,24,17,0.6417910447761194,0.3582089552238806,0.5405405405405406,0.4594594594594595
SF-I23-1,SF-I23-2,78,44,53,36,25,8,0.6794871794871795,0.32051282051282054,0.8181818181818182,0.18181818181818182
SF-I23-1,SF-I24,45,47,22,38,23,9,0.4888888888888889,0.5111111111111111,0.8085106382978723,0.19148936170212766
SF-I23-1,SF-F26,12,30,8,8,4,22,0.6666666666666666,0.3333333333333333,0.26666666666666666,0.7333333333333333
SF-I23-1,SF-M13,22,3,19,0,3,3,0.8636363636363636,0.13636363636363635,0.0,1.0
SF-I23-1,SF-M15,3,2,0,0,3,2,0.0,1.0,0.0,1.0
SF-I23-1,SF-L19,7,4,1,0,6,4,0.14285714285714285,0.8571428571428571,0.0,1.0
SF-I23-1,SF-L20,5,8,4,1,1,7,0.8,0.2,0.125,0.875
SF-I23-1,SF-N20-1,19,8,7,5,12,3,0.3684210526315789,0.631578947368421,0.625,0.375
SF-I23-1,SF-M20,18,54,3,3,15,51,0.16666666666666666,0.8333333333333334,0.05555555555555555,0.9444444444444444
SF-I23-1,SF-K17-2,23,16,4,1,19,15,0.17391304347826086,0.8260869565217391,0.0625,0.9375
SF-I23-1,SF-K20,20,7,3,1,17,6,0.15,0.85,0.14285714285714285,0.8571428571428571
SF-I23-1,SF-K15-,6,11,2,2,4,9,0.3333333333333333,0.6666666666666666,0.18181818181818182,0.8181818181818182
SF-I23-1,SF-K19,11,5,3,1,8,4,0.2727272727272727,0.7272727272727273,0.2,0.8
SF-I23-1,SF-K18,9,6,5,1,4,5,0.5555555555555556,0.4444444444444444,0.16666666666666666,0.8333333333333334
SF-I23-1,SF-K17,13,17,3,3,10,14,0.23076923076923078,0.7692307692307693,0.17647058823529413,0.8235294117647058
SF-I23-1,SF-J16,8,12,1,2,7,10,0.125,0.875,0.16666666666666666,0.8333333333333334
SF-I23-1,SF-J18,16,9,2,0,14,9,0.125,0.875,0.0,1.0
SF-I23-1,SF-J20,17,13,5,7,12,6,0.29411764705882354,0.7058823529411765,0.5384615384615384,0.46153846153846156
SF-I23-1,SF-J19,30,30,13,16,17,14,0.43333333333333335,0.5666666666666667,0.5333333333333333,0.4666666666666667
SF-I23-1,SF-M12,2,2,0,0,2,2,0.0,1.0,0.0,1.0
SF-I23-1,SF-M10,4,5,0,1,4,4,0.0,1.0,0.2,0.8
SF-I23-1,SF-M11,4,3,0,3,4,0,0.0,1.0,1.0,0.0
SF-I23-1,SF-R19,24,1,0,0,24,1,0.0,1.0,0.0,1.0
SF-I23-1,SF-Q21-2,74,2,15,0,59,2,0.20270270270270271,0.7972972972972973,0.0,1.0
SF-I23-1,SF-Q21-1,17,2,13,2,4,0,0.7647058823529411,0.23529411764705882,1.0,0.0
SF-I23-1,SF-O18,2,6,1,2,1,4,0.5,0.5,0.3333333333333333,0.6666666666666666
SF-I23-1,SF-O19,6,7,2,0,4,7,0.3333333333333333,0.6666666666666666,0.0,1.0
SF-I23-1,SF-O21,12,24,1,7,11,17,0.08333333333333333,0.9166666666666666,0.2916666666666667,0.7083333333333334
SF-I23-1,SF-O22,27,22,12,11,15,11,0.4444444444444444,0.5555555555555556,0.5,0.5
SF-I23-1,SF-N21,7,4,2,0,5,4,0.2857142857142857,0.7142857142857143,0.0,1.0
SF-I23-1,SF-N20-2,2,1,0,1,2,0,0.0,1.0,1.0,0.0
SF-I23-1,SF-M21,10,11,1,1,9,10,0.1,0.9,0.09090909090909091,0.9090909090909091
SF-I23-1,SF-L21,61,88,10,18,51,70,0.16393442622950818,0.8360655737704918,0.20454545454545456,0.7954545454545454
SF-I23-1,SF-S29,2,2,2,2,0,0,1.0,0.0,1.0,0.0
SF-I23-1,SF-P30,4,1,0,0,4,1,0.0,1.0,0.0,1.0
SF-I23-1,SF-O30,3,1,1,0,2,1,0.3333333333333333,0.6666666666666666,0.0,1.0
SF-I23-1,SF-N27,8,12,2,11,6,1,0.25,0.75,0.9166666666666666,0.08333333333333333
SF-I23-1,SF-N29,6,1,1,1,5,0,0.16666666666666666,0.8333333333333334,1.0,0.0
SF-I23-1,SF-N28,5,6,5,1,0,5,1.0,0.0,0.16666666666666666,0.8333333333333334
SF-I23-1,SF-L30-1,30,26,5,2,25,24,0.16666666666666666,0.8333333333333334,0.07692307692307693,0.9230769230769231
SF-I23-1,SF-L31-1,4,2,2,1,2,1,0.5,0.5,0.5,0.5
SF-I23-1,SF-L29,13,4,5,1,8,3,0.38461538461538464,0.6153846153846154,0.25,0.75
SF-I23-1,SF-J29-1,3,4,1,4,2,0,0.3333333333333333,0.6666666666666666,1.0,0.0
SF-I23-1,SF-I30,9,15,9,10,0,5,1.0,0.0,0.6666666666666666,0.3333333333333333
SF-I23-1,SF-I29-2,5,10,2,2,3,8,0.4,0.6,0.2,0.8
SF-I23-1,SF-I27,8,7,4,4,4,3,0.5,0.5,0.5714285714285714,0.42857142857142855
SF-I23-1,SF-I30-2,9,3,8,1,1,2,0.8888888888888888,0.1111111111111111,0.3333333333333333,0.6666666666666666
SF-I23-1,SF I29-1,13,14,8,11,5,3,0.6153846153846154,0.38461538461538464,0.7857142857142857,0.21428571428571427
SF-I23-1,SF-H28,1,5,0,2,1,3,0.0,1.0,0.4,0.6
SF-I23-1,SF-S24,1,4,0,2,1,2,0.0,1.0,0.5,0.5
SF-I23-1,SF-R24,20,18,13,8,7,10,0.65,0.35,0.4444444444444444,0.5555555555555556
SF-I23-1,SF-Q26,2,3,0,1,2,2,0.0,1.0,0.3333333333333333,0.6666666666666666
SF-I23-1,SF-P26,7,8,1,1,6,7,0.14285714285714285,0.8571428571428571,0.125,0.875
SF-I23-1,SF-O25-2,1,3,0,1,1,2,0.0,1.0,0.3333333333333333,0.6666666666666666
SF-I23-1,SF-N22-1B,15,3,2,1,13,2,0.13333333333333333,0.8666666666666667,0.3333333333333333,0.6666666666666666
SF-I23-1,SF-N26,3,4,0,0,3,4,0.0,1.0,0.0,1.0
SF-I23-1,SF-N25,2,1,1,0,1,1,0.5,0.5,0.0,1.0
SF-I23-1,SF-T21,3,6,0,3,3,3,0.0,1.0,0.5,0.5
SF-I23-1,SF-T22,10,5,1,1,9,4,0.1,0.9,0.2,0.8
SF-I23-1,SF-S22-2,1,3,0,0,1,3,0.0,1.0,0.0,1.0
SF-I23-1,SF-S22-1,5,3,2,1,3,2,0.4,0.6,0.3333333333333333,0.6666666666666666
SF-I23-1,SF-Q23-3,4,5,2,2,2,3,0.5,0.5,0.4,0.6
SF-I23-1,SF-Q22-1,5,10,3,0,2,10,0.6,0.4,0.0,1.0
SF-I23-1,SF-Q22-2,14,8,2,2,12,6,0.14285714285714285,0.8571428571428571,0.25,0.75
SF-I23-1,SF-P22,18,9,8,4,10,5,0.4444444444444444,0.5555555555555556,0.4444444444444444,0.5555555555555556
SF-I23-1,SF-U21,3,1,0,0,3,1,0.0,1.0,0.0,1.0
SF-I23-1,SF-T20,15,14,2,0,13,14,0.13333333333333333,0.8666666666666667,0.0,1.0
SF-I23-1,SF-S21,28,2,0,0,28,2,0.0,1.0,0.0,1.0
SF-I23-1,SF-U30,2,7,0,6,2,1,0.0,1.0,0.8571428571428571,0.14285714285714285
SF-F26,SF-M26,3,2,0,0,3,2,0.0,1.0,0.0,1.0
SF-F26,SF-M25,9,13,0,7,9,6,0.0,1.0,0.5384615384615384,0.46153846153846156
SF-F26,SF-M26-2,8,6,2,1,6,5,0.25,0.75,0.16666666666666666,0.8333333333333334
SF-F26,SF-L27,2,5,1,2,1,3,0.5,0.5,0.4,0.6
SF-F26,SF-K26,11,21,3,9,8,12,0.2727272727272727,0.7272727272727273,0.42857142857142855,0.5714285714285714
SF-F26,SF-J27,10,13,9,12,1,1,0.9,0.1,0.9230769230769231,0.07692307692307693
SF-F26,SF-M30,16,14,3,5,13,9,0.1875,0.8125,0.35714285714285715,0.6428571428571429
SF-F26,SF-L27-2,6,1,0,1,6,0,0.0,1.0,1.0,0.0
SF-F26,SF-J29-3,10,29,5,10,5,19,0.5,0.5,0.3448275862068966,0.6551724137931034
SF-F26,SF-J29,88,98,36,62,52,36,0.4090909090909091,0.5909090909090909,0.6326530612244898,0.3673469387755102
SF-F26,SF-L26,9,21,3,14,6,7,0.3333333333333333,0.6666666666666666,0.6666666666666666,0.3333333333333333
SF-F26,SF-M28,17,28,5,5,12,23,0.29411764705882354,0.7058823529411765,0.17857142857142858,0.8214285714285714
SF-F26,SF-M27,2,3,1,2,1,1,0.5,0.5,0.6666666666666666,0.3333333333333333
SF-F26,SF-L25,11,21,5,8,6,13,0.45454545454545453,0.5454545454545454,0.38095238095238093,0.6190476190476191
SF-F26,SF-M24,10,17,5,7,5,10,0.5,0.5,0.4117647058823529,0.5882352941176471
SF-F26,SF-L24,9,17,1,8,8,9,0.1111111111111111,0.8888888888888888,0.47058823529411764,0.5294117647058824
SF-F26,SF-N23,3,6,0,4,3,2,0.0,1.0,0.6666666666666666,0.3333333333333333
SF-F26,SF-N24-2,2,4,1,1,1,3,0.5,0.5,0.25,0.75
SF-F26,SF-K27-2,15,15,9,10,6,5,0.6,0.4,0.6666666666666666,0.3333333333333333
SF-F26,SF-J26-2,52,71,8,10,44,61,0.15384615384615385,0.8461538461538461,0.14084507042253522,0.8591549295774648
SF-F26,SF-K28-3,1,1,0,1,1,0,0.0,1.0,1.0,0.0
SF-F26,SF-L28,5,7,2,3,3,4,0.4,0.6,0.42857142857142855,0.5714285714285714
SF-F26,SF-K28,3,48,2,46,1,2,0.6666666666666666,0.3333333333333333,0.9583333333333334,0.041666666666666664
SF-F26,SF-K29-1,38,29,23,12,15,17,0.6052631578947368,0.39473684210526316,0.41379310344827586,0.5862068965517241
SF-F26,SF-J28-2,11,12,2,5,9,7,0.18181818181818182,0.8181818181818182,0.4166666666666667,0.5833333333333334
SF-F26,SF-K27,2,3,0,0,2,3,0.0,1.0,0.0,1.0
SF-F26,SF-K25,31,33,11,22,20,11,0.3548387096774194,0.6451612903225806,0.6666666666666666,0.3333333333333333
SF-F26,SF-J25,36,39,8,15,28,24,0.2222222222222222,0.7777777777777778,0.38461538461538464,0.6153846153846154
SF-F26,SF-H26-2,20,20,2,7,18,13,0.1,0.9,0.35,0.65
SF-F26,SF-P24,12,31,3,2,9,29,0.25,0.75,0.06451612903225806,0.9354838709677419
SF-F26,SF-J24,15,26,8,12,7,14,0.5333333333333333,0.4666666666666667,0.46153846153846156,0.5384615384615384
SF-F26,SF-O24,18,41,3,6,15,35,0.16666666666666666,0.8333333333333334,0.14634146341463414,0.8536585365853658
SF-F26,SF-J26,19,13,3,6,16,7,0.15789473684210525,0.8421052631578947,0.46153846153846156,0.5384615384615384
SF-F26,SF-I26-,22,21,3,10,19,11,0.13636363636363635,0.8636363636363636,0.47619047619047616,0.5238095238095238
SF-F26,SF-I25,56,46,35,31,21,15,0.625,0.375,0.6739130434782609,0.32608695652173914
SF-F26,SF-K23,3,6,1,1,2,5,0.3333333333333333,0.6666666666666666,0.16666666666666666,0.8333333333333334
SF-F26,SF-H26,61,125,19,95,42,30,0.3114754098360656,0.6885245901639344,0.76,0.24
SF-F26,SF-O23,12,9,3,2,9,7,0.25,0.75,0.2222222222222222,0.7777777777777778
SF-F26,SF-H27-1,15,20,10,14,5,6,0.6666666666666666,0.3333333333333333,0.7,0.3
SF-F26,SF-F28-2,52,45,30,27,22,18,0.5769230769230769,0.4230769230769231,0.6,0.4
SF-F26,SF-G27,108,117,37,65,71,52,0.3425925925925926,0.6574074074074074,0.5555555555555556,0.4444444444444444
SF-F26,SF-M22-2,19,37,3,12,16,25,0.15789473684210525,0.8421052631578947,0.32432432432432434,0.6756756756756757
SF-F26,SF-L22,21,26,4,12,17,14,0.19047619047619047,0.8095238095238095,0.46153846153846156,0.5384615384615384
SF-F26,SF-F27,74,52,25,35,49,17,0.33783783783783783,0.6621621621621622,0.6730769230769231,0.3269230769230769
SF-F26,SF-N22-2,33,37,8,11,25,26,0.24242424242424243,0.7575757575757576,0.2972972972972973,0.7027027027027027
SF-F26,SF-G28-2,10,19,4,5,6,14,0.4,0.6,0.2631578947368421,0.7368421052631579
SF-F26,SF-G28-1,12,4,8,2,4,2,0.6666666666666666,0.3333333333333333,0.5,0.5
SF-F26,SF-M22-1,2,11,1,2,1,9,0.5,0.5,0.18181818181818182,0.8181818181818182
SF-F26,SF-O25-1,7,8,0,0,7,8,0.0,1.0,0.0,1.0
SF-F26,SF-K22-2,19,19,6,7,13,12,0.3157894736842105,0.6842105263157895,0.3684210526315789,0.631578947368421
SF-F26,SF-K24,36,32,8,7,28,25,0.2222222222222222,0.7777777777777778,0.21875,0.78125
SF-F26,SF-J23-2,24,30,10,8,14,22,0.4166666666666667,0.5833333333333334,0.26666666666666666,0.7333333333333333
SF-F26,SF-G23,15,13,7,2,8,11,0.4666666666666667,0.5333333333333333,0.15384615384615385,0.8461538461538461
SF-F26,SF-G24,86,56,39,16,47,40,0.45348837209302323,0.5465116279069767,0.2857142857142857,0.7142857142857143
SF-F26,SF-G25,56,36,36,8,20,28,0.6428571428571429,0.35714285714285715,0.2222222222222222,0.7777777777777778
SF-F26,SF-F23,33,38,12,9,21,29,0.36363636363636365,0.6363636363636364,0.23684210526315788,0.7631578947368421
SF-F26,SF-E23,44,45,21,7,23,38,0.4772727272727273,0.5227272727272727,0.15555555555555556,0.8444444444444444
SF-F26,SF-D24,25,12,13,3,12,9,0.52,0.48,0.25,0.75
SF-F26,SF-C22,15,32,4,5,11,27,0.26666666666666666,0.7333333333333333,0.15625,0.84375
SF-F26,SF-B22,34,40,8,21,26,19,0.23529411764705882,0.7647058823529411,0.525,0.475
SF-F26,SF-J17,13,18,5,4,8,14,0.38461538461538464,0.6153846153846154,0.2222222222222222,0.7777777777777778
SF-F26,SF-I19,17,13,4,3,13,10,0.23529411764705882,0.7647058823529411,0.23076923076923078,0.7692307692307693
SF-F26,SF-I20,5,15,1,9,4,6,0.2,0.8,0.6,0.4
SF-F26,SF-H16,17,6,2,0,15,6,0.11764705882352941,0.8823529411764706,0.0,1.0
SF-F26,SF-H19,20,11,0,0,20,11,0.0,1.0,0.0,1.0
SF-F26,SF-H20,12,13,5,4,7,9,0.4166666666666667,0.5833333333333334,0.3076923076923077,0.6923076923076923
SF-F26,SF-H18,12,5,3,2,9,3,0.25,0.75,0.4,0.6
SF-F26,SF-H17,5,2,0,0,5,2,0.0,1.0,0.0,1.0
SF-F26,SF-G19,11,18,3,3,8,15,0.2727272727272727,0.7272727272727273,0.16666666666666666,0.8333333333333334
SF-F26,SF-G17,28,22,7,0,21,22,0.25,0.75,0.0,1.0
SF-F26,SF-G18,49,17,4,2,45,15,0.08163265306122448,0.9183673469387755,0.11764705882352941,0.8823529411764706
SF-F26,SF-G20,32,43,8,7,24,36,0.25,0.75,0.16279069767441862,0.8372093023255814
SF-F26,SF-F19,17,12,3,0,14,12,0.17647058823529413,0.8235294117647058,0.0,1.0
SF-F26,SF-E18,31,43,4,4,27,39,0.12903225806451613,0.8709677419354839,0.09302325581395349,0.9069767441860465
SF-F26,SF-E20,9,22,2,0,7,22,0.2222222222222222,0.7777777777777778,0.0,1.0
SF-F26,SF-H30,16,15,8,3,8,12,0.5,0.5,0.2,0.8
SF-F26,SF-G30-2,34,59,19,30,15,29,0.5588235294117647,0.4411764705882353,0.5084745762711864,0.4915254237288136
SF-F26,SF-F30-1,56,78,35,69,21,9,0.625,0.375,0.8846153846153846,0.11538461538461539
SF-F26,SF-E29-2,53,52,26,31,27,21,0.49056603773584906,0.5094339622641509,0.5961538461538461,0.40384615384615385
SF-F26,SF-E29-1,28,32,15,17,13,15,0.5357142857142857,0.4642857142857143,0.53125,0.46875
SF-F26,SF-D29,17,25,5,8,12,17,0.29411764705882354,0.7058823529411765,0.32,0.68
SF-F26,SF-D28,50,60,26,40,24,20,0.52,0.48,0.6666666666666666,0.3333333333333333
SF-F26,SF-A27,25,23,15,16,10,7,0.6,0.4,0.6956521739130435,0.30434782608695654
SF-F26,SF-G29-2,51,53,22,14,29,39,0.43137254901960786,0.5686274509803921,0.2641509433962264,0.7358490566037735
SF-F26,SF-G29-1,54,139,44,131,10,8,0.8148148148148148,0.18518518518518517,0.9424460431654677,0.05755395683453238
SF-F26,SF-G30-1,43,38,17,21,26,17,0.3953488372093023,0.6046511627906976,0.5526315789473685,0.4473684210526316
SF-F26,SF-G29-3,30,16,19,12,11,4,0.6333333333333333,0.36666666666666664,0.75,0.25
SF-F26,SF-F30-2,39,41,14,29,25,12,0.358974358974359,0.6410256410256411,0.7073170731707317,0.2926829268292683
SF-F26,SF-F29,16,22,9,6,7,16,0.5625,0.4375,0.2727272727272727,0.7272727272727273
SF-F26,SF-E29-3,8,8,0,5,8,3,0.0,1.0,0.625,0.375
SF-F26,SF-F28-1,27,16,15,10,12,6,0.5555555555555556,0.4444444444444444,0.625,0.375
SF-F26,SF-E28-2,8,3,4,3,4,0,0.5,0.5,1.0,0.0
SF-F26,SF-E28,24,25,12,14,12,11,0.5,0.5,0.56,0.44
SF-F26,SF-J10,7,12,1,1,6,11,0.14285714285714285,0.8571428571428571,0.08333333333333333,0.9166666666666666
SF-F26,SF-J12,24,5,5,2,19,3,0.20833333333333334,0.7916666666666666,0.4,0.6
SF-F26,SF-J13,3,4,1,1,2,3,0.3333333333333333,0.6666666666666666,0.25,0.75
SF-F26,SF-J15,7,2,1,0,6,2,0.14285714285714285,0.8571428571428571,0.0,1.0
SF-F26,SF-I16,5,3,1,2,4,1,0.2,0.8,0.6666666666666666,0.3333333333333333
SF-F26,SF-H15,5,1,3,0,2,1,0.6,0.4,0.0,1.0
SF-F26,SF-G9,3,3,1,3,2,0,0.3333333333333333,0.6666666666666666,1.0,0.0
SF-F26,SF-G13,4,6,0,0,4,6,0.0,1.0,0.0,1.0
SF-F26,SF-G11,5,2,0,0,5,2,0.0,1.0,0.0,1.0
SF-F26,SF-G12,3,4,0,0,3,4,0.0,1.0,0.0,1.0
SF-F26,SF-G10-1,5,3,1,0,4,3,0.2,0.8,0.0,1.0
SF-F26,SF-F15,5,4,0,0,5,4,0.0,1.0,0.0,1.0
SF-F26,SF-F16,4,8,0,0,4,8,0.0,1.0,0.0,1.0
SF-F26,SF-C21,3,6,2,0,1,6,0.6666666666666666,0.3333333333333333,0.0,1.0
SF-F26,SF-C20,9,24,0,8,9,16,0.0,1.0,0.3333333333333333,0.6666666666666666
SF-F26,SF-B21,5,5,2,1,3,4,0.4,0.6,0.2,0.8
SF-F26,SF-B19,19,25,5,3,14,22,0.2631578947368421,0.7368421052631579,0.12,0.88
SF-F26,SF-A20,7,24,0,13,7,11,0.0,1.0,0.5416666666666666,0.4583333333333333
SF-F26,SF-A19,7,13,1,9,6,4,0.14285714285714285,0.8571428571428571,0.6923076923076923,0.3076923076923077
SF-F26,SF-C26,35,98,21,37,14,61,0.6,0.4,0.37755102040816324,0.6224489795918368
SF-F26,SF-C25,59,55,14,12,45,43,0.23728813559322035,0.7627118644067796,0.21818181818181817,0.7818181818181819
SF-F26,SF-B25,39,51,16,17,23,34,0.41025641025641024,0.5897435897435898,0.3333333333333333,0.6666666666666666
SF-F26,SF-E27,15,10,9,4,6,6,0.6,0.4,0.4,0.6
SF-F26,SF-B28-2,12,2,2,0,10,2,0.16666666666666666,0.8333333333333334,0.0,1.0
SF-F26,SF-D27,37,64,26,36,11,28,0.7027027027027027,0.2972972972972973,0.5625,0.4375
SF-F26,SF-C28-2,9,14,6,1,3,13,0.6666666666666666,0.3333333333333333,0.07142857142857142,0.9285714285714286
SF-F26,SF-C28-1,8,5,7,4,1,1,0.875,0.125,0.8,0.2
SF-F26,SF-B28,14,31,11,17,3,14,0.7857142857142857,0.21428571428571427,0.5483870967741935,0.45161290322580644
SF-F26,SF-J1,3,4,0,1,3,3,0.0,1.0,0.25,0.75
SF-F26,SF-H0,2,1,0,0,2,1,0.0,1.0,0.0,1.0
SF-F26,SF-G5,2,3,0,0,2,3,0.0,1.0,0.0,1.0
SF-F26,SF-F9,3,2,2,2,1,0,0.6666666666666666,0.3333333333333333,1.0,0.0
SF-F26,SF-H25,10,5,2,1,8,4,0.2,0.8,0.2,0.8
SF-F26,SF-G26,61,59,25,26,36,33,0.4098360655737705,0.5901639344262295,0.4406779661016949,0.559322033898305
SF-F26,SF-K21,28,22,5,0,23,22,0.17857142857142858,0.8214285714285714,0.0,1.0
SF-F26,SF-K22-1,19,40,9,27,10,13,0.47368421052631576,0.5263157894736842,0.675,0.325
SF-F26,SF-J23-1,134,152,40,51,94,101,0.29850746268656714,0.7014925373134329,0.3355263157894737,0.6644736842105263
SF-F26,SF-J22-1,26,27,3,4,23,23,0.11538461538461539,0.8846153846153846,0.14814814814814814,0.8518518518518519
SF-F26,SF-J22-2,39,52,8,13,31,39,0.20512820512820512,0.7948717948717948,0.25,0.75
SF-F26,SF-J21,23,26,9,6,14,20,0.391304347826087,0.6086956521739131,0.23076923076923078,0.7692307692307693
SF-F26,SF-I21,3,11,2,5,1,6,0.6666666666666666,0.3333333333333333,0.45454545454545453,0.5454545454545454
SF-F26,SF-I22,15,12,3,4,12,8,0.2,0.8,0.3333333333333333,0.6666666666666666
SF-F26,SF-I23-2,26,20,16,12,10,8,0.6153846153846154,0.38461538461538464,0.6,0.4
SF-F26,SF-I24,8,11,4,5,4,6,0.5,0.5,0.45454545454545453,0.5454545454545454
SF-F26,SF-I23-1,30,12,8,8,22,4,0.26666666666666666,0.7333333333333333,0.6666666666666666,0.3333333333333333
SF-F26,SF-M13,10,8,0,1,10,7,0.0,1.0,0.125,0.875
SF-F26,SF-M15,25,28,2,1,23,27,0.08,0.92,0.03571428571428571,0.9642857142857143
SF-F26,SF-L19,22,15,2,0,20,15,0.09090909090909091,0.9090909090909091,0.0,1.0
SF-F26,SF-L20,19,31,4,2,15,29,0.21052631578947367,0.7894736842105263,0.06451612903225806,0.9354838709677419
SF-F26,SF-N20-1,17,8,3,3,14,5,0.17647058823529413,0.8235294117647058,0.375,0.625
SF-F26,SF-M20,54,45,5,7,49,38,0.09259259259259259,0.9074074074074074,0.15555555555555556,0.8444444444444444
SF-F26,SF-K17-2,6,6,1,1,5,5,0.16666666666666666,0.8333333333333334,0.16666666666666666,0.8333333333333334
SF-F26,SF-K20,13,15,5,5,8,10,0.38461538461538464,0.6153846153846154,0.3333333333333333,0.6666666666666666
SF-F26,SF-K15-,29,31,9,5,20,26,0.3103448275862069,0.6896551724137931,0.16129032258064516,0.8387096774193549
SF-F26,SF-K19,19,23,2,2,17,21,0.10526315789473684,0.8947368421052632,0.08695652173913043,0.9130434782608695
SF-F26,SF-K18,17,7,2,1,15,6,0.11764705882352941,0.8823529411764706,0.14285714285714285,0.8571428571428571
SF-F26,SF-K17,14,17,2,2,12,15,0.14285714285714285,0.8571428571428571,0.11764705882352941,0.8823529411764706
SF-F26,SF-J16,9,9,1,1,8,8,0.1111111111111111,0.8888888888888888,0.1111111111111111,0.8888888888888888
SF-F26,SF-J18,30,24,5,3,25,21,0.16666666666666666,0.8333333333333334,0.125,0.875
SF-F26,SF-J20,15,19,7,7,8,12,0.4666666666666667,0.5333333333333333,0.3684210526315789,0.631578947368421
SF-F26,SF-J19,32,47,12,16,20,31,0.375,0.625,0.3404255319148936,0.6595744680851063
SF-F26,SF-M12,5,4,1,2,4,2,0.2,0.8,0.5,0.5
SF-F26,SF-M10,4,2,0,1,4,1,0.0,1.0,0.5,0.5
SF-F26,SF-M11,5,8,3,2,2,6,0.6,0.4,0.25,0.75
SF-F26,SF-R19,4,12,0,4,4,8,0.0,1.0,0.3333333333333333,0.6666666666666666
SF-F26,SF-R20,4,5,1,0,3,5,0.25,0.75,0.0,1.0
SF-F26,SF-Q21-2,14,10,3,0,11,10,0.21428571428571427,0.7857142857142857,0.0,1.0
SF-F26,SF-Q21-1,3,8,0,2,3,6,0.0,1.0,0.25,0.75
SF-F26,SF-P21,10,15,2,2,8,13,0.2,0.8,0.13333333333333333,0.8666666666666667
SF-F26,SF-O18,19,30,3,6,16,24,0.15789473684210525,0.8421052631578947,0.2,0.8
SF-F26,SF-O19,21,21,3,3,18,18,0.14285714285714285,0.8571428571428571,0.14285714285714285,0.8571428571428571
SF-F26,SF-O21,23,42,12,14,11,28,0.5217391304347826,0.4782608695652174,0.3333333333333333,0.6666666666666666
SF-F26,SF-O22,26,49,7,22,19,27,0.2692307692307692,0.7307692307692307,0.4489795918367347,0.5510204081632653
SF-F26,SF-N21,10,22,5,8,5,14,0.5,0.5,0.36363636363636365,0.6363636363636364
SF-F26,SF-N20-2,7,7,3,2,4,5,0.42857142857142855,0.5714285714285714,0.2857142857142857,0.7142857142857143
SF-F26,SF-M21,18,20,6,4,12,16,0.3333333333333333,0.6666666666666666,0.2,0.8
SF-F26,SF-L21,42,84,14,39,28,45,0.3333333333333333,0.6666666666666666,0.4642857142857143,0.5357142857142857
SF-F26,SF-S29,1,2,0,0,1,2,0.0,1.0,0.0,1.0
SF-F26,SF-Q30,12,17,1,3,11,14,0.08333333333333333,0.9166666666666666,0.17647058823529413,0.8235294117647058
SF-F26,SF-P30,11,14,1,6,10,8,0.09090909090909091,0.9090909090909091,0.42857142857142855,0.5714285714285714
SF-F26,SF-O30-2,6,8,0,2,6,6,0.0,1.0,0.25,0.75
SF-F26,SF-O30,28,25,6,3,22,22,0.21428571428571427,0.7857142857142857,0.12,0.88
SF-F26,SF-N27,20,24,1,2,19,22,0.05,0.95,0.08333333333333333,0.9166666666666666
SF-F26,SF-N29,11,8,2,1,9,7,0.18181818181818182,0.8181818181818182,0.125,0.875
SF-F26,SF-N28,62,41,3,5,59,36,0.04838709677419355,0.9516129032258065,0.12195121951219512,0.8780487804878049
SF-F26,SF-L30-1,19,19,11,10,8,9,0.5789473684210527,0.42105263157894735,0.5263157894736842,0.47368421052631576
SF-F26,SF-L31-1,10,10,6,4,4,6,0.6,0.4,0.4,0.6
SF-F26,SF-K30-2,11,13,4,5,7,8,0.36363636363636365,0.6363636363636364,0.38461538461538464,0.6153846153846154
SF-F26,SF-L29,24,23,9,11,15,12,0.375,0.625,0.4782608695652174,0.5217391304347826
SF-F26,SF-J29-1,50,19,17,11,33,8,0.34,0.66,0.5789473684210527,0.42105263157894735
SF-F26,SF-I30,43,31,28,10,15,21,0.6511627906976745,0.3488372093023256,0.3225806451612903,0.6774193548387096
SF-F26,SF-I29-2,9,4,3,2,6,2,0.3333333333333333,0.6666666666666666,0.5,0.5
SF-F26,SF-I27,22,23,12,13,10,10,0.5454545454545454,0.45454545454545453,0.5652173913043478,0.43478260869565216
SF-F26,SF-I28,10,22,1,5,9,17,0.1,0.9,0.22727272727272727,0.7727272727272727
SF-F26,SF-I30-2,40,33,9,12,31,21,0.225,0.775,0.36363636363636365,0.6363636363636364
SF-F26,SF I29-1,16,15,3,3,13,12,0.1875,0.8125,0.2,0.8
SF-F26,SF-H28,29,30,14,15,15,15,0.4827586206896552,0.5172413793103449,0.5,0.5
SF-F26,SF-H29,10,2,5,2,5,0,0.5,0.5,1.0,0.0
SF-F26,SF-S24,11,11,2,1,9,10,0.18181818181818182,0.8181818181818182,0.09090909090909091,0.9090909090909091
SF-F26,SF-R24,26,41,5,13,21,28,0.19230769230769232,0.8076923076923077,0.3170731707317073,0.6829268292682927
SF-F26,SF-R26,2,4,0,1,2,3,0.0,1.0,0.25,0.75
SF-F26,SF-Q26,4,10,3,3,1,7,0.75,0.25,0.3,0.7
SF-F26,SF-P26,7,2,0,0,7,2,0.0,1.0,0.0,1.0
SF-F26,SF-O25-2,3,8,2,1,1,7,0.6666666666666666,0.3333333333333333,0.125,0.875
SF-F26,SF-N22-1B,3,2,0,0,3,2,0.0,1.0,0.0,1.0
SF-F26,SF-N26,6,6,2,0,4,6,0.3333333333333333,0.6666666666666666,0.0,1.0
SF-F26,SF-N25,3,2,0,0,3,2,0.0,1.0,0.0,1.0
SF-F26,SF-T22,9,10,4,3,5,7,0.4444444444444444,0.5555555555555556,0.3,0.7
SF-F26,SF-S22-2,2,2,1,2,1,0,0.5,0.5,1.0,0.0
SF-F26,SF-S22-1,8,6,0,4,8,2,0.0,1.0,0.6666666666666666,0.3333333333333333
SF-F26,SF-Q23-3,3,6,0,3,3,3,0.0,1.0,0.5,0.5
SF-F26,SF-Q22-1,12,20,1,8,11,12,0.08333333333333333,0.9166666666666666,0.4,0.6
SF-F26,SF-Q22-2,7,18,4,8,3,10,0.5714285714285714,0.42857142857142855,0.4444444444444444,0.5555555555555556
SF-F26,SF-P22,12,17,9,11,3,6,0.75,0.25,0.6470588235294118,0.35294117647058826
SF-F26,SF-U21,3,1,0,0,3,1,0.0,1.0,0.0,1.0
SF-F26,SF-T20,5,6,1,3,4,3,0.2,0.8,0.5,0.5
SF-F26,SF-S21,4,6,1,1,3,5,0.25,0.75,0.16666666666666666,0.8333333333333334
SF-F26,SF-X30,1,2,0,1,1,1,0.0,1.0,0.5,0.5
SF-F26,SF-V31,3,2,0,0,3,2,0.0,1.0,0.0,1.0
SF-F26,SF-X19,1,1,0,0,1,1,0.0,1.0,0.0,1.0
SF-F26,SF-Y25,4,4,0,0,4,4,0.0,1.0,0.0,1.0
SF-M13,SF-M25,1,2,0,0,1,2,0.0,1.0,0.0,1.0
SF-M13,SF-L27,1,1,1,0,0,1,1.0,0.0,0.0,1.0
SF-M13,SF-K26,2,3,0,1,2,2,0.0,1.0,0.3333333333333333,0.6666666666666666
SF-M13,SF-M30,65,135,1,18,64,117,0.015384615384615385,0.9846153846153847,0.13333333333333333,0.8666666666666667
SF-M13,SF-J29-3,1,8,0,5,1,3,0.0,1.0,0.625,0.375
SF-M13,SF-J29,4,6,2,2,2,4,0.5,0.5,0.3333333333333333,0.6666666666666666
SF-M13,SF-L26,2,4,0,2,2,2,0.0,1.0,0.5,0.5
SF-M13,SF-M28,3,3,0,0,3,3,0.0,1.0,0.0,1.0
SF-M13,SF-L25,2,12,0,10,2,2,0.0,1.0,0.8333333333333334,0.16666666666666666
SF-M13,SF-M24,3,1,0,1,3,0,0.0,1.0,1.0,0.0
SF-M13,SF-L24,4,9,0,7,4,2,0.0,1.0,0.7777777777777778,0.2222222222222222
SF-M13,SF-N23,4,5,1,0,3,5,0.25,0.75,0.0,1.0
SF-M13,SF-N24-2,1,5,0,1,1,4,0.0,1.0,0.2,0.8
SF-M13,SF-K27-2,1,3,0,0,1,3,0.0,1.0,0.0,1.0
SF-M13,SF-J26-2,8,18,0,0,8,18,0.0,1.0,0.0,1.0
SF-M13,SF-L28,24,26,0,5,24,21,0.0,1.0,0.19230769230769232,0.8076923076923077
SF-M13,SF-K28,1,1,0,0,1,1,0.0,1.0,0.0,1.0
SF-M13,SF-K29-1,3,1,0,0,3,1,0.0,1.0,0.0,1.0
SF-M13,SF-K25,8,6,1,3,7,3,0.125,0.875,0.5,0.5
SF-M13,SF-J25,4,4,2,1,2,3,0.5,0.5,0.25,0.75
SF-M13,SF-P24,6,6,5,2,1,4,0.8333333333333334,0.16666666666666666,0.3333333333333333,0.6666666666666666
SF-M13,SF-J24,1,7,1,1,0,6,1.0,0.0,0.14285714285714285,0.8571428571428571
SF-M13,SF-O24,9,20,0,0,9,20,0.0,1.0,0.0,1.0
SF-M13,SF-I26-,5,1,0,0,5,1,0.0,1.0,0.0,1.0
SF-M13,SF-I25,22,39,12,15,10,24,0.5454545454545454,0.45454545454545453,0.38461538461538464,0.6153846153846154
SF-M13,SF-K23,4,5,0,1,4,4,0.0,1.0,0.2,0.8
SF-M13,SF-H26,5,16,1,11,4,5,0.2,0.8,0.6875,0.3125
SF-M13,SF-O23,12,16,0,4,12,12,0.0,1.0,0.25,0.75
SF-M13,SF-F28-2,23,7,0,1,23,6,0.0,1.0,0.14285714285714285,0.8571428571428571
SF-M13,SF-G27,7,23,0,15,7,8,0.0,1.0,0.6521739130434783,0.34782608695652173
SF-M13,SF-M22-2,7,13,0,3,7,10,0.0,1.0,0.23076923076923078,0.7692307692307693
SF-M13,SF-L22,3,1,0,0,3,1,0.0,1.0,0.0,1.0
SF-M13,SF-F27,13,50,0,4,13,46,0.0,1.0,0.08,0.92
SF-M13,SF-N22-2,23,24,3,4,20,20,0.13043478260869565,0.8695652173913043,0.16666666666666666,0.8333333333333334
SF-M13,SF-M22-1,2,6,1,4,1,2,0.5,0.5,0.6666666666666666,0.3333333333333333
SF-M13,SF-K22-2,3,5,0,2,3,3,0.0,1.0,0.4,0.6
SF-M13,SF-K24,5,7,1,5,4,2,0.2,0.8,0.7142857142857143,0.2857142857142857
SF-M13,SF-J23-2,9,11,0,7,9,4,0.0,1.0,0.6363636363636364,0.36363636363636365
SF-M13,SF-G23,1,2,1,1,0,1,1.0,0.0,0.5,0.5
SF-M13,SF-G24,11,20,2,1,9,19,0.18181818181818182,0.8181818181818182,0.05,0.95
SF-M13,SF-G25,13,12,0,4,13,8,0.0,1.0,0.3333333333333333,0.6666666666666666
SF-M13,SF-F23,3,9,0,0,3,9,0.0,1.0,0.0,1.0
SF-M13,SF-E23,11,11,0,0,11,11,0.0,1.0,0.0,1.0
SF-M13,SF-D24,7,3,0,0,7,3,0.0,1.0,0.0,1.0
SF-M13,SF-C22,1,1,0,0,1,1,0.0,1.0,0.0,1.0
SF-M13,SF-B22,3,6,1,0,2,6,0.3333333333333333,0.6666666666666666,0.0,1.0
SF-M13,SF-J17,13,16,2,3,11,13,0.15384615384615385,0.8461538461538461,0.1875,0.8125
SF-M13,SF-I19,4,5,0,0,4,5,0.0,1.0,0.0,1.0
SF-M13,SF-I20,10,7,8,6,2,1,0.8,0.2,0.8571428571428571,0.14285714285714285
SF-M13,SF-H16,24,42,7,4,17,38,0.2916666666666667,0.7083333333333334,0.09523809523809523,0.9047619047619048
SF-M13,SF-H20,2,9,0,4,2,5,0.0,1.0,0.4444444444444444,0.5555555555555556
SF-M13,SF-H18,2,6,0,0,2,6,0.0,1.0,0.0,1.0
SF-M13,SF-H17,5,6,1,0,4,6,0.2,0.8,0.0,1.0
SF-M13,SF-G19,2,5,0,3,2,2,0.0,1.0,0.6,0.4
SF-M13,SF-G17,10,3,1,0,9,3,0.1,0.9,0.0,1.0
SF-M13,SF-G18,42,37,6,7,36,30,0.14285714285714285,0.8571428571428571,0.1891891891891892,0.8108108108108109
SF-M13,SF-G20,4,9,1,3,3,6,0.25,0.75,0.3333333333333333,0.6666666666666666
SF-M13,SF-F19,14,25,0,2,14,23,0.0,1.0,0.08,0.92
SF-M13,SF-E18,11,3,3,0,8,3,0.2727272727272727,0.7272727272727273,0.0,1.0
SF-M13,SF-E20,8,5,0,0,8,5,0.0,1.0,0.0,1.0
SF-M13,SF-G30-2,2,14,0,0,2,14,0.0,1.0,0.0,1.0
SF-M13,SF-E29-2,5,12,0,0,5,12,0.0,1.0,0.0,1.0
SF-M13,SF-G29-2,12,8,1,3,11,5,0.08333333333333333,0.9166666666666666,0.375,0.625
SF-M13,SF-G29-1,2,1,0,0,2,1,0.0,1.0,0.0,1.0
SF-M13,SF-G30-1,16,45,0,38,16,7,0.0,1.0,0.8444444444444444,0.15555555555555556
SF-M13,SF-G29-3,1,2,0,0,1,2,0.0,1.0,0.0,1.0
SF-M13,SF-F29,12,5,0,3,12,2,0.0,1.0,0.6,0.4
SF-M13,SF-E29-3,32,25,0,21,32,4,0.0,1.0,0.84,0.16
SF-M13,SF-F28-1,26,2,0,1,26,1,0.0,1.0,0.5,0.5
SF-M13,SF-J10,147,126,84,71,63,55,0.5714285714285714,0.42857142857142855,0.5634920634920635,0.4365079365079365
SF-M13,SF-J12,66,85,24,47,42,38,0.36363636363636365,0.6363636363636364,0.5529411764705883,0.4470588235294118
SF-M13,SF-J13,36,30,7,6,29,24,0.19444444444444445,0.8055555555555556,0.2,0.8
SF-M13,SF-J15,4,6,3,0,1,6,0.75,0.25,0.0,1.0
SF-M13,SF-J14,1,1,1,0,0,1,1.0,0.0,0.0,1.0
SF-M13,SF-H13,88,76,11,8,77,68,0.125,0.875,0.10526315789473684,0.8947368421052632
SF-M13,SF-I16,7,4,2,2,5,2,0.2857142857142857,0.7142857142857143,0.5,0.5
SF-M13,SF-H12,13,19,4,5,9,14,0.3076923076923077,0.6923076923076923,0.2631578947368421,0.7368421052631579
SF-M13,SF-G10-2,18,16,3,1,15,15,0.16666666666666666,0.8333333333333334,0.0625,0.9375
SF-M13,SF-H15,2,5,0,3,2,2,0.0,1.0,0.6,0.4
SF-M13,SF-G9,11,12,0,1,11,11,0.0,1.0,0.08333333333333333,0.9166666666666666
SF-M13,SF-H14,6,3,1,1,5,2,0.16666666666666666,0.8333333333333334,0.3333333333333333,0.6666666666666666
SF-M13,SF-G13,49,45,9,12,40,33,0.1836734693877551,0.8163265306122449,0.26666666666666666,0.7333333333333333
SF-M13,SF-G11,42,37,35,28,7,9,0.8333333333333334,0.16666666666666666,0.7567567567567568,0.24324324324324326
SF-M13,SF-G12,15,24,2,2,13,22,0.13333333333333333,0.8666666666666667,0.08333333333333333,0.9166666666666666
SF-M13,SF-G10-1,11,7,4,1,7,6,0.36363636363636365,0.6363636363636364,0.14285714285714285,0.8571428571428571
SF-M13,SF-F15,8,13,3,0,5,13,0.375,0.625,0.0,1.0
SF-M13,SF-F16,11,7,1,1,10,6,0.09090909090909091,0.9090909090909091,0.14285714285714285,0.8571428571428571
SF-M13,SF-C20,3,13,0,0,3,13,0.0,1.0,0.0,1.0
SF-M13,SF-B21,2,3,0,0,2,3,0.0,1.0,0.0,1.0
SF-M13,SF-B19,1,3,1,2,0,1,1.0,0.0,0.6666666666666666,0.3333333333333333
SF-M13,SF-A20,4,2,0,0,4,2,0.0,1.0,0.0,1.0
SF-M13,SF-C26,2,1,0,0,2,1,0.0,1.0,0.0,1.0
SF-M13,SF-C25,13,4,0,1,13,3,0.0,1.0,0.25,0.75
SF-M13,SF-B25,3,8,0,2,3,6,0.0,1.0,0.25,0.75
SF-M13,SF-E27,1,3,0,0,1,3,0.0,1.0,0.0,1.0
SF-M13,SF-J1,85,138,19,79,66,59,0.2235294117647059,0.7764705882352941,0.572463768115942,0.427536231884058
SF-M13,SF-H0,5,18,2,5,3,13,0.4,0.6,0.2777777777777778,0.7222222222222222
SF-M13,SF-J3,23,95,1,43,22,52,0.043478260869565216,0.9565217391304348,0.45263157894736844,0.5473684210526316
SF-M13,SF-J5,8,10,4,9,4,1,0.5,0.5,0.9,0.1
SF-M13,SF-G6,52,53,3,3,49,50,0.057692307692307696,0.9423076923076923,0.05660377358490566,0.9433962264150944
SF-M13,SF-G8,31,59,21,35,10,24,0.6774193548387096,0.3225806451612903,0.5932203389830508,0.4067796610169492
SF-M13,SF-G5,17,10,2,3,15,7,0.11764705882352941,0.8823529411764706,0.3,0.7
SF-M13,SF-G7,39,39,1,4,38,35,0.02564102564102564,0.9743589743589743,0.10256410256410256,0.8974358974358975
SF-M13,SF-F9,30,36,4,14,26,22,0.13333333333333333,0.8666666666666667,0.3888888888888889,0.6111111111111112
SF-M13,SF-G26,11,2,4,0,7,2,0.36363636363636365,0.6363636363636364,0.0,1.0
SF-M13,SF-K21,48,73,23,40,25,33,0.4791666666666667,0.5208333333333334,0.547945205479452,0.4520547945205479
SF-M13,SF-K22-1,8,9,1,4,7,5,0.125,0.875,0.4444444444444444,0.5555555555555556
SF-M13,SF-J23-1,26,30,5,7,21,23,0.19230769230769232,0.8076923076923077,0.23333333333333334,0.7666666666666667
SF-M13,SF-J22-1,16,18,4,9,12,9,0.25,0.75,0.5,0.5
SF-M13,SF-J22-2,12,9,0,5,12,4,0.0,1.0,0.5555555555555556,0.4444444444444444
SF-M13,SF-J21,24,38,1,8,23,30,0.041666666666666664,0.9583333333333334,0.21052631578947367,0.7894736842105263
SF-M13,SF-I21,3,2,1,0,2,2,0.3333333333333333,0.6666666666666666,0.0,1.0
SF-M13,SF-I22,2,5,0,0,2,5,0.0,1.0,0.0,1.0
SF-M13,SF-I23-2,7,9,1,3,6,6,0.14285714285714285,0.8571428571428571,0.3333333333333333,0.6666666666666666
SF-M13,SF-I24,16,27,2,0,14,27,0.125,0.875,0.0,1.0
SF-M13,SF-I23-1,3,22,0,19,3,3,0.0,1.0,0.8636363636363636,0.13636363636363635
SF-M13,SF-F26,8,10,1,0,7,10,0.125,0.875,0.0,1.0
SF-M13,SF-M15,36,41,17,21,19,20,0.4722222222222222,0.5277777777777778,0.5121951219512195,0.4878048780487805
SF-M13,SF-L19,69,60,11,12,58,48,0.15942028985507245,0.8405797101449275,0.2,0.8
SF-M13,SF-L20,59,89,8,16,51,73,0.13559322033898305,0.864406779661017,0.1797752808988764,0.8202247191011236
SF-M13,SF-N20-1,21,28,1,1,20,27,0.047619047619047616,0.9523809523809523,0.03571428571428571,0.9642857142857143
SF-M13,SF-M20,65,79,10,29,55,50,0.15384615384615385,0.8461538461538461,0.3670886075949367,0.6329113924050633
SF-M13,SF-K17-2,16,25,4,14,12,11,0.25,0.75,0.56,0.44
SF-M13,SF-K20,217,122,126,33,91,89,0.5806451612903226,0.41935483870967744,0.27049180327868855,0.7295081967213115
SF-M13,SF-K15-,56,60,27,38,29,22,0.48214285714285715,0.5178571428571429,0.6333333333333333,0.36666666666666664
SF-M13,SF-K19,117,219,28,97,89,122,0.23931623931623933,0.7606837606837606,0.4429223744292237,0.5570776255707762
SF-M13,SF-K18,100,83,17,24,83,59,0.17,0.83,0.2891566265060241,0.7108433734939759
SF-M13,SF-K17,89,55,30,24,59,31,0.33707865168539325,0.6629213483146067,0.43636363636363634,0.5636363636363636
SF-M13,SF-J16,186,202,10,60,176,142,0.053763440860215055,0.946236559139785,0.297029702970297,0.7029702970297029
SF-M13,SF-J18,41,40,18,9,23,31,0.43902439024390244,0.5609756097560976,0.225,0.775
SF-M13,SF-J20,40,45,0,1,40,44,0.0,1.0,0.022222222222222223,0.9777777777777777
SF-M13,SF-J19,34,18,0,2,34,16,0.0,1.0,0.1111111111111111,0.8888888888888888
SF-M13,SF-O12,3,2,2,0,1,2,0.6666666666666666,0.3333333333333333,0.0,1.0
SF-M13,SF-M12,69,51,37,17,32,34,0.5362318840579711,0.463768115942029,0.3333333333333333,0.6666666666666666
SF-M13,SF-M10,79,75,40,39,39,36,0.5063291139240507,0.4936708860759494,0.52,0.48
SF-M13,SF-M11,46,63,15,29,31,34,0.32608695652173914,0.6739130434782609,0.4603174603174603,0.5396825396825397
SF-M13,SF-R19,9,6,0,0,9,6,0.0,1.0,0.0,1.0
SF-M13,SF-R20,2,3,0,0,2,3,0.0,1.0,0.0,1.0
SF-M13,SF-Q21-2,8,6,0,0,8,6,0.0,1.0,0.0,1.0
SF-M13,SF-Q21-1,6,6,0,1,6,5,0.0,1.0,0.16666666666666666,0.8333333333333334
SF-M13,SF-P21,20,10,3,0,17,10,0.15,0.85,0.0,1.0
SF-M13,SF-O18,92,31,3,6,89,25,0.03260869565217391,0.967391304347826,0.1935483870967742,0.8064516129032258
SF-M13,SF-O19,12,30,1,10,11,20,0.08333333333333333,0.9166666666666666,0.3333333333333333,0.6666666666666666
SF-M13,SF-O21,52,50,9,10,43,40,0.17307692307692307,0.8269230769230769,0.2,0.8
SF-M13,SF-O22,14,79,3,21,11,58,0.21428571428571427,0.7857142857142857,0.26582278481012656,0.7341772151898734
SF-M13,SF-N21,16,17,4,9,12,8,0.25,0.75,0.5294117647058824,0.47058823529411764
SF-M13,SF-N20-2,18,11,6,8,12,3,0.3333333333333333,0.6666666666666666,0.7272727272727273,0.2727272727272727
SF-M13,SF-M21,8,30,1,7,7,23,0.125,0.875,0.23333333333333334,0.7666666666666667
SF-M13,SF-L21,32,38,6,8,26,30,0.1875,0.8125,0.21052631578947367,0.7894736842105263
SF-M13,SF-O30-2,1,2,0,0,1,2,0.0,1.0,0.0,1.0
SF-M13,SF-O30,16,28,0,3,16,25,0.0,1.0,0.10714285714285714,0.8928571428571429
SF-M13,SF-N27,1,11,0,3,1,8,0.0,1.0,0.2727272727272727,0.7272727272727273
SF-M13,SF-N29,8,23,0,12,8,11,0.0,1.0,0.5217391304347826,0.4782608695652174
SF-M13,SF-N28,6,1,0,0,6,1,0.0,1.0,0.0,1.0
SF-M13,SF-L30-1,20,137,3,101,17,36,0.15,0.85,0.7372262773722628,0.26277372262773724
SF-M13,SF-K30-2,3,72,1,56,2,16,0.3333333333333333,0.6666666666666666,0.7777777777777778,0.2222222222222222
SF-M13,SF-L29,9,14,2,5,7,9,0.2222222222222222,0.7777777777777778,0.35714285714285715,0.6428571428571429
SF-M13,SF-I30,1,9,0,0,1,9,0.0,1.0,0.0,1.0
SF-M13,SF-I27,3,7,0,0,3,7,0.0,1.0,0.0,1.0
SF-M13,SF-I28,3,1,0,0,3,1,0.0,1.0,0.0,1.0
SF-M13,SF I29-1,2,1,0,0,2,1,0.0,1.0,0.0,1.0
SF-M13,SF-H29,5,1,0,1,5,0,0.0,1.0,1.0,0.0
SF-M13,SF-S24,4,4,0,2,4,2,0.0,1.0,0.5,0.5
SF-M13,SF-R24,8,15,2,7,6,8,0.25,0.75,0.4666666666666667,0.5333333333333333
SF-M13,SF-Q26,5,4,2,2,3,2,0.4,0.6,0.5,0.5
SF-M13,SF-P26,14,23,1,11,13,12,0.07142857142857142,0.9285714285714286,0.4782608695652174,0.5217391304347826
SF-M13,SF-N22-1B,4,6,0,5,4,1,0.0,1.0,0.8333333333333334,0.16666666666666666
SF-M13,SF-N25,4,2,3,2,1,0,0.75,0.25,1.0,0.0
SF-M13,SF-T22,2,1,1,1,1,0,0.5,0.5,1.0,0.0
SF-M13,SF-S22-1,20,4,7,0,13,4,0.35,0.65,0.0,1.0
SF-M13,SF-Q23-3,17,6,0,3,17,3,0.0,1.0,0.5,0.5
SF-M13,SF-Q22-1,12,24,1,1,11,23,0.08333333333333333,0.9166666666666666,0.041666666666666664,0.9583333333333334
SF-M13,SF-Q22-2,50,37,2,3,48,34,0.04,0.96,0.08108108108108109,0.918918918918919
SF-M13,SF-P22,10,8,6,4,4,4,0.6,0.4,0.5,0.5
SF-M13,SF-W19,2,1,1,0,1,1,0.5,0.5,0.0,1.0
SF-M13,SF-W19-2,1,12,0,0,1,12,0.0,1.0,0.0,1.0
SF-M13,SF-T20,3,1,0,0,3,1,0.0,1.0,0.0,1.0
SF-M13,SF-S21,5,3,0,3,5,0,0.0,1.0,1.0,0.0
SF-M13,SF-W14,2,3,0,0,2,3,0.0,1.0,0.0,1.0
SF-M13,SF-Z6,1,3,0,2,1,1,0.0,1.0,0.6666666666666666,0.3333333333333333
SF-M13,SF-W8,1,2,1,2,0,0,1.0,0.0,1.0,0.0
SF-M13,SF-X14,2,1,0,0,2,1,0.0,1.0,0.0,1.0
SF-M15,SF-M26,1,2,0,0,1,2,0.0,1.0,0.0,1.0
SF-M15,SF-M25,6,5,0,1,6,4,0.0,1.0,0.2,0.8
SF-M15,SF-M26-2,2,1,0,1,2,0,0.0,1.0,1.0,0.0
SF-M15,SF-K26,5,13,0,4,5,9,0.0,1.0,0.3076923076923077,0.6923076923076923
SF-M15,SF-J27,3,2,0,2,3,0,0.0,1.0,1.0,0.0
SF-M15,SF-M30,33,80,16,68,17,12,0.48484848484848486,0.5151515151515151,0.85,0.15
SF-M15,SF-L27-2,4,2,1,1,3,1,0.25,0.75,0.5,0.5
SF-M15,SF-J29,5,6,2,1,3,5,0.4,0.6,0.16666666666666666,0.8333333333333334
SF-M15,SF-L26,1,1,0,1,1,0,0.0,1.0,1.0,0.0
SF-M15,SF-M28,5,3,0,1,5,2,0.0,1.0,0.3333333333333333,0.6666666666666666
SF-M15,SF-L25,4,1,0,0,4,1,0.0,1.0,0.0,1.0
SF-M15,SF-M24,4,3,0,3,4,0,0.0,1.0,1.0,0.0
SF-M15,SF-N23,9,9,1,2,8,7,0.1111111111111111,0.8888888888888888,0.2222222222222222,0.7777777777777778
SF-M15,SF-N24-2,7,14,2,3,5,11,0.2857142857142857,0.7142857142857143,0.21428571428571427,0.7857142857142857
SF-M15,SF-K27-2,7,15,1,3,6,12,0.14285714285714285,0.8571428571428571,0.2,0.8
SF-M15,SF-J26-2,2,2,1,0,1,2,0.5,0.5,0.0,1.0
SF-M15,SF-L28,4,6,1,1,3,5,0.25,0.75,0.16666666666666666,0.8333333333333334
SF-M15,SF-K25,4,8,0,4,4,4,0.0,1.0,0.5,0.5
SF-M15,SF-J25,9,19,4,5,5,14,0.4444444444444444,0.5555555555555556,0.2631578947368421,0.7368421052631579
SF-M15,SF-H26-2,2,12,0,8,2,4,0.0,1.0,0.6666666666666666,0.3333333333333333
SF-M15,SF-P24,19,48,1,8,18,40,0.05263157894736842,0.9473684210526315,0.16666666666666666,0.8333333333333334
SF-M15,SF-J24,4,13,0,0,4,13,0.0,1.0,0.0,1.0
SF-M15,SF-O24,28,62,0,10,28,52,0.0,1.0,0.16129032258064516,0.8387096774193549
SF-M15,SF-J26,1,5,0,0,1,5,0.0,1.0,0.0,1.0
SF-M15,SF-I25,5,18,1,4,4,14,0.2,0.8,0.2222222222222222,0.7777777777777778
SF-M15,SF-K23,3,5,1,4,2,1,0.3333333333333333,0.6666666666666666,0.8,0.2
SF-M15,SF-H26,16,34,1,20,15,14,0.0625,0.9375,0.5882352941176471,0.4117647058823529
SF-M15,SF-O23,9,11,1,5,8,6,0.1111111111111111,0.8888888888888888,0.45454545454545453,0.5454545454545454
SF-M15,SF-H27-1,3,1,1,0,2,1,0.3333333333333333,0.6666666666666666,0.0,1.0
SF-M15,SF-F28-2,22,28,1,7,21,21,0.045454545454545456,0.9545454545454546,0.25,0.75
SF-M15,SF-G27,8,20,0,7,8,13,0.0,1.0,0.35,0.65
SF-M15,SF-M22-2,15,12,1,5,14,7,0.06666666666666667,0.9333333333333333,0.4166666666666667,0.5833333333333334
SF-M15,SF-L22,9,15,0,7,9,8,0.0,1.0,0.4666666666666667,0.5333333333333333
SF-M15,SF-F27,10,11,2,2,8,9,0.2,0.8,0.18181818181818182,0.8181818181818182
SF-M15,SF-N22-2,25,40,4,14,21,26,0.16,0.84,0.35,0.65
SF-M15,SF-G28-2,2,2,0,1,2,1,0.0,1.0,0.5,0.5
SF-M15,SF-M22-1,6,18,1,2,5,16,0.16666666666666666,0.8333333333333334,0.1111111111111111,0.8888888888888888
SF-M15,SF-O25-1,2,3,0,3,2,0,0.0,1.0,1.0,0.0
SF-M15,SF-K22-2,10,6,0,4,10,2,0.0,1.0,0.6666666666666666,0.3333333333333333
SF-M15,SF-K24,7,6,3,4,4,2,0.42857142857142855,0.5714285714285714,0.6666666666666666,0.3333333333333333
SF-M15,SF-J23-2,6,10,2,9,4,1,0.3333333333333333,0.6666666666666666,0.9,0.1
SF-M15,SF-G23,6,10,1,2,5,8,0.16666666666666666,0.8333333333333334,0.2,0.8
SF-M15,SF-G24,11,15,3,2,8,13,0.2727272727272727,0.7272727272727273,0.13333333333333333,0.8666666666666667
SF-M15,SF-G25,10,6,1,3,9,3,0.1,0.9,0.5,0.5
SF-M15,SF-F23,18,11,0,1,18,10,0.0,1.0,0.09090909090909091,0.9090909090909091
SF-M15,SF-E23,12,36,0,1,12,35,0.0,1.0,0.027777777777777776,0.9722222222222222
SF-M15,SF-D24,3,4,0,0,3,4,0.0,1.0,0.0,1.0
SF-M15,SF-C22,14,9,2,2,12,7,0.14285714285714285,0.8571428571428571,0.2222222222222222,0.7777777777777778
SF-M15,SF-B22,7,8,1,1,6,7,0.14285714285714285,0.8571428571428571,0.125,0.875
SF-M15,SF-J17,46,41,9,19,37,22,0.1956521739130435,0.8043478260869565,0.4634146341463415,0.5365853658536586
SF-M15,SF-I19,21,17,2,1,19,16,0.09523809523809523,0.9047619047619048,0.058823529411764705,0.9411764705882353
SF-M15,SF-I20,3,3,1,2,2,1,0.3333333333333333,0.6666666666666666,0.6666666666666666,0.3333333333333333
SF-M15,SF-H16,48,38,10,5,38,33,0.20833333333333334,0.7916666666666666,0.13157894736842105,0.868421052631579
SF-M15,SF-H19,3,1,2,0,1,1,0.6666666666666666,0.3333333333333333,0.0,1.0
SF-M15,SF-H20,10,17,0,5,10,12,0.0,1.0,0.29411764705882354,0.7058823529411765
SF-M15,SF-H18,9,7,4,2,5,5,0.4444444444444444,0.5555555555555556,0.2857142857142857,0.7142857142857143
SF-M15,SF-H17,4,4,1,1,3,3,0.25,0.75,0.25,0.75
SF-M15,SF-G19,5,16,0,9,5,7,0.0,1.0,0.5625,0.4375
SF-M15,SF-G17,7,9,2,1,5,8,0.2857142857142857,0.7142857142857143,0.1111111111111111,0.8888888888888888
SF-M15,SF-G18,16,17,3,3,13,14,0.1875,0.8125,0.17647058823529413,0.8235294117647058
SF-M15,SF-G20,16,14,1,4,15,10,0.0625,0.9375,0.2857142857142857,0.7142857142857143
SF-M15,SF-F19,14,23,1,3,13,20,0.07142857142857142,0.9285714285714286,0.13043478260869565,0.8695652173913043
SF-M15,SF-E18,8,8,3,1,5,7,0.375,0.625,0.125,0.875
SF-M15,SF-E20,13,9,2,0,11,9,0.15384615384615385,0.8461538461538461,0.0,1.0
SF-M15,SF-H30,1,1,0,1,1,0,0.0,1.0,1.0,0.0
SF-M15,SF-G30-2,13,19,0,2,13,17,0.0,1.0,0.10526315789473684,0.8947368421052632
SF-M15,SF-E29-2,8,16,1,6,7,10,0.125,0.875,0.375,0.625
SF-M15,SF-E29-1,2,6,0,2,2,4,0.0,1.0,0.3333333333333333,0.6666666666666666
SF-M15,SF-D29,2,4,0,3,2,1,0.0,1.0,0.75,0.25
SF-M15,SF-G29-2,3,3,0,0,3,3,0.0,1.0,0.0,1.0
SF-M15,SF-G29-1,1,2,0,1,1,1,0.0,1.0,0.5,0.5
SF-M15,SF-F30-2,2,5,1,3,1,2,0.5,0.5,0.6,0.4
SF-M15,SF-F29,4,5,1,3,3,2,0.25,0.75,0.6,0.4
SF-M15,SF-E29-3,5,6,1,2,4,4,0.2,0.8,0.3333333333333333,0.6666666666666666
SF-M15,SF-F28-1,25,56,0,8,25,48,0.0,1.0,0.14285714285714285,0.8571428571428571
SF-M15,SF-E28-2,1,1,0,1,1,0,0.0,1.0,1.0,0.0
SF-M15,SF-E28,3,5,0,0,3,5,0.0,1.0,0.0,1.0
SF-M15,SF-J10,65,104,10,24,55,80,0.15384615384615385,0.8461538461538461,0.23076923076923078,0.7692307692307693
SF-M15,SF-J12,46,41,21,24,25,17,0.45652173913043476,0.5434782608695652,0.5853658536585366,0.4146341463414634
SF-M15,SF-J13,20,8,5,1,15,7,0.25,0.75,0.125,0.875
SF-M15,SF-J15,17,7,9,1,8,6,0.5294117647058824,0.47058823529411764,0.14285714285714285,0.8571428571428571
SF-M15,SF-J14,3,2,1,0,2,2,0.3333333333333333,0.6666666666666666,0.0,1.0
SF-M15,SF-H13,15,7,4,0,11,7,0.26666666666666666,0.7333333333333333,0.0,1.0
SF-M15,SF-I16,15,2,6,1,9,1,0.4,0.6,0.5,0.5
SF-M15,SF-H12,14,15,4,6,10,9,0.2857142857142857,0.7142857142857143,0.4,0.6
SF-M15,SF-G10-2,10,6,0,2,10,4,0.0,1.0,0.3333333333333333,0.6666666666666666
SF-M15,SF-H15,8,5,2,0,6,5,0.25,0.75,0.0,1.0
SF-M15,SF-G9,9,5,4,4,5,1,0.4444444444444444,0.5555555555555556,0.8,0.2
SF-M15,SF-H14,5,4,1,1,4,3,0.2,0.8,0.25,0.75
SF-M15,SF-G13,30,17,11,6,19,11,0.36666666666666664,0.6333333333333333,0.35294117647058826,0.6470588235294118
SF-M15,SF-G11,7,2,0,0,7,2,0.0,1.0,0.0,1.0
SF-M15,SF-G12,13,32,5,8,8,24,0.38461538461538464,0.6153846153846154,0.25,0.75
SF-M15,SF-G10-1,4,2,2,0,2,2,0.5,0.5,0.0,1.0
SF-M15,SF-F15,14,18,1,3,13,15,0.07142857142857142,0.9285714285714286,0.16666666666666666,0.8333333333333334
SF-M15,SF-F16,10,9,3,1,7,8,0.3,0.7,0.1111111111111111,0.8888888888888888
SF-M15,SF-C21,1,1,0,0,1,1,0.0,1.0,0.0,1.0
SF-M15,SF-C20,6,7,1,3,5,4,0.16666666666666666,0.8333333333333334,0.42857142857142855,0.5714285714285714
SF-M15,SF-B21,1,2,0,1,1,1,0.0,1.0,0.5,0.5
SF-M15,SF-B19,9,9,1,5,8,4,0.1111111111111111,0.8888888888888888,0.5555555555555556,0.4444444444444444
SF-M15,SF-A20,7,6,0,2,7,4,0.0,1.0,0.3333333333333333,0.6666666666666666
SF-M15,SF-A19,1,2,0,0,1,2,0.0,1.0,0.0,1.0
SF-M15,SF-C26,2,2,0,0,2,2,0.0,1.0,0.0,1.0
SF-M15,SF-C25,4,7,0,2,4,5,0.0,1.0,0.2857142857142857,0.7142857142857143
SF-M15,SF-B25,6,8,0,0,6,8,0.0,1.0,0.0,1.0
SF-M15,SF-E27,1,3,0,2,1,1,0.0,1.0,0.6666666666666666,0.3333333333333333
SF-M15,SF-D27,3,1,1,0,2,1,0.3333333333333333,0.6666666666666666,0.0,1.0
SF-M15,SF-C28-2,2,3,0,0,2,3,0.0,1.0,0.0,1.0
SF-M15,SF-J1,58,76,10,42,48,34,0.1724137931034483,0.8275862068965517,0.5526315789473685,0.4473684210526316
SF-M15,SF-H0,9,19,0,14,9,5,0.0,1.0,0.7368421052631579,0.2631578947368421
SF-M15,SF-J3,7,14,0,8,7,6,0.0,1.0,0.5714285714285714,0.42857142857142855
SF-M15,SF-J5,5,18,0,5,5,13,0.0,1.0,0.2777777777777778,0.7222222222222222
SF-M15,SF-G8,4,7,2,3,2,4,0.5,0.5,0.42857142857142855,0.5714285714285714
SF-M15,SF-G5,12,8,2,3,10,5,0.16666666666666666,0.8333333333333334,0.375,0.625
SF-M15,SF-G7,8,20,0,2,8,18,0.0,1.0,0.1,0.9
SF-M15,SF-F9,7,6,0,3,7,3,0.0,1.0,0.5,0.5
SF-M15,SF-G26,11,8,2,2,9,6,0.18181818181818182,0.8181818181818182,0.25,0.75
SF-M15,SF-K21,38,67,4,38,34,29,0.10526315789473684,0.8947368421052632,0.5671641791044776,0.43283582089552236
SF-M15,SF-K22-1,11,32,2,14,9,18,0.18181818181818182,0.8181818181818182,0.4375,0.5625
SF-M15,SF-J23-1,41,44,5,9,36,35,0.12195121951219512,0.8780487804878049,0.20454545454545456,0.7954545454545454
SF-M15,SF-J22-1,37,52,6,15,31,37,0.16216216216216217,0.8378378378378378,0.28846153846153844,0.7115384615384616
SF-M15,SF-J22-2,13,12,0,9,13,3,0.0,1.0,0.75,0.25
SF-M15,SF-J21,49,85,3,22,46,63,0.061224489795918366,0.9387755102040817,0.25882352941176473,0.7411764705882353
SF-M15,SF-I21,3,7,1,3,2,4,0.3333333333333333,0.6666666666666666,0.42857142857142855,0.5714285714285714
SF-M15,SF-I22,8,5,0,0,8,5,0.0,1.0,0.0,1.0
SF-M15,SF-I23-2,10,18,4,13,6,5,0.4,0.6,0.7222222222222222,0.2777777777777778
SF-M15,SF-I24,8,14,2,9,6,5,0.25,0.75,0.6428571428571429,0.35714285714285715
SF-M15,SF-I23-1,2,3,0,0,2,3,0.0,1.0,0.0,1.0
SF-M15,SF-F26,28,25,1,2,27,23,0.03571428571428571,0.9642857142857143,0.08,0.92
SF-M15,SF-M13,41,36,21,17,20,19,0.5121951219512195,0.4878048780487805,0.4722222222222222,0.5277777777777778
SF-M15,SF-L19,34,32,1,5,33,27,0.029411764705882353,0.9705882352941176,0.15625,0.84375
SF-M15,SF-L20,24,26,1,13,23,13,0.041666666666666664,0.9583333333333334,0.5,0.5
SF-M15,SF-N20-1,17,28,2,9,15,19,0.11764705882352941,0.8823529411764706,0.32142857142857145,0.6785714285714286
SF-M15,SF-M20,54,59,7,29,47,30,0.12962962962962962,0.8703703703703703,0.4915254237288136,0.5084745762711864
SF-M15,SF-K17-2,41,53,12,36,29,17,0.2926829268292683,0.7073170731707317,0.6792452830188679,0.32075471698113206
SF-M15,SF-K20,63,35,17,14,46,21,0.2698412698412698,0.7301587301587301,0.4,0.6
SF-M15,SF-K15-,29,57,10,24,19,33,0.3448275862068966,0.6551724137931034,0.42105263157894735,0.5789473684210527
SF-M15,SF-K19,54,74,13,34,41,40,0.24074074074074073,0.7592592592592593,0.4594594594594595,0.5405405405405406
SF-M15,SF-K18,47,63,5,18,42,45,0.10638297872340426,0.8936170212765957,0.2857142857142857,0.7142857142857143
SF-M15,SF-K17,48,40,15,25,33,15,0.3125,0.6875,0.625,0.375
SF-M15,SF-J16,21,17,7,7,14,10,0.3333333333333333,0.6666666666666666,0.4117647058823529,0.5882352941176471
SF-M15,SF-J18,95,103,18,41,77,62,0.18947368421052632,0.8105263157894737,0.39805825242718446,0.6019417475728155
SF-M15,SF-J20,9,11,1,2,8,9,0.1111111111111111,0.8888888888888888,0.18181818181818182,0.8181818181818182
SF-M15,SF-J19,17,22,7,9,10,13,0.4117647058823529,0.5882352941176471,0.4090909090909091,0.5909090909090909
SF-M15,SF-O12,3,4,0,0,3,4,0.0,1.0,0.0,1.0
SF-M15,SF-M12,71,73,14,22,57,51,0.19718309859154928,0.8028169014084507,0.3013698630136986,0.6986301369863014
SF-M15,SF-M10,33,27,16,16,17,11,0.48484848484848486,0.5151515151515151,0.5925925925925926,0.4074074074074074
SF-M15,SF-M11,90,93,28,28,62,65,0.3111111111111111,0.6888888888888889,0.3010752688172043,0.6989247311827957
SF-M15,SF-R19,10,21,0,1,10,20,0.0,1.0,0.047619047619047616,0.9523809523809523
SF-M15,SF-R20,4,6,0,0,4,6,0.0,1.0,0.0,1.0
SF-M15,SF-Q21-2,3,7,1,3,2,4,0.3333333333333333,0.6666666666666666,0.42857142857142855,0.5714285714285714
SF-M15,SF-Q21-1,3,7,0,0,3,7,0.0,1.0,0.0,1.0
SF-M15,SF-P21,10,9,1,0,9,9,0.1,0.9,0.0,1.0
SF-M15,SF-O18,16,10,4,2,12,8,0.25,0.75,0.2,0.8
SF-M15,SF-O19,29,26,4,4,25,22,0.13793103448275862,0.8620689655172413,0.15384615384615385,0.8461538461538461
SF-M15,SF-O21,51,80,2,24,49,56,0.0392156862745098,0.9607843137254902,0.3,0.7
SF-M15,SF-O22,17,48,5,22,12,26,0.29411764705882354,0.7058823529411765,0.4583333333333333,0.5416666666666666
SF-M15,SF-N21,10,13,1,7,9,6,0.1,0.9,0.5384615384615384,0.46153846153846156
SF-M15,SF-N20-2,10,3,1,0,9,3,0.1,0.9,0.0,1.0
SF-M15,SF-M21,22,14,9,4,13,10,0.4090909090909091,0.5909090909090909,0.2857142857142857,0.7142857142857143
SF-M15,SF-L21,24,38,1,14,23,24,0.041666666666666664,0.9583333333333334,0.3684210526315789,0.631578947368421
SF-M15,SF-S29,2,1,2,1,0,0,1.0,0.0,1.0,0.0
SF-M15,SF-Q30,1,1,1,0,0,1,1.0,0.0,0.0,1.0
SF-M15,SF-P30,21,14,0,0,21,14,0.0,1.0,0.0,1.0
SF-M15,SF-O30,16,19,2,3,14,16,0.125,0.875,0.15789473684210525,0.8421052631578947
SF-M15,SF-N27,2,1,1,0,1,1,0.5,0.5,0.0,1.0
SF-M15,SF-N29,17,11,0,0,17,11,0.0,1.0,0.0,1.0
SF-M15,SF-N28,15,13,0,0,15,13,0.0,1.0,0.0,1.0
SF-M15,SF-L30-1,31,97,7,51,24,46,0.22580645161290322,0.7741935483870968,0.5257731958762887,0.4742268041237113
SF-M15,SF-L31-1,1,1,0,0,1,1,0.0,1.0,0.0,1.0
SF-M15,SF-K30-2,1,6,0,3,1,3,0.0,1.0,0.5,0.5
SF-M15,SF-L29,21,12,2,11,19,1,0.09523809523809523,0.9047619047619048,0.9166666666666666,0.08333333333333333
SF-M15,SF-I30-2,1,2,0,1,1,1,0.0,1.0,0.5,0.5
SF-M15,SF-H28,3,4,0,1,3,3,0.0,1.0,0.25,0.75
SF-M15,SF-S24,5,9,1,3,4,6,0.2,0.8,0.3333333333333333,0.6666666666666666
SF-M15,SF-R24,9,43,2,5,7,38,0.2222222222222222,0.7777777777777778,0.11627906976744186,0.8837209302325582
SF-M15,SF-R26,3,1,0,0,3,1,0.0,1.0,0.0,1.0
SF-M15,SF-Q26,4,6,2,1,2,5,0.5,0.5,0.16666666666666666,0.8333333333333334
SF-M15,SF-P26,11,23,1,12,10,11,0.09090909090909091,0.9090909090909091,0.5217391304347826,0.4782608695652174
SF-M15,SF-O25-2,12,3,0,2,12,1,0.0,1.0,0.6666666666666666,0.3333333333333333
SF-M15,SF-N22-1B,11,21,1,12,10,9,0.09090909090909091,0.9090909090909091,0.5714285714285714,0.42857142857142855
SF-M15,SF-N26,10,7,0,0,10,7,0.0,1.0,0.0,1.0
SF-M15,SF-N25,2,3,0,1,2,2,0.0,1.0,0.3333333333333333,0.6666666666666666
SF-M15,SF-T21,1,2,0,0,1,2,0.0,1.0,0.0,1.0
SF-M15,SF-T22,4,7,0,0,4,7,0.0,1.0,0.0,1.0
SF-M15,SF-S22-2,3,1,0,0,3,1,0.0,1.0,0.0,1.0
SF-M15,SF-S22-1,4,6,1,1,3,5,0.25,0.75,0.16666666666666666,0.8333333333333334
SF-M15,SF-Q23-3,9,5,2,2,7,3,0.2222222222222222,0.7777777777777778,0.4,0.6
SF-M15,SF-Q22-1,13,20,1,5,12,15,0.07692307692307693,0.9230769230769231,0.25,0.75
SF-M15,SF-Q22-2,10,26,4,6,6,20,0.4,0.6,0.23076923076923078,0.7692307692307693
SF-M15,SF-P22,7,18,1,6,6,12,0.14285714285714285,0.8571428571428571,0.3333333333333333,0.6666666666666666
SF-M15,SF-U21,2,1,0,0,2,1,0.0,1.0,0.0,1.0
SF-M15,SF-T20,6,8,0,0,6,8,0.0,1.0,0.0,1.0
SF-M15,SF-S21,2,2,0,0,2,2,0.0,1.0,0.0,1.0
SF-M15,SF-W14,1,1,0,1,1,0,0.0,1.0,1.0,0.0
SF-M15,SF-W8,5,4,0,0,5,4,0.0,1.0,0.0,1.0
SF-M15,SF-AA15,1,1,0,1,1,0,0.0,1.0,1.0,0.0
SF-L19,SF-M25,9,7,2,2,7,5,0.2222222222222222,0.7777777777777778,0.2857142857142857,0.7142857142857143
SF-L19,SF-L27,1,7,1,2,0,5,1.0,0.0,0.2857142857142857,0.7142857142857143
SF-L19,SF-K26,5,8,0,2,5,6,0.0,1.0,0.25,0.75
SF-L19,SF-J27,1,1,0,0,1,1,0.0,1.0,0.0,1.0
SF-L19,SF-M30,20,14,1,2,19,12,0.05,0.95,0.14285714285714285,0.8571428571428571
SF-L19,SF-J29-3,1,1,0,1,1,0,0.0,1.0,1.0,0.0
SF-L19,SF-J29,4,7,1,1,3,6,0.25,0.75,0.14285714285714285,0.8571428571428571
SF-L19,SF-L26,6,33,2,18,4,15,0.3333333333333333,0.6666666666666666,0.5454545454545454,0.45454545454545453
SF-L19,SF-M28,8,6,1,2,7,4,0.125,0.875,0.3333333333333333,0.6666666666666666
SF-L19,SF-L25,4,7,0,4,4,3,0.0,1.0,0.5714285714285714,0.42857142857142855
SF-L19,SF-M24,2,12,0,6,2,6,0.0,1.0,0.5,0.5
SF-L19,SF-L24,7,8,0,5,7,3,0.0,1.0,0.625,0.375
SF-L19,SF-N23,33,18,17,4,16,14,0.5151515151515151,0.48484848484848486,0.2222222222222222,0.7777777777777778
SF-L19,SF-N24-2,25,13,1,5,24,8,0.04,0.96,0.38461538461538464,0.6153846153846154
SF-L19,SF-K27-2,8,6,3,2,5,4,0.375,0.625,0.3333333333333333,0.6666666666666666
SF-L19,SF-J26-2,6,4,1,2,5,2,0.16666666666666666,0.8333333333333334,0.5,0.5
SF-L19,SF-K28-3,1,1,0,0,1,1,0.0,1.0,0.0,1.0
SF-L19,SF-L28,1,3,0,0,1,3,0.0,1.0,0.0,1.0
SF-L19,SF-K28,1,1,1,1,0,0,1.0,0.0,1.0,0.0
SF-L19,SF-K29-1,1,2,0,0,1,2,0.0,1.0,0.0,1.0
SF-L19,SF-K25,10,19,6,7,4,12,0.6,0.4,0.3684210526315789,0.631578947368421
SF-L19,SF-J25,10,15,6,9,4,6,0.6,0.4,0.6,0.4
SF-L19,SF-H26-2,2,3,0,1,2,2,0.0,1.0,0.3333333333333333,0.6666666666666666
SF-L19,SF-P24,22,12,3,7,19,5,0.13636363636363635,0.8636363636363636,0.5833333333333334,0.4166666666666667
SF-L19,SF-J24,3,16,1,7,2,9,0.3333333333333333,0.6666666666666666,0.4375,0.5625
SF-L19,SF-O24,13,3,2,1,11,2,0.15384615384615385,0.8461538461538461,0.3333333333333333,0.6666666666666666
SF-L19,SF-J26,4,4,1,0,3,4,0.25,0.75,0.0,1.0
SF-L19,SF-I26-,4,2,3,1,1,1,0.75,0.25,0.5,0.5
SF-L19,SF-I25,11,10,4,3,7,7,0.36363636363636365,0.6363636363636364,0.3,0.7
SF-L19,SF-K23,26,4,24,3,2,1,0.9230769230769231,0.07692307692307693,0.75,0.25
SF-L19,SF-H26,24,44,10,19,14,25,0.4166666666666667,0.5833333333333334,0.4318181818181818,0.5681818181818182
SF-L19,SF-O23,27,16,5,4,22,12,0.18518518518518517,0.8148148148148148,0.25,0.75
SF-L19,SF-H27-1,6,4,0,0,6,4,0.0,1.0,0.0,1.0
SF-L19,SF-F28-2,39,48,1,4,38,44,0.02564102564102564,0.9743589743589743,0.08333333333333333,0.9166666666666666
SF-L19,SF-G27,46,54,4,30,42,24,0.08695652173913043,0.9130434782608695,0.5555555555555556,0.4444444444444444
SF-L19,SF-M22-2,29,24,1,10,28,14,0.034482758620689655,0.9655172413793104,0.4166666666666667,0.5833333333333334
SF-L19,SF-L22,12,20,0,12,12,8,0.0,1.0,0.6,0.4
SF-L19,SF-F27,29,22,4,9,25,13,0.13793103448275862,0.8620689655172413,0.4090909090909091,0.5909090909090909
SF-L19,SF-N22-2,35,35,8,22,27,13,0.22857142857142856,0.7714285714285715,0.6285714285714286,0.37142857142857144
SF-L19,SF-G28-1,3,19,1,2,2,17,0.3333333333333333,0.6666666666666666,0.10526315789473684,0.8947368421052632
SF-L19,SF-M22-1,8,17,1,14,7,3,0.125,0.875,0.8235294117647058,0.17647058823529413
SF-L19,SF-O25-1,28,6,1,6,27,0,0.03571428571428571,0.9642857142857143,1.0,0.0
SF-L19,SF-K22-2,2,9,0,7,2,2,0.0,1.0,0.7777777777777778,0.2222222222222222
SF-L19,SF-K24,10,5,5,2,5,3,0.5,0.5,0.4,0.6
SF-L19,SF-J23-2,23,8,15,5,8,3,0.6521739130434783,0.34782608695652173,0.625,0.375
SF-L19,SF-G23,3,4,0,1,3,3,0.0,1.0,0.25,0.75
SF-L19,SF-G24,53,56,4,1,49,55,0.07547169811320754,0.9245283018867925,0.017857142857142856,0.9821428571428571
SF-L19,SF-G25,19,15,4,2,15,13,0.21052631578947367,0.7894736842105263,0.13333333333333333,0.8666666666666667
SF-L19,SF-F23,18,10,1,0,17,10,0.05555555555555555,0.9444444444444444,0.0,1.0
SF-L19,SF-E23,13,8,2,2,11,6,0.15384615384615385,0.8461538461538461,0.25,0.75
SF-L19,SF-D24,5,8,0,1,5,7,0.0,1.0,0.125,0.875
SF-L19,SF-C22,4,7,1,0,3,7,0.25,0.75,0.0,1.0
SF-L19,SF-B22,3,4,0,1,3,3,0.0,1.0,0.25,0.75
SF-L19,SF-J17,18,23,6,4,12,19,0.3333333333333333,0.6666666666666666,0.17391304347826086,0.8260869565217391
SF-L19,SF-I19,4,5,1,0,3,5,0.25,0.75,0.0,1.0
SF-L19,SF-I20,7,2,3,0,4,2,0.42857142857142855,0.5714285714285714,0.0,1.0
SF-L19,SF-H16,8,5,2,1,6,4,0.25,0.75,0.2,0.8
SF-L19,SF-H19,4,4,1,1,3,3,0.25,0.75,0.25,0.75
SF-L19,SF-H20,6,3,2,0,4,3,0.3333333333333333,0.6666666666666666,0.0,1.0
SF-L19,SF-H18,3,3,0,1,3,2,0.0,1.0,0.3333333333333333,0.6666666666666666
SF-L19,SF-H17,4,3,0,0,4,3,0.0,1.0,0.0,1.0
SF-L19,SF-G19,6,13,1,3,5,10,0.16666666666666666,0.8333333333333334,0.23076923076923078,0.7692307692307693
SF-L19,SF-G18,15,17,1,1,14,16,0.06666666666666667,0.9333333333333333,0.058823529411764705,0.9411764705882353
SF-L19,SF-G20,12,16,3,4,9,12,0.25,0.75,0.25,0.75
SF-L19,SF-F19,4,2,2,1,2,1,0.5,0.5,0.5,0.5
SF-L19,SF-E18,3,8,1,1,2,7,0.3333333333333333,0.6666666666666666,0.125,0.875
SF-L19,SF-E20,22,23,7,2,15,21,0.3181818181818182,0.6818181818181818,0.08695652173913043,0.9130434782608695
SF-L19,SF-G30-2,4,8,2,4,2,4,0.5,0.5,0.5,0.5
SF-L19,SF-F30-1,1,5,0,3,1,2,0.0,1.0,0.6,0.4
SF-L19,SF-E29-2,9,19,0,9,9,10,0.0,1.0,0.47368421052631576,0.5263157894736842
SF-L19,SF-E29-1,1,7,1,1,0,6,1.0,0.0,0.14285714285714285,0.8571428571428571
SF-L19,SF-D29,4,1,0,0,4,1,0.0,1.0,0.0,1.0
SF-L19,SF-D28,10,2,1,0,9,2,0.1,0.9,0.0,1.0
SF-L19,SF-A27,3,2,1,0,2,2,0.3333333333333333,0.6666666666666666,0.0,1.0
SF-L19,SF-G29-2,11,14,3,2,8,12,0.2727272727272727,0.7272727272727273,0.14285714285714285,0.8571428571428571
SF-L19,SF-G29-1,6,1,0,0,6,1,0.0,1.0,0.0,1.0
SF-L19,SF-G30-1,4,8,1,2,3,6,0.25,0.75,0.25,0.75
SF-L19,SF-G29-3,1,4,0,0,1,4,0.0,1.0,0.0,1.0
SF-L19,SF-F30-2,1,1,0,0,1,1,0.0,1.0,0.0,1.0
SF-L19,SF-E29-3,5,32,0,1,5,31,0.0,1.0,0.03125,0.96875
SF-L19,SF-F28-1,6,3,1,0,5,3,0.16666666666666666,0.8333333333333334,0.0,1.0
SF-L19,SF-E28,1,1,0,0,1,1,0.0,1.0,0.0,1.0
SF-L19,SF-J10,20,30,6,9,14,21,0.3,0.7,0.3,0.7
SF-L19,SF-J12,10,21,2,4,8,17,0.2,0.8,0.19047619047619047,0.8095238095238095
SF-L19,SF-J13,7,11,2,1,5,10,0.2857142857142857,0.7142857142857143,0.09090909090909091,0.9090909090909091
SF-L19,SF-J14,1,1,0,0,1,1,0.0,1.0,0.0,1.0
SF-L19,SF-H13,2,3,1,0,1,3,0.5,0.5,0.0,1.0
SF-L19,SF-I16,2,5,1,0,1,5,0.5,0.5,0.0,1.0
SF-L19,SF-H12,3,4,0,0,3,4,0.0,1.0,0.0,1.0
SF-L19,SF-G10-2,10,5,2,0,8,5,0.2,0.8,0.0,1.0
SF-L19,SF-H15,4,6,0,0,4,6,0.0,1.0,0.0,1.0
SF-L19,SF-G9,6,3,0,1,6,2,0.0,1.0,0.3333333333333333,0.6666666666666666
SF-L19,SF-G13,5,9,1,2,4,7,0.2,0.8,0.2222222222222222,0.7777777777777778
SF-L19,SF-G11,4,3,1,1,3,2,0.25,0.75,0.3333333333333333,0.6666666666666666
SF-L19,SF-G12,11,10,1,2,10,8,0.09090909090909091,0.9090909090909091,0.2,0.8
SF-L19,SF-G10-1,2,2,0,0,2,2,0.0,1.0,0.0,1.0
SF-L19,SF-F15,2,2,0,0,2,2,0.0,1.0,0.0,1.0
SF-L19,SF-F16,4,2,1,0,3,2,0.25,0.75,0.0,1.0
SF-L19,SF-B21,2,2,0,1,2,1,0.0,1.0,0.5,0.5
SF-L19,SF-A20,7,12,1,0,6,12,0.14285714285714285,0.8571428571428571,0.0,1.0
SF-L19,SF-C26,1,10,0,2,1,8,0.0,1.0,0.2,0.8
SF-L19,SF-C25,6,14,1,2,5,12,0.16666666666666666,0.8333333333333334,0.14285714285714285,0.8571428571428571
SF-L19,SF-B25,1,4,0,1,1,3,0.0,1.0,0.25,0.75
SF-L19,SF-E27,5,2,0,0,5,2,0.0,1.0,0.0,1.0
SF-L19,SF-D27,3,6,0,2,3,4,0.0,1.0,0.3333333333333333,0.6666666666666666
SF-L19,SF-C28-2,4,3,0,0,4,3,0.0,1.0,0.0,1.0
SF-L19,SF-J1,8,28,2,7,6,21,0.25,0.75,0.25,0.75
SF-L19,SF-J3,4,9,0,3,4,6,0.0,1.0,0.3333333333333333,0.6666666666666666
SF-L19,SF-J5,2,3,0,1,2,2,0.0,1.0,0.3333333333333333,0.6666666666666666
SF-L19,SF-G5,3,7,0,1,3,6,0.0,1.0,0.14285714285714285,0.8571428571428571
SF-L19,SF-G7,17,17,2,0,15,17,0.11764705882352941,0.8823529411764706,0.0,1.0
SF-L19,SF-F9,2,2,2,1,0,1,1.0,0.0,0.5,0.5
SF-L19,SF-G26,17,5,0,2,17,3,0.0,1.0,0.4,0.6
SF-L19,SF-K21,15,10,4,5,11,5,0.26666666666666666,0.7333333333333333,0.5,0.5
SF-L19,SF-K22-1,26,21,6,17,20,4,0.23076923076923078,0.7692307692307693,0.8095238095238095,0.19047619047619047
SF-L19,SF-J23-1,34,47,8,23,26,24,0.23529411764705882,0.7647058823529411,0.48936170212765956,0.5106382978723404
SF-L19,SF-J22-1,12,69,4,18,8,51,0.3333333333333333,0.6666666666666666,0.2608695652173913,0.7391304347826086
SF-L19,SF-J22-2,29,31,20,15,9,16,0.6896551724137931,0.3103448275862069,0.4838709677419355,0.5161290322580645
SF-L19,SF-J21,26,51,2,13,24,38,0.07692307692307693,0.9230769230769231,0.2549019607843137,0.7450980392156863
SF-L19,SF-I21,2,1,0,1,2,0,0.0,1.0,1.0,0.0
SF-L19,SF-I22,5,16,3,5,2,11,0.6,0.4,0.3125,0.6875
SF-L19,SF-I23-2,6,4,1,2,5,2,0.16666666666666666,0.8333333333333334,0.5,0.5
SF-L19,SF-I24,8,5,4,2,4,3,0.5,0.5,0.4,0.6
SF-L19,SF-I23-1,4,7,0,1,4,6,0.0,1.0,0.14285714285714285,0.8571428571428571
SF-L19,SF-F26,15,22,0,2,15,20,0.0,1.0,0.09090909090909091,0.9090909090909091
SF-L19,SF-M13,60,69,12,11,48,58,0.2,0.8,0.15942028985507245,0.8405797101449275
SF-L19,SF-M15,32,34,5,1,27,33,0.15625,0.84375,0.029411764705882353,0.9705882352941176
SF-L19,SF-L20,33,81,8,62,25,19,0.24242424242424243,0.7575757575757576,0.7654320987654321,0.2345679012345679
SF-L19,SF-N20-1,21,19,6,13,15,6,0.2857142857142857,0.7142857142857143,0.6842105263157895,0.3157894736842105
SF-L19,SF-M20,46,56,12,34,34,22,0.2608695652173913,0.7391304347826086,0.6071428571428571,0.39285714285714285
SF-L19,SF-K17-2,12,14,8,4,4,10,0.6666666666666666,0.3333333333333333,0.2857142857142857,0.7142857142857143
SF-L19,SF-K20,26,45,18,29,8,16,0.6923076923076923,0.3076923076923077,0.6444444444444445,0.35555555555555557
SF-L19,SF-K15-,44,65,24,21,20,44,0.5454545454545454,0.45454545454545453,0.3230769230769231,0.676923076923077
SF-L19,SF-K19,46,45,23,16,23,29,0.5,0.5,0.35555555555555557,0.6444444444444445
SF-L19,SF-K18,21,29,11,10,10,19,0.5238095238095238,0.47619047619047616,0.3448275862068966,0.6551724137931034
SF-L19,SF-K17,24,25,10,11,14,14,0.4166666666666667,0.5833333333333334,0.44,0.56
SF-L19,SF-J16,12,5,5,0,7,5,0.4166666666666667,0.5833333333333334,0.0,1.0
SF-L19,SF-J18,20,22,9,2,11,20,0.45,0.55,0.09090909090909091,0.9090909090909091
SF-L19,SF-J20,9,7,0,2,9,5,0.0,1.0,0.2857142857142857,0.7142857142857143
SF-L19,SF-J19,17,5,4,1,13,4,0.23529411764705882,0.7647058823529411,0.2,0.8
SF-L19,SF-M12,9,8,1,1,8,7,0.1111111111111111,0.8888888888888888,0.125,0.875
SF-L19,SF-M10,4,15,3,2,1,13,0.75,0.25,0.13333333333333333,0.8666666666666667
SF-L19,SF-M11,15,19,8,7,7,12,0.5333333333333333,0.4666666666666667,0.3684210526315789,0.631578947368421
SF-L19,SF-R19,13,7,3,1,10,6,0.23076923076923078,0.7692307692307693,0.14285714285714285,0.8571428571428571
SF-L19,SF-R20,6,3,2,0,4,3,0.3333333333333333,0.6666666666666666,0.0,1.0
SF-L19,SF-Q21-2,16,16,3,2,13,14,0.1875,0.8125,0.125,0.875
SF-L19,SF-Q21-1,18,9,11,4,7,5,0.6111111111111112,0.3888888888888889,0.4444444444444444,0.5555555555555556
SF-L19,SF-P21,17,22,3,14,14,8,0.17647058823529413,0.8235294117647058,0.6363636363636364,0.36363636363636365
SF-L19,SF-O18,43,31,8,8,35,23,0.18604651162790697,0.813953488372093,0.25806451612903225,0.7419354838709677
SF-L19,SF-O19,47,27,10,11,37,16,0.2127659574468085,0.7872340425531915,0.4074074074074074,0.5925925925925926
SF-L19,SF-O21,44,66,4,21,40,45,0.09090909090909091,0.9090909090909091,0.3181818181818182,0.6818181818181818
SF-L19,SF-O22,29,49,2,17,27,32,0.06896551724137931,0.9310344827586207,0.3469387755102041,0.6530612244897959
SF-L19,SF-N21,86,104,20,21,66,83,0.23255813953488372,0.7674418604651163,0.20192307692307693,0.7980769230769231
SF-L19,SF-N20-2,12,10,1,9,11,1,0.08333333333333333,0.9166666666666666,0.9,0.1
SF-L19,SF-M21,12,9,6,5,6,4,0.5,0.5,0.5555555555555556,0.4444444444444444
SF-L19,SF-L21,43,66,17,40,26,26,0.3953488372093023,0.6046511627906976,0.6060606060606061,0.3939393939393939
SF-L19,SF-S30,1,5,0,1,1,4,0.0,1.0,0.2,0.8
SF-L19,SF-P30,3,6,0,3,3,3,0.0,1.0,0.5,0.5
SF-L19,SF-O30-2,1,5,0,1,1,4,0.0,1.0,0.2,0.8
SF-L19,SF-O30,6,7,0,1,6,6,0.0,1.0,0.14285714285714285,0.8571428571428571
SF-L19,SF-N27,1,10,0,2,1,8,0.0,1.0,0.2,0.8
SF-L19,SF-N29,18,16,0,3,18,13,0.0,1.0,0.1875,0.8125
SF-L19,SF-N28,8,6,0,1,8,5,0.0,1.0,0.16666666666666666,0.8333333333333334
SF-L19,SF-L30-1,18,26,2,4,16,22,0.1111111111111111,0.8888888888888888,0.15384615384615385,0.8461538461538461
SF-L19,SF-L31-1,2,1,0,1,2,0,0.0,1.0,1.0,0.0
SF-L19,SF-K30-2,4,2,1,1,3,1,0.25,0.75,0.5,0.5
SF-L19,SF-L29,1,9,0,3,1,6,0.0,1.0,0.3333333333333333,0.6666666666666666
SF-L19,SF-J29-1,1,1,0,0,1,1,0.0,1.0,0.0,1.0
SF-L19,SF-I30,1,3,0,0,1,3,0.0,1.0,0.0,1.0
SF-L19,SF-I27,5,11,0,5,5,6,0.0,1.0,0.45454545454545453,0.5454545454545454
SF-L19,SF-I28,1,5,0,3,1,2,0.0,1.0,0.6,0.4
SF-L19,SF-H28,8,1,3,1,5,0,0.375,0.625,1.0,0.0
SF-L19,SF-H29,5,3,0,1,5,2,0.0,1.0,0.3333333333333333,0.6666666666666666
SF-L19,SF-S24,13,8,0,3,13,5,0.0,1.0,0.375,0.625
SF-L19,SF-R24,8,51,2,11,6,40,0.25,0.75,0.21568627450980393,0.7843137254901961
SF-L19,SF-R26,2,1,0,0,2,1,0.0,1.0,0.0,1.0
SF-L19,SF-Q26,2,3,0,0,2,3,0.0,1.0,0.0,1.0
SF-L19,SF-P26,4,7,0,0,4,7,0.0,1.0,0.0,1.0
SF-L19,SF-O25-2,40,62,5,54,35,8,0.125,0.875,0.8709677419354839,0.12903225806451613
SF-L19,SF-N22-1B,14,71,2,61,12,10,0.14285714285714285,0.8571428571428571,0.8591549295774648,0.14084507042253522
SF-L19,SF-N26,15,15,2,4,13,11,0.13333333333333333,0.8666666666666667,0.26666666666666666,0.7333333333333333
SF-L19,SF-N25,6,5,2,2,4,3,0.3333333333333333,0.6666666666666666,0.4,0.6
SF-L19,SF-T22,5,25,0,3,5,22,0.0,1.0,0.12,0.88
SF-L19,SF-S22-2,7,2,1,0,6,2,0.14285714285714285,0.8571428571428571,0.0,1.0
SF-L19,SF-S22-1,11,7,3,2,8,5,0.2727272727272727,0.7272727272727273,0.2857142857142857,0.7142857142857143
SF-L19,SF-Q23-3,7,6,0,0,7,6,0.0,1.0,0.0,1.0
SF-L19,SF-Q22-1,16,8,2,3,14,5,0.125,0.875,0.375,0.625
SF-L19,SF-Q22-2,14,22,5,4,9,18,0.35714285714285715,0.6428571428571429,0.18181818181818182,0.8181818181818182
SF-L19,SF-P22,14,22,4,7,10,15,0.2857142857142857,0.7142857142857143,0.3181818181818182,0.6818181818181818
SF-L19,SF-W19,3,3,0,0,3,3,0.0,1.0,0.0,1.0
SF-L19,SF-W19-2,1,4,0,0,1,4,0.0,1.0,0.0,1.0
SF-L19,SF-U21,4,3,1,2,3,1,0.25,0.75,0.6666666666666666,0.3333333333333333
SF-L19,SF-T20,12,4,0,0,12,4,0.0,1.0,0.0,1.0
SF-L19,SF-S21,7,3,2,0,5,3,0.2857142857142857,0.7142857142857143,0.0,1.0
SF-L19,SF-V32,1,2,1,2,0,0,1.0,0.0,1.0,0.0
SF-L19,SF-W14,2,1,0,0,2,1,0.0,1.0,0.0,1.0
SF-L20,SF-M26,3,1,0,1,3,0,0.0,1.0,1.0,0.0
SF-L20,SF-M25,8,7,2,3,6,4,0.25,0.75,0.42857142857142855,0.5714285714285714
SF-L20,SF-M26-2,1,3,0,1,1,2,0.0,1.0,0.3333333333333333,0.6666666666666666
SF-L20,SF-K26,14,12,4,5,10,7,0.2857142857142857,0.7142857142857143,0.4166666666666667,0.5833333333333334
SF-L20,SF-M30,13,6,5,1,8,5,0.38461538461538464,0.6153846153846154,0.16666666666666666,0.8333333333333334
SF-L20,SF-J29-3,5,2,2,2,3,0,0.4,0.6,1.0,0.0
SF-L20,SF-J29,6,13,3,7,3,6,0.5,0.5,0.5384615384615384,0.46153846153846156
SF-L20,SF-L26,39,47,15,17,24,30,0.38461538461538464,0.6153846153846154,0.3617021276595745,0.6382978723404256
SF-L20,SF-M28,4,2,0,0,4,2,0.0,1.0,0.0,1.0
SF-L20,SF-L25,8,6,2,3,6,3,0.25,0.75,0.5,0.5
SF-L20,SF-M24,10,3,4,3,6,0,0.4,0.6,1.0,0.0
SF-L20,SF-L24,8,12,3,9,5,3,0.375,0.625,0.75,0.25
SF-L20,SF-N23,7,5,1,2,6,3,0.14285714285714285,0.8571428571428571,0.4,0.6
SF-L20,SF-N24-2,7,27,0,2,7,25,0.0,1.0,0.07407407407407407,0.9259259259259259
SF-L20,SF-K27-2,27,11,5,2,22,9,0.18518518518518517,0.8148148148148148,0.18181818181818182,0.8181818181818182
SF-L20,SF-J26-2,7,6,2,3,5,3,0.2857142857142857,0.7142857142857143,0.5,0.5
SF-L20,SF-K28,1,1,0,1,1,0,0.0,1.0,1.0,0.0
SF-L20,SF-K29-1,3,15,0,12,3,3,0.0,1.0,0.8,0.2
SF-L20,SF-J28-2,5,1,0,0,5,1,0.0,1.0,0.0,1.0
SF-L20,SF-K27,2,2,1,0,1,2,0.5,0.5,0.0,1.0
SF-L20,SF-K25,4,5,1,2,3,3,0.25,0.75,0.4,0.6
SF-L20,SF-J25,16,12,2,8,14,4,0.125,0.875,0.6666666666666666,0.3333333333333333
SF-L20,SF-H26-2,2,7,0,0,2,7,0.0,1.0,0.0,1.0
SF-L20,SF-P24,10,10,4,3,6,7,0.4,0.6,0.3,0.7
SF-L20,SF-N22-1A,3,11,2,5,1,6,0.6666666666666666,0.3333333333333333,0.45454545454545453,0.5454545454545454
SF-L20,SF-J24,8,9,3,2,5,7,0.375,0.625,0.2222222222222222,0.7777777777777778
SF-L20,SF-O24,4,3,1,1,3,2,0.25,0.75,0.3333333333333333,0.6666666666666666
SF-L20,SF-J26,2,2,0,0,2,2,0.0,1.0,0.0,1.0
SF-L20,SF-I26-,3,1,1,0,2,1,0.3333333333333333,0.6666666666666666,0.0,1.0
SF-L20,SF-I25,16,21,11,10,5,11,0.6875,0.3125,0.47619047619047616,0.5238095238095238
SF-L20,SF-K23,6,5,3,4,3,1,0.5,0.5,0.8,0.2
SF-L20,SF-H26,24,38,9,18,15,20,0.375,0.625,0.47368421052631576,0.5263157894736842
SF-L20,SF-O23,10,25,4,12,6,13,0.4,0.6,0.48,0.52
SF-L20,SF-H27-1,5,2,1,1,4,1,0.2,0.8,0.5,0.5
SF-L20,SF-F28-2,75,44,25,26,50,18,0.3333333333333333,0.6666666666666666,0.5909090909090909,0.4090909090909091
SF-L20,SF-G27,47,49,13,30,34,19,0.2765957446808511,0.723404255319149,0.6122448979591837,0.3877551020408163
SF-L20,SF-M22-2,31,15,13,7,18,8,0.41935483870967744,0.5806451612903226,0.4666666666666667,0.5333333333333333
SF-L20,SF-L22,13,17,6,2,7,15,0.46153846153846156,0.5384615384615384,0.11764705882352941,0.8823529411764706
SF-L20,SF-F27,28,58,1,41,27,17,0.03571428571428571,0.9642857142857143,0.7068965517241379,0.29310344827586204
SF-L20,SF-N22-2,25,59,8,52,17,7,0.32,0.68,0.8813559322033898,0.11864406779661017
SF-L20,SF-G28-2,23,27,1,4,22,23,0.043478260869565216,0.9565217391304348,0.14814814814814814,0.8518518518518519
SF-L20,SF-G28-1,10,2,6,0,4,2,0.6,0.4,0.0,1.0
SF-L20,SF-M22-1,12,13,0,6,12,7,0.0,1.0,0.46153846153846156,0.5384615384615384
SF-L20,SF-O25-1,1,4,0,2,1,2,0.0,1.0,0.5,0.5
SF-L20,SF-K22-2,8,3,4,1,4,2,0.5,0.5,0.3333333333333333,0.6666666666666666
SF-L20,SF-K24,10,13,3,3,7,10,0.3,0.7,0.23076923076923078,0.7692307692307693
SF-L20,SF-J23-2,12,15,7,12,5,3,0.5833333333333334,0.4166666666666667,0.8,0.2
SF-L20,SF-G23,6,7,4,2,2,5,0.6666666666666666,0.3333333333333333,0.2857142857142857,0.7142857142857143
SF-L20,SF-G24,23,10,3,0,20,10,0.13043478260869565,0.8695652173913043,0.0,1.0
SF-L20,SF-G25,9,11,1,1,8,10,0.1111111111111111,0.8888888888888888,0.09090909090909091,0.9090909090909091
SF-L20,SF-F23,12,8,1,2,11,6,0.08333333333333333,0.9166666666666666,0.25,0.75
SF-L20,SF-E23,15,8,2,0,13,8,0.13333333333333333,0.8666666666666667,0.0,1.0
SF-L20,SF-D24,13,1,5,0,8,1,0.38461538461538464,0.6153846153846154,0.0,1.0
SF-L20,SF-C22,5,7,2,0,3,7,0.4,0.6,0.0,1.0
SF-L20,SF-B22,6,6,0,1,6,5,0.0,1.0,0.16666666666666666,0.8333333333333334
SF-L20,SF-J17,22,13,9,3,13,10,0.4090909090909091,0.5909090909090909,0.23076923076923078,0.7692307692307693
SF-L20,SF-I19,15,9,1,1,14,8,0.06666666666666667,0.9333333333333333,0.1111111111111111,0.8888888888888888
SF-L20,SF-I20,114,117,109,113,5,4,0.956140350877193,0.043859649122807015,0.9658119658119658,0.03418803418803419
SF-L20,SF-H16,7,11,2,3,5,8,0.2857142857142857,0.7142857142857143,0.2727272727272727,0.7272727272727273
SF-L20,SF-H19,1,2,1,0,0,2,1.0,0.0,0.0,1.0
SF-L20,SF-H20,8,9,0,3,8,6,0.0,1.0,0.3333333333333333,0.6666666666666666
SF-L20,SF-H18,8,3,0,1,8,2,0.0,1.0,0.3333333333333333,0.6666666666666666
SF-L20,SF-H17,12,6,1,0,11,6,0.08333333333333333,0.9166666666666666,0.0,1.0
SF-L20,SF-G19,6,4,3,1,3,3,0.5,0.5,0.25,0.75
SF-L20,SF-G17,18,12,0,0,18,12,0.0,1.0,0.0,1.0
SF-L20,SF-G18,14,15,1,0,13,15,0.07142857142857142,0.9285714285714286,0.0,1.0
SF-L20,SF-G20,12,11,2,5,10,6,0.16666666666666666,0.8333333333333334,0.45454545454545453,0.5454545454545454
SF-L20,SF-F19,4,11,1,2,3,9,0.25,0.75,0.18181818181818182,0.8181818181818182
SF-L20,SF-E18,3,4,0,1,3,3,0.0,1.0,0.25,0.75
SF-L20,SF-E20,8,5,4,0,4,5,0.5,0.5,0.0,1.0
SF-L20,SF-H30,1,2,1,0,0,2,1.0,0.0,0.0,1.0
SF-L20,SF-G30-2,9,7,3,1,6,6,0.3333333333333333,0.6666666666666666,0.14285714285714285,0.8571428571428571
SF-L20,SF-E29-2,17,25,6,14,11,11,0.35294117647058826,0.6470588235294118,0.56,0.44
SF-L20,SF-E29-1,11,9,2,8,9,1,0.18181818181818182,0.8181818181818182,0.8888888888888888,0.1111111111111111
SF-L20,SF-D29,2,10,0,0,2,10,0.0,1.0,0.0,1.0
SF-L20,SF-D28,2,1,1,1,1,0,0.5,0.5,1.0,0.0
SF-L20,SF-G29-2,6,2,2,0,4,2,0.3333333333333333,0.6666666666666666,0.0,1.0
SF-L20,SF-G29-1,6,11,0,1,6,10,0.0,1.0,0.09090909090909091,0.9090909090909091
SF-L20,SF-G30-1,4,6,1,4,3,2,0.25,0.75,0.6666666666666666,0.3333333333333333
SF-L20,SF-G29-3,5,8,1,5,4,3,0.2,0.8,0.625,0.375
SF-L20,SF-F30-2,2,1,2,1,0,0,1.0,0.0,1.0,0.0
SF-L20,SF-F29,2,1,0,1,2,0,0.0,1.0,1.0,0.0
SF-L20,SF-E29-3,3,10,2,4,1,6,0.6666666666666666,0.3333333333333333,0.4,0.6
SF-L20,SF-F28-1,21,10,5,4,16,6,0.23809523809523808,0.7619047619047619,0.4,0.6
SF-L20,SF-E28-2,3,4,2,3,1,1,0.6666666666666666,0.3333333333333333,0.75,0.25
SF-L20,SF-E28,2,6,0,6,2,0,0.0,1.0,1.0,0.0
SF-L20,SF-J10,6,8,3,4,3,4,0.5,0.5,0.5,0.5
SF-L20,SF-J12,22,16,2,3,20,13,0.09090909090909091,0.9090909090909091,0.1875,0.8125
SF-L20,SF-J13,9,12,2,4,7,8,0.2222222222222222,0.7777777777777778,0.3333333333333333,0.6666666666666666
SF-L20,SF-J15,2,1,2,0,0,1,1.0,0.0,0.0,1.0
SF-L20,SF-H13,10,4,0,0,10,4,0.0,1.0,0.0,1.0
SF-L20,SF-I16,7,3,2,0,5,3,0.2857142857142857,0.7142857142857143,0.0,1.0
SF-L20,SF-H12,18,3,0,2,18,1,0.0,1.0,0.6666666666666666,0.3333333333333333
SF-L20,SF-G13,9,6,3,3,6,3,0.3333333333333333,0.6666666666666666,0.5,0.5
SF-L20,SF-G11,10,2,0,0,10,2,0.0,1.0,0.0,1.0
SF-L20,SF-G12,36,27,4,0,32,27,0.1111111111111111,0.8888888888888888,0.0,1.0
SF-L20,SF-G10-1,1,1,0,0,1,1,0.0,1.0,0.0,1.0
SF-L20,SF-F15,1,8,0,2,1,6,0.0,1.0,0.25,0.75
SF-L20,SF-F16,2,3,0,1,2,2,0.0,1.0,0.3333333333333333,0.6666666666666666
SF-L20,SF-C20,3,1,0,1,3,0,0.0,1.0,1.0,0.0
SF-L20,SF-B19,1,3,0,0,1,3,0.0,1.0,0.0,1.0
SF-L20,SF-A20,3,3,1,3,2,0,0.3333333333333333,0.6666666666666666,1.0,0.0
SF-L20,SF-C26,6,9,0,3,6,6,0.0,1.0,0.3333333333333333,0.6666666666666666
SF-L20,SF-C25,3,5,0,0,3,5,0.0,1.0,0.0,1.0
SF-L20,SF-B25,11,5,0,2,11,3,0.0,1.0,0.4,0.6
SF-L20,SF-E27,8,5,1,0,7,5,0.125,0.875,0.0,1.0
SF-L20,SF-C28-2,1,4,0,0,1,4,0.0,1.0,0.0,1.0
SF-L20,SF-C28-1,1,1,1,0,0,1,1.0,0.0,0.0,1.0
SF-L20,SF-B28,5,2,0,1,5,1,0.0,1.0,0.5,0.5
SF-L20,SF-J1,13,19,2,5,11,14,0.15384615384615385,0.8461538461538461,0.2631578947368421,0.7368421052631579
SF-L20,SF-J3,3,3,3,1,0,2,1.0,0.0,0.3333333333333333,0.6666666666666666
SF-L20,SF-J5,4,2,1,0,3,2,0.25,0.75,0.0,1.0
SF-L20,SF-G8,4,1,1,0,3,1,0.25,0.75,0.0,1.0
SF-L20,SF-G7,3,5,1,2,2,3,0.3333333333333333,0.6666666666666666,0.4,0.6
SF-L20,SF-H25,3,6,0,1,3,5,0.0,1.0,0.16666666666666666,0.8333333333333334
SF-L20,SF-G26,5,9,1,1,4,8,0.2,0.8,0.1111111111111111,0.8888888888888888
SF-L20,SF-K21,34,99,21,21,13,78,0.6176470588235294,0.38235294117647056,0.21212121212121213,0.7878787878787878
SF-L20,SF-K22-1,66,72,34,55,32,17,0.5151515151515151,0.48484848484848486,0.7638888888888888,0.2361111111111111
SF-L20,SF-J23-1,48,52,10,28,38,24,0.20833333333333334,0.7916666666666666,0.5384615384615384,0.46153846153846156
SF-L20,SF-J22-1,8,9,0,2,8,7,0.0,1.0,0.2222222222222222,0.7777777777777778
SF-L20,SF-J22-2,11,14,1,3,10,11,0.09090909090909091,0.9090909090909091,0.21428571428571427,0.7857142857142857
SF-L20,SF-J21,40,40,4,18,36,22,0.1,0.9,0.45,0.55
SF-L20,SF-I21,17,15,3,1,14,14,0.17647058823529413,0.8235294117647058,0.06666666666666667,0.9333333333333333
SF-L20,SF-I22,5,5,2,2,3,3,0.4,0.6,0.4,0.6
SF-L20,SF-I23-2,5,9,2,3,3,6,0.4,0.6,0.3333333333333333,0.6666666666666666
SF-L20,SF-I24,11,8,5,2,6,6,0.45454545454545453,0.5454545454545454,0.25,0.75
SF-L20,SF-I23-1,8,5,1,4,7,1,0.125,0.875,0.8,0.2
SF-L20,SF-F26,31,19,2,4,29,15,0.06451612903225806,0.9354838709677419,0.21052631578947367,0.7894736842105263
SF-L20,SF-M13,89,59,16,8,73,51,0.1797752808988764,0.8202247191011236,0.13559322033898305,0.864406779661017
SF-L20,SF-M15,26,24,13,1,13,23,0.5,0.5,0.041666666666666664,0.9583333333333334
SF-L20,SF-L19,81,33,62,8,19,25,0.7654320987654321,0.2345679012345679,0.24242424242424243,0.7575757575757576
SF-L20,SF-N20-1,4,3,3,1,1,2,0.75,0.25,0.3333333333333333,0.6666666666666666
SF-L20,SF-M20,34,23,23,13,11,10,0.6764705882352942,0.3235294117647059,0.5652173913043478,0.43478260869565216
SF-L20,SF-K17-2,28,23,12,1,16,22,0.42857142857142855,0.5714285714285714,0.043478260869565216,0.9565217391304348
SF-L20,SF-K20,98,71,74,34,24,37,0.7551020408163265,0.24489795918367346,0.4788732394366197,0.5211267605633803
SF-L20,SF-K15-,29,46,10,7,19,39,0.3448275862068966,0.6551724137931034,0.15217391304347827,0.8478260869565217
SF-L20,SF-K19,69,76,47,38,22,38,0.6811594202898551,0.3188405797101449,0.5,0.5
SF-L20,SF-K18,75,95,54,14,21,81,0.72,0.28,0.14736842105263157,0.8526315789473684
SF-L20,SF-K17,31,35,8,9,23,26,0.25806451612903225,0.7419354838709677,0.2571428571428571,0.7428571428571429
SF-L20,SF-J16,6,5,0,1,6,4,0.0,1.0,0.2,0.8
SF-L20,SF-J18,54,53,12,4,42,49,0.2222222222222222,0.7777777777777778,0.07547169811320754,0.9245283018867925
SF-L20,SF-J20,9,11,5,2,4,9,0.5555555555555556,0.4444444444444444,0.18181818181818182,0.8181818181818182
SF-L20,SF-J19,31,16,3,1,28,15,0.0967741935483871,0.9032258064516129,0.0625,0.9375
SF-L20,SF-M12,12,31,1,1,11,30,0.08333333333333333,0.9166666666666666,0.03225806451612903,0.967741935483871
SF-L20,SF-M10,9,10,5,0,4,10,0.5555555555555556,0.4444444444444444,0.0,1.0
SF-L20,SF-M11,16,13,8,4,8,9,0.5,0.5,0.3076923076923077,0.6923076923076923
SF-L20,SF-R19,6,8,1,1,5,7,0.16666666666666666,0.8333333333333334,0.125,0.875
SF-L20,SF-R20,4,3,1,0,3,3,0.25,0.75,0.0,1.0
SF-L20,SF-Q21-2,2,3,1,0,1,3,0.5,0.5,0.0,1.0
SF-L20,SF-Q21-1,4,3,1,1,3,2,0.25,0.75,0.3333333333333333,0.6666666666666666
SF-L20,SF-P21,9,14,1,2,8,12,0.1111111111111111,0.8888888888888888,0.14285714285714285,0.8571428571428571
SF-L20,SF-O18,18,26,6,4,12,22,0.3333333333333333,0.6666666666666666,0.15384615384615385,0.8461538461538461
SF-L20,SF-O19,9,32,3,17,6,15,0.3333333333333333,0.6666666666666666,0.53125,0.46875
SF-L20,SF-O21,66,90,15,38,51,52,0.22727272727272727,0.7727272727272727,0.4222222222222222,0.5777777777777777
SF-L20,SF-O22,42,64,14,17,28,47,0.3333333333333333,0.6666666666666666,0.265625,0.734375
SF-L20,SF-N21,19,6,10,4,9,2,0.5263157894736842,0.47368421052631576,0.6666666666666666,0.3333333333333333
SF-L20,SF-N20-2,10,7,1,2,9,5,0.1,0.9,0.2857142857142857,0.7142857142857143
SF-L20,SF-M21,25,15,13,7,12,8,0.52,0.48,0.4666666666666667,0.5333333333333333
SF-L20,SF-L21,76,47,51,27,25,20,0.6710526315789473,0.32894736842105265,0.574468085106383,0.425531914893617
SF-L20,SF-S30,2,1,0,1,2,0,0.0,1.0,1.0,0.0
SF-L20,SF-Q30,5,6,0,1,5,5,0.0,1.0,0.16666666666666666,0.8333333333333334
SF-L20,SF-P30,6,4,3,0,3,4,0.5,0.5,0.0,1.0
SF-L20,SF-O30-2,3,4,0,0,3,4,0.0,1.0,0.0,1.0
SF-L20,SF-O30,6,4,2,1,4,3,0.3333333333333333,0.6666666666666666,0.25,0.75
SF-L20,SF-N27,2,7,0,2,2,5,0.0,1.0,0.2857142857142857,0.7142857142857143
SF-L20,SF-N29,6,2,2,0,4,2,0.3333333333333333,0.6666666666666666,0.0,1.0
SF-L20,SF-N28,9,9,3,5,6,4,0.3333333333333333,0.6666666666666666,0.5555555555555556,0.4444444444444444
SF-L20,SF-L30-1,6,9,2,1,4,8,0.3333333333333333,0.6666666666666666,0.1111111111111111,0.8888888888888888
SF-L20,SF-K30-2,2,6,2,6,0,0,1.0,0.0,1.0,0.0
SF-L20,SF-L29,4,3,1,1,3,2,0.25,0.75,0.3333333333333333,0.6666666666666666
SF-L20,SF-I30,6,2,0,1,6,1,0.0,1.0,0.5,0.5
SF-L20,SF-I29-2,1,1,0,1,1,0,0.0,1.0,1.0,0.0
SF-L20,SF-I27,12,2,1,0,11,2,0.08333333333333333,0.9166666666666666,0.0,1.0
SF-L20,SF-I28,3,3,1,1,2,2,0.3333333333333333,0.6666666666666666,0.3333333333333333,0.6666666666666666
SF-L20,SF-I30-2,1,2,0,0,1,2,0.0,1.0,0.0,1.0
SF-L20,SF-H28,5,2,4,1,1,1,0.8,0.2,0.5,0.5
SF-L20,SF-S24,4,16,0,3,4,13,0.0,1.0,0.1875,0.8125
SF-L20,SF-R24,8,15,1,4,7,11,0.125,0.875,0.26666666666666666,0.7333333333333333
SF-L20,SF-Q26,2,3,0,2,2,1,0.0,1.0,0.6666666666666666,0.3333333333333333
SF-L20,SF-P26,8,16,3,1,5,15,0.375,0.625,0.0625,0.9375
SF-L20,SF-O25-2,10,4,1,0,9,4,0.1,0.9,0.0,1.0
SF-L20,SF-N22-1B,10,29,3,14,7,15,0.3,0.7,0.4827586206896552,0.5172413793103449
SF-L20,SF-N26,5,4,1,2,4,2,0.2,0.8,0.5,0.5
SF-L20,SF-N25,2,2,0,0,2,2,0.0,1.0,0.0,1.0
SF-L20,SF-T21,33,27,0,0,33,27,0.0,1.0,0.0,1.0
SF-L20,SF-T22,55,46,44,39,11,7,0.8,0.2,0.8478260869565217,0.15217391304347827
SF-L20,SF-S22-2,5,5,1,4,4,1,0.2,0.8,0.8,0.2
SF-L20,SF-S22-1,8,31,6,21,2,10,0.75,0.25,0.6774193548387096,0.3225806451612903
SF-L20,SF-Q23-3,7,10,1,2,6,8,0.14285714285714285,0.8571428571428571,0.2,0.8
SF-L20,SF-Q22-1,15,19,3,9,12,10,0.2,0.8,0.47368421052631576,0.5263157894736842
SF-L20,SF-Q22-2,19,13,9,6,10,7,0.47368421052631576,0.5263157894736842,0.46153846153846156,0.5384615384615384
SF-L20,SF-P22,18,16,6,6,12,10,0.3333333333333333,0.6666666666666666,0.375,0.625
SF-L20,SF-W19-2,1,1,1,0,0,1,1.0,0.0,0.0,1.0
SF-L20,SF-U21,2,4,0,0,2,4,0.0,1.0,0.0,1.0
SF-L20,SF-T20,21,23,11,0,10,23,0.5238095238095238,0.47619047619047616,0.0,1.0
SF-L20,SF-S21,3,4,0,0,3,4,0.0,1.0,0.0,1.0
SF-L20,SF-Z28,2,4,0,0,2,4,0.0,1.0,0.0,1.0
SF-N20-1,SF-M26,3,3,2,0,1,3,0.6666666666666666,0.3333333333333333,0.0,1.0
SF-N20-1,SF-M25,8,13,3,5,5,8,0.375,0.625,0.38461538461538464,0.6153846153846154
SF-N20-1,SF-M26-2,8,15,0,1,8,14,0.0,1.0,0.06666666666666667,0.9333333333333333
SF-N20-1,SF-L27,3,1,2,1,1,0,0.6666666666666666,0.3333333333333333,1.0,0.0
SF-N20-1,SF-K26,7,5,1,2,6,3,0.14285714285714285,0.8571428571428571,0.4,0.6
SF-N20-1,SF-M30,18,22,3,3,15,19,0.16666666666666666,0.8333333333333334,0.13636363636363635,0.8636363636363636
SF-N20-1,SF-L27-2,2,1,0,1,2,0,0.0,1.0,1.0,0.0
SF-N20-1,SF-J29-3,3,5,0,0,3,5,0.0,1.0,0.0,1.0
SF-N20-1,SF-J29,2,3,0,0,2,3,0.0,1.0,0.0,1.0
SF-N20-1,SF-L26,90,85,5,10,85,75,0.05555555555555555,0.9444444444444444,0.11764705882352941,0.8823529411764706
SF-N20-1,SF-M28,12,4,2,2,10,2,0.16666666666666666,0.8333333333333334,0.5,0.5
SF-N20-1,SF-L25,13,25,0,5,13,20,0.0,1.0,0.2,0.8
SF-N20-1,SF-M24,12,5,4,2,8,3,0.3333333333333333,0.6666666666666666,0.4,0.6
SF-N20-1,SF-L24,6,7,2,4,4,3,0.3333333333333333,0.6666666666666666,0.5714285714285714,0.42857142857142855
SF-N20-1,SF-N23,12,3,4,3,8,0,0.3333333333333333,0.6666666666666666,1.0,0.0
SF-N20-1,SF-N24-2,7,7,2,6,5,1,0.2857142857142857,0.7142857142857143,0.8571428571428571,0.14285714285714285
SF-N20-1,SF-K27-2,9,10,0,0,9,10,0.0,1.0,0.0,1.0
SF-N20-1,SF-J26-2,3,4,1,1,2,3,0.3333333333333333,0.6666666666666666,0.25,0.75
SF-N20-1,SF-L28,5,2,1,2,4,0,0.2,0.8,1.0,0.0
SF-N20-1,SF-K28,2,1,2,1,0,0,1.0,0.0,1.0,0.0
SF-N20-1,SF-K29-1,7,1,0,0,7,1,0.0,1.0,0.0,1.0
SF-N20-1,SF-J28-2,1,4,0,0,1,4,0.0,1.0,0.0,1.0
SF-N20-1,SF-K27,2,2,1,0,1,2,0.5,0.5,0.0,1.0
SF-N20-1,SF-K25,10,11,6,8,4,3,0.6,0.4,0.7272727272727273,0.2727272727272727
SF-N20-1,SF-J25,15,2,4,1,11,1,0.26666666666666666,0.7333333333333333,0.5,0.5
SF-N20-1,SF-P24,5,7,2,3,3,4,0.4,0.6,0.42857142857142855,0.5714285714285714
SF-N20-1,SF-N22-1A,4,1,1,1,3,0,0.25,0.75,1.0,0.0
SF-N20-1,SF-J24,2,9,0,0,2,9,0.0,1.0,0.0,1.0
SF-N20-1,SF-O24,3,2,2,1,1,1,0.6666666666666666,0.3333333333333333,0.5,0.5
SF-N20-1,SF-J26,5,4,2,3,3,1,0.4,0.6,0.75,0.25
SF-N20-1,SF-I26-,1,21,0,0,1,21,0.0,1.0,0.0,1.0
SF-N20-1,SF-I25,10,13,2,5,8,8,0.2,0.8,0.38461538461538464,0.6153846153846154
SF-N20-1,SF-K23,1,5,0,2,1,3,0.0,1.0,0.4,0.6
SF-N20-1,SF-H26,23,36,2,20,21,16,0.08695652173913043,0.9130434782608695,0.5555555555555556,0.4444444444444444
SF-N20-1,SF-O23,37,48,15,11,22,37,0.40540540540540543,0.5945945945945946,0.22916666666666666,0.7708333333333334
SF-N20-1,SF-H27-1,2,6,0,0,2,6,0.0,1.0,0.0,1.0
SF-N20-1,SF-F28-2,17,17,0,5,17,12,0.0,1.0,0.29411764705882354,0.7058823529411765
SF-N20-1,SF-G27,10,29,1,7,9,22,0.1,0.9,0.2413793103448276,0.7586206896551724
SF-N20-1,SF-M22-2,21,11,6,8,15,3,0.2857142857142857,0.7142857142857143,0.7272727272727273,0.2727272727272727
SF-N20-1,SF-L22,15,18,4,4,11,14,0.26666666666666666,0.7333333333333333,0.2222222222222222,0.7777777777777778
SF-N20-1,SF-F27,8,14,2,7,6,7,0.25,0.75,0.5,0.5
SF-N20-1,SF-N22-2,39,27,12,19,27,8,0.3076923076923077,0.6923076923076923,0.7037037037037037,0.2962962962962963
SF-N20-1,SF-G28-2,4,2,2,1,2,1,0.5,0.5,0.5,0.5
SF-N20-1,SF-M22-1,7,10,0,3,7,7,0.0,1.0,0.3,0.7
SF-N20-1,SF-O25-1,4,3,2,1,2,2,0.5,0.5,0.3333333333333333,0.6666666666666666
SF-N20-1,SF-K22-2,9,10,4,4,5,6,0.4444444444444444,0.5555555555555556,0.4,0.6
SF-N20-1,SF-K24,6,6,5,1,1,5,0.8333333333333334,0.16666666666666666,0.16666666666666666,0.8333333333333334
SF-N20-1,SF-J23-2,8,9,2,1,6,8,0.25,0.75,0.1111111111111111,0.8888888888888888
SF-N20-1,SF-G23,5,7,1,0,4,7,0.2,0.8,0.0,1.0
SF-N20-1,SF-G24,4,8,1,1,3,7,0.25,0.75,0.125,0.875
SF-N20-1,SF-G25,12,10,5,1,7,9,0.4166666666666667,0.5833333333333334,0.1,0.9
SF-N20-1,SF-F23,6,14,1,3,5,11,0.16666666666666666,0.8333333333333334,0.21428571428571427,0.7857142857142857
SF-N20-1,SF-E23,18,18,9,3,9,15,0.5,0.5,0.16666666666666666,0.8333333333333334
SF-N20-1,SF-D24,5,2,4,1,1,1,0.8,0.2,0.5,0.5
SF-N20-1,SF-C22,5,8,0,1,5,7,0.0,1.0,0.125,0.875
SF-N20-1,SF-B22,10,15,3,3,7,12,0.3,0.7,0.2,0.8
SF-N20-1,SF-J17,12,12,3,1,9,11,0.25,0.75,0.08333333333333333,0.9166666666666666
SF-N20-1,SF-I19,4,5,1,1,3,4,0.25,0.75,0.2,0.8
SF-N20-1,SF-H16,2,2,0,0,2,2,0.0,1.0,0.0,1.0
SF-N20-1,SF-H20,4,4,1,2,3,2,0.25,0.75,0.5,0.5
SF-N20-1,SF-H18,1,1,0,0,1,1,0.0,1.0,0.0,1.0
SF-N20-1,SF-G19,2,2,0,0,2,2,0.0,1.0,0.0,1.0
SF-N20-1,SF-G17,1,1,0,0,1,1,0.0,1.0,0.0,1.0
SF-N20-1,SF-G18,5,6,1,0,4,6,0.2,0.8,0.0,1.0
SF-N20-1,SF-G20,5,7,0,1,5,6,0.0,1.0,0.14285714285714285,0.8571428571428571
SF-N20-1,SF-E18,7,1,2,0,5,1,0.2857142857142857,0.7142857142857143,0.0,1.0
SF-N20-1,SF-E20,15,13,12,4,3,9,0.8,0.2,0.3076923076923077,0.6923076923076923
SF-N20-1,SF-G30-2,5,5,1,2,4,3,0.2,0.8,0.4,0.6
SF-N20-1,SF-F30-1,4,3,0,0,4,3,0.0,1.0,0.0,1.0
SF-N20-1,SF-E29-2,7,26,5,16,2,10,0.7142857142857143,0.2857142857142857,0.6153846153846154,0.38461538461538464
SF-N20-1,SF-E29-1,11,5,6,0,5,5,0.5454545454545454,0.45454545454545453,0.0,1.0
SF-N20-1,SF-D28,2,5,1,1,1,4,0.5,0.5,0.2,0.8
SF-N20-1,SF-G29-2,2,23,1,1,1,22,0.5,0.5,0.043478260869565216,0.9565217391304348
SF-N20-1,SF-G30-1,2,7,1,1,1,6,0.5,0.5,0.14285714285714285,0.8571428571428571
SF-N20-1,SF-G29-3,3,1,1,1,2,0,0.3333333333333333,0.6666666666666666,1.0,0.0
SF-N20-1,SF-E29-3,3,3,1,0,2,3,0.3333333333333333,0.6666666666666666,0.0,1.0
SF-N20-1,SF-F28-1,2,2,0,1,2,1,0.0,1.0,0.5,0.5
SF-N20-1,SF-E28-2,1,6,0,2,1,4,0.0,1.0,0.3333333333333333,0.6666666666666666
SF-N20-1,SF-J10,6,4,2,0,4,4,0.3333333333333333,0.6666666666666666,0.0,1.0
SF-N20-1,SF-J12,4,9,1,4,3,5,0.25,0.75,0.4444444444444444,0.5555555555555556
SF-N20-1,SF-H12,1,1,1,0,0,1,1.0,0.0,0.0,1.0
SF-N20-1,SF-G13,3,7,0,0,3,7,0.0,1.0,0.0,1.0
SF-N20-1,SF-G11,2,1,0,0,2,1,0.0,1.0,0.0,1.0
SF-N20-1,SF-G12,2,2,0,0,2,2,0.0,1.0,0.0,1.0
SF-N20-1,SF-F15,3,2,0,0,3,2,0.0,1.0,0.0,1.0
SF-N20-1,SF-F16,1,3,0,0,1,3,0.0,1.0,0.0,1.0
SF-N20-1,SF-B21,1,1,0,0,1,1,0.0,1.0,0.0,1.0
SF-N20-1,SF-B19,4,5,0,0,4,5,0.0,1.0,0.0,1.0
SF-N20-1,SF-C26,11,2,1,0,10,2,0.09090909090909091,0.9090909090909091,0.0,1.0
SF-N20-1,SF-C25,3,10,0,2,3,8,0.0,1.0,0.2,0.8
SF-N20-1,SF-B25,15,24,2,1,13,23,0.13333333333333333,0.8666666666666667,0.041666666666666664,0.9583333333333334
SF-N20-1,SF-B28,2,2,0,0,2,2,0.0,1.0,0.0,1.0
SF-N20-1,SF-J1,2,12,0,1,2,11,0.0,1.0,0.08333333333333333,0.9166666666666666
SF-N20-1,SF-G6,1,1,0,0,1,1,0.0,1.0,0.0,1.0
SF-N20-1,SF-G8,20,1,19,1,1,0,0.95,0.05,1.0,0.0
SF-N20-1,SF-G7,1,1,0,0,1,1,0.0,1.0,0.0,1.0
SF-N20-1,SF-G26,8,6,4,1,4,5,0.5,0.5,0.16666666666666666,0.8333333333333334
SF-N20-1,SF-K21,6,7,2,0,4,7,0.3333333333333333,0.6666666666666666,0.0,1.0
SF-N20-1,SF-K22-1,17,7,11,1,6,6,0.6470588235294118,0.35294117647058826,0.14285714285714285,0.8571428571428571
SF-N20-1,SF-J23-1,46,44,13,13,33,31,0.2826086956521739,0.717391304347826,0.29545454545454547,0.7045454545454546
SF-N20-1,SF-J22-1,4,13,1,4,3,9,0.25,0.75,0.3076923076923077,0.6923076923076923
SF-N20-1,SF-J22-2,7,5,4,2,3,3,0.5714285714285714,0.42857142857142855,0.4,0.6
SF-N20-1,SF-J21,10,16,4,4,6,12,0.4,0.6,0.25,0.75
SF-N20-1,SF-I22,4,3,2,1,2,2,0.5,0.5,0.3333333333333333,0.6666666666666666
SF-N20-1,SF-I23-2,5,6,0,1,5,5,0.0,1.0,0.16666666666666666,0.8333333333333334
SF-N20-1,SF-I24,6,3,2,3,4,0,0.3333333333333333,0.6666666666666666,1.0,0.0
SF-N20-1,SF-I23-1,8,19,5,7,3,12,0.625,0.375,0.3684210526315789,0.631578947368421
SF-N20-1,SF-F26,8,17,3,3,5,14,0.375,0.625,0.17647058823529413,0.8235294117647058
SF-N20-1,SF-M13,28,21,1,1,27,20,0.03571428571428571,0.9642857142857143,0.047619047619047616,0.9523809523809523
SF-N20-1,SF-M15,28,17,9,2,19,15,0.32142857142857145,0.6785714285714286,0.11764705882352941,0.8823529411764706
SF-N20-1,SF-L19,19,21,13,6,6,15,0.6842105263157895,0.3157894736842105,0.2857142857142857,0.7142857142857143
SF-N20-1,SF-L20,3,4,1,3,2,1,0.3333333333333333,0.6666666666666666,0.75,0.25
SF-N20-1,SF-M20,17,23,9,11,8,12,0.5294117647058824,0.47058823529411764,0.4782608695652174,0.5217391304347826
SF-N20-1,SF-K17-2,23,13,9,0,14,13,0.391304347826087,0.6086956521739131,0.0,1.0
SF-N20-1,SF-K20,8,15,4,7,4,8,0.5,0.5,0.4666666666666667,0.5333333333333333
SF-N20-1,SF-K15-,13,18,5,4,8,14,0.38461538461538464,0.6153846153846154,0.2222222222222222,0.7777777777777778
SF-N20-1,SF-K19,12,11,4,2,8,9,0.3333333333333333,0.6666666666666666,0.18181818181818182,0.8181818181818182
SF-N20-1,SF-K18,18,8,12,2,6,6,0.6666666666666666,0.3333333333333333,0.25,0.75
SF-N20-1,SF-K17,18,8,4,2,14,6,0.2222222222222222,0.7777777777777778,0.25,0.75
SF-N20-1,SF-J16,10,6,1,1,9,5,0.1,0.9,0.16666666666666666,0.8333333333333334
SF-N20-1,SF-J18,13,14,4,0,9,14,0.3076923076923077,0.6923076923076923,0.0,1.0
SF-N20-1,SF-J20,1,3,0,0,1,3,0.0,1.0,0.0,1.0
SF-N20-1,SF-J19,15,11,0,0,15,11,0.0,1.0,0.0,1.0
SF-N20-1,SF-M12,6,3,2,0,4,3,0.3333333333333333,0.6666666666666666,0.0,1.0
SF-N20-1,SF-M10,4,8,1,0,3,8,0.25,0.75,0.0,1.0
SF-N20-1,SF-M11,12,14,1,3,11,11,0.08333333333333333,0.9166666666666666,0.21428571428571427,0.7857142857142857
SF-N20-1,SF-R19,3,5,1,0,2,5,0.3333333333333333,0.6666666666666666,0.0,1.0
SF-N20-1,SF-R20,20,19,1,2,19,17,0.05,0.95,0.10526315789473684,0.8947368421052632
SF-N20-1,SF-Q21-2,11,12,2,0,9,12,0.18181818181818182,0.8181818181818182,0.0,1.0
SF-N20-1,SF-Q21-1,8,2,1,1,7,1,0.125,0.875,0.5,0.5
SF-N20-1,SF-P21,19,7,8,0,11,7,0.42105263157894735,0.5789473684210527,0.0,1.0
SF-N20-1,SF-O18,21,18,8,6,13,12,0.38095238095238093,0.6190476190476191,0.3333333333333333,0.6666666666666666
SF-N20-1,SF-O19,12,17,5,12,7,5,0.4166666666666667,0.5833333333333334,0.7058823529411765,0.29411764705882354
SF-N20-1,SF-O21,22,32,7,19,15,13,0.3181818181818182,0.6818181818181818,0.59375,0.40625
SF-N20-1,SF-O22,44,51,11,20,33,31,0.25,0.75,0.39215686274509803,0.6078431372549019
SF-N20-1,SF-N21,19,16,8,11,11,5,0.42105263157894735,0.5789473684210527,0.6875,0.3125
SF-N20-1,SF-N20-2,9,16,4,10,5,6,0.4444444444444444,0.5555555555555556,0.625,0.375
SF-N20-1,SF-M21,18,15,7,8,11,7,0.3888888888888889,0.6111111111111112,0.5333333333333333,0.4666666666666667
SF-N20-1,SF-L21,79,67,15,30,64,37,0.189873417721519,0.810126582278481,0.44776119402985076,0.5522388059701493
SF-N20-1,SF-Q30,3,1,0,1,3,0,0.0,1.0,1.0,0.0
SF-N20-1,SF-P30,4,1,3,1,1,0,0.75,0.25,1.0,0.0
SF-N20-1,SF-O30,7,4,1,1,6,3,0.14285714285714285,0.8571428571428571,0.25,0.75
SF-N20-1,SF-N27,9,7,4,1,5,6,0.4444444444444444,0.5555555555555556,0.14285714285714285,0.8571428571428571
SF-N20-1,SF-N29,1,3,0,2,1,1,0.0,1.0,0.6666666666666666,0.3333333333333333
SF-N20-1,SF-N28,7,5,3,1,4,4,0.42857142857142855,0.5714285714285714,0.2,0.8
SF-N20-1,SF-L30-1,10,18,1,0,9,18,0.1,0.9,0.0,1.0
SF-N20-1,SF-K30-2,4,2,0,2,4,0,0.0,1.0,1.0,0.0
SF-N20-1,SF-L29,20,6,2,1,18,5,0.1,0.9,0.16666666666666666,0.8333333333333334
SF-N20-1,SF-J29-1,4,2,0,1,4,1,0.0,1.0,0.5,0.5
SF-N20-1,SF-I27,2,8,1,2,1,6,0.5,0.5,0.25,0.75
SF-N20-1,SF-I28,2,4,2,2,0,2,1.0,0.0,0.5,0.5
SF-N20-1,SF-I30-2,3,2,0,1,3,1,0.0,1.0,0.5,0.5
SF-N20-1,SF-H28,2,3,1,1,1,2,0.5,0.5,0.3333333333333333,0.6666666666666666
SF-N20-1,SF-S24,27,19,5,3,22,16,0.18518518518518517,0.8148148148148148,0.15789473684210525,0.8421052631578947
SF-N20-1,SF-R24,14,19,6,5,8,14,0.42857142857142855,0.5714285714285714,0.2631578947368421,0.7368421052631579
SF-N20-1,SF-R26,8,2,0,0,8,2,0.0,1.0,0.0,1.0
SF-N20-1,SF-Q26,4,5,0,3,4,2,0.0,1.0,0.6,0.4
SF-N20-1,SF-P26,10,7,0,1,10,6,0.0,1.0,0.14285714285714285,0.8571428571428571
SF-N20-1,SF-O25-2,3,4,0,0,3,4,0.0,1.0,0.0,1.0
SF-N20-1,SF-N22-1B,33,52,19,41,14,11,0.5757575757575758,0.42424242424242425,0.7884615384615384,0.21153846153846154
SF-N20-1,SF-N26,3,4,1,0,2,4,0.3333333333333333,0.6666666666666666,0.0,1.0
SF-N20-1,SF-N25,6,5,1,3,5,2,0.16666666666666666,0.8333333333333334,0.6,0.4
SF-N20-1,SF-T21,9,1,4,0,5,1,0.4444444444444444,0.5555555555555556,0.0,1.0
SF-N20-1,SF-T22,9,10,4,6,5,4,0.4444444444444444,0.5555555555555556,0.6,0.4
SF-N20-1,SF-S22-1,21,33,1,7,20,26,0.047619047619047616,0.9523809523809523,0.21212121212121213,0.7878787878787878
SF-N20-1,SF-Q23-3,12,9,5,3,7,6,0.4166666666666667,0.5833333333333334,0.3333333333333333,0.6666666666666666
SF-N20-1,SF-Q22-1,100,71,8,46,92,25,0.08,0.92,0.647887323943662,0.352112676056338
SF-N20-1,SF-Q22-2,24,16,0,2,24,14,0.0,1.0,0.125,0.875
SF-N20-1,SF-P22,42,27,11,7,31,20,0.2619047619047619,0.7380952380952381,0.25925925925925924,0.7407407407407407
SF-N20-1,SF-W19,11,13,0,0,11,13,0.0,1.0,0.0,1.0
SF-N20-1,SF-U21,5,2,0,0,5,2,0.0,1.0,0.0,1.0
SF-N20-1,SF-T20,9,11,1,0,8,11,0.1111111111111111,0.8888888888888888,0.0,1.0
SF-N20-1,SF-S21,10,13,0,0,10,13,0.0,1.0,0.0,1.0
SF-M20,SF-M25,30,17,4,4,26,13,0.13333333333333333,0.8666666666666667,0.23529411764705882,0.7647058823529411
SF-M20,SF-M26-2,2,10,0,2,2,8,0.0,1.0,0.2,0.8
SF-M20,SF-K26,11,22,4,8,7,14,0.36363636363636365,0.6363636363636364,0.36363636363636365,0.6363636363636364
SF-M20,SF-J27,2,4,1,4,1,0,0.5,0.5,1.0,0.0
SF-M20,SF-M30,163,150,108,124,55,26,0.6625766871165644,0.3374233128834356,0.8266666666666667,0.17333333333333334
SF-M20,SF-L27-2,2,3,0,1,2,2,0.0,1.0,0.3333333333333333,0.6666666666666666
SF-M20,SF-J29-3,4,5,1,0,3,5,0.25,0.75,0.0,1.0
SF-M20,SF-J29,11,15,4,4,7,11,0.36363636363636365,0.6363636363636364,0.26666666666666666,0.7333333333333333
SF-M20,SF-L26,160,218,35,58,125,160,0.21875,0.78125,0.26605504587155965,0.7339449541284404
SF-M20,SF-M28,39,7,2,2,37,5,0.05128205128205128,0.9487179487179487,0.2857142857142857,0.7142857142857143
SF-M20,SF-M27,3,2,0,0,3,2,0.0,1.0,0.0,1.0
SF-M20,SF-L25,16,14,1,5,15,9,0.0625,0.9375,0.35714285714285715,0.6428571428571429
SF-M20,SF-M24,18,21,4,15,14,6,0.2222222222222222,0.7777777777777778,0.7142857142857143,0.2857142857142857
SF-M20,SF-L24,17,18,6,12,11,6,0.35294117647058826,0.6470588235294118,0.6666666666666666,0.3333333333333333
SF-M20,SF-N23,13,16,4,5,9,11,0.3076923076923077,0.6923076923076923,0.3125,0.6875
SF-M20,SF-N24-2,7,11,3,2,4,9,0.42857142857142855,0.5714285714285714,0.18181818181818182,0.8181818181818182
SF-M20,SF-K27-2,9,16,2,6,7,10,0.2222222222222222,0.7777777777777778,0.375,0.625
SF-M20,SF-J26-2,15,15,3,5,12,10,0.2,0.8,0.3333333333333333,0.6666666666666666
SF-M20,SF-L28,11,14,3,4,8,10,0.2727272727272727,0.7272727272727273,0.2857142857142857,0.7142857142857143
SF-M20,SF-K29-1,8,3,4,1,4,2,0.5,0.5,0.3333333333333333,0.6666666666666666
SF-M20,SF-J28-2,6,6,3,0,3,6,0.5,0.5,0.0,1.0
SF-M20,SF-K27,5,3,3,2,2,1,0.6,0.4,0.6666666666666666,0.3333333333333333
SF-M20,SF-K25,14,39,0,19,14,20,0.0,1.0,0.48717948717948717,0.5128205128205128
SF-M20,SF-J25,25,11,2,2,23,9,0.08,0.92,0.18181818181818182,0.8181818181818182
SF-M20,SF-H26-2,15,6,0,3,15,3,0.0,1.0,0.5,0.5
SF-M20,SF-P24,21,27,12,13,9,14,0.5714285714285714,0.42857142857142855,0.48148148148148145,0.5185185185185185
SF-M20,SF-N22-1A,2,2,1,0,1,2,0.5,0.5,0.0,1.0
SF-M20,SF-J24,9,22,2,10,7,12,0.2222222222222222,0.7777777777777778,0.45454545454545453,0.5454545454545454
SF-M20,SF-O24,5,15,2,8,3,7,0.4,0.6,0.5333333333333333,0.4666666666666667
SF-M20,SF-J26,6,10,1,2,5,8,0.16666666666666666,0.8333333333333334,0.2,0.8
SF-M20,SF-I26-,11,4,3,3,8,1,0.2727272727272727,0.7272727272727273,0.75,0.25
SF-M20,SF-I25,46,52,11,25,35,27,0.2391304347826087,0.7608695652173914,0.4807692307692308,0.5192307692307693
SF-M20,SF-K23,12,3,1,3,11,0,0.08333333333333333,0.9166666666666666,1.0,0.0
SF-M20,SF-H26,105,122,39,59,66,63,0.37142857142857144,0.6285714285714286,0.48360655737704916,0.5163934426229508
SF-M20,SF-O23,22,29,5,16,17,13,0.22727272727272727,0.7727272727272727,0.5517241379310345,0.4482758620689655
SF-M20,SF-H27-1,10,4,0,2,10,2,0.0,1.0,0.5,0.5
SF-M20,SF-F28-2,39,38,4,15,35,23,0.10256410256410256,0.8974358974358975,0.39473684210526316,0.6052631578947368
SF-M20,SF-G27,91,67,15,20,76,47,0.16483516483516483,0.8351648351648352,0.29850746268656714,0.7014925373134329
SF-M20,SF-M22-2,31,14,10,6,21,8,0.3225806451612903,0.6774193548387096,0.42857142857142855,0.5714285714285714
SF-M20,SF-L22,15,26,4,14,11,12,0.26666666666666666,0.7333333333333333,0.5384615384615384,0.46153846153846156
SF-M20,SF-F27,19,45,5,25,14,20,0.2631578947368421,0.7368421052631579,0.5555555555555556,0.4444444444444444
SF-M20,SF-N22-2,52,53,23,25,29,28,0.4423076923076923,0.5576923076923077,0.4716981132075472,0.5283018867924528
SF-M20,SF-G28-2,7,4,1,0,6,4,0.14285714285714285,0.8571428571428571,0.0,1.0
SF-M20,SF-G28-1,3,7,0,1,3,6,0.0,1.0,0.14285714285714285,0.8571428571428571
SF-M20,SF-M22-1,9,41,3,25,6,16,0.3333333333333333,0.6666666666666666,0.6097560975609756,0.3902439024390244
SF-M20,SF-O25-1,4,7,1,4,3,3,0.25,0.75,0.5714285714285714,0.42857142857142855
SF-M20,SF-K22-2,21,23,9,18,12,5,0.42857142857142855,0.5714285714285714,0.782608695652174,0.21739130434782608
SF-M20,SF-K24,25,31,11,17,14,14,0.44,0.56,0.5483870967741935,0.45161290322580644
SF-M20,SF-J23-2,46,41,15,20,31,21,0.32608695652173914,0.6739130434782609,0.4878048780487805,0.5121951219512195
SF-M20,SF-G23,16,19,2,1,14,18,0.125,0.875,0.05263157894736842,0.9473684210526315
SF-M20,SF-G24,26,48,4,3,22,45,0.15384615384615385,0.8461538461538461,0.0625,0.9375
SF-M20,SF-G25,34,45,13,7,21,38,0.38235294117647056,0.6176470588235294,0.15555555555555556,0.8444444444444444
SF-M20,SF-F23,20,15,7,1,13,14,0.35,0.65,0.06666666666666667,0.9333333333333333
SF-M20,SF-E23,26,26,5,3,21,23,0.19230769230769232,0.8076923076923077,0.11538461538461539,0.8846153846153846
SF-M20,SF-D24,11,6,0,0,11,6,0.0,1.0,0.0,1.0
SF-M20,SF-C22,6,6,1,0,5,6,0.16666666666666666,0.8333333333333334,0.0,1.0
SF-M20,SF-B22,3,5,1,0,2,5,0.3333333333333333,0.6666666666666666,0.0,1.0
SF-M20,SF-J17,43,49,10,1,33,48,0.23255813953488372,0.7674418604651163,0.02040816326530612,0.9795918367346939
SF-M20,SF-I19,20,28,1,1,19,27,0.05,0.95,0.03571428571428571,0.9642857142857143
SF-M20,SF-I20,13,12,7,3,6,9,0.5384615384615384,0.46153846153846156,0.25,0.75
SF-M20,SF-H16,22,5,4,0,18,5,0.18181818181818182,0.8181818181818182,0.0,1.0
SF-M20,SF-H19,2,3,0,1,2,2,0.0,1.0,0.3333333333333333,0.6666666666666666
SF-M20,SF-H20,26,27,5,2,21,25,0.19230769230769232,0.8076923076923077,0.07407407407407407,0.9259259259259259
SF-M20,SF-H18,4,6,1,1,3,5,0.25,0.75,0.16666666666666666,0.8333333333333334
SF-M20,SF-H17,5,2,0,0,5,2,0.0,1.0,0.0,1.0
SF-M20,SF-G19,131,153,119,144,12,9,0.9083969465648855,0.0916030534351145,0.9411764705882353,0.058823529411764705
SF-M20,SF-G17,7,3,0,0,7,3,0.0,1.0,0.0,1.0
SF-M20,SF-G18,30,28,5,2,25,26,0.16666666666666666,0.8333333333333334,0.07142857142857142,0.9285714285714286
SF-M20,SF-G20,14,16,7,1,7,15,0.5,0.5,0.0625,0.9375
SF-M20,SF-F19,13,12,3,1,10,11,0.23076923076923078,0.7692307692307693,0.08333333333333333,0.9166666666666666
SF-M20,SF-E18,21,14,6,1,15,13,0.2857142857142857,0.7142857142857143,0.07142857142857142,0.9285714285714286
SF-M20,SF-E20,16,19,2,2,14,17,0.125,0.875,0.10526315789473684,0.8947368421052632
SF-M20,SF-H30,1,2,0,0,1,2,0.0,1.0,0.0,1.0
SF-M20,SF-G30-2,14,19,2,2,12,17,0.14285714285714285,0.8571428571428571,0.10526315789473684,0.8947368421052632
SF-M20,SF-F30-1,6,6,1,1,5,5,0.16666666666666666,0.8333333333333334,0.16666666666666666,0.8333333333333334
SF-M20,SF-E29-2,40,62,2,22,38,40,0.05,0.95,0.3548387096774194,0.6451612903225806
SF-M20,SF-E29-1,23,29,5,9,18,20,0.21739130434782608,0.782608695652174,0.3103448275862069,0.6896551724137931
SF-M20,SF-D29,6,4,3,1,3,3,0.5,0.5,0.25,0.75
SF-M20,SF-D28,10,13,0,6,10,7,0.0,1.0,0.46153846153846156,0.5384615384615384
SF-M20,SF-A27,6,10,1,6,5,4,0.16666666666666666,0.8333333333333334,0.6,0.4
SF-M20,SF-G29-2,42,16,0,4,42,12,0.0,1.0,0.25,0.75
SF-M20,SF-G29-1,28,11,4,2,24,9,0.14285714285714285,0.8571428571428571,0.18181818181818182,0.8181818181818182
SF-M20,SF-G30-1,2,8,0,0,2,8,0.0,1.0,0.0,1.0
SF-M20,SF-G29-3,27,11,3,5,24,6,0.1111111111111111,0.8888888888888888,0.45454545454545453,0.5454545454545454
SF-M20,SF-F30-2,3,6,2,1,1,5,0.6666666666666666,0.3333333333333333,0.16666666666666666,0.8333333333333334
SF-M20,SF-F29,4,9,0,3,4,6,0.0,1.0,0.3333333333333333,0.6666666666666666
SF-M20,SF-E29-3,31,72,3,9,28,63,0.0967741935483871,0.9032258064516129,0.125,0.875
SF-M20,SF-F28-1,19,17,4,6,15,11,0.21052631578947367,0.7894736842105263,0.35294117647058826,0.6470588235294118
SF-M20,SF-E28-2,17,6,0,1,17,5,0.0,1.0,0.16666666666666666,0.8333333333333334
SF-M20,SF-E28,7,5,0,1,7,4,0.0,1.0,0.2,0.8
SF-M20,SF-J10,20,20,3,3,17,17,0.15,0.85,0.15,0.85
SF-M20,SF-J12,33,29,8,4,25,25,0.24242424242424243,0.7575757575757576,0.13793103448275862,0.8620689655172413
SF-M20,SF-J13,17,9,4,2,13,7,0.23529411764705882,0.7647058823529411,0.2222222222222222,0.7777777777777778
SF-M20,SF-J15,4,2,3,0,1,2,0.75,0.25,0.0,1.0
SF-M20,SF-H13,6,6,1,1,5,5,0.16666666666666666,0.8333333333333334,0.16666666666666666,0.8333333333333334
SF-M20,SF-I16,5,2,3,0,2,2,0.6,0.4,0.0,1.0
SF-M20,SF-H12,4,9,1,1,3,8,0.25,0.75,0.1111111111111111,0.8888888888888888
SF-M20,SF-G10-2,6,8,4,1,2,7,0.6666666666666666,0.3333333333333333,0.125,0.875
SF-M20,SF-H15,6,6,3,1,3,5,0.5,0.5,0.16666666666666666,0.8333333333333334
SF-M20,SF-G9,6,4,1,2,5,2,0.16666666666666666,0.8333333333333334,0.5,0.5
SF-M20,SF-H14,1,3,1,0,0,3,1.0,0.0,0.0,1.0
SF-M20,SF-G13,20,28,4,6,16,22,0.2,0.8,0.21428571428571427,0.7857142857142857
SF-M20,SF-G11,9,9,1,1,8,8,0.1111111111111111,0.8888888888888888,0.1111111111111111,0.8888888888888888
SF-M20,SF-G12,13,5,3,0,10,5,0.23076923076923078,0.7692307692307693,0.0,1.0
SF-M20,SF-G10-1,5,6,0,0,5,6,0.0,1.0,0.0,1.0
SF-M20,SF-F15,6,3,0,0,6,3,0.0,1.0,0.0,1.0
SF-M20,SF-F16,4,8,2,5,2,3,0.5,0.5,0.625,0.375
SF-M20,SF-C21,1,6,0,0,1,6,0.0,1.0,0.0,1.0
SF-M20,SF-C20,1,4,0,1,1,3,0.0,1.0,0.25,0.75
SF-M20,SF-B19,3,5,1,0,2,5,0.3333333333333333,0.6666666666666666,0.0,1.0
SF-M20,SF-A20,4,3,0,0,4,3,0.0,1.0,0.0,1.0
SF-M20,SF-A19,3,4,0,0,3,4,0.0,1.0,0.0,1.0
SF-M20,SF-C26,22,30,6,10,16,20,0.2727272727272727,0.7272727272727273,0.3333333333333333,0.6666666666666666
SF-M20,SF-C25,16,10,3,3,13,7,0.1875,0.8125,0.3,0.7
SF-M20,SF-B25,5,7,0,1,5,6,0.0,1.0,0.14285714285714285,0.8571428571428571
SF-M20,SF-E27,13,9,3,1,10,8,0.23076923076923078,0.7692307692307693,0.1111111111111111,0.8888888888888888
SF-M20,SF-B28-2,4,5,0,1,4,4,0.0,1.0,0.2,0.8
SF-M20,SF-D27,8,18,0,7,8,11,0.0,1.0,0.3888888888888889,0.6111111111111112
SF-M20,SF-C28-2,3,8,1,1,2,7,0.3333333333333333,0.6666666666666666,0.125,0.875
SF-M20,SF-C28-1,3,3,1,1,2,2,0.3333333333333333,0.6666666666666666,0.3333333333333333,0.6666666666666666
SF-M20,SF-B28,3,5,1,3,2,2,0.3333333333333333,0.6666666666666666,0.6,0.4
SF-M20,SF-J1,20,39,5,19,15,20,0.25,0.75,0.48717948717948717,0.5128205128205128
SF-M20,SF-H0,7,8,1,4,6,4,0.14285714285714285,0.8571428571428571,0.5,0.5
SF-M20,SF-J3,8,9,6,7,2,2,0.75,0.25,0.7777777777777778,0.2222222222222222
SF-M20,SF-J5,3,4,1,2,2,2,0.3333333333333333,0.6666666666666666,0.5,0.5
SF-M20,SF-G8,46,55,44,47,2,8,0.9565217391304348,0.043478260869565216,0.8545454545454545,0.14545454545454545
SF-M20,SF-G5,2,6,0,4,2,2,0.0,1.0,0.6666666666666666,0.3333333333333333
SF-M20,SF-G7,7,4,4,3,3,1,0.5714285714285714,0.42857142857142855,0.75,0.25
SF-M20,SF-F9,3,4,0,2,3,2,0.0,1.0,0.5,0.5
SF-M20,SF-H25,4,6,0,1,4,5,0.0,1.0,0.16666666666666666,0.8333333333333334
SF-M20,SF-G26,24,29,5,10,19,19,0.20833333333333334,0.7916666666666666,0.3448275862068966,0.6551724137931034
SF-M20,SF-K21,52,34,36,10,16,24,0.6923076923076923,0.3076923076923077,0.29411764705882354,0.7058823529411765
SF-M20,SF-K22-1,99,28,30,13,69,15,0.30303030303030304,0.696969696969697,0.4642857142857143,0.5357142857142857
SF-M20,SF-J23-1,196,169,50,49,146,120,0.25510204081632654,0.7448979591836735,0.28994082840236685,0.7100591715976331
SF-M20,SF-J22-1,34,25,9,6,25,19,0.2647058823529412,0.7352941176470589,0.24,0.76
SF-M20,SF-J22-2,28,19,4,6,24,13,0.14285714285714285,0.8571428571428571,0.3157894736842105,0.6842105263157895
SF-M20,SF-J21,47,42,8,6,39,36,0.1702127659574468,0.8297872340425532,0.14285714285714285,0.8571428571428571
SF-M20,SF-I21,8,6,2,1,6,5,0.25,0.75,0.16666666666666666,0.8333333333333334
SF-M20,SF-I22,17,12,4,2,13,10,0.23529411764705882,0.7647058823529411,0.16666666666666666,0.8333333333333334
SF-M20,SF-I23-2,18,19,5,5,13,14,0.2777777777777778,0.7222222222222222,0.2631578947368421,0.7368421052631579
SF-M20,SF-I24,17,10,3,5,14,5,0.17647058823529413,0.8235294117647058,0.5,0.5
SF-M20,SF-I23-1,54,18,3,3,51,15,0.05555555555555555,0.9444444444444444,0.16666666666666666,0.8333333333333334
SF-M20,SF-F26,45,54,7,5,38,49,0.15555555555555556,0.8444444444444444,0.09259259259259259,0.9074074074074074
SF-M20,SF-M13,79,65,29,10,50,55,0.3670886075949367,0.6329113924050633,0.15384615384615385,0.8461538461538461
SF-M20,SF-M15,59,54,29,7,30,47,0.4915254237288136,0.5084745762711864,0.12962962962962962,0.8703703703703703
SF-M20,SF-L19,56,46,34,12,22,34,0.6071428571428571,0.39285714285714285,0.2608695652173913,0.7391304347826086
SF-M20,SF-L20,23,34,13,23,10,11,0.5652173913043478,0.43478260869565216,0.6764705882352942,0.3235294117647059
SF-M20,SF-N20-1,23,17,11,9,12,8,0.4782608695652174,0.5217391304347826,0.5294117647058824,0.47058823529411764
SF-M20,SF-K17-2,47,22,19,2,28,20,0.40425531914893614,0.5957446808510638,0.09090909090909091,0.9090909090909091
SF-M20,SF-K20,114,90,57,44,57,46,0.5,0.5,0.4888888888888889,0.5111111111111111
SF-M20,SF-K15-,101,87,41,27,60,60,0.40594059405940597,0.594059405940594,0.3103448275862069,0.6896551724137931
SF-M20,SF-K19,111,104,71,39,40,65,0.6396396396396397,0.36036036036036034,0.375,0.625
SF-M20,SF-K18,94,46,48,6,46,40,0.5106382978723404,0.48936170212765956,0.13043478260869565,0.8695652173913043
SF-M20,SF-K17,58,64,18,16,40,48,0.3103448275862069,0.6896551724137931,0.25,0.75
SF-M20,SF-J16,26,14,8,1,18,13,0.3076923076923077,0.6923076923076923,0.07142857142857142,0.9285714285714286
SF-M20,SF-J18,75,67,20,8,55,59,0.26666666666666666,0.7333333333333333,0.11940298507462686,0.8805970149253731
SF-M20,SF-J20,4,9,0,3,4,6,0.0,1.0,0.3333333333333333,0.6666666666666666
SF-M20,SF-J19,33,29,8,9,25,20,0.24242424242424243,0.7575757575757576,0.3103448275862069,0.6896551724137931
SF-M20,SF-M12,23,23,5,2,18,21,0.21739130434782608,0.782608695652174,0.08695652173913043,0.9130434782608695
SF-M20,SF-M10,7,12,1,2,6,10,0.14285714285714285,0.8571428571428571,0.16666666666666666,0.8333333333333334
SF-M20,SF-M11,30,18,4,4,26,14,0.13333333333333333,0.8666666666666667,0.2222222222222222,0.7777777777777778
SF-M20,SF-R19,19,24,1,0,18,24,0.05263157894736842,0.9473684210526315,0.0,1.0
SF-M20,SF-R20,9,4,1,1,8,3,0.1111111111111111,0.8888888888888888,0.25,0.75
SF-M20,SF-Q21-2,14,9,2,1,12,8,0.14285714285714285,0.8571428571428571,0.1111111111111111,0.8888888888888888
SF-M20,SF-Q21-1,12,7,7,2,5,5,0.5833333333333334,0.4166666666666667,0.2857142857142857,0.7142857142857143
SF-M20,SF-P21,24,36,5,14,19,22,0.20833333333333334,0.7916666666666666,0.3888888888888889,0.6111111111111112
SF-M20,SF-O18,29,57,14,14,15,43,0.4827586206896552,0.5172413793103449,0.24561403508771928,0.7543859649122807
SF-M20,SF-O19,29,35,12,19,17,16,0.41379310344827586,0.5862068965517241,0.5428571428571428,0.45714285714285713
SF-M20,SF-O21,57,65,19,35,38,30,0.3333333333333333,0.6666666666666666,0.5384615384615384,0.46153846153846156
SF-M20,SF-O22,44,83,7,37,37,46,0.1590909090909091,0.8409090909090909,0.4457831325301205,0.5542168674698795
SF-M20,SF-N21,45,64,13,31,32,33,0.28888888888888886,0.7111111111111111,0.484375,0.515625
SF-M20,SF-N20-2,25,10,15,7,10,3,0.6,0.4,0.7,0.3
SF-M20,SF-M21,24,13,10,6,14,7,0.4166666666666667,0.5833333333333334,0.46153846153846156,0.5384615384615384
SF-M20,SF-L21,103,69,39,34,64,35,0.3786407766990291,0.6213592233009708,0.4927536231884058,0.5072463768115942
SF-M20,SF-Q30,5,3,0,2,5,1,0.0,1.0,0.6666666666666666,0.3333333333333333
SF-M20,SF-P30,7,8,0,1,7,7,0.0,1.0,0.125,0.875
SF-M20,SF-O30-2,2,5,1,1,1,4,0.5,0.5,0.2,0.8
SF-M20,SF-O30,22,16,5,3,17,13,0.22727272727272727,0.7727272727272727,0.1875,0.8125
SF-M20,SF-N27,12,14,4,11,8,3,0.3333333333333333,0.6666666666666666,0.7857142857142857,0.21428571428571427
SF-M20,SF-N29,14,3,1,1,13,2,0.07142857142857142,0.9285714285714286,0.3333333333333333,0.6666666666666666
SF-M20,SF-N28,20,7,1,2,19,5,0.05,0.95,0.2857142857142857,0.7142857142857143
SF-M20,SF-L30-1,18,152,2,122,16,30,0.1111111111111111,0.8888888888888888,0.8026315789473685,0.19736842105263158
SF-M20,SF-K30-2,2,19,1,16,1,3,0.5,0.5,0.8421052631578947,0.15789473684210525
SF-M20,SF-L29,11,14,1,1,10,13,0.09090909090909091,0.9090909090909091,0.07142857142857142,0.9285714285714286
SF-M20,SF-J29-1,2,8,0,2,2,6,0.0,1.0,0.25,0.75
SF-M20,SF-I30,2,1,1,0,1,1,0.5,0.5,0.0,1.0
SF-M20,SF-I29-2,1,1,0,0,1,1,0.0,1.0,0.0,1.0
SF-M20,SF-I27,8,12,3,4,5,8,0.375,0.625,0.3333333333333333,0.6666666666666666
SF-M20,SF-I28,2,4,0,3,2,1,0.0,1.0,0.75,0.25
SF-M20,SF-I30-2,4,4,2,0,2,4,0.5,0.5,0.0,1.0
SF-M20,SF I29-1,3,6,0,1,3,5,0.0,1.0,0.16666666666666666,0.8333333333333334
SF-M20,SF-H28,8,23,2,13,6,10,0.25,0.75,0.5652173913043478,0.43478260869565216
SF-M20,SF-S24,20,24,3,4,17,20,0.15,0.85,0.16666666666666666,0.8333333333333334
SF-M20,SF-R24,48,36,5,11,43,25,0.10416666666666667,0.8958333333333334,0.3055555555555556,0.6944444444444444
SF-M20,SF-Q26,4,1,1,1,3,0,0.25,0.75,1.0,0.0
SF-M20,SF-P26,14,22,1,1,13,21,0.07142857142857142,0.9285714285714286,0.045454545454545456,0.9545454545454546
SF-M20,SF-O25-2,7,17,1,8,6,9,0.14285714285714285,0.8571428571428571,0.47058823529411764,0.5294117647058824
SF-M20,SF-N22-1B,14,36,5,17,9,19,0.35714285714285715,0.6428571428571429,0.4722222222222222,0.5277777777777778
SF-M20,SF-N26,8,6,3,1,5,5,0.375,0.625,0.16666666666666666,0.8333333333333334
SF-M20,SF-N25,13,14,3,4,10,10,0.23076923076923078,0.7692307692307693,0.2857142857142857,0.7142857142857143
SF-M20,SF-T21,4,10,1,2,3,8,0.25,0.75,0.2,0.8
SF-M20,SF-T22,11,20,0,4,11,16,0.0,1.0,0.2,0.8
SF-M20,SF-S22-2,13,11,0,0,13,11,0.0,1.0,0.0,1.0
SF-M20,SF-S22-1,13,26,5,6,8,20,0.38461538461538464,0.6153846153846154,0.23076923076923078,0.7692307692307693
SF-M20,SF-Q23-3,20,23,4,6,16,17,0.2,0.8,0.2608695652173913,0.7391304347826086
SF-M20,SF-Q22-1,36,48,12,16,24,32,0.3333333333333333,0.6666666666666666,0.3333333333333333,0.6666666666666666
SF-M20,SF-Q22-2,28,25,10,6,18,19,0.35714285714285715,0.6428571428571429,0.24,0.76
SF-M20,SF-P22,37,61,6,12,31,49,0.16216216216216217,0.8378378378378378,0.19672131147540983,0.8032786885245902
SF-M20,SF-W19,3,3,0,1,3,2,0.0,1.0,0.3333333333333333,0.6666666666666666
SF-M20,SF-U21,5,1,1,0,4,1,0.2,0.8,0.0,1.0
SF-M20,SF-T20,13,21,2,0,11,21,0.15384615384615385,0.8461538461538461,0.0,1.0
SF-M20,SF-S21,5,5,3,2,2,3,0.6,0.4,0.4,0.6
SF-M20,SF-Y30,1,1,0,0,1,1,0.0,1.0,0.0,1.0
SF-M20,SF-U30,16,33,0,0,16,33,0.0,1.0,0.0,1.0
SF-M20,SF-Z16,8,11,0,0,8,11,0.0,1.0,0.0,1.0
SF-M20,SF-X19,7,3,0,0,7,3,0.0,1.0,0.0,1.0
SF-M20,SF-Y25,6,5,0,0,6,5,0.0,1.0,0.0,1.0
SF-K17-2,SF-M25,5,3,1,2,4,1,0.2,0.8,0.6666666666666666,0.3333333333333333
SF-K17-2,SF-M26-2,1,1,0,1,1,0,0.0,1.0,1.0,0.0
SF-K17-2,SF-M30,1,4,0,2,1,2,0.0,1.0,0.5,0.5
SF-K17-2,SF-L27-2,1,2,0,1,1,1,0.0,1.0,0.5,0.5
SF-K17-2,SF-J29,4,8,0,1,4,7,0.0,1.0,0.125,0.875
SF-K17-2,SF-L26,9,39,0,22,9,17,0.0,1.0,0.5641025641025641,0.4358974358974359
SF-K17-2,SF-L24,2,3,0,2,2,1,0.0,1.0,0.6666666666666666,0.3333333333333333
SF-K17-2,SF-N23,3,2,0,1,3,1,0.0,1.0,0.5,0.5
SF-K17-2,SF-N24-2,4,4,0,4,4,0,0.0,1.0,1.0,0.0
SF-K17-2,SF-K27-2,1,3,0,0,1,3,0.0,1.0,0.0,1.0
SF-K17-2,SF-J26-2,5,9,2,3,3,6,0.4,0.6,0.3333333333333333,0.6666666666666666
SF-K17-2,SF-K28-3,1,3,1,0,0,3,1.0,0.0,0.0,1.0
SF-K17-2,SF-K29-1,3,9,1,3,2,6,0.3333333333333333,0.6666666666666666,0.3333333333333333,0.6666666666666666
SF-K17-2,SF-K25,2,7,0,2,2,5,0.0,1.0,0.2857142857142857,0.7142857142857143
SF-K17-2,SF-J25,2,47,0,5,2,42,0.0,1.0,0.10638297872340426,0.8936170212765957
SF-K17-2,SF-H26-2,1,8,0,0,1,8,0.0,1.0,0.0,1.0
SF-K17-2,SF-P24,2,2,0,1,2,1,0.0,1.0,0.5,0.5
SF-K17-2,SF-N22-1A,2,5,0,2,2,3,0.0,1.0,0.4,0.6
SF-K17-2,SF-J24,1,18,1,1,0,17,1.0,0.0,0.05555555555555555,0.9444444444444444
SF-K17-2,SF-O24,1,4,0,2,1,2,0.0,1.0,0.5,0.5
SF-K17-2,SF-I25,12,17,2,9,10,8,0.16666666666666666,0.8333333333333334,0.5294117647058824,0.47058823529411764
SF-K17-2,SF-H26,10,20,2,10,8,10,0.2,0.8,0.5,0.5
SF-K17-2,SF-O23,4,7,1,2,3,5,0.25,0.75,0.2857142857142857,0.7142857142857143
SF-K17-2,SF-H27-1,5,3,1,1,4,2,0.2,0.8,0.3333333333333333,0.6666666666666666
SF-K17-2,SF-F28-2,2,5,1,0,1,5,0.5,0.5,0.0,1.0
SF-K17-2,SF-G27,7,13,2,5,5,8,0.2857142857142857,0.7142857142857143,0.38461538461538464,0.6153846153846154
SF-K17-2,SF-M22-2,9,13,0,5,9,8,0.0,1.0,0.38461538461538464,0.6153846153846154
SF-K17-2,SF-L22,10,8,0,2,10,6,0.0,1.0,0.25,0.75
SF-K17-2,SF-F27,3,5,0,1,3,4,0.0,1.0,0.2,0.8
SF-K17-2,SF-N22-2,12,11,1,5,11,6,0.08333333333333333,0.9166666666666666,0.45454545454545453,0.5454545454545454
SF-K17-2,SF-M22-1,5,9,2,4,3,5,0.4,0.6,0.4444444444444444,0.5555555555555556
SF-K17-2,SF-K22-2,2,9,0,5,2,4,0.0,1.0,0.5555555555555556,0.4444444444444444
SF-K17-2,SF-K24,6,10,0,2,6,8,0.0,1.0,0.2,0.8
SF-K17-2,SF-J23-2,3,24,0,16,3,8,0.0,1.0,0.6666666666666666,0.3333333333333333
SF-K17-2,SF-G23,6,9,1,1,5,8,0.16666666666666666,0.8333333333333334,0.1111111111111111,0.8888888888888888
SF-K17-2,SF-G24,7,11,1,0,6,11,0.14285714285714285,0.8571428571428571,0.0,1.0
SF-K17-2,SF-G25,8,8,1,2,7,6,0.125,0.875,0.25,0.75
SF-K17-2,SF-F23,8,6,0,0,8,6,0.0,1.0,0.0,1.0
SF-K17-2,SF-E23,12,5,1,1,11,4,0.08333333333333333,0.9166666666666666,0.2,0.8
SF-K17-2,SF-D24,9,5,0,0,9,5,0.0,1.0,0.0,1.0
SF-K17-2,SF-B22,1,6,0,2,1,4,0.0,1.0,0.3333333333333333,0.6666666666666666
SF-K17-2,SF-J17,8,5,4,0,4,5,0.5,0.5,0.0,1.0
SF-K17-2,SF-I19,6,3,4,1,2,2,0.6666666666666666,0.3333333333333333,0.3333333333333333,0.6666666666666666
SF-K17-2,SF-I20,1,3,0,2,1,1,0.0,1.0,0.6666666666666666,0.3333333333333333
SF-K17-2,SF-H16,40,18,17,1,23,17,0.425,0.575,0.05555555555555555,0.9444444444444444
SF-K17-2,SF-H20,2,4,0,2,2,2,0.0,1.0,0.5,0.5
SF-K17-2,SF-H18,3,7,1,4,2,3,0.3333333333333333,0.6666666666666666,0.5714285714285714,0.42857142857142855
SF-K17-2,SF-H17,2,2,0,1,2,1,0.0,1.0,0.5,0.5
SF-K17-2,SF-G19,6,8,2,2,4,6,0.3333333333333333,0.6666666666666666,0.25,0.75
SF-K17-2,SF-G17,11,2,8,1,3,1,0.7272727272727273,0.2727272727272727,0.5,0.5
SF-K17-2,SF-G18,9,8,0,1,9,7,0.0,1.0,0.125,0.875
SF-K17-2,SF-G20,9,7,2,0,7,7,0.2222222222222222,0.7777777777777778,0.0,1.0
SF-K17-2,SF-F19,4,9,2,4,2,5,0.5,0.5,0.4444444444444444,0.5555555555555556
SF-K17-2,SF-E18,6,3,2,0,4,3,0.3333333333333333,0.6666666666666666,0.0,1.0
SF-K17-2,SF-E20,6,10,0,0,6,10,0.0,1.0,0.0,1.0
SF-K17-2,SF-G30-2,6,4,0,1,6,3,0.0,1.0,0.25,0.75
SF-K17-2,SF-E29-2,2,6,0,2,2,4,0.0,1.0,0.3333333333333333,0.6666666666666666
SF-K17-2,SF-E29-1,2,11,0,3,2,8,0.0,1.0,0.2727272727272727,0.7272727272727273
SF-K17-2,SF-D28,2,1,0,0,2,1,0.0,1.0,0.0,1.0
SF-K17-2,SF-A27,1,4,0,4,1,0,0.0,1.0,1.0,0.0
SF-K17-2,SF-G29-1,2,3,0,0,2,3,0.0,1.0,0.0,1.0
SF-K17-2,SF-G30-1,1,2,0,0,1,2,0.0,1.0,0.0,1.0
SF-K17-2,SF-G29-3,2,2,0,0,2,2,0.0,1.0,0.0,1.0
SF-K17-2,SF-F28-1,2,3,0,1,2,2,0.0,1.0,0.3333333333333333,0.6666666666666666
SF-K17-2,SF-E28-2,1,1,0,0,1,1,0.0,1.0,0.0,1.0
SF-K17-2,SF-J10,13,10,8,6,5,4,0.6153846153846154,0.38461538461538464,0.6,0.4
SF-K17-2,SF-J12,24,19,2,6,22,13,0.08333333333333333,0.9166666666666666,0.3157894736842105,0.6842105263157895
SF-K17-2,SF-J13,31,15,1,2,30,13,0.03225806451612903,0.967741935483871,0.13333333333333333,0.8666666666666667
SF-K17-2,SF-H13,7,10,2,0,5,10,0.2857142857142857,0.7142857142857143,0.0,1.0
SF-K17-2,SF-I16,8,10,2,1,6,9,0.25,0.75,0.1,0.9
SF-K17-2,SF-H12,7,8,2,0,5,8,0.2857142857142857,0.7142857142857143,0.0,1.0
SF-K17-2,SF-G10-2,7,3,1,1,6,2,0.14285714285714285,0.8571428571428571,0.3333333333333333,0.6666666666666666
SF-K17-2,SF-H15,13,4,6,2,7,2,0.46153846153846156,0.5384615384615384,0.5,0.5
SF-K17-2,SF-G9,14,25,12,24,2,1,0.8571428571428571,0.14285714285714285,0.96,0.04
SF-K17-2,SF-G13,12,3,4,0,8,3,0.3333333333333333,0.6666666666666666,0.0,1.0
SF-K17-2,SF-G11,6,6,3,5,3,1,0.5,0.5,0.8333333333333334,0.16666666666666666
SF-K17-2,SF-G12,25,8,8,1,17,7,0.32,0.68,0.125,0.875
SF-K17-2,SF-G10-1,2,4,2,0,0,4,1.0,0.0,0.0,1.0
SF-K17-2,SF-F15,13,6,1,1,12,5,0.07692307692307693,0.9230769230769231,0.16666666666666666,0.8333333333333334
SF-K17-2,SF-F16,8,2,0,0,8,2,0.0,1.0,0.0,1.0
SF-K17-2,SF-C21,13,15,0,0,13,15,0.0,1.0,0.0,1.0
SF-K17-2,SF-B19,1,5,0,2,1,3,0.0,1.0,0.4,0.6
SF-K17-2,SF-A20,2,1,0,0,2,1,0.0,1.0,0.0,1.0
SF-K17-2,SF-A19,2,1,0,0,2,1,0.0,1.0,0.0,1.0
SF-K17-2,SF-C25,1,5,0,1,1,4,0.0,1.0,0.2,0.8
SF-K17-2,SF-D27,3,4,0,2,3,2,0.0,1.0,0.5,0.5
SF-K17-2,SF-J1,19,25,6,16,13,9,0.3157894736842105,0.6842105263157895,0.64,0.36
SF-K17-2,SF-H0,10,7,2,1,8,6,0.2,0.8,0.14285714285714285,0.8571428571428571
SF-K17-2,SF-J3,7,3,0,1,7,2,0.0,1.0,0.3333333333333333,0.6666666666666666
SF-K17-2,SF-J5,8,5,4,1,4,4,0.5,0.5,0.2,0.8
SF-K17-2,SF-G8,4,1,1,0,3,1,0.25,0.75,0.0,1.0
SF-K17-2,SF-G7,7,1,2,1,5,0,0.2857142857142857,0.7142857142857143,1.0,0.0
SF-K17-2,SF-H25,1,4,0,4,1,0,0.0,1.0,1.0,0.0
SF-K17-2,SF-G26,6,2,1,2,5,0,0.16666666666666666,0.8333333333333334,1.0,0.0
SF-K17-2,SF-K21,28,32,0,11,28,21,0.0,1.0,0.34375,0.65625
SF-K17-2,SF-K22-1,13,9,6,4,7,5,0.46153846153846156,0.5384615384615384,0.4444444444444444,0.5555555555555556
SF-K17-2,SF-J23-1,20,39,2,21,18,18,0.1,0.9,0.5384615384615384,0.46153846153846156
SF-K17-2,SF-J22-1,20,24,4,10,16,14,0.2,0.8,0.4166666666666667,0.5833333333333334
SF-K17-2,SF-J22-2,3,3,0,0,3,3,0.0,1.0,0.0,1.0
SF-K17-2,SF-J21,29,45,1,20,28,25,0.034482758620689655,0.9655172413793104,0.4444444444444444,0.5555555555555556
SF-K17-2,SF-I22,9,5,1,2,8,3,0.1111111111111111,0.8888888888888888,0.4,0.6
SF-K17-2,SF-I23-2,4,6,1,3,3,3,0.25,0.75,0.5,0.5
SF-K17-2,SF-I24,1,8,1,7,0,1,1.0,0.0,0.875,0.125
SF-K17-2,SF-I23-1,16,23,1,4,15,19,0.0625,0.9375,0.17391304347826086,0.8260869565217391
SF-K17-2,SF-F26,6,6,1,1,5,5,0.16666666666666666,0.8333333333333334,0.16666666666666666,0.8333333333333334
SF-K17-2,SF-M13,25,16,14,4,11,12,0.56,0.44,0.25,0.75
SF-K17-2,SF-M15,53,41,36,12,17,29,0.6792452830188679,0.32075471698113206,0.2926829268292683,0.7073170731707317
SF-K17-2,SF-L19,14,12,4,8,10,4,0.2857142857142857,0.7142857142857143,0.6666666666666666,0.3333333333333333
SF-K17-2,SF-L20,23,28,1,12,22,16,0.043478260869565216,0.9565217391304348,0.42857142857142855,0.5714285714285714
SF-K17-2,SF-N20-1,13,23,0,9,13,14,0.0,1.0,0.391304347826087,0.6086956521739131
SF-K17-2,SF-M20,22,47,2,19,20,28,0.09090909090909091,0.9090909090909091,0.40425531914893614,0.5957446808510638
SF-K17-2,SF-K20,39,58,12,32,27,26,0.3076923076923077,0.6923076923076923,0.5517241379310345,0.4482758620689655
SF-K17-2,SF-K15-,28,47,8,33,20,14,0.2857142857142857,0.7142857142857143,0.7021276595744681,0.2978723404255319
SF-K17-2,SF-K19,32,32,12,21,20,11,0.375,0.625,0.65625,0.34375
SF-K17-2,SF-K18,18,25,6,12,12,13,0.3333333333333333,0.6666666666666666,0.48,0.52
SF-K17-2,SF-K17,15,20,7,14,8,6,0.4666666666666667,0.5333333333333333,0.7,0.3
SF-K17-2,SF-J16,10,2,5,1,5,1,0.5,0.5,0.5,0.5
SF-K17-2,SF-J18,26,39,6,19,20,20,0.23076923076923078,0.7692307692307693,0.48717948717948717,0.5128205128205128
SF-K17-2,SF-J20,2,4,1,2,1,2,0.5,0.5,0.5,0.5
SF-K17-2,SF-J19,13,8,1,3,12,5,0.07692307692307693,0.9230769230769231,0.375,0.625
SF-K17-2,SF-O12,2,1,2,0,0,1,1.0,0.0,0.0,1.0
SF-K17-2,SF-M12,14,10,6,6,8,4,0.42857142857142855,0.5714285714285714,0.6,0.4
SF-K17-2,SF-M10,19,11,10,8,9,3,0.5263157894736842,0.47368421052631576,0.7272727272727273,0.2727272727272727
SF-K17-2,SF-M11,20,15,7,5,13,10,0.35,0.65,0.3333333333333333,0.6666666666666666
SF-K17-2,SF-R20,2,2,0,0,2,2,0.0,1.0,0.0,1.0
SF-K17-2,SF-Q21-2,11,6,0,0,11,6,0.0,1.0,0.0,1.0
SF-K17-2,SF-Q21-1,5,5,1,4,4,1,0.2,0.8,0.8,0.2
SF-K17-2,SF-P21,3,8,0,0,3,8,0.0,1.0,0.0,1.0
SF-K17-2,SF-O18,6,14,1,2,5,12,0.16666666666666666,0.8333333333333334,0.14285714285714285,0.8571428571428571
SF-K17-2,SF-O19,32,51,2,27,30,24,0.0625,0.9375,0.5294117647058824,0.47058823529411764
SF-K17-2,SF-O21,45,116,3,58,42,58,0.06666666666666667,0.9333333333333333,0.5,0.5
SF-K17-2,SF-O22,16,21,1,7,15,14,0.0625,0.9375,0.3333333333333333,0.6666666666666666
SF-K17-2,SF-N21,11,11,2,6,9,5,0.18181818181818182,0.8181818181818182,0.5454545454545454,0.45454545454545453
SF-K17-2,SF-N20-2,6,11,3,6,3,5,0.5,0.5,0.5454545454545454,0.45454545454545453
SF-K17-2,SF-M21,6,9,1,3,5,6,0.16666666666666666,0.8333333333333334,0.3333333333333333,0.6666666666666666
SF-K17-2,SF-L21,30,35,3,17,27,18,0.1,0.9,0.4857142857142857,0.5142857142857142
SF-K17-2,SF-Q30,5,4,0,0,5,4,0.0,1.0,0.0,1.0
SF-K17-2,SF-P30,1,9,0,2,1,7,0.0,1.0,0.2222222222222222,0.7777777777777778
SF-K17-2,SF-O30-2,1,4,0,0,1,4,0.0,1.0,0.0,1.0
SF-K17-2,SF-N27,1,4,0,1,1,3,0.0,1.0,0.25,0.75
SF-K17-2,SF-N29,2,1,0,1,2,0,0.0,1.0,1.0,0.0
SF-K17-2,SF-N28,13,8,2,1,11,7,0.15384615384615385,0.8461538461538461,0.125,0.875
SF-K17-2,SF-L30-1,2,11,0,5,2,6,0.0,1.0,0.45454545454545453,0.5454545454545454
SF-K17-2,SF-I27,1,1,0,1,1,0,0.0,1.0,1.0,0.0
SF-K17-2,SF I29-1,1,1,0,0,1,1,0.0,1.0,0.0,1.0
SF-K17-2,SF-H28,2,1,0,1,2,0,0.0,1.0,1.0,0.0
SF-K17-2,SF-S24,4,4,0,3,4,1,0.0,1.0,0.75,0.25
SF-K17-2,SF-R24,4,5,1,0,3,5,0.25,0.75,0.0,1.0
SF-K17-2,SF-P26,3,8,0,1,3,7,0.0,1.0,0.125,0.875
SF-K17-2,SF-O25-2,2,2,0,0,2,2,0.0,1.0,0.0,1.0
SF-K17-2,SF-N22-1B,1,4,0,2,1,2,0.0,1.0,0.5,0.5
SF-K17-2,SF-N26,4,8,0,0,4,8,0.0,1.0,0.0,1.0
SF-K17-2,SF-N25,5,3,1,3,4,0,0.2,0.8,1.0,0.0
SF-K17-2,SF-S22-1,4,6,0,4,4,2,0.0,1.0,0.6666666666666666,0.3333333333333333
SF-K17-2,SF-Q23-3,6,6,1,2,5,4,0.16666666666666666,0.8333333333333334,0.3333333333333333,0.6666666666666666
SF-K17-2,SF-Q22-1,4,8,2,2,2,6,0.5,0.5,0.25,0.75
SF-K17-2,SF-Q22-2,4,14,1,3,3,11,0.25,0.75,0.21428571428571427,0.7857142857142857
SF-K17-2,SF-P22,10,9,3,3,7,6,0.3,0.7,0.3333333333333333,0.6666666666666666
SF-K17-2,SF-W19,1,2,0,0,1,2,0.0,1.0,0.0,1.0
SF-K17-2,SF-U21,1,2,1,0,0,2,1.0,0.0,0.0,1.0
SF-K17-2,SF-T20,3,1,0,0,3,1,0.0,1.0,0.0,1.0
SF-K20,SF-M26,1,1,0,0,1,1,0.0,1.0,0.0,1.0
SF-K20,SF-M25,4,13,0,8,4,5,0.0,1.0,0.6153846153846154,0.38461538461538464
SF-K20,SF-M26-2,1,1,0,1,1,0,0.0,1.0,1.0,0.0
SF-K20,SF-K26,7,22,1,11,6,11,0.14285714285714285,0.8571428571428571,0.5,0.5
SF-K20,SF-J27,2,6,1,2,1,4,0.5,0.5,0.3333333333333333,0.6666666666666666
SF-K20,SF-M30,19,32,3,4,16,28,0.15789473684210525,0.8421052631578947,0.125,0.875
SF-K20,SF-J29-3,5,1,1,1,4,0,0.2,0.8,1.0,0.0
SF-K20,SF-J29,30,30,4,3,26,27,0.13333333333333333,0.8666666666666667,0.1,0.9
SF-K20,SF-L26,26,32,2,8,24,24,0.07692307692307693,0.9230769230769231,0.25,0.75
SF-K20,SF-M28,4,4,0,0,4,4,0.0,1.0,0.0,1.0
SF-K20,SF-L25,5,7,1,5,4,2,0.2,0.8,0.7142857142857143,0.2857142857142857
SF-K20,SF-M24,17,7,8,2,9,5,0.47058823529411764,0.5294117647058824,0.2857142857142857,0.7142857142857143
SF-K20,SF-L24,9,10,3,7,6,3,0.3333333333333333,0.6666666666666666,0.7,0.3
SF-K20,SF-N23,12,8,4,7,8,1,0.3333333333333333,0.6666666666666666,0.875,0.125
SF-K20,SF-N24-2,12,11,1,6,11,5,0.08333333333333333,0.9166666666666666,0.5454545454545454,0.45454545454545453
SF-K20,SF-K27-2,14,14,3,5,11,9,0.21428571428571427,0.7857142857142857,0.35714285714285715,0.6428571428571429
SF-K20,SF-J26-2,13,9,1,2,12,7,0.07692307692307693,0.9230769230769231,0.2222222222222222,0.7777777777777778
SF-K20,SF-L28,3,1,1,0,2,1,0.3333333333333333,0.6666666666666666,0.0,1.0
SF-K20,SF-K28,1,2,0,2,1,0,0.0,1.0,1.0,0.0
SF-K20,SF-K29-1,7,5,1,1,6,4,0.14285714285714285,0.8571428571428571,0.2,0.8
SF-K20,SF-J28-2,3,3,0,1,3,2,0.0,1.0,0.3333333333333333,0.6666666666666666
SF-K20,SF-K25,6,18,3,5,3,13,0.5,0.5,0.2777777777777778,0.7222222222222222
SF-K20,SF-J25,13,26,4,16,9,10,0.3076923076923077,0.6923076923076923,0.6153846153846154,0.38461538461538464
SF-K20,SF-H26-2,3,7,0,0,3,7,0.0,1.0,0.0,1.0
SF-K20,SF-P24,8,20,3,8,5,12,0.375,0.625,0.4,0.6
SF-K20,SF-N22-1A,5,1,1,0,4,1,0.2,0.8,0.0,1.0
SF-K20,SF-J24,4,8,0,5,4,3,0.0,1.0,0.625,0.375
SF-K20,SF-O24,2,7,1,3,1,4,0.5,0.5,0.42857142857142855,0.5714285714285714
SF-K20,SF-J26,3,7,2,3,1,4,0.6666666666666666,0.3333333333333333,0.42857142857142855,0.5714285714285714
SF-K20,SF-I26-,3,2,3,0,0,2,1.0,0.0,0.0,1.0
SF-K20,SF-I25,19,27,8,15,11,12,0.42105263157894735,0.5789473684210527,0.5555555555555556,0.4444444444444444
SF-K20,SF-K23,4,3,1,3,3,0,0.25,0.75,1.0,0.0
SF-K20,SF-H26,35,35,11,18,24,17,0.3142857142857143,0.6857142857142857,0.5142857142857142,0.4857142857142857
SF-K20,SF-O23,8,26,1,10,7,16,0.125,0.875,0.38461538461538464,0.6153846153846154
SF-K20,SF-H27-1,4,4,3,3,1,1,0.75,0.25,0.75,0.25
SF-K20,SF-F28-2,57,85,24,43,33,42,0.42105263157894735,0.5789473684210527,0.5058823529411764,0.49411764705882355
SF-K20,SF-G27,25,50,6,26,19,24,0.24,0.76,0.52,0.48
SF-K20,SF-M22-2,35,34,10,24,25,10,0.2857142857142857,0.7142857142857143,0.7058823529411765,0.29411764705882354
SF-K20,SF-L22,31,16,5,5,26,11,0.16129032258064516,0.8387096774193549,0.3125,0.6875
SF-K20,SF-F27,15,20,1,8,14,12,0.06666666666666667,0.9333333333333333,0.4,0.6
SF-K20,SF-N22-2,64,89,16,35,48,54,0.25,0.75,0.39325842696629215,0.6067415730337079
SF-K20,SF-G28-2,1,2,0,0,1,2,0.0,1.0,0.0,1.0
SF-K20,SF-M22-1,11,19,2,11,9,8,0.18181818181818182,0.8181818181818182,0.5789473684210527,0.42105263157894735
SF-K20,SF-O25-1,1,6,0,2,1,4,0.0,1.0,0.3333333333333333,0.6666666666666666
SF-K20,SF-K22-2,12,14,7,5,5,9,0.5833333333333334,0.4166666666666667,0.35714285714285715,0.6428571428571429
SF-K20,SF-K24,17,7,5,1,12,6,0.29411764705882354,0.7058823529411765,0.14285714285714285,0.8571428571428571
SF-K20,SF-J23-2,20,14,8,7,12,7,0.4,0.6,0.5,0.5
SF-K20,SF-G23,2,3,0,0,2,3,0.0,1.0,0.0,1.0
SF-K20,SF-G24,9,17,2,1,7,16,0.2222222222222222,0.7777777777777778,0.058823529411764705,0.9411764705882353
SF-K20,SF-G25,18,16,6,4,12,12,0.3333333333333333,0.6666666666666666,0.25,0.75
SF-K20,SF-F23,12,11,1,3,11,8,0.08333333333333333,0.9166666666666666,0.2727272727272727,0.7272727272727273
SF-K20,SF-E23,14,7,3,0,11,7,0.21428571428571427,0.7857142857142857,0.0,1.0
SF-K20,SF-D24,7,6,3,0,4,6,0.42857142857142855,0.5714285714285714,0.0,1.0
SF-K20,SF-C22,12,6,1,0,11,6,0.08333333333333333,0.9166666666666666,0.0,1.0
SF-K20,SF-B22,54,39,2,1,52,38,0.037037037037037035,0.9629629629629629,0.02564102564102564,0.9743589743589743
SF-K20,SF-J17,24,51,8,13,16,38,0.3333333333333333,0.6666666666666666,0.2549019607843137,0.7450980392156863
SF-K20,SF-I19,6,5,0,0,6,5,0.0,1.0,0.0,1.0
SF-K20,SF-I20,2,3,0,2,2,1,0.0,1.0,0.6666666666666666,0.3333333333333333
SF-K20,SF-H16,15,22,2,5,13,17,0.13333333333333333,0.8666666666666667,0.22727272727272727,0.7727272727272727
SF-K20,SF-H19,7,15,0,10,7,5,0.0,1.0,0.6666666666666666,0.3333333333333333
SF-K20,SF-H20,21,10,9,4,12,6,0.42857142857142855,0.5714285714285714,0.4,0.6
SF-K20,SF-H18,16,12,5,2,11,10,0.3125,0.6875,0.16666666666666666,0.8333333333333334
SF-K20,SF-H17,3,7,1,0,2,7,0.3333333333333333,0.6666666666666666,0.0,1.0
SF-K20,SF-G19,26,26,6,8,20,18,0.23076923076923078,0.7692307692307693,0.3076923076923077,0.6923076923076923
SF-K20,SF-G17,3,4,0,0,3,4,0.0,1.0,0.0,1.0
SF-K20,SF-G18,18,24,3,3,15,21,0.16666666666666666,0.8333333333333334,0.125,0.875
SF-K20,SF-G20,14,15,9,2,5,13,0.6428571428571429,0.35714285714285715,0.13333333333333333,0.8666666666666667
SF-K20,SF-F19,25,16,2,6,23,10,0.08,0.92,0.375,0.625
SF-K20,SF-E18,6,10,0,5,6,5,0.0,1.0,0.5,0.5
SF-K20,SF-E20,29,36,2,1,27,35,0.06896551724137931,0.9310344827586207,0.027777777777777776,0.9722222222222222
SF-K20,SF-H30,2,5,2,5,0,0,1.0,0.0,1.0,0.0
SF-K20,SF-G30-2,15,13,0,6,15,7,0.0,1.0,0.46153846153846156,0.5384615384615384
SF-K20,SF-F30-1,2,3,0,2,2,1,0.0,1.0,0.6666666666666666,0.3333333333333333
SF-K20,SF-E29-2,13,21,3,14,10,7,0.23076923076923078,0.7692307692307693,0.6666666666666666,0.3333333333333333
SF-K20,SF-E29-1,6,6,2,4,4,2,0.3333333333333333,0.6666666666666666,0.6666666666666666,0.3333333333333333
SF-K20,SF-D29,3,5,0,2,3,3,0.0,1.0,0.4,0.6
SF-K20,SF-D28,27,5,2,0,25,5,0.07407407407407407,0.9259259259259259,0.0,1.0
SF-K20,SF-A27,1,3,0,1,1,2,0.0,1.0,0.3333333333333333,0.6666666666666666
SF-K20,SF-G29-2,11,18,3,8,8,10,0.2727272727272727,0.7272727272727273,0.4444444444444444,0.5555555555555556
SF-K20,SF-G29-1,2,1,2,0,0,1,1.0,0.0,0.0,1.0
SF-K20,SF-G30-1,2,6,1,2,1,4,0.5,0.5,0.3333333333333333,0.6666666666666666
SF-K20,SF-G29-3,1,4,0,0,1,4,0.0,1.0,0.0,1.0
SF-K20,SF-F30-2,2,2,0,1,2,1,0.0,1.0,0.5,0.5
SF-K20,SF-F29,4,2,0,2,4,0,0.0,1.0,1.0,0.0
SF-K20,SF-E29-3,8,13,1,4,7,9,0.125,0.875,0.3076923076923077,0.6923076923076923
SF-K20,SF-F28-1,12,8,2,2,10,6,0.16666666666666666,0.8333333333333334,0.25,0.75
SF-K20,SF-E28-2,5,5,2,1,3,4,0.4,0.6,0.2,0.8
SF-K20,SF-E28,2,3,1,1,1,2,0.5,0.5,0.3333333333333333,0.6666666666666666
SF-K20,SF-J10,21,25,8,13,13,12,0.38095238095238093,0.6190476190476191,0.52,0.48
SF-K20,SF-J12,36,26,16,7,20,19,0.4444444444444444,0.5555555555555556,0.2692307692307692,0.7307692307692307
SF-K20,SF-J13,17,15,2,5,15,10,0.11764705882352941,0.8823529411764706,0.3333333333333333,0.6666666666666666
SF-K20,SF-J15,5,1,1,1,4,0,0.2,0.8,1.0,0.0
SF-K20,SF-H13,11,6,2,1,9,5,0.18181818181818182,0.8181818181818182,0.16666666666666666,0.8333333333333334
SF-K20,SF-I16,9,12,1,1,8,11,0.1111111111111111,0.8888888888888888,0.08333333333333333,0.9166666666666666
SF-K20,SF-H12,3,7,0,1,3,6,0.0,1.0,0.14285714285714285,0.8571428571428571
SF-K20,SF-G10-2,11,2,4,0,7,2,0.36363636363636365,0.6363636363636364,0.0,1.0
SF-K20,SF-H15,2,2,0,0,2,2,0.0,1.0,0.0,1.0
SF-K20,SF-G9,15,4,1,0,14,4,0.06666666666666667,0.9333333333333333,0.0,1.0
SF-K20,SF-H14,4,4,2,0,2,4,0.5,0.5,0.0,1.0
SF-K20,SF-G13,10,17,4,6,6,11,0.4,0.6,0.35294117647058826,0.6470588235294118
SF-K20,SF-G11,13,12,1,5,12,7,0.07692307692307693,0.9230769230769231,0.4166666666666667,0.5833333333333334
SF-K20,SF-G12,18,22,1,3,17,19,0.05555555555555555,0.9444444444444444,0.13636363636363635,0.8636363636363636
SF-K20,SF-G10-1,3,2,0,0,3,2,0.0,1.0,0.0,1.0
SF-K20,SF-F15,5,6,1,2,4,4,0.2,0.8,0.3333333333333333,0.6666666666666666
SF-K20,SF-F16,6,10,1,0,5,10,0.16666666666666666,0.8333333333333334,0.0,1.0
SF-K20,SF-C21,3,7,1,1,2,6,0.3333333333333333,0.6666666666666666,0.14285714285714285,0.8571428571428571
SF-K20,SF-C20,4,12,0,4,4,8,0.0,1.0,0.3333333333333333,0.6666666666666666
SF-K20,SF-B21,5,2,0,0,5,2,0.0,1.0,0.0,1.0
SF-K20,SF-A20,4,6,0,1,4,5,0.0,1.0,0.16666666666666666,0.8333333333333334
SF-K20,SF-A19,3,1,1,1,2,0,0.3333333333333333,0.6666666666666666,1.0,0.0
SF-K20,SF-C26,6,46,0,3,6,43,0.0,1.0,0.06521739130434782,0.9347826086956522
SF-K20,SF-C25,10,9,0,1,10,8,0.0,1.0,0.1111111111111111,0.8888888888888888
SF-K20,SF-B25,9,3,0,2,9,1,0.0,1.0,0.6666666666666666,0.3333333333333333
SF-K20,SF-E27,2,2,1,0,1,2,0.5,0.5,0.0,1.0
SF-K20,SF-B28-2,4,2,0,0,4,2,0.0,1.0,0.0,1.0
SF-K20,SF-D27,7,7,3,1,4,6,0.42857142857142855,0.5714285714285714,0.14285714285714285,0.8571428571428571
SF-K20,SF-C28-2,5,6,0,0,5,6,0.0,1.0,0.0,1.0
SF-K20,SF-B28,1,4,0,2,1,2,0.0,1.0,0.5,0.5
SF-K20,SF-J1,17,53,6,28,11,25,0.35294117647058826,0.6470588235294118,0.5283018867924528,0.4716981132075472
SF-K20,SF-H0,6,7,1,2,5,5,0.16666666666666666,0.8333333333333334,0.2857142857142857,0.7142857142857143
SF-K20,SF-J3,6,10,3,5,3,5,0.5,0.5,0.5,0.5
SF-K20,SF-J5,2,11,0,4,2,7,0.0,1.0,0.36363636363636365,0.6363636363636364
SF-K20,SF-G6,1,3,0,1,1,2,0.0,1.0,0.3333333333333333,0.6666666666666666
SF-K20,SF-G8,8,10,2,5,6,5,0.25,0.75,0.5,0.5
SF-K20,SF-G5,6,5,3,1,3,4,0.5,0.5,0.2,0.8
SF-K20,SF-G7,6,10,1,3,5,7,0.16666666666666666,0.8333333333333334,0.3,0.7
SF-K20,SF-H25,2,1,0,0,2,1,0.0,1.0,0.0,1.0
SF-K20,SF-G26,10,9,2,5,8,4,0.2,0.8,0.5555555555555556,0.4444444444444444
SF-K20,SF-K21,29,32,12,16,17,16,0.41379310344827586,0.5862068965517241,0.5,0.5
SF-K20,SF-K22-1,23,18,7,7,16,11,0.30434782608695654,0.6956521739130435,0.3888888888888889,0.6111111111111112
SF-K20,SF-J23-1,51,49,13,18,38,31,0.2549019607843137,0.7450980392156863,0.3673469387755102,0.6326530612244898
SF-K20,SF-J22-1,18,15,3,8,15,7,0.16666666666666666,0.8333333333333334,0.5333333333333333,0.4666666666666667
SF-K20,SF-J22-2,6,5,3,3,3,2,0.5,0.5,0.6,0.4
SF-K20,SF-J21,25,28,5,14,20,14,0.2,0.8,0.5,0.5
SF-K20,SF-I21,3,4,1,2,2,2,0.3333333333333333,0.6666666666666666,0.5,0.5
SF-K20,SF-I22,5,6,2,3,3,3,0.4,0.6,0.5,0.5
SF-K20,SF-I23-2,7,21,2,12,5,9,0.2857142857142857,0.7142857142857143,0.5714285714285714,0.42857142857142855
SF-K20,SF-I24,16,23,8,3,8,20,0.5,0.5,0.13043478260869565,0.8695652173913043
SF-K20,SF-I23-1,7,20,1,3,6,17,0.14285714285714285,0.8571428571428571,0.15,0.85
SF-K20,SF-F26,15,13,5,5,10,8,0.3333333333333333,0.6666666666666666,0.38461538461538464,0.6153846153846154
SF-K20,SF-M13,122,217,33,126,89,91,0.27049180327868855,0.7295081967213115,0.5806451612903226,0.41935483870967744
SF-K20,SF-M15,35,63,14,17,21,46,0.4,0.6,0.2698412698412698,0.7301587301587301
SF-K20,SF-L19,45,26,29,18,16,8,0.6444444444444445,0.35555555555555557,0.6923076923076923,0.3076923076923077
SF-K20,SF-L20,71,98,34,74,37,24,0.4788732394366197,0.5211267605633803,0.7551020408163265,0.24489795918367346
SF-K20,SF-N20-1,15,8,7,4,8,4,0.4666666666666667,0.5333333333333333,0.5,0.5
SF-K20,SF-M20,90,114,44,57,46,57,0.4888888888888889,0.5111111111111111,0.5,0.5
SF-K20,SF-K17-2,58,39,32,12,26,27,0.5517241379310345,0.4482758620689655,0.3076923076923077,0.6923076923076923
SF-K20,SF-K15-,71,135,39,70,32,65,0.5492957746478874,0.4507042253521127,0.5185185185185185,0.48148148148148145
SF-K20,SF-K19,67,86,41,59,26,27,0.6119402985074627,0.3880597014925373,0.686046511627907,0.313953488372093
SF-K20,SF-K18,65,57,48,19,17,38,0.7384615384615385,0.26153846153846155,0.3333333333333333,0.6666666666666666
SF-K20,SF-K17,28,58,12,31,16,27,0.42857142857142855,0.5714285714285714,0.5344827586206896,0.46551724137931033
SF-K20,SF-J16,11,25,5,7,6,18,0.45454545454545453,0.5454545454545454,0.28,0.72
SF-K20,SF-J18,30,44,14,18,16,26,0.4666666666666667,0.5333333333333333,0.4090909090909091,0.5909090909090909
SF-K20,SF-J20,5,2,2,0,3,2,0.4,0.6,0.0,1.0
SF-K20,SF-J19,20,14,5,1,15,13,0.25,0.75,0.07142857142857142,0.9285714285714286
SF-K20,SF-M12,16,31,5,12,11,19,0.3125,0.6875,0.3870967741935484,0.6129032258064516
SF-K20,SF-M10,10,17,5,4,5,13,0.5,0.5,0.23529411764705882,0.7647058823529411
SF-K20,SF-M11,21,33,9,14,12,19,0.42857142857142855,0.5714285714285714,0.42424242424242425,0.5757575757575758
SF-K20,SF-R19,7,9,1,0,6,9,0.14285714285714285,0.8571428571428571,0.0,1.0
SF-K20,SF-R20,1,3,0,0,1,3,0.0,1.0,0.0,1.0
SF-K20,SF-Q21-2,12,8,4,1,8,7,0.3333333333333333,0.6666666666666666,0.125,0.875
SF-K20,SF-Q21-1,16,7,11,2,5,5,0.6875,0.3125,0.2857142857142857,0.7142857142857143
SF-K20,SF-P21,13,10,7,3,6,7,0.5384615384615384,0.46153846153846156,0.3,0.7
SF-K20,SF-O18,31,38,11,8,20,30,0.3548387096774194,0.6451612903225806,0.21052631578947367,0.7894736842105263
SF-K20,SF-O19,20,32,9,16,11,16,0.45,0.55,0.5,0.5
SF-K20,SF-O21,74,100,23,51,51,49,0.3108108108108108,0.6891891891891891,0.51,0.49
SF-K20,SF-O22,38,50,5,27,33,23,0.13157894736842105,0.868421052631579,0.54,0.46
SF-K20,SF-N21,25,19,8,10,17,9,0.32,0.68,0.5263157894736842,0.47368421052631576
SF-K20,SF-N20-2,18,3,7,2,11,1,0.3888888888888889,0.6111111111111112,0.6666666666666666,0.3333333333333333
SF-K20,SF-M21,34,24,19,11,15,13,0.5588235294117647,0.4411764705882353,0.4583333333333333,0.5416666666666666
SF-K20,SF-L21,92,74,39,43,53,31,0.42391304347826086,0.5760869565217391,0.581081081081081,0.4189189189189189
SF-K20,SF-Q30,3,1,0,0,3,1,0.0,1.0,0.0,1.0
SF-K20,SF-P30,8,9,3,6,5,3,0.375,0.625,0.6666666666666666,0.3333333333333333
SF-K20,SF-O30,12,1,0,0,12,1,0.0,1.0,0.0,1.0
SF-K20,SF-N27,3,7,0,4,3,3,0.0,1.0,0.5714285714285714,0.42857142857142855
SF-K20,SF-N29,7,2,1,1,6,1,0.14285714285714285,0.8571428571428571,0.5,0.5
SF-K20,SF-N28,7,7,3,0,4,7,0.42857142857142855,0.5714285714285714,0.0,1.0
SF-K20,SF-L30-1,10,7,1,3,9,4,0.1,0.9,0.42857142857142855,0.5714285714285714
SF-K20,SF-K30-2,94,4,93,4,1,0,0.9893617021276596,0.010638297872340425,1.0,0.0
SF-K20,SF-J29-1,3,3,2,1,1,2,0.6666666666666666,0.3333333333333333,0.3333333333333333,0.6666666666666666
SF-K20,SF-I30,4,11,0,2,4,9,0.0,1.0,0.18181818181818182,0.8181818181818182
SF-K20,SF-I29-2,2,3,2,2,0,1,1.0,0.0,0.6666666666666666,0.3333333333333333
SF-K20,SF-I27,2,4,0,0,2,4,0.0,1.0,0.0,1.0
SF-K20,SF-I30-2,1,3,0,2,1,1,0.0,1.0,0.6666666666666666,0.3333333333333333
SF-K20,SF-H28,1,6,0,4,1,2,0.0,1.0,0.6666666666666666,0.3333333333333333
SF-K20,SF-S24,6,8,2,1,4,7,0.3333333333333333,0.6666666666666666,0.125,0.875
SF-K20,SF-R24,15,12,6,3,9,9,0.4,0.6,0.25,0.75
SF-K20,SF-R26,4,2,1,2,3,0,0.25,0.75,1.0,0.0
SF-K20,SF-Q26,21,3,1,1,20,2,0.047619047619047616,0.9523809523809523,0.3333333333333333,0.6666666666666666
SF-K20,SF-P26,41,84,3,2,38,82,0.07317073170731707,0.926829268292683,0.023809523809523808,0.9761904761904762
SF-K20,SF-O25-2,1,5,0,1,1,4,0.0,1.0,0.2,0.8
SF-K20,SF-N22-1B,15,18,3,6,12,12,0.2,0.8,0.3333333333333333,0.6666666666666666
SF-K20,SF-N26,6,5,1,2,5,3,0.16666666666666666,0.8333333333333334,0.4,0.6
SF-K20,SF-N25,7,5,2,1,5,4,0.2857142857142857,0.7142857142857143,0.2,0.8
SF-K20,SF-T21,3,2,2,0,1,2,0.6666666666666666,0.3333333333333333,0.0,1.0
SF-K20,SF-T22,84,70,4,2,80,68,0.047619047619047616,0.9523809523809523,0.02857142857142857,0.9714285714285714
SF-K20,SF-S22-2,5,2,1,1,4,1,0.2,0.8,0.5,0.5
SF-K20,SF-S22-1,24,30,4,4,20,26,0.16666666666666666,0.8333333333333334,0.13333333333333333,0.8666666666666667
SF-K20,SF-Q23-3,21,17,5,4,16,13,0.23809523809523808,0.7619047619047619,0.23529411764705882,0.7647058823529411
SF-K20,SF-Q22-1,64,55,5,10,59,45,0.078125,0.921875,0.18181818181818182,0.8181818181818182
SF-K20,SF-Q22-2,25,14,9,5,16,9,0.36,0.64,0.35714285714285715,0.6428571428571429
SF-K20,SF-P22,44,30,7,11,37,19,0.1590909090909091,0.8409090909090909,0.36666666666666664,0.6333333333333333
SF-K20,SF-W19,2,1,0,1,2,0,0.0,1.0,1.0,0.0
SF-K20,SF-U21,11,3,0,1,11,2,0.0,1.0,0.3333333333333333,0.6666666666666666
SF-K20,SF-T20,6,7,1,1,5,6,0.16666666666666666,0.8333333333333334,0.14285714285714285,0.8571428571428571
SF-K20,SF-AA28,12,1,0,0,12,1,0.0,1.0,0.0,1.0
SF-K20,SF-Z28,1,3,0,0,1,3,0.0,1.0,0.0,1.0
SF-K20,SF-Z7,5,11,0,0,5,11,0.0,1.0,0.0,1.0
SF-K20,SF-W8,1,2,1,2,0,0,1.0,0.0,1.0,0.0
SF-K15-,SF-M25,3,5,1,0,2,5,0.3333333333333333,0.6666666666666666,0.0,1.0
SF-K15-,SF-M26-2,7,6,1,5,6,1,0.14285714285714285,0.8571428571428571,0.8333333333333334,0.16666666666666666
SF-K15-,SF-L27,4,3,1,2,3,1,0.25,0.75,0.6666666666666666,0.3333333333333333
SF-K15-,SF-K26,9,23,0,17,9,6,0.0,1.0,0.7391304347826086,0.2608695652173913
SF-K15-,SF-J27,4,1,1,0,3,1,0.25,0.75,0.0,1.0
SF-K15-,SF-M30,11,119,0,97,11,22,0.0,1.0,0.8151260504201681,0.18487394957983194
SF-K15-,SF-L27-2,4,1,1,1,3,0,0.25,0.75,1.0,0.0
SF-K15-,SF-J29-3,2,3,0,1,2,2,0.0,1.0,0.3333333333333333,0.6666666666666666
SF-K15-,SF-J29,15,5,3,1,12,4,0.2,0.8,0.2,0.8
SF-K15-,SF-L26,6,3,0,1,6,2,0.0,1.0,0.3333333333333333,0.6666666666666666
SF-K15-,SF-M28,4,3,1,0,3,3,0.25,0.75,0.0,1.0
SF-K15-,SF-L25,6,8,1,2,5,6,0.16666666666666666,0.8333333333333334,0.25,0.75
SF-K15-,SF-M24,7,6,2,3,5,3,0.2857142857142857,0.7142857142857143,0.5,0.5
SF-K15-,SF-L24,8,8,1,3,7,5,0.125,0.875,0.375,0.625
SF-K15-,SF-N23,6,15,0,10,6,5,0.0,1.0,0.6666666666666666,0.3333333333333333
SF-K15-,SF-N24-2,9,7,2,2,7,5,0.2222222222222222,0.7777777777777778,0.2857142857142857,0.7142857142857143
SF-K15-,SF-K27-2,30,9,6,4,24,5,0.2,0.8,0.4444444444444444,0.5555555555555556
SF-K15-,SF-J26-2,20,21,0,4,20,17,0.0,1.0,0.19047619047619047,0.8095238095238095
SF-K15-,SF-K28-3,8,12,0,0,8,12,0.0,1.0,0.0,1.0
SF-K15-,SF-K28,1,6,0,0,1,6,0.0,1.0,0.0,1.0
SF-K15-,SF-K29-1,5,5,2,1,3,4,0.4,0.6,0.2,0.8
SF-K15-,SF-J28-2,4,7,0,0,4,7,0.0,1.0,0.0,1.0
SF-K15-,SF-K27,34,10,32,10,2,0,0.9411764705882353,0.058823529411764705,1.0,0.0
SF-K15-,SF-K25,1,9,1,3,0,6,1.0,0.0,0.3333333333333333,0.6666666666666666
SF-K15-,SF-J25,27,25,7,14,20,11,0.25925925925925924,0.7407407407407407,0.56,0.44
SF-K15-,SF-H26-2,10,1,3,0,7,1,0.3,0.7,0.0,1.0
SF-K15-,SF-P24,11,14,0,8,11,6,0.0,1.0,0.5714285714285714,0.42857142857142855
SF-K15-,SF-J24,14,5,3,1,11,4,0.21428571428571427,0.7857142857142857,0.2,0.8
SF-K15-,SF-O24,9,3,4,1,5,2,0.4444444444444444,0.5555555555555556,0.3333333333333333,0.6666666666666666
SF-K15-,SF-J26,7,9,0,4,7,5,0.0,1.0,0.4444444444444444,0.5555555555555556
SF-K15-,SF-I26-,7,7,1,5,6,2,0.14285714285714285,0.8571428571428571,0.7142857142857143,0.2857142857142857
SF-K15-,SF-I25,41,25,28,15,13,10,0.6829268292682927,0.3170731707317073,0.6,0.4
SF-K15-,SF-K23,1,1,0,0,1,1,0.0,1.0,0.0,1.0
SF-K15-,SF-H26,38,41,14,21,24,20,0.3684210526315789,0.631578947368421,0.5121951219512195,0.4878048780487805
SF-K15-,SF-O23,12,8,4,5,8,3,0.3333333333333333,0.6666666666666666,0.625,0.375
SF-K15-,SF-H27-1,1,4,1,1,0,3,1.0,0.0,0.25,0.75
SF-K15-,SF-F28-2,8,7,1,3,7,4,0.125,0.875,0.42857142857142855,0.5714285714285714
SF-K15-,SF-G27,19,25,6,8,13,17,0.3157894736842105,0.6842105263157895,0.32,0.68
SF-K15-,SF-M22-2,31,30,6,8,25,22,0.1935483870967742,0.8064516129032258,0.26666666666666666,0.7333333333333333
SF-K15-,SF-L22,28,8,4,4,24,4,0.14285714285714285,0.8571428571428571,0.5,0.5
SF-K15-,SF-F27,10,5,3,0,7,5,0.3,0.7,0.0,1.0
SF-K15-,SF-N22-2,54,53,13,15,41,38,0.24074074074074073,0.7592592592592593,0.2830188679245283,0.7169811320754716
SF-K15-,SF-G28-1,23,29,19,26,4,3,0.8260869565217391,0.17391304347826086,0.896551724137931,0.10344827586206896
SF-K15-,SF-M22-1,14,11,6,7,8,4,0.42857142857142855,0.5714285714285714,0.6363636363636364,0.36363636363636365
SF-K15-,SF-O25-1,4,3,1,1,3,2,0.25,0.75,0.3333333333333333,0.6666666666666666
SF-K15-,SF-K22-2,26,26,9,14,17,12,0.34615384615384615,0.6538461538461539,0.5384615384615384,0.46153846153846156
SF-K15-,SF-K24,12,16,3,2,9,14,0.25,0.75,0.125,0.875
SF-K15-,SF-J23-2,17,7,7,1,10,6,0.4117647058823529,0.5882352941176471,0.14285714285714285,0.8571428571428571
SF-K15-,SF-G23,14,10,3,0,11,10,0.21428571428571427,0.7857142857142857,0.0,1.0
SF-K15-,SF-G24,84,113,13,9,71,104,0.15476190476190477,0.8452380952380952,0.07964601769911504,0.9203539823008849
SF-K15-,SF-G25,27,18,11,1,16,17,0.4074074074074074,0.5925925925925926,0.05555555555555555,0.9444444444444444
SF-K15-,SF-F23,28,24,3,2,25,22,0.10714285714285714,0.8928571428571429,0.08333333333333333,0.9166666666666666
SF-K15-,SF-E23,35,34,4,1,31,33,0.11428571428571428,0.8857142857142857,0.029411764705882353,0.9705882352941176
SF-K15-,SF-D24,11,7,3,2,8,5,0.2727272727272727,0.7272727272727273,0.2857142857142857,0.7142857142857143
SF-K15-,SF-C22,13,17,0,1,13,16,0.0,1.0,0.058823529411764705,0.9411764705882353
SF-K15-,SF-B22,5,12,2,4,3,8,0.4,0.6,0.3333333333333333,0.6666666666666666
SF-K15-,SF-J17,129,92,66,21,63,71,0.5116279069767442,0.4883720930232558,0.22826086956521738,0.7717391304347826
SF-K15-,SF-I19,77,32,9,4,68,28,0.11688311688311688,0.8831168831168831,0.125,0.875
SF-K15-,SF-I20,17,11,3,1,14,10,0.17647058823529413,0.8235294117647058,0.09090909090909091,0.9090909090909091
SF-K15-,SF-H16,87,53,35,12,52,41,0.40229885057471265,0.5977011494252874,0.22641509433962265,0.7735849056603774
SF-K15-,SF-H19,12,7,6,3,6,4,0.5,0.5,0.42857142857142855,0.5714285714285714
SF-K15-,SF-H20,12,22,8,8,4,14,0.6666666666666666,0.3333333333333333,0.36363636363636365,0.6363636363636364
SF-K15-,SF-H18,17,18,3,2,14,16,0.17647058823529413,0.8235294117647058,0.1111111111111111,0.8888888888888888
SF-K15-,SF-G19,24,33,9,11,15,22,0.375,0.625,0.3333333333333333,0.6666666666666666
SF-K15-,SF-G17,4,10,4,3,0,7,1.0,0.0,0.3,0.7
SF-K15-,SF-G18,27,18,12,7,15,11,0.4444444444444444,0.5555555555555556,0.3888888888888889,0.6111111111111112
SF-K15-,SF-G20,40,25,9,5,31,20,0.225,0.775,0.2,0.8
SF-K15-,SF-F19,25,19,3,3,22,16,0.12,0.88,0.15789473684210525,0.8421052631578947
SF-K15-,SF-E18,23,21,5,2,18,19,0.21739130434782608,0.782608695652174,0.09523809523809523,0.9047619047619048
SF-K15-,SF-E20,16,18,4,2,12,16,0.25,0.75,0.1111111111111111,0.8888888888888888
SF-K15-,SF-H30,1,2,0,0,1,2,0.0,1.0,0.0,1.0
SF-K15-,SF-G30-2,19,20,0,0,19,20,0.0,1.0,0.0,1.0
SF-K15-,SF-F30-1,1,4,0,0,1,4,0.0,1.0,0.0,1.0
SF-K15-,SF-E29-2,14,8,0,3,14,5,0.0,1.0,0.375,0.625
SF-K15-,SF-E29-1,6,10,2,3,4,7,0.3333333333333333,0.6666666666666666,0.3,0.7
SF-K15-,SF-D28,5,2,1,0,4,2,0.2,0.8,0.0,1.0
SF-K15-,SF-G29-2,13,14,5,5,8,9,0.38461538461538464,0.6153846153846154,0.35714285714285715,0.6428571428571429
SF-K15-,SF-G29-1,4,3,0,1,4,2,0.0,1.0,0.3333333333333333,0.6666666666666666
SF-K15-,SF-G30-1,9,7,1,0,8,7,0.1111111111111111,0.8888888888888888,0.0,1.0
SF-K15-,SF-G29-3,4,4,0,0,4,4,0.0,1.0,0.0,1.0
SF-K15-,SF-F30-2,3,2,0,1,3,1,0.0,1.0,0.5,0.5
SF-K15-,SF-E29-3,3,4,0,1,3,3,0.0,1.0,0.25,0.75
SF-K15-,SF-F28-1,4,5,3,2,1,3,0.75,0.25,0.4,0.6
SF-K15-,SF-E28,2,1,0,0,2,1,0.0,1.0,0.0,1.0
SF-K15-,SF-J10,70,109,50,57,20,52,0.7142857142857143,0.2857142857142857,0.5229357798165137,0.47706422018348627
SF-K15-,SF-J12,71,89,37,43,34,46,0.5211267605633803,0.4788732394366197,0.48314606741573035,0.5168539325842697
SF-K15-,SF-J13,46,41,30,17,16,24,0.6521739130434783,0.34782608695652173,0.4146341463414634,0.5853658536585366
SF-K15-,SF-J15,25,11,10,1,15,10,0.4,0.6,0.09090909090909091,0.9090909090909091
SF-K15-,SF-J14,13,3,7,0,6,3,0.5384615384615384,0.46153846153846156,0.0,1.0
SF-K15-,SF-H13,19,15,7,2,12,13,0.3684210526315789,0.631578947368421,0.13333333333333333,0.8666666666666667
SF-K15-,SF-I16,32,18,15,4,17,14,0.46875,0.53125,0.2222222222222222,0.7777777777777778
SF-K15-,SF-H12,33,19,12,4,21,15,0.36363636363636365,0.6363636363636364,0.21052631578947367,0.7894736842105263
SF-K15-,SF-G10-2,17,9,3,1,14,8,0.17647058823529413,0.8235294117647058,0.1111111111111111,0.8888888888888888
SF-K15-,SF-H15,18,4,10,2,8,2,0.5555555555555556,0.4444444444444444,0.5,0.5
SF-K15-,SF-G9,19,29,7,16,12,13,0.3684210526315789,0.631578947368421,0.5517241379310345,0.4482758620689655
SF-K15-,SF-H14,12,7,5,1,7,6,0.4166666666666667,0.5833333333333334,0.14285714285714285,0.8571428571428571
SF-K15-,SF-G13,35,37,12,9,23,28,0.34285714285714286,0.6571428571428571,0.24324324324324326,0.7567567567567568
SF-K15-,SF-G11,30,32,9,11,21,21,0.3,0.7,0.34375,0.65625
SF-K15-,SF-G12,76,84,7,19,69,65,0.09210526315789473,0.9078947368421053,0.2261904761904762,0.7738095238095238
SF-K15-,SF-G10-1,13,10,2,3,11,7,0.15384615384615385,0.8461538461538461,0.3,0.7
SF-K15-,SF-F15,18,23,11,4,7,19,0.6111111111111112,0.3888888888888889,0.17391304347826086,0.8260869565217391
SF-K15-,SF-F16,11,1,6,0,5,1,0.5454545454545454,0.45454545454545453,0.0,1.0
SF-K15-,SF-C21,4,2,0,0,4,2,0.0,1.0,0.0,1.0
SF-K15-,SF-C20,10,16,1,1,9,15,0.1,0.9,0.0625,0.9375
SF-K15-,SF-B21,3,4,1,1,2,3,0.3333333333333333,0.6666666666666666,0.25,0.75
SF-K15-,SF-B19,1,10,0,3,1,7,0.0,1.0,0.3,0.7
SF-K15-,SF-A20,4,7,3,1,1,6,0.75,0.25,0.14285714285714285,0.8571428571428571
SF-K15-,SF-A19,3,8,0,3,3,5,0.0,1.0,0.375,0.625
SF-K15-,SF-C26,20,14,1,1,19,13,0.05,0.95,0.07142857142857142,0.9285714285714286
SF-K15-,SF-C25,15,11,1,0,14,11,0.06666666666666667,0.9333333333333333,0.0,1.0
SF-K15-,SF-B25,4,3,0,0,4,3,0.0,1.0,0.0,1.0
SF-K15-,SF-E27,7,3,0,1,7,2,0.0,1.0,0.3333333333333333,0.6666666666666666
SF-K15-,SF-D27,16,2,0,0,16,2,0.0,1.0,0.0,1.0
SF-K15-,SF-J1,238,461,107,229,131,232,0.4495798319327731,0.5504201680672269,0.4967462039045553,0.5032537960954447
SF-K15-,SF-H0,55,105,24,58,31,47,0.43636363636363634,0.5636363636363636,0.5523809523809524,0.44761904761904764
SF-K15-,SF-J3,27,62,14,42,13,20,0.5185185185185185,0.48148148148148145,0.6774193548387096,0.3225806451612903
SF-K15-,SF-J5,22,51,7,28,15,23,0.3181818181818182,0.6818181818181818,0.5490196078431373,0.45098039215686275
SF-K15-,SF-G6,8,24,6,8,2,16,0.75,0.25,0.3333333333333333,0.6666666666666666
SF-K15-,SF-G8,19,25,7,7,12,18,0.3684210526315789,0.631578947368421,0.28,0.72
SF-K15-,SF-G5,26,20,5,8,21,12,0.19230769230769232,0.8076923076923077,0.4,0.6
SF-K15-,SF-G7,32,60,17,9,15,51,0.53125,0.46875,0.15,0.85
SF-K15-,SF-F9,17,41,2,18,15,23,0.11764705882352941,0.8823529411764706,0.43902439024390244,0.5609756097560976
SF-K15-,SF-H25,6,15,3,4,3,11,0.5,0.5,0.26666666666666666,0.7333333333333333
SF-K15-,SF-G26,14,5,0,0,14,5,0.0,1.0,0.0,1.0
SF-K15-,SF-K21,68,79,22,31,46,48,0.3235294117647059,0.6764705882352942,0.3924050632911392,0.6075949367088608
SF-K15-,SF-K22-1,31,18,15,9,16,9,0.4838709677419355,0.5161290322580645,0.5,0.5
SF-K15-,SF-J23-1,69,86,20,31,49,55,0.2898550724637681,0.7101449275362319,0.36046511627906974,0.6395348837209303
SF-K15-,SF-J22-1,30,37,7,13,23,24,0.23333333333333334,0.7666666666666667,0.35135135135135137,0.6486486486486487
SF-K15-,SF-J22-2,42,18,4,5,38,13,0.09523809523809523,0.9047619047619048,0.2777777777777778,0.7222222222222222
SF-K15-,SF-J21,77,53,28,19,49,34,0.36363636363636365,0.6363636363636364,0.3584905660377358,0.6415094339622641
SF-K15-,SF-I21,13,35,3,5,10,30,0.23076923076923078,0.7692307692307693,0.14285714285714285,0.8571428571428571
SF-K15-,SF-I22,17,5,4,1,13,4,0.23529411764705882,0.7647058823529411,0.2,0.8
SF-K15-,SF-I23-2,16,15,8,8,8,7,0.5,0.5,0.5333333333333333,0.4666666666666667
SF-K15-,SF-I24,13,13,4,7,9,6,0.3076923076923077,0.6923076923076923,0.5384615384615384,0.46153846153846156
SF-K15-,SF-I23-1,11,6,2,2,9,4,0.18181818181818182,0.8181818181818182,0.3333333333333333,0.6666666666666666
SF-K15-,SF-F26,31,29,5,9,26,20,0.16129032258064516,0.8387096774193549,0.3103448275862069,0.6896551724137931
SF-K15-,SF-M13,60,56,38,27,22,29,0.6333333333333333,0.36666666666666664,0.48214285714285715,0.5178571428571429
SF-K15-,SF-M15,57,29,24,10,33,19,0.42105263157894735,0.5789473684210527,0.3448275862068966,0.6551724137931034
SF-K15-,SF-L19,65,44,21,24,44,20,0.3230769230769231,0.676923076923077,0.5454545454545454,0.45454545454545453
SF-K15-,SF-L20,46,29,7,10,39,19,0.15217391304347827,0.8478260869565217,0.3448275862068966,0.6551724137931034
SF-K15-,SF-N20-1,18,13,4,5,14,8,0.2222222222222222,0.7777777777777778,0.38461538461538464,0.6153846153846154
SF-K15-,SF-M20,87,101,27,41,60,60,0.3103448275862069,0.6896551724137931,0.40594059405940597,0.594059405940594
SF-K15-,SF-K17-2,47,28,33,8,14,20,0.7021276595744681,0.2978723404255319,0.2857142857142857,0.7142857142857143
SF-K15-,SF-K20,135,71,70,39,65,32,0.5185185185185185,0.48148148148148145,0.5492957746478874,0.4507042253521127
SF-K15-,SF-K19,155,85,74,38,81,47,0.4774193548387097,0.5225806451612903,0.4470588235294118,0.5529411764705883
SF-K15-,SF-K18,196,154,117,87,79,67,0.5969387755102041,0.4030612244897959,0.564935064935065,0.43506493506493504
SF-K15-,SF-K17,219,129,148,65,71,64,0.6757990867579908,0.3242009132420091,0.5038759689922481,0.49612403100775193
SF-K15-,SF-J16,130,64,69,25,61,39,0.5307692307692308,0.46923076923076923,0.390625,0.609375
SF-K15-,SF-J18,179,130,86,54,93,76,0.48044692737430167,0.5195530726256983,0.4153846153846154,0.5846153846153846
SF-K15-,SF-J20,14,20,7,10,7,10,0.5,0.5,0.5,0.5
SF-K15-,SF-J19,72,33,16,5,56,28,0.2222222222222222,0.7777777777777778,0.15151515151515152,0.8484848484848485
SF-K15-,SF-O12,2,4,2,3,0,1,1.0,0.0,0.75,0.25
SF-K15-,SF-M12,42,48,27,24,15,24,0.6428571428571429,0.35714285714285715,0.5,0.5
SF-K15-,SF-M10,72,92,39,47,33,45,0.5416666666666666,0.4583333333333333,0.5108695652173914,0.4891304347826087
SF-K15-,SF-M11,189,216,130,134,59,82,0.6878306878306878,0.31216931216931215,0.6203703703703703,0.37962962962962965
SF-K15-,SF-R19,10,19,2,1,8,18,0.2,0.8,0.05263157894736842,0.9473684210526315
SF-K15-,SF-R20,4,4,0,0,4,4,0.0,1.0,0.0,1.0
SF-K15-,SF-Q21-2,13,6,3,0,10,6,0.23076923076923078,0.7692307692307693,0.0,1.0
SF-K15-,SF-Q21-1,14,7,8,2,6,5,0.5714285714285714,0.42857142857142855,0.2857142857142857,0.7142857142857143
SF-K15-,SF-P21,26,28,3,3,23,25,0.11538461538461539,0.8846153846153846,0.10714285714285714,0.8928571428571429
SF-K15-,SF-O18,44,36,15,9,29,27,0.3409090909090909,0.6590909090909091,0.25,0.75
SF-K15-,SF-O19,68,53,3,17,65,36,0.04411764705882353,0.9558823529411765,0.32075471698113206,0.6792452830188679
SF-K15-,SF-O21,72,96,13,21,59,75,0.18055555555555555,0.8194444444444444,0.21875,0.78125
SF-K15-,SF-O22,27,54,9,22,18,32,0.3333333333333333,0.6666666666666666,0.4074074074074074,0.5925925925925926
SF-K15-,SF-N21,47,43,25,21,22,22,0.5319148936170213,0.46808510638297873,0.4883720930232558,0.5116279069767442
SF-K15-,SF-N20-2,34,23,12,10,22,13,0.35294117647058826,0.6470588235294118,0.43478260869565216,0.5652173913043478
SF-K15-,SF-M21,42,52,17,17,25,35,0.40476190476190477,0.5952380952380952,0.3269230769230769,0.6730769230769231
SF-K15-,SF-L21,139,106,30,39,109,67,0.2158273381294964,0.7841726618705036,0.36792452830188677,0.6320754716981132
SF-K15-,SF-Q30,3,2,2,2,1,0,0.6666666666666666,0.3333333333333333,1.0,0.0
SF-K15-,SF-P30,5,2,0,1,5,1,0.0,1.0,0.5,0.5
SF-K15-,SF-O30-2,3,2,0,0,3,2,0.0,1.0,0.0,1.0
SF-K15-,SF-O30,26,43,0,33,26,10,0.0,1.0,0.7674418604651163,0.23255813953488372
SF-K15-,SF-N27,15,12,2,5,13,7,0.13333333333333333,0.8666666666666667,0.4166666666666667,0.5833333333333334
SF-K15-,SF-N29,5,5,3,0,2,5,0.6,0.4,0.0,1.0
SF-K15-,SF-N28,22,8,12,3,10,5,0.5454545454545454,0.45454545454545453,0.375,0.625
SF-K15-,SF-L30-1,19,40,7,31,12,9,0.3684210526315789,0.631578947368421,0.775,0.225
SF-K15-,SF-K30-2,2,2,2,2,0,0,1.0,0.0,1.0,0.0
SF-K15-,SF-L29,20,15,3,3,17,12,0.15,0.85,0.2,0.8
SF-K15-,SF-J29-1,3,5,0,0,3,5,0.0,1.0,0.0,1.0
SF-K15-,SF-I30,5,3,5,3,0,0,1.0,0.0,1.0,0.0
SF-K15-,SF-I27,11,3,0,2,11,1,0.0,1.0,0.6666666666666666,0.3333333333333333
SF-K15-,SF-I28,9,7,1,1,8,6,0.1111111111111111,0.8888888888888888,0.14285714285714285,0.8571428571428571
SF-K15-,SF-I30-2,1,2,1,0,0,2,1.0,0.0,0.0,1.0
SF-K15-,SF I29-1,1,1,0,0,1,1,0.0,1.0,0.0,1.0
SF-K15-,SF-H28,4,3,2,0,2,3,0.5,0.5,0.0,1.0
SF-K15-,SF-S24,9,6,1,4,8,2,0.1111111111111111,0.8888888888888888,0.6666666666666666,0.3333333333333333
SF-K15-,SF-R24,19,14,3,4,16,10,0.15789473684210525,0.8421052631578947,0.2857142857142857,0.7142857142857143
SF-K15-,SF-R26,2,2,0,0,2,2,0.0,1.0,0.0,1.0
SF-K15-,SF-Q26,3,5,1,3,2,2,0.3333333333333333,0.6666666666666666,0.6,0.4
SF-K15-,SF-P26,12,12,0,3,12,9,0.0,1.0,0.25,0.75
SF-K15-,SF-O25-2,7,15,4,12,3,3,0.5714285714285714,0.42857142857142855,0.8,0.2
SF-K15-,SF-N22-1B,4,7,1,0,3,7,0.25,0.75,0.0,1.0
SF-K15-,SF-N26,5,5,0,0,5,5,0.0,1.0,0.0,1.0
SF-K15-,SF-N25,8,3,5,2,3,1,0.625,0.375,0.6666666666666666,0.3333333333333333
SF-K15-,SF-T21,3,7,0,0,3,7,0.0,1.0,0.0,1.0
SF-K15-,SF-T22,12,25,0,4,12,21,0.0,1.0,0.16,0.84
SF-K15-,SF-S22-2,5,1,1,0,4,1,0.2,0.8,0.0,1.0
SF-K15-,SF-S22-1,39,21,22,9,17,12,0.5641025641025641,0.4358974358974359,0.42857142857142855,0.5714285714285714
SF-K15-,SF-Q23-3,13,13,1,1,12,12,0.07692307692307693,0.9230769230769231,0.07692307692307693,0.9230769230769231
SF-K15-,SF-Q22-1,22,19,0,4,22,15,0.0,1.0,0.21052631578947367,0.7894736842105263
SF-K15-,SF-Q22-2,36,23,7,5,29,18,0.19444444444444445,0.8055555555555556,0.21739130434782608,0.782608695652174
SF-K15-,SF-P22,24,27,5,12,19,15,0.20833333333333334,0.7916666666666666,0.4444444444444444,0.5555555555555556
SF-K15-,SF-W19,1,2,0,0,1,2,0.0,1.0,0.0,1.0
SF-K15-,SF-U21,4,1,3,0,1,1,0.75,0.25,0.0,1.0
SF-K15-,SF-T20,16,7,1,0,15,7,0.0625,0.9375,0.0,1.0
SF-K15-,SF-S21,10,5,6,2,4,3,0.6,0.4,0.4,0.6
SF-K15-,SF-W14,2,4,0,2,2,2,0.0,1.0,0.5,0.5
SF-K15-,SF-W8,1,6,0,6,1,0,0.0,1.0,1.0,0.0
SF-K15-,SF-Y14,2,1,0,0,2,1,0.0,1.0,0.0,1.0
SF-K19,SF-M25,6,7,1,2,5,5,0.16666666666666666,0.8333333333333334,0.2857142857142857,0.7142857142857143
SF-K19,SF-M26-2,2,6,2,6,0,0,1.0,0.0,1.0,0.0
SF-K19,SF-L27,1,1,0,1,1,0,0.0,1.0,1.0,0.0
SF-K19,SF-K26,4,6,0,2,4,4,0.0,1.0,0.3333333333333333,0.6666666666666666
SF-K19,SF-J27,9,9,1,1,8,8,0.1111111111111111,0.8888888888888888,0.1111111111111111,0.8888888888888888
SF-K19,SF-M30,40,100,2,7,38,93,0.05,0.95,0.07,0.93
SF-K19,SF-L27-2,1,1,0,0,1,1,0.0,1.0,0.0,1.0
SF-K19,SF-J29,6,23,1,6,5,17,0.16666666666666666,0.8333333333333334,0.2608695652173913,0.7391304347826086
SF-K19,SF-L26,17,23,8,13,9,10,0.47058823529411764,0.5294117647058824,0.5652173913043478,0.43478260869565216
SF-K19,SF-M28,10,5,2,1,8,4,0.2,0.8,0.2,0.8
SF-K19,SF-M27,1,1,0,0,1,1,0.0,1.0,0.0,1.0
SF-K19,SF-L25,11,16,2,5,9,11,0.18181818181818182,0.8181818181818182,0.3125,0.6875
SF-K19,SF-M24,4,15,1,13,3,2,0.25,0.75,0.8666666666666667,0.13333333333333333
SF-K19,SF-L24,3,7,1,4,2,3,0.3333333333333333,0.6666666666666666,0.5714285714285714,0.42857142857142855
SF-K19,SF-N23,10,16,3,7,7,9,0.3,0.7,0.4375,0.5625
SF-K19,SF-N24-2,12,14,3,4,9,10,0.25,0.75,0.2857142857142857,0.7142857142857143
SF-K19,SF-K27-2,4,12,3,2,1,10,0.75,0.25,0.16666666666666666,0.8333333333333334
SF-K19,SF-J26-2,4,6,0,3,4,3,0.0,1.0,0.5,0.5
SF-K19,SF-L28,4,4,0,1,4,3,0.0,1.0,0.25,0.75
SF-K19,SF-K28,2,2,0,0,2,2,0.0,1.0,0.0,1.0
SF-K19,SF-K29-1,1,3,1,1,0,2,1.0,0.0,0.3333333333333333,0.6666666666666666
SF-K19,SF-K27,3,1,1,0,2,1,0.3333333333333333,0.6666666666666666,0.0,1.0
SF-K19,SF-K25,23,37,2,12,21,25,0.08695652173913043,0.9130434782608695,0.32432432432432434,0.6756756756756757
SF-K19,SF-J25,19,14,3,6,16,8,0.15789473684210525,0.8421052631578947,0.42857142857142855,0.5714285714285714
SF-K19,SF-H26-2,2,3,1,0,1,3,0.5,0.5,0.0,1.0
SF-K19,SF-P24,3,11,1,2,2,9,0.3333333333333333,0.6666666666666666,0.18181818181818182,0.8181818181818182
SF-K19,SF-N22-1A,3,5,0,1,3,4,0.0,1.0,0.2,0.8
SF-K19,SF-J24,7,20,1,8,6,12,0.14285714285714285,0.8571428571428571,0.4,0.6
SF-K19,SF-O24,12,17,9,12,3,5,0.75,0.25,0.7058823529411765,0.29411764705882354
SF-K19,SF-J26,1,2,0,1,1,1,0.0,1.0,0.5,0.5
SF-K19,SF-I26-,3,3,1,0,2,3,0.3333333333333333,0.6666666666666666,0.0,1.0
SF-K19,SF-I25,27,37,4,8,23,29,0.14814814814814814,0.8518518518518519,0.21621621621621623,0.7837837837837838
SF-K19,SF-H26,55,39,13,16,42,23,0.23636363636363636,0.7636363636363637,0.41025641025641024,0.5897435897435898
SF-K19,SF-O23,3,14,1,8,2,6,0.3333333333333333,0.6666666666666666,0.5714285714285714,0.42857142857142855
SF-K19,SF-H27-1,2,3,0,2,2,1,0.0,1.0,0.6666666666666666,0.3333333333333333
SF-K19,SF-F28-2,21,19,10,5,11,14,0.47619047619047616,0.5238095238095238,0.2631578947368421,0.7368421052631579
SF-K19,SF-G27,32,29,5,14,27,15,0.15625,0.84375,0.4827586206896552,0.5172413793103449
SF-K19,SF-M22-2,39,70,9,43,30,27,0.23076923076923078,0.7692307692307693,0.6142857142857143,0.38571428571428573
SF-K19,SF-L22,15,24,0,8,15,16,0.0,1.0,0.3333333333333333,0.6666666666666666
SF-K19,SF-F27,13,19,0,9,13,10,0.0,1.0,0.47368421052631576,0.5263157894736842
SF-K19,SF-N22-2,43,70,9,27,34,43,0.20930232558139536,0.7906976744186046,0.38571428571428573,0.6142857142857143
SF-K19,SF-G28-2,2,1,0,0,2,1,0.0,1.0,0.0,1.0
SF-K19,SF-G28-1,5,3,4,0,1,3,0.8,0.2,0.0,1.0
SF-K19,SF-M22-1,4,31,1,17,3,14,0.25,0.75,0.5483870967741935,0.45161290322580644
SF-K19,SF-O25-1,7,4,1,2,6,2,0.14285714285714285,0.8571428571428571,0.5,0.5
SF-K19,SF-K22-2,13,15,8,6,5,9,0.6153846153846154,0.38461538461538464,0.4,0.6
SF-K19,SF-K24,5,7,1,3,4,4,0.2,0.8,0.42857142857142855,0.5714285714285714
SF-K19,SF-J23-2,12,30,4,13,8,17,0.3333333333333333,0.6666666666666666,0.43333333333333335,0.5666666666666667
SF-K19,SF-G23,5,2,1,2,4,0,0.2,0.8,1.0,0.0
SF-K19,SF-G24,25,39,1,5,24,34,0.04,0.96,0.1282051282051282,0.8717948717948718
SF-K19,SF-G25,20,23,2,0,18,23,0.1,0.9,0.0,1.0
SF-K19,SF-F23,59,45,1,1,58,44,0.01694915254237288,0.9830508474576272,0.022222222222222223,0.9777777777777777
SF-K19,SF-E23,14,17,4,4,10,13,0.2857142857142857,0.7142857142857143,0.23529411764705882,0.7647058823529411
SF-K19,SF-D24,7,2,1,0,6,2,0.14285714285714285,0.8571428571428571,0.0,1.0
SF-K19,SF-C22,9,4,1,0,8,4,0.1111111111111111,0.8888888888888888,0.0,1.0
SF-K19,SF-B22,5,19,1,0,4,19,0.2,0.8,0.0,1.0
SF-K19,SF-J17,26,20,17,3,9,17,0.6538461538461539,0.34615384615384615,0.15,0.85
SF-K19,SF-I19,9,8,4,5,5,3,0.4444444444444444,0.5555555555555556,0.625,0.375
SF-K19,SF-I20,3,3,0,1,3,2,0.0,1.0,0.3333333333333333,0.6666666666666666
SF-K19,SF-H16,22,29,5,2,17,27,0.22727272727272727,0.7727272727272727,0.06896551724137931,0.9310344827586207
SF-K19,SF-H19,19,8,3,2,16,6,0.15789473684210525,0.8421052631578947,0.25,0.75
SF-K19,SF-H20,13,6,5,2,8,4,0.38461538461538464,0.6153846153846154,0.3333333333333333,0.6666666666666666
SF-K19,SF-H18,21,7,4,1,17,6,0.19047619047619047,0.8095238095238095,0.14285714285714285,0.8571428571428571
SF-K19,SF-G19,12,12,0,5,12,7,0.0,1.0,0.4166666666666667,0.5833333333333334
SF-K19,SF-G17,7,12,4,2,3,10,0.5714285714285714,0.42857142857142855,0.16666666666666666,0.8333333333333334
SF-K19,SF-G18,22,26,3,6,19,20,0.13636363636363635,0.8636363636363636,0.23076923076923078,0.7692307692307693
SF-K19,SF-G20,44,38,2,4,42,34,0.045454545454545456,0.9545454545454546,0.10526315789473684,0.8947368421052632
SF-K19,SF-F19,20,26,1,6,19,20,0.05,0.95,0.23076923076923078,0.7692307692307693
SF-K19,SF-E18,16,11,3,5,13,6,0.1875,0.8125,0.45454545454545453,0.5454545454545454
SF-K19,SF-E20,11,21,2,0,9,21,0.18181818181818182,0.8181818181818182,0.0,1.0
SF-K19,SF-H30,3,4,0,2,3,2,0.0,1.0,0.5,0.5
SF-K19,SF-G30-2,8,10,2,2,6,8,0.25,0.75,0.2,0.8
SF-K19,SF-F30-1,3,3,1,1,2,2,0.3333333333333333,0.6666666666666666,0.3333333333333333,0.6666666666666666
SF-K19,SF-E29-2,7,20,1,8,6,12,0.14285714285714285,0.8571428571428571,0.4,0.6
SF-K19,SF-E29-1,3,15,1,5,2,10,0.3333333333333333,0.6666666666666666,0.3333333333333333,0.6666666666666666
SF-K19,SF-D28,2,3,0,1,2,2,0.0,1.0,0.3333333333333333,0.6666666666666666
SF-K19,SF-A27,2,5,1,1,1,4,0.5,0.5,0.2,0.8
SF-K19,SF-G29-2,7,8,2,1,5,7,0.2857142857142857,0.7142857142857143,0.125,0.875
SF-K19,SF-G29-1,8,14,1,6,7,8,0.125,0.875,0.42857142857142855,0.5714285714285714
SF-K19,SF-G29-3,5,4,0,0,5,4,0.0,1.0,0.0,1.0
SF-K19,SF-F30-2,3,4,0,1,3,3,0.0,1.0,0.25,0.75
SF-K19,SF-E29-3,12,11,3,3,9,8,0.25,0.75,0.2727272727272727,0.7272727272727273
SF-K19,SF-F28-1,2,3,0,1,2,2,0.0,1.0,0.3333333333333333,0.6666666666666666
SF-K19,SF-E28-2,7,6,2,4,5,2,0.2857142857142857,0.7142857142857143,0.6666666666666666,0.3333333333333333
SF-K19,SF-E28,4,2,0,1,4,1,0.0,1.0,0.5,0.5
SF-K19,SF-J10,27,31,14,19,13,12,0.5185185185185185,0.48148148148148145,0.6129032258064516,0.3870967741935484
SF-K19,SF-J12,34,25,14,10,20,15,0.4117647058823529,0.5882352941176471,0.4,0.6
SF-K19,SF-J13,17,20,6,2,11,18,0.35294117647058826,0.6470588235294118,0.1,0.9
SF-K19,SF-J15,6,1,3,0,3,1,0.5,0.5,0.0,1.0
SF-K19,SF-J14,6,4,1,0,5,4,0.16666666666666666,0.8333333333333334,0.0,1.0
SF-K19,SF-H13,10,16,4,5,6,11,0.4,0.6,0.3125,0.6875
SF-K19,SF-I16,16,3,12,1,4,2,0.75,0.25,0.3333333333333333,0.6666666666666666
SF-K19,SF-H12,9,7,3,2,6,5,0.3333333333333333,0.6666666666666666,0.2857142857142857,0.7142857142857143
SF-K19,SF-G10-2,3,6,0,5,3,1,0.0,1.0,0.8333333333333334,0.16666666666666666
SF-K19,SF-H15,27,2,6,2,21,0,0.2222222222222222,0.7777777777777778,1.0,0.0
SF-K19,SF-G9,1,1,0,0,1,1,0.0,1.0,0.0,1.0
SF-K19,SF-H14,4,2,1,0,3,2,0.25,0.75,0.0,1.0
SF-K19,SF-G13,14,13,6,3,8,10,0.42857142857142855,0.5714285714285714,0.23076923076923078,0.7692307692307693
SF-K19,SF-G11,15,11,4,7,11,4,0.26666666666666666,0.7333333333333333,0.6363636363636364,0.36363636363636365
SF-K19,SF-G12,11,14,2,3,9,11,0.18181818181818182,0.8181818181818182,0.21428571428571427,0.7857142857142857
SF-K19,SF-G10-1,1,2,0,0,1,2,0.0,1.0,0.0,1.0
SF-K19,SF-F15,7,3,2,1,5,2,0.2857142857142857,0.7142857142857143,0.3333333333333333,0.6666666666666666
SF-K19,SF-F16,11,10,2,1,9,9,0.18181818181818182,0.8181818181818182,0.1,0.9
SF-K19,SF-C21,5,2,0,0,5,2,0.0,1.0,0.0,1.0
SF-K19,SF-C20,9,6,1,2,8,4,0.1111111111111111,0.8888888888888888,0.3333333333333333,0.6666666666666666
SF-K19,SF-B21,1,3,1,1,0,2,1.0,0.0,0.3333333333333333,0.6666666666666666
SF-K19,SF-B19,3,13,0,3,3,10,0.0,1.0,0.23076923076923078,0.7692307692307693
SF-K19,SF-A20,2,9,0,6,2,3,0.0,1.0,0.6666666666666666,0.3333333333333333
SF-K19,SF-A19,1,2,1,0,0,2,1.0,0.0,0.0,1.0
SF-K19,SF-C25,14,9,4,2,10,7,0.2857142857142857,0.7142857142857143,0.2222222222222222,0.7777777777777778
SF-K19,SF-B25,1,11,0,4,1,7,0.0,1.0,0.36363636363636365,0.6363636363636364
SF-K19,SF-E27,2,4,0,0,2,4,0.0,1.0,0.0,1.0
SF-K19,SF-D27,4,10,1,2,3,8,0.25,0.75,0.2,0.8
SF-K19,SF-B28,1,3,0,2,1,1,0.0,1.0,0.6666666666666666,0.3333333333333333
SF-K19,SF-J1,65,71,21,38,44,33,0.3230769230769231,0.676923076923077,0.5352112676056338,0.4647887323943662
SF-K19,SF-H0,12,19,2,9,10,10,0.16666666666666666,0.8333333333333334,0.47368421052631576,0.5263157894736842
SF-K19,SF-J3,7,8,2,4,5,4,0.2857142857142857,0.7142857142857143,0.5,0.5
SF-K19,SF-J5,6,8,2,6,4,2,0.3333333333333333,0.6666666666666666,0.75,0.25
SF-K19,SF-G6,2,2,0,1,2,1,0.0,1.0,0.5,0.5
SF-K19,SF-G8,4,4,2,1,2,3,0.5,0.5,0.25,0.75
SF-K19,SF-G5,7,7,0,2,7,5,0.0,1.0,0.2857142857142857,0.7142857142857143
SF-K19,SF-G7,14,11,4,3,10,8,0.2857142857142857,0.7142857142857143,0.2727272727272727,0.7272727272727273
SF-K19,SF-F9,6,6,3,3,3,3,0.5,0.5,0.5,0.5
SF-K19,SF-H25,4,1,2,0,2,1,0.5,0.5,0.0,1.0
SF-K19,SF-G26,9,5,1,4,8,1,0.1111111111111111,0.8888888888888888,0.8,0.2
SF-K19,SF-K21,120,100,74,51,46,49,0.6166666666666667,0.38333333333333336,0.51,0.49
SF-K19,SF-K22-1,16,23,9,12,7,11,0.5625,0.4375,0.5217391304347826,0.4782608695652174
SF-K19,SF-J23-1,92,117,16,36,76,81,0.17391304347826086,0.8260869565217391,0.3076923076923077,0.6923076923076923
SF-K19,SF-J22-1,38,48,6,25,32,23,0.15789473684210525,0.8421052631578947,0.5208333333333334,0.4791666666666667
SF-K19,SF-J22-2,11,8,0,5,11,3,0.0,1.0,0.625,0.375
SF-K19,SF-J21,59,73,11,33,48,40,0.1864406779661017,0.8135593220338984,0.4520547945205479,0.547945205479452
SF-K19,SF-I21,4,1,1,1,3,0,0.25,0.75,1.0,0.0
SF-K19,SF-I22,6,3,3,0,3,3,0.5,0.5,0.0,1.0
SF-K19,SF-I23-2,7,9,2,5,5,4,0.2857142857142857,0.7142857142857143,0.5555555555555556,0.4444444444444444
SF-K19,SF-I24,10,7,3,2,7,5,0.3,0.7,0.2857142857142857,0.7142857142857143
SF-K19,SF-I23-1,5,11,1,3,4,8,0.2,0.8,0.2727272727272727,0.7272727272727273
SF-K19,SF-F26,23,19,2,2,21,17,0.08695652173913043,0.9130434782608695,0.10526315789473684,0.8947368421052632
SF-K19,SF-M13,219,117,97,28,122,89,0.4429223744292237,0.5570776255707762,0.23931623931623933,0.7606837606837606
SF-K19,SF-M15,74,54,34,13,40,41,0.4594594594594595,0.5405405405405406,0.24074074074074073,0.7592592592592593
SF-K19,SF-L19,45,46,16,23,29,23,0.35555555555555557,0.6444444444444445,0.5,0.5
SF-K19,SF-L20,76,69,38,47,38,22,0.5,0.5,0.6811594202898551,0.3188405797101449
SF-K19,SF-N20-1,11,12,2,4,9,8,0.18181818181818182,0.8181818181818182,0.3333333333333333,0.6666666666666666
SF-K19,SF-M20,104,111,39,71,65,40,0.375,0.625,0.6396396396396397,0.36036036036036034
SF-K19,SF-K17-2,32,32,21,12,11,20,0.65625,0.34375,0.375,0.625
SF-K19,SF-K20,86,67,59,41,27,26,0.686046511627907,0.313953488372093,0.6119402985074627,0.3880597014925373
SF-K19,SF-K15-,85,155,38,74,47,81,0.4470588235294118,0.5529411764705883,0.4774193548387097,0.5225806451612903
SF-K19,SF-K18,78,59,60,39,18,20,0.7692307692307693,0.23076923076923078,0.6610169491525424,0.3389830508474576
SF-K19,SF-K17,49,49,32,34,17,15,0.6530612244897959,0.3469387755102041,0.6938775510204082,0.30612244897959184
SF-K19,SF-J16,14,13,3,6,11,7,0.21428571428571427,0.7857142857142857,0.46153846153846156,0.5384615384615384
SF-K19,SF-J18,30,27,16,11,14,16,0.5333333333333333,0.4666666666666667,0.4074074074074074,0.5925925925925926
SF-K19,SF-J20,6,6,5,3,1,3,0.8333333333333334,0.16666666666666666,0.5,0.5
SF-K19,SF-J19,12,12,4,2,8,10,0.3333333333333333,0.6666666666666666,0.16666666666666666,0.8333333333333334
SF-K19,SF-M12,37,27,22,7,15,20,0.5945945945945946,0.40540540540540543,0.25925925925925924,0.7407407407407407
SF-K19,SF-M10,11,23,6,11,5,12,0.5454545454545454,0.45454545454545453,0.4782608695652174,0.5217391304347826
SF-K19,SF-M11,44,65,17,31,27,34,0.38636363636363635,0.6136363636363636,0.47692307692307695,0.5230769230769231
SF-K19,SF-R19,5,8,3,2,2,6,0.6,0.4,0.25,0.75
SF-K19,SF-R20,5,7,0,1,5,6,0.0,1.0,0.14285714285714285,0.8571428571428571
SF-K19,SF-Q21-2,4,6,1,2,3,4,0.25,0.75,0.3333333333333333,0.6666666666666666
SF-K19,SF-Q21-1,3,3,1,0,2,3,0.3333333333333333,0.6666666666666666,0.0,1.0
SF-K19,SF-P21,30,22,8,7,22,15,0.26666666666666666,0.7333333333333333,0.3181818181818182,0.6818181818181818
SF-K19,SF-O18,51,42,1,4,50,38,0.0196078431372549,0.9803921568627451,0.09523809523809523,0.9047619047619048
SF-K19,SF-O19,20,16,7,10,13,6,0.35,0.65,0.625,0.375
SF-K19,SF-O21,67,123,12,68,55,55,0.1791044776119403,0.8208955223880597,0.5528455284552846,0.44715447154471544
SF-K19,SF-O22,30,40,10,24,20,16,0.3333333333333333,0.6666666666666666,0.6,0.4
SF-K19,SF-N21,43,23,10,10,33,13,0.23255813953488372,0.7674418604651163,0.43478260869565216,0.5652173913043478
SF-K19,SF-N20-2,27,10,5,5,22,5,0.18518518518518517,0.8148148148148148,0.5,0.5
SF-K19,SF-M21,55,79,41,63,14,16,0.7454545454545455,0.2545454545454545,0.7974683544303798,0.20253164556962025
SF-K19,SF-L21,102,75,45,44,57,31,0.4411764705882353,0.5588235294117647,0.5866666666666667,0.41333333333333333
SF-K19,SF-S29,1,1,0,1,1,0,0.0,1.0,1.0,0.0
SF-K19,SF-Q30,3,2,0,0,3,2,0.0,1.0,0.0,1.0
SF-K19,SF-P30,6,6,1,2,5,4,0.16666666666666666,0.8333333333333334,0.3333333333333333,0.6666666666666666
SF-K19,SF-O30-2,1,8,0,3,1,5,0.0,1.0,0.375,0.625
SF-K19,SF-O30,3,6,0,3,3,3,0.0,1.0,0.5,0.5
SF-K19,SF-N27,12,14,6,3,6,11,0.5,0.5,0.21428571428571427,0.7857142857142857
SF-K19,SF-N29,5,4,0,3,5,1,0.0,1.0,0.75,0.25
SF-K19,SF-N28,11,11,3,4,8,7,0.2727272727272727,0.7272727272727273,0.36363636363636365,0.6363636363636364
SF-K19,SF-L30-1,14,19,0,8,14,11,0.0,1.0,0.42105263157894735,0.5789473684210527
SF-K19,SF-L31-1,2,4,0,2,2,2,0.0,1.0,0.5,0.5
SF-K19,SF-K30-2,3,21,2,20,1,1,0.6666666666666666,0.3333333333333333,0.9523809523809523,0.047619047619047616
SF-K19,SF-L29,3,8,0,1,3,7,0.0,1.0,0.125,0.875
SF-K19,SF-J29-1,4,4,0,0,4,4,0.0,1.0,0.0,1.0
SF-K19,SF-I30,12,8,2,2,10,6,0.16666666666666666,0.8333333333333334,0.25,0.75
SF-K19,SF-I29-2,1,2,0,2,1,0,0.0,1.0,1.0,0.0
SF-K19,SF-I27,3,7,0,2,3,5,0.0,1.0,0.2857142857142857,0.7142857142857143
SF-K19,SF-I28,5,5,0,1,5,4,0.0,1.0,0.2,0.8
SF-K19,SF-I30-2,3,1,0,1,3,0,0.0,1.0,1.0,0.0
SF-K19,SF I29-1,1,2,0,0,1,2,0.0,1.0,0.0,1.0
SF-K19,SF-H28,4,2,3,0,1,2,0.75,0.25,0.0,1.0
SF-K19,SF-S24,8,11,1,3,7,8,0.125,0.875,0.2727272727272727,0.7272727272727273
SF-K19,SF-R24,21,26,7,2,14,24,0.3333333333333333,0.6666666666666666,0.07692307692307693,0.9230769230769231
SF-K19,SF-R26,3,1,0,0,3,1,0.0,1.0,0.0,1.0
SF-K19,SF-Q26,7,7,0,2,7,5,0.0,1.0,0.2857142857142857,0.7142857142857143
SF-K19,SF-P26,32,45,2,2,30,43,0.0625,0.9375,0.044444444444444446,0.9555555555555556
SF-K19,SF-O25-2,14,9,2,3,12,6,0.14285714285714285,0.8571428571428571,0.3333333333333333,0.6666666666666666
SF-K19,SF-N22-1B,11,31,4,21,7,10,0.36363636363636365,0.6363636363636364,0.6774193548387096,0.3225806451612903
SF-K19,SF-N26,10,2,1,0,9,2,0.1,0.9,0.0,1.0
SF-K19,SF-N25,11,14,1,2,10,12,0.09090909090909091,0.9090909090909091,0.14285714285714285,0.8571428571428571
SF-K19,SF-T21,2,4,0,1,2,3,0.0,1.0,0.25,0.75
SF-K19,SF-T22,4,13,0,0,4,13,0.0,1.0,0.0,1.0
SF-K19,SF-S22-2,1,5,0,0,1,5,0.0,1.0,0.0,1.0
SF-K19,SF-S22-1,9,28,3,9,6,19,0.3333333333333333,0.6666666666666666,0.32142857142857145,0.6785714285714286
SF-K19,SF-Q23-3,29,16,6,4,23,12,0.20689655172413793,0.7931034482758621,0.25,0.75
SF-K19,SF-Q22-1,15,31,3,3,12,28,0.2,0.8,0.0967741935483871,0.9032258064516129
SF-K19,SF-Q22-2,30,24,4,3,26,21,0.13333333333333333,0.8666666666666667,0.125,0.875
SF-K19,SF-P22,16,18,3,8,13,10,0.1875,0.8125,0.4444444444444444,0.5555555555555556
SF-K19,SF-W19,4,2,0,1,4,1,0.0,1.0,0.5,0.5
SF-K19,SF-W19-2,1,1,0,0,1,1,0.0,1.0,0.0,1.0
SF-K19,SF-U21,3,6,0,2,3,4,0.0,1.0,0.3333333333333333,0.6666666666666666
SF-K19,SF-T20,8,12,1,3,7,9,0.125,0.875,0.25,0.75
SF-K19,SF-W14,2,2,0,0,2,2,0.0,1.0,0.0,1.0
SF-K18,SF-M25,3,8,1,2,2,6,0.3333333333333333,0.6666666666666666,0.25,0.75
SF-K18,SF-M26-2,6,2,0,0,6,2,0.0,1.0,0.0,1.0
SF-K18,SF-L27,3,1,0,1,3,0,0.0,1.0,1.0,0.0
SF-K18,SF-K26,3,7,0,2,3,5,0.0,1.0,0.2857142857142857,0.7142857142857143
SF-K18,SF-M30,8,21,0,10,8,11,0.0,1.0,0.47619047619047616,0.5238095238095238
SF-K18,SF-J29-3,1,4,0,1,1,3,0.0,1.0,0.25,0.75
SF-K18,SF-J29,4,10,1,1,3,9,0.25,0.75,0.1,0.9
SF-K18,SF-L26,12,3,0,1,12,2,0.0,1.0,0.3333333333333333,0.6666666666666666
SF-K18,SF-M28,6,5,1,2,5,3,0.16666666666666666,0.8333333333333334,0.4,0.6
SF-K18,SF-L25,14,10,0,2,14,8,0.0,1.0,0.2,0.8
SF-K18,SF-M24,4,28,3,28,1,0,0.75,0.25,1.0,0.0
SF-K18,SF-N23,4,16,1,7,3,9,0.25,0.75,0.4375,0.5625
SF-K18,SF-N24-2,14,9,3,3,11,6,0.21428571428571427,0.7857142857142857,0.3333333333333333,0.6666666666666666
SF-K18,SF-K27-2,17,8,0,4,17,4,0.0,1.0,0.5,0.5
SF-K18,SF-J26-2,4,7,3,5,1,2,0.75,0.25,0.7142857142857143,0.2857142857142857
SF-K18,SF-L28,1,18,0,5,1,13,0.0,1.0,0.2777777777777778,0.7222222222222222
SF-K18,SF-K28,2,2,1,1,1,1,0.5,0.5,0.5,0.5
SF-K18,SF-K29-1,4,8,0,1,4,7,0.0,1.0,0.125,0.875
SF-K18,SF-K27,5,9,0,1,5,8,0.0,1.0,0.1111111111111111,0.8888888888888888
SF-K18,SF-K25,6,23,0,10,6,13,0.0,1.0,0.43478260869565216,0.5652173913043478
SF-K18,SF-J25,4,15,1,5,3,10,0.25,0.75,0.3333333333333333,0.6666666666666666
SF-K18,SF-H26-2,3,1,1,0,2,1,0.3333333333333333,0.6666666666666666,0.0,1.0
SF-K18,SF-P24,58,52,2,9,56,43,0.034482758620689655,0.9655172413793104,0.17307692307692307,0.8269230769230769
SF-K18,SF-N22-1A,5,10,0,2,5,8,0.0,1.0,0.2,0.8
SF-K18,SF-J24,2,9,0,2,2,7,0.0,1.0,0.2222222222222222,0.7777777777777778
SF-K18,SF-O24,4,4,0,2,4,2,0.0,1.0,0.5,0.5
SF-K18,SF-I26-,2,2,1,0,1,2,0.5,0.5,0.0,1.0
SF-K18,SF-I25,6,216,0,90,6,126,0.0,1.0,0.4166666666666667,0.5833333333333334
SF-K18,SF-K23,2,6,0,0,2,6,0.0,1.0,0.0,1.0
SF-K18,SF-H26,15,38,5,17,10,21,0.3333333333333333,0.6666666666666666,0.4473684210526316,0.5526315789473685
SF-K18,SF-O23,8,16,0,7,8,9,0.0,1.0,0.4375,0.5625
SF-K18,SF-H27-1,3,4,1,0,2,4,0.3333333333333333,0.6666666666666666,0.0,1.0
SF-K18,SF-F28-2,5,31,1,21,4,10,0.2,0.8,0.6774193548387096,0.3225806451612903
SF-K18,SF-G27,13,35,2,8,11,27,0.15384615384615385,0.8461538461538461,0.22857142857142856,0.7714285714285715
SF-K18,SF-M22-2,22,40,3,14,19,26,0.13636363636363635,0.8636363636363636,0.35,0.65
SF-K18,SF-L22,18,17,5,4,13,13,0.2777777777777778,0.7222222222222222,0.23529411764705882,0.7647058823529411
SF-K18,SF-F27,8,5,2,2,6,3,0.25,0.75,0.4,0.6
SF-K18,SF-N22-2,48,54,5,21,43,33,0.10416666666666667,0.8958333333333334,0.3888888888888889,0.6111111111111112
SF-K18,SF-G28-1,2,1,0,0,2,1,0.0,1.0,0.0,1.0
SF-K18,SF-M22-1,12,13,2,5,10,8,0.16666666666666666,0.8333333333333334,0.38461538461538464,0.6153846153846154
SF-K18,SF-O25-1,4,3,1,1,3,2,0.25,0.75,0.3333333333333333,0.6666666666666666
SF-K18,SF-K22-2,7,17,1,6,6,11,0.14285714285714285,0.8571428571428571,0.35294117647058826,0.6470588235294118
SF-K18,SF-K24,6,13,0,2,6,11,0.0,1.0,0.15384615384615385,0.8461538461538461
SF-K18,SF-J23-2,20,35,3,11,17,24,0.15,0.85,0.3142857142857143,0.6857142857142857
SF-K18,SF-G23,2,4,0,2,2,2,0.0,1.0,0.5,0.5
SF-K18,SF-G24,6,25,2,10,4,15,0.3333333333333333,0.6666666666666666,0.4,0.6
SF-K18,SF-G25,7,14,3,3,4,11,0.42857142857142855,0.5714285714285714,0.21428571428571427,0.7857142857142857
SF-K18,SF-F23,18,16,2,3,16,13,0.1111111111111111,0.8888888888888888,0.1875,0.8125
SF-K18,SF-E23,17,22,1,4,16,18,0.058823529411764705,0.9411764705882353,0.18181818181818182,0.8181818181818182
SF-K18,SF-D24,5,9,0,0,5,9,0.0,1.0,0.0,1.0
SF-K18,SF-C22,6,7,1,1,5,6,0.16666666666666666,0.8333333333333334,0.14285714285714285,0.8571428571428571
SF-K18,SF-B22,5,5,2,0,3,5,0.4,0.6,0.0,1.0
SF-K18,SF-J17,56,40,29,6,27,34,0.5178571428571429,0.48214285714285715,0.15,0.85
SF-K18,SF-I19,10,4,4,1,6,3,0.4,0.6,0.25,0.75
SF-K18,SF-I20,7,6,2,4,5,2,0.2857142857142857,0.7142857142857143,0.6666666666666666,0.3333333333333333
SF-K18,SF-H16,52,45,25,4,27,41,0.4807692307692308,0.5192307692307693,0.08888888888888889,0.9111111111111111
SF-K18,SF-H19,4,3,2,0,2,3,0.5,0.5,0.0,1.0
SF-K18,SF-H20,7,7,2,3,5,4,0.2857142857142857,0.7142857142857143,0.42857142857142855,0.5714285714285714
SF-K18,SF-H18,17,26,2,6,15,20,0.11764705882352941,0.8823529411764706,0.23076923076923078,0.7692307692307693
SF-K18,SF-H17,18,10,4,0,14,10,0.2222222222222222,0.7777777777777778,0.0,1.0
SF-K18,SF-G19,24,26,4,6,20,20,0.16666666666666666,0.8333333333333334,0.23076923076923078,0.7692307692307693
SF-K18,SF-G17,13,6,2,1,11,5,0.15384615384615385,0.8461538461538461,0.16666666666666666,0.8333333333333334
SF-K18,SF-G18,32,22,3,2,29,20,0.09375,0.90625,0.09090909090909091,0.9090909090909091
SF-K18,SF-G20,18,19,4,4,14,15,0.2222222222222222,0.7777777777777778,0.21052631578947367,0.7894736842105263
SF-K18,SF-F19,29,22,4,5,25,17,0.13793103448275862,0.8620689655172413,0.22727272727272727,0.7727272727272727
SF-K18,SF-E18,17,20,4,4,13,16,0.23529411764705882,0.7647058823529411,0.2,0.8
SF-K18,SF-E20,16,11,2,1,14,10,0.125,0.875,0.09090909090909091,0.9090909090909091
SF-K18,SF-H30,5,3,4,1,1,2,0.8,0.2,0.3333333333333333,0.6666666666666666
SF-K18,SF-G30-2,7,7,0,1,7,6,0.0,1.0,0.14285714285714285,0.8571428571428571
SF-K18,SF-F30-1,1,2,1,1,0,1,1.0,0.0,0.5,0.5
SF-K18,SF-E29-2,11,17,4,6,7,11,0.36363636363636365,0.6363636363636364,0.35294117647058826,0.6470588235294118
SF-K18,SF-E29-1,4,5,1,3,3,2,0.25,0.75,0.6,0.4
SF-K18,SF-D29,5,1,3,0,2,1,0.6,0.4,0.0,1.0
SF-K18,SF-D28,2,5,1,4,1,1,0.5,0.5,0.8,0.2
SF-K18,SF-A27,2,4,1,0,1,4,0.5,0.5,0.0,1.0
SF-K18,SF-G29-2,7,9,1,4,6,5,0.14285714285714285,0.8571428571428571,0.4444444444444444,0.5555555555555556
SF-K18,SF-G29-1,11,15,2,3,9,12,0.18181818181818182,0.8181818181818182,0.2,0.8
SF-K18,SF-G30-1,2,7,1,0,1,7,0.5,0.5,0.0,1.0
SF-K18,SF-G29-3,7,3,2,1,5,2,0.2857142857142857,0.7142857142857143,0.3333333333333333,0.6666666666666666
SF-K18,SF-F30-2,5,6,1,3,4,3,0.2,0.8,0.5,0.5
SF-K18,SF-F29,3,9,0,2,3,7,0.0,1.0,0.2222222222222222,0.7777777777777778
SF-K18,SF-F28-1,9,9,0,1,9,8,0.0,1.0,0.1111111111111111,0.8888888888888888
SF-K18,SF-E28-2,1,1,0,0,1,1,0.0,1.0,0.0,1.0
SF-K18,SF-E28,6,10,1,1,5,9,0.16666666666666666,0.8333333333333334,0.1,0.9
SF-K18,SF-J10,45,50,22,25,23,25,0.4888888888888889,0.5111111111111111,0.5,0.5
SF-K18,SF-J12,31,51,8,19,23,32,0.25806451612903225,0.7419354838709677,0.37254901960784315,0.6274509803921569
SF-K18,SF-J13,30,19,4,9,26,10,0.13333333333333333,0.8666666666666667,0.47368421052631576,0.5263157894736842
SF-K18,SF-J15,4,3,3,1,1,2,0.75,0.25,0.3333333333333333,0.6666666666666666
SF-K18,SF-J14,4,3,0,0,4,3,0.0,1.0,0.0,1.0
SF-K18,SF-H13,4,7,2,2,2,5,0.5,0.5,0.2857142857142857,0.7142857142857143
SF-K18,SF-I16,15,5,11,1,4,4,0.7333333333333333,0.26666666666666666,0.2,0.8
SF-K18,SF-H12,13,7,2,3,11,4,0.15384615384615385,0.8461538461538461,0.42857142857142855,0.5714285714285714
SF-K18,SF-G10-2,15,12,2,4,13,8,0.13333333333333333,0.8666666666666667,0.3333333333333333,0.6666666666666666
SF-K18,SF-H15,6,2,4,0,2,2,0.6666666666666666,0.3333333333333333,0.0,1.0
SF-K18,SF-G9,3,2,1,1,2,1,0.3333333333333333,0.6666666666666666,0.5,0.5
SF-K18,SF-H14,10,6,4,2,6,4,0.4,0.6,0.3333333333333333,0.6666666666666666
SF-K18,SF-G13,37,30,4,3,33,27,0.10810810810810811,0.8918918918918919,0.1,0.9
SF-K18,SF-G11,14,13,4,7,10,6,0.2857142857142857,0.7142857142857143,0.5384615384615384,0.46153846153846156
SF-K18,SF-G12,28,24,9,9,19,15,0.32142857142857145,0.6785714285714286,0.375,0.625
SF-K18,SF-G10-1,4,7,1,3,3,4,0.25,0.75,0.42857142857142855,0.5714285714285714
SF-K18,SF-F15,8,11,0,0,8,11,0.0,1.0,0.0,1.0
SF-K18,SF-F16,10,8,2,2,8,6,0.2,0.8,0.25,0.75
SF-K18,SF-C21,1,3,0,0,1,3,0.0,1.0,0.0,1.0
SF-K18,SF-C20,5,20,0,3,5,17,0.0,1.0,0.15,0.85
SF-K18,SF-B21,2,1,0,0,2,1,0.0,1.0,0.0,1.0
SF-K18,SF-B19,4,26,0,0,4,26,0.0,1.0,0.0,1.0
SF-K18,SF-A20,8,4,0,1,8,3,0.0,1.0,0.25,0.75
SF-K18,SF-A19,1,2,0,0,1,2,0.0,1.0,0.0,1.0
SF-K18,SF-C26,5,9,1,0,4,9,0.2,0.8,0.0,1.0
SF-K18,SF-C25,15,6,2,2,13,4,0.13333333333333333,0.8666666666666667,0.3333333333333333,0.6666666666666666
SF-K18,SF-B25,7,3,2,1,5,2,0.2857142857142857,0.7142857142857143,0.3333333333333333,0.6666666666666666
SF-K18,SF-E27,5,3,1,2,4,1,0.2,0.8,0.6666666666666666,0.3333333333333333
SF-K18,SF-B28-2,1,1,0,0,1,1,0.0,1.0,0.0,1.0
SF-K18,SF-D27,3,6,1,2,2,4,0.3333333333333333,0.6666666666666666,0.3333333333333333,0.6666666666666666
SF-K18,SF-B28,2,4,0,2,2,2,0.0,1.0,0.5,0.5
SF-K18,SF-J1,92,130,45,94,47,36,0.4891304347826087,0.5108695652173914,0.7230769230769231,0.27692307692307694
SF-K18,SF-H0,24,22,11,16,13,6,0.4583333333333333,0.5416666666666666,0.7272727272727273,0.2727272727272727
SF-K18,SF-J3,14,24,4,17,10,7,0.2857142857142857,0.7142857142857143,0.7083333333333334,0.2916666666666667
SF-K18,SF-J5,14,16,6,7,8,9,0.42857142857142855,0.5714285714285714,0.4375,0.5625
SF-K18,SF-G6,1,5,0,3,1,2,0.0,1.0,0.6,0.4
SF-K18,SF-G8,6,8,3,4,3,4,0.5,0.5,0.5,0.5
SF-K18,SF-G5,6,9,0,2,6,7,0.0,1.0,0.2222222222222222,0.7777777777777778
SF-K18,SF-G7,14,21,3,7,11,14,0.21428571428571427,0.7857142857142857,0.3333333333333333,0.6666666666666666
SF-K18,SF-F9,7,10,0,5,7,5,0.0,1.0,0.5,0.5
SF-K18,SF-H25,3,12,2,6,1,6,0.6666666666666666,0.3333333333333333,0.5,0.5
SF-K18,SF-G26,7,8,0,3,7,5,0.0,1.0,0.375,0.625
SF-K18,SF-K21,47,62,19,23,28,39,0.40425531914893614,0.5957446808510638,0.3709677419354839,0.6290322580645161
SF-K18,SF-K22-1,18,10,2,7,16,3,0.1111111111111111,0.8888888888888888,0.7,0.3
SF-K18,SF-J23-1,31,61,9,20,22,41,0.2903225806451613,0.7096774193548387,0.32786885245901637,0.6721311475409836
SF-K18,SF-J22-1,18,30,2,13,16,17,0.1111111111111111,0.8888888888888888,0.43333333333333335,0.5666666666666667
SF-K18,SF-J22-2,31,9,0,3,31,6,0.0,1.0,0.3333333333333333,0.6666666666666666
SF-K18,SF-J21,47,44,4,13,43,31,0.0851063829787234,0.9148936170212766,0.29545454545454547,0.7045454545454546
SF-K18,SF-I21,8,7,1,1,7,6,0.125,0.875,0.14285714285714285,0.8571428571428571
SF-K18,SF-I22,12,11,3,3,9,8,0.25,0.75,0.2727272727272727,0.7272727272727273
SF-K18,SF-I23-2,11,22,2,11,9,11,0.18181818181818182,0.8181818181818182,0.5,0.5
SF-K18,SF-I24,9,10,1,4,8,6,0.1111111111111111,0.8888888888888888,0.4,0.6
SF-K18,SF-I23-1,6,9,1,5,5,4,0.16666666666666666,0.8333333333333334,0.5555555555555556,0.4444444444444444
SF-K18,SF-F26,7,17,1,2,6,15,0.14285714285714285,0.8571428571428571,0.11764705882352941,0.8823529411764706
SF-K18,SF-M13,83,100,24,17,59,83,0.2891566265060241,0.7108433734939759,0.17,0.83
SF-K18,SF-M15,63,47,18,5,45,42,0.2857142857142857,0.7142857142857143,0.10638297872340426,0.8936170212765957
SF-K18,SF-L19,29,21,10,11,19,10,0.3448275862068966,0.6551724137931034,0.5238095238095238,0.47619047619047616
SF-K18,SF-L20,95,75,14,54,81,21,0.14736842105263157,0.8526315789473684,0.72,0.28
SF-K18,SF-N20-1,8,18,2,12,6,6,0.25,0.75,0.6666666666666666,0.3333333333333333
SF-K18,SF-M20,46,94,6,48,40,46,0.13043478260869565,0.8695652173913043,0.5106382978723404,0.48936170212765956
SF-K18,SF-K17-2,25,18,12,6,13,12,0.48,0.52,0.3333333333333333,0.6666666666666666
SF-K18,SF-K20,57,65,19,48,38,17,0.3333333333333333,0.6666666666666666,0.7384615384615385,0.26153846153846155
SF-K18,SF-K15-,154,196,87,117,67,79,0.564935064935065,0.43506493506493504,0.5969387755102041,0.4030612244897959
SF-K18,SF-K19,59,78,39,60,20,18,0.6610169491525424,0.3389830508474576,0.7692307692307693,0.23076923076923078
SF-K18,SF-K17,58,65,38,47,20,18,0.6551724137931034,0.3448275862068966,0.7230769230769231,0.27692307692307694
SF-K18,SF-J16,12,19,9,15,3,4,0.75,0.25,0.7894736842105263,0.21052631578947367
SF-K18,SF-J18,60,37,29,18,31,19,0.48333333333333334,0.5166666666666667,0.4864864864864865,0.5135135135135135
SF-K18,SF-J20,6,6,3,2,3,4,0.5,0.5,0.3333333333333333,0.6666666666666666
SF-K18,SF-J19,16,11,3,1,13,10,0.1875,0.8125,0.09090909090909091,0.9090909090909091
SF-K18,SF-O12,3,4,1,0,2,4,0.3333333333333333,0.6666666666666666,0.0,1.0
SF-K18,SF-M12,30,24,6,7,24,17,0.2,0.8,0.2916666666666667,0.7083333333333334
SF-K18,SF-M10,22,34,10,18,12,16,0.45454545454545453,0.5454545454545454,0.5294117647058824,0.47058823529411764
SF-K18,SF-M11,45,46,19,20,26,26,0.4222222222222222,0.5777777777777777,0.43478260869565216,0.5652173913043478
SF-K18,SF-R19,3,9,0,2,3,7,0.0,1.0,0.2222222222222222,0.7777777777777778
SF-K18,SF-R20,7,6,0,0,7,6,0.0,1.0,0.0,1.0
SF-K18,SF-Q21-2,3,6,2,0,1,6,0.6666666666666666,0.3333333333333333,0.0,1.0
SF-K18,SF-Q21-1,12,15,5,4,7,11,0.4166666666666667,0.5833333333333334,0.26666666666666666,0.7333333333333333
SF-K18,SF-P21,20,21,7,12,13,9,0.35,0.65,0.5714285714285714,0.42857142857142855
SF-K18,SF-O18,22,24,3,2,19,22,0.13636363636363635,0.8636363636363636,0.08333333333333333,0.9166666666666666
SF-K18,SF-O19,26,33,5,20,21,13,0.19230769230769232,0.8076923076923077,0.6060606060606061,0.3939393939393939
SF-K18,SF-O21,37,77,8,30,29,47,0.21621621621621623,0.7837837837837838,0.38961038961038963,0.6103896103896104
SF-K18,SF-O22,24,56,0,18,24,38,0.0,1.0,0.32142857142857145,0.6785714285714286
SF-K18,SF-N21,23,39,3,12,20,27,0.13043478260869565,0.8695652173913043,0.3076923076923077,0.6923076923076923
SF-K18,SF-N20-2,13,9,8,5,5,4,0.6153846153846154,0.38461538461538464,0.5555555555555556,0.4444444444444444
SF-K18,SF-M21,25,59,0,46,25,13,0.0,1.0,0.7796610169491526,0.22033898305084745
SF-K18,SF-L21,122,121,13,77,109,44,0.10655737704918032,0.8934426229508197,0.6363636363636364,0.36363636363636365
SF-K18,SF-S29,5,1,0,1,5,0,0.0,1.0,1.0,0.0
SF-K18,SF-S30,2,2,1,1,1,1,0.5,0.5,0.5,0.5
SF-K18,SF-Q30,1,3,0,0,1,3,0.0,1.0,0.0,1.0
SF-K18,SF-P30,3,5,0,1,3,4,0.0,1.0,0.2,0.8
SF-K18,SF-O30-2,5,1,0,0,5,1,0.0,1.0,0.0,1.0
SF-K18,SF-O30,7,8,1,4,6,4,0.14285714285714285,0.8571428571428571,0.5,0.5
SF-K18,SF-N27,4,6,2,2,2,4,0.5,0.5,0.3333333333333333,0.6666666666666666
SF-K18,SF-N29,7,3,0,0,7,3,0.0,1.0,0.0,1.0
SF-K18,SF-N28,4,17,2,8,2,9,0.5,0.5,0.47058823529411764,0.5294117647058824
SF-K18,SF-L30-1,6,13,3,6,3,7,0.5,0.5,0.46153846153846156,0.5384615384615384
SF-K18,SF-K30-2,5,4,1,0,4,4,0.2,0.8,0.0,1.0
SF-K18,SF-L29,4,4,1,0,3,4,0.25,0.75,0.0,1.0
SF-K18,SF-J29-1,2,2,0,0,2,2,0.0,1.0,0.0,1.0
SF-K18,SF-I30,6,15,0,4,6,11,0.0,1.0,0.26666666666666666,0.7333333333333333
SF-K18,SF-I27,4,7,2,5,2,2,0.5,0.5,0.7142857142857143,0.2857142857142857
SF-K18,SF-H28,1,5,0,3,1,2,0.0,1.0,0.6,0.4
SF-K18,SF-H29,2,1,0,0,2,1,0.0,1.0,0.0,1.0
SF-K18,SF-S24,1,4,1,0,0,4,1.0,0.0,0.0,1.0
SF-K18,SF-R24,14,20,3,6,11,14,0.21428571428571427,0.7857142857142857,0.3,0.7
SF-K18,SF-R26,2,4,0,2,2,2,0.0,1.0,0.5,0.5
SF-K18,SF-Q26,3,2,0,0,3,2,0.0,1.0,0.0,1.0
SF-K18,SF-P26,44,49,0,1,44,48,0.0,1.0,0.02040816326530612,0.9795918367346939
SF-K18,SF-O25-2,12,3,1,0,11,3,0.08333333333333333,0.9166666666666666,0.0,1.0
SF-K18,SF-N22-1B,6,9,2,2,4,7,0.3333333333333333,0.6666666666666666,0.2222222222222222,0.7777777777777778
SF-K18,SF-N26,7,6,3,0,4,6,0.42857142857142855,0.5714285714285714,0.0,1.0
SF-K18,SF-N25,5,8,0,0,5,8,0.0,1.0,0.0,1.0
SF-K18,SF-T22,6,3,0,0,6,3,0.0,1.0,0.0,1.0
SF-K18,SF-S22-2,4,1,0,0,4,1,0.0,1.0,0.0,1.0
SF-K18,SF-S22-1,4,59,0,5,4,54,0.0,1.0,0.0847457627118644,0.9152542372881356
SF-K18,SF-Q23-3,8,6,0,1,8,5,0.0,1.0,0.16666666666666666,0.8333333333333334
SF-K18,SF-Q22-1,12,19,5,9,7,10,0.4166666666666667,0.5833333333333334,0.47368421052631576,0.5263157894736842
SF-K18,SF-Q22-2,12,22,2,9,10,13,0.16666666666666666,0.8333333333333334,0.4090909090909091,0.5909090909090909
SF-K18,SF-P22,22,18,4,6,18,12,0.18181818181818182,0.8181818181818182,0.3333333333333333,0.6666666666666666
SF-K18,SF-W19,3,3,0,2,3,1,0.0,1.0,0.6666666666666666,0.3333333333333333
SF-K18,SF-W19-2,2,3,0,1,2,2,0.0,1.0,0.3333333333333333,0.6666666666666666
SF-K18,SF-U21,5,5,0,0,5,5,0.0,1.0,0.0,1.0
SF-K18,SF-T20,1,4,0,1,1,3,0.0,1.0,0.25,0.75
SF-K18,SF-V32,1,4,1,4,0,0,1.0,0.0,1.0,0.0
SF-K17,SF-M25,3,3,1,0,2,3,0.3333333333333333,0.6666666666666666,0.0,1.0
SF-K17,SF-M26-2,2,4,0,3,2,1,0.0,1.0,0.75,0.25
SF-K17,SF-K26,7,5,1,2,6,3,0.14285714285714285,0.8571428571428571,0.4,0.6
SF-K17,SF-M30,4,3,0,3,4,0,0.0,1.0,1.0,0.0
SF-K17,SF-J29,9,23,0,9,9,14,0.0,1.0,0.391304347826087,0.6086956521739131
SF-K17,SF-L26,1,2,0,0,1,2,0.0,1.0,0.0,1.0
SF-K17,SF-M28,4,1,2,0,2,1,0.5,0.5,0.0,1.0
SF-K17,SF-M24,5,6,0,4,5,2,0.0,1.0,0.6666666666666666,0.3333333333333333
SF-K17,SF-L24,2,7,0,2,2,5,0.0,1.0,0.2857142857142857,0.7142857142857143
SF-K17,SF-N23,1,12,1,5,0,7,1.0,0.0,0.4166666666666667,0.5833333333333334
SF-K17,SF-N24-2,4,6,1,4,3,2,0.25,0.75,0.6666666666666666,0.3333333333333333
SF-K17,SF-K27-2,12,4,4,2,8,2,0.3333333333333333,0.6666666666666666,0.5,0.5
SF-K17,SF-J26-2,6,11,0,6,6,5,0.0,1.0,0.5454545454545454,0.45454545454545453
SF-K17,SF-K28-3,1,2,0,0,1,2,0.0,1.0,0.0,1.0
SF-K17,SF-K28,2,1,0,1,2,0,0.0,1.0,1.0,0.0
SF-K17,SF-K29-1,3,3,1,0,2,3,0.3333333333333333,0.6666666666666666,0.0,1.0
SF-K17,SF-K25,7,9,4,2,3,7,0.5714285714285714,0.42857142857142855,0.2222222222222222,0.7777777777777778
SF-K17,SF-J25,9,6,3,2,6,4,0.3333333333333333,0.6666666666666666,0.3333333333333333,0.6666666666666666
SF-K17,SF-H26-2,4,18,0,3,4,15,0.0,1.0,0.16666666666666666,0.8333333333333334
SF-K17,SF-P24,4,7,1,1,3,6,0.25,0.75,0.14285714285714285,0.8571428571428571
SF-K17,SF-N22-1A,3,1,0,0,3,1,0.0,1.0,0.0,1.0
SF-K17,SF-J24,9,3,4,0,5,3,0.4444444444444444,0.5555555555555556,0.0,1.0
SF-K17,SF-O24,4,4,3,3,1,1,0.75,0.25,0.75,0.25
SF-K17,SF-J26,1,1,0,0,1,1,0.0,1.0,0.0,1.0
SF-K17,SF-I26-,2,1,1,1,1,0,0.5,0.5,1.0,0.0
SF-K17,SF-I25,35,30,13,22,22,8,0.37142857142857144,0.6285714285714286,0.7333333333333333,0.26666666666666666
SF-K17,SF-K23,2,2,1,0,1,2,0.5,0.5,0.0,1.0
SF-K17,SF-H26,25,17,15,7,10,10,0.6,0.4,0.4117647058823529,0.5882352941176471
SF-K17,SF-O23,7,8,2,2,5,6,0.2857142857142857,0.7142857142857143,0.25,0.75
SF-K17,SF-H27-1,3,2,0,0,3,2,0.0,1.0,0.0,1.0
SF-K17,SF-F28-2,12,10,3,5,9,5,0.25,0.75,0.5,0.5
SF-K17,SF-G27,14,19,2,14,12,5,0.14285714285714285,0.8571428571428571,0.7368421052631579,0.2631578947368421
SF-K17,SF-M22-2,16,33,2,21,14,12,0.125,0.875,0.6363636363636364,0.36363636363636365
SF-K17,SF-L22,13,17,4,3,9,14,0.3076923076923077,0.6923076923076923,0.17647058823529413,0.8235294117647058
SF-K17,SF-F27,5,6,2,3,3,3,0.4,0.6,0.5,0.5
SF-K17,SF-N22-2,41,43,8,20,33,23,0.1951219512195122,0.8048780487804879,0.46511627906976744,0.5348837209302325
SF-K17,SF-G28-2,2,3,1,0,1,3,0.5,0.5,0.0,1.0
SF-K17,SF-G28-1,1,1,1,1,0,0,1.0,0.0,1.0,0.0
SF-K17,SF-M22-1,10,17,4,15,6,2,0.4,0.6,0.8823529411764706,0.11764705882352941
SF-K17,SF-K22-2,8,14,3,3,5,11,0.375,0.625,0.21428571428571427,0.7857142857142857
SF-K17,SF-K24,7,18,5,6,2,12,0.7142857142857143,0.2857142857142857,0.3333333333333333,0.6666666666666666
SF-K17,SF-J23-2,8,12,0,10,8,2,0.0,1.0,0.8333333333333334,0.16666666666666666
SF-K17,SF-G23,6,5,0,1,6,4,0.0,1.0,0.2,0.8
SF-K17,SF-G24,42,15,3,2,39,13,0.07142857142857142,0.9285714285714286,0.13333333333333333,0.8666666666666667
SF-K17,SF-G25,20,17,2,0,18,17,0.1,0.9,0.0,1.0
SF-K17,SF-F23,14,14,2,2,12,12,0.14285714285714285,0.8571428571428571,0.14285714285714285,0.8571428571428571
SF-K17,SF-E23,11,22,1,4,10,18,0.09090909090909091,0.9090909090909091,0.18181818181818182,0.8181818181818182
SF-K17,SF-D24,22,19,2,2,20,17,0.09090909090909091,0.9090909090909091,0.10526315789473684,0.8947368421052632
SF-K17,SF-C22,11,15,0,0,11,15,0.0,1.0,0.0,1.0
SF-K17,SF-B22,9,5,0,0,9,5,0.0,1.0,0.0,1.0
SF-K17,SF-J17,65,51,35,23,30,28,0.5384615384615384,0.46153846153846156,0.45098039215686275,0.5490196078431373
SF-K17,SF-I19,10,10,6,4,4,6,0.6,0.4,0.4,0.6
SF-K17,SF-I20,5,11,1,5,4,6,0.2,0.8,0.45454545454545453,0.5454545454545454
SF-K17,SF-H16,69,66,28,13,41,53,0.4057971014492754,0.5942028985507246,0.19696969696969696,0.803030303030303
SF-K17,SF-H19,5,6,1,3,4,3,0.2,0.8,0.5,0.5
SF-K17,SF-H20,10,15,7,12,3,3,0.7,0.3,0.8,0.2
SF-K17,SF-H18,7,10,4,1,3,9,0.5714285714285714,0.42857142857142855,0.1,0.9
SF-K17,SF-H17,5,4,1,1,4,3,0.2,0.8,0.25,0.75
SF-K17,SF-G19,15,32,6,17,9,15,0.4,0.6,0.53125,0.46875
SF-K17,SF-G17,5,4,0,0,5,4,0.0,1.0,0.0,1.0
SF-K17,SF-G18,11,11,2,4,9,7,0.18181818181818182,0.8181818181818182,0.36363636363636365,0.6363636363636364
SF-K17,SF-G20,13,15,3,5,10,10,0.23076923076923078,0.7692307692307693,0.3333333333333333,0.6666666666666666
SF-K17,SF-F19,21,44,2,6,19,38,0.09523809523809523,0.9047619047619048,0.13636363636363635,0.8636363636363636
SF-K17,SF-E18,9,11,3,2,6,9,0.3333333333333333,0.6666666666666666,0.18181818181818182,0.8181818181818182
SF-K17,SF-E20,11,9,3,1,8,8,0.2727272727272727,0.7272727272727273,0.1111111111111111,0.8888888888888888
SF-K17,SF-H30,1,3,0,2,1,1,0.0,1.0,0.6666666666666666,0.3333333333333333
SF-K17,SF-G30-2,7,8,0,1,7,7,0.0,1.0,0.125,0.875
SF-K17,SF-F30-1,7,7,0,2,7,5,0.0,1.0,0.2857142857142857,0.7142857142857143
SF-K17,SF-E29-2,7,7,3,4,4,3,0.42857142857142855,0.5714285714285714,0.5714285714285714,0.42857142857142855
SF-K17,SF-E29-1,6,7,2,6,4,1,0.3333333333333333,0.6666666666666666,0.8571428571428571,0.14285714285714285
SF-K17,SF-D29,7,1,1,0,6,1,0.14285714285714285,0.8571428571428571,0.0,1.0
SF-K17,SF-D28,4,9,0,3,4,6,0.0,1.0,0.3333333333333333,0.6666666666666666
SF-K17,SF-A27,3,8,2,2,1,6,0.6666666666666666,0.3333333333333333,0.25,0.75
SF-K17,SF-G29-2,6,5,1,1,5,4,0.16666666666666666,0.8333333333333334,0.2,0.8
SF-K17,SF-G29-1,8,3,1,0,7,3,0.125,0.875,0.0,1.0
SF-K17,SF-G30-1,2,5,0,2,2,3,0.0,1.0,0.4,0.6
SF-K17,SF-G29-3,1,4,0,0,1,4,0.0,1.0,0.0,1.0
SF-K17,SF-F30-2,6,9,0,6,6,3,0.0,1.0,0.6666666666666666,0.3333333333333333
SF-K17,SF-F29,1,2,0,1,1,1,0.0,1.0,0.5,0.5
SF-K17,SF-E29-3,4,2,0,1,4,1,0.0,1.0,0.5,0.5
SF-K17,SF-F28-1,5,5,1,1,4,4,0.2,0.8,0.2,0.8
SF-K17,SF-E28,3,4,0,1,3,3,0.0,1.0,0.25,0.75
SF-K17,SF-J10,58,83,28,36,30,47,0.4827586206896552,0.5172413793103449,0.43373493975903615,0.5662650602409639
SF-K17,SF-J12,49,57,24,34,25,23,0.4897959183673469,0.5102040816326531,0.5964912280701754,0.40350877192982454
SF-K17,SF-J13,21,27,6,10,15,17,0.2857142857142857,0.7142857142857143,0.37037037037037035,0.6296296296296297
SF-K17,SF-J15,6,6,4,1,2,5,0.6666666666666666,0.3333333333333333,0.16666666666666666,0.8333333333333334
SF-K17,SF-H13,10,10,5,6,5,4,0.5,0.5,0.6,0.4
SF-K17,SF-I16,35,8,21,1,14,7,0.6,0.4,0.125,0.875
SF-K17,SF-H12,8,10,2,3,6,7,0.25,0.75,0.3,0.7
SF-K17,SF-G10-2,2,4,0,0,2,4,0.0,1.0,0.0,1.0
SF-K17,SF-H15,7,4,6,0,1,4,0.8571428571428571,0.14285714285714285,0.0,1.0
SF-K17,SF-G9,7,5,0,0,7,5,0.0,1.0,0.0,1.0
SF-K17,SF-H14,4,4,0,0,4,4,0.0,1.0,0.0,1.0
SF-K17,SF-G13,16,28,6,11,10,17,0.375,0.625,0.39285714285714285,0.6071428571428571
SF-K17,SF-G11,23,20,3,6,20,14,0.13043478260869565,0.8695652173913043,0.3,0.7
SF-K17,SF-G12,25,25,11,11,14,14,0.44,0.56,0.44,0.56
SF-K17,SF-G10-1,4,7,2,3,2,4,0.5,0.5,0.42857142857142855,0.5714285714285714
SF-K17,SF-F15,5,6,0,0,5,6,0.0,1.0,0.0,1.0
SF-K17,SF-F16,5,6,0,1,5,5,0.0,1.0,0.16666666666666666,0.8333333333333334
SF-K17,SF-C21,2,3,0,0,2,3,0.0,1.0,0.0,1.0
SF-K17,SF-B21,2,5,0,1,2,4,0.0,1.0,0.2,0.8
SF-K17,SF-B19,5,12,1,0,4,12,0.2,0.8,0.0,1.0
SF-K17,SF-A20,3,14,0,4,3,10,0.0,1.0,0.2857142857142857,0.7142857142857143
SF-K17,SF-A19,3,4,0,1,3,3,0.0,1.0,0.25,0.75
SF-K17,SF-C26,3,6,1,1,2,5,0.3333333333333333,0.6666666666666666,0.16666666666666666,0.8333333333333334
SF-K17,SF-C25,14,17,2,0,12,17,0.14285714285714285,0.8571428571428571,0.0,1.0
SF-K17,SF-B25,7,9,1,2,6,7,0.14285714285714285,0.8571428571428571,0.2222222222222222,0.7777777777777778
SF-K17,SF-E27,5,1,0,0,5,1,0.0,1.0,0.0,1.0
SF-K17,SF-D27,20,4,0,0,20,4,0.0,1.0,0.0,1.0
SF-K17,SF-B28,2,2,0,0,2,2,0.0,1.0,0.0,1.0
SF-K17,SF-J1,83,180,29,123,54,57,0.3493975903614458,0.6506024096385542,0.6833333333333333,0.31666666666666665
SF-K17,SF-H0,21,31,6,22,15,9,0.2857142857142857,0.7142857142857143,0.7096774193548387,0.2903225806451613
SF-K17,SF-J3,16,34,5,14,11,20,0.3125,0.6875,0.4117647058823529,0.5882352941176471
SF-K17,SF-J5,13,18,0,9,13,9,0.0,1.0,0.5,0.5
SF-K17,SF-G6,1,2,0,2,1,0,0.0,1.0,1.0,0.0
SF-K17,SF-G8,6,6,3,4,3,2,0.5,0.5,0.6666666666666666,0.3333333333333333
SF-K17,SF-G5,9,16,3,9,6,7,0.3333333333333333,0.6666666666666666,0.5625,0.4375
SF-K17,SF-G7,10,21,2,10,8,11,0.2,0.8,0.47619047619047616,0.5238095238095238
SF-K17,SF-F9,2,7,1,4,1,3,0.5,0.5,0.5714285714285714,0.42857142857142855
SF-K17,SF-H25,6,4,3,4,3,0,0.5,0.5,1.0,0.0
SF-K17,SF-G26,3,10,2,3,1,7,0.6666666666666666,0.3333333333333333,0.3,0.7
SF-K17,SF-K21,33,40,10,21,23,19,0.30303030303030304,0.696969696969697,0.525,0.475
SF-K17,SF-K22-1,13,8,6,5,7,3,0.46153846153846156,0.5384615384615384,0.625,0.375
SF-K17,SF-J23-1,31,38,16,14,15,24,0.5161290322580645,0.4838709677419355,0.3684210526315789,0.631578947368421
SF-K17,SF-J22-1,27,24,4,11,23,13,0.14814814814814814,0.8518518518518519,0.4583333333333333,0.5416666666666666
SF-K17,SF-J22-2,19,14,3,6,16,8,0.15789473684210525,0.8421052631578947,0.42857142857142855,0.5714285714285714
SF-K17,SF-J21,34,55,6,17,28,38,0.17647058823529413,0.8235294117647058,0.3090909090909091,0.6909090909090909
SF-K17,SF-I21,2,4,0,2,2,2,0.0,1.0,0.5,0.5
SF-K17,SF-I22,7,12,0,3,7,9,0.0,1.0,0.25,0.75
SF-K17,SF-I23-2,12,13,1,3,11,10,0.08333333333333333,0.9166666666666666,0.23076923076923078,0.7692307692307693
SF-K17,SF-I24,13,14,5,9,8,5,0.38461538461538464,0.6153846153846154,0.6428571428571429,0.35714285714285715
SF-K17,SF-I23-1,17,13,3,3,14,10,0.17647058823529413,0.8235294117647058,0.23076923076923078,0.7692307692307693
SF-K17,SF-F26,17,14,2,2,15,12,0.11764705882352941,0.8823529411764706,0.14285714285714285,0.8571428571428571
SF-K17,SF-M13,55,89,24,30,31,59,0.43636363636363634,0.5636363636363636,0.33707865168539325,0.6629213483146067
SF-K17,SF-M15,40,48,25,15,15,33,0.625,0.375,0.3125,0.6875
SF-K17,SF-L19,25,24,11,10,14,14,0.44,0.56,0.4166666666666667,0.5833333333333334
SF-K17,SF-L20,35,31,9,8,26,23,0.2571428571428571,0.7428571428571429,0.25806451612903225,0.7419354838709677
SF-K17,SF-N20-1,8,18,2,4,6,14,0.25,0.75,0.2222222222222222,0.7777777777777778
SF-K17,SF-M20,64,58,16,18,48,40,0.25,0.75,0.3103448275862069,0.6896551724137931
SF-K17,SF-K17-2,20,15,14,7,6,8,0.7,0.3,0.4666666666666667,0.5333333333333333
SF-K17,SF-K20,58,28,31,12,27,16,0.5344827586206896,0.46551724137931033,0.42857142857142855,0.5714285714285714
SF-K17,SF-K15-,129,219,65,148,64,71,0.5038759689922481,0.49612403100775193,0.6757990867579908,0.3242009132420091
SF-K17,SF-K19,49,49,34,32,15,17,0.6938775510204082,0.30612244897959184,0.6530612244897959,0.3469387755102041
SF-K17,SF-K18,65,58,47,38,18,20,0.7230769230769231,0.27692307692307694,0.6551724137931034,0.3448275862068966
SF-K17,SF-J16,60,39,41,21,19,18,0.6833333333333333,0.31666666666666665,0.5384615384615384,0.46153846153846156
SF-K17,SF-J18,63,48,35,31,28,17,0.5555555555555556,0.4444444444444444,0.6458333333333334,0.3541666666666667
SF-K17,SF-J20,9,7,3,2,6,5,0.3333333333333333,0.6666666666666666,0.2857142857142857,0.7142857142857143
SF-K17,SF-J19,35,50,13,14,22,36,0.37142857142857144,0.6285714285714286,0.28,0.72
SF-K17,SF-O12,4,4,0,0,4,4,0.0,1.0,0.0,1.0
SF-K17,SF-M12,40,63,8,27,32,36,0.2,0.8,0.42857142857142855,0.5714285714285714
SF-K17,SF-M10,15,46,6,29,9,17,0.4,0.6,0.6304347826086957,0.3695652173913043
SF-K17,SF-M11,39,58,19,31,20,27,0.48717948717948717,0.5128205128205128,0.5344827586206896,0.46551724137931033
SF-K17,SF-R19,4,3,1,0,3,3,0.25,0.75,0.0,1.0
SF-K17,SF-R20,2,4,0,0,2,4,0.0,1.0,0.0,1.0
SF-K17,SF-Q21-2,4,6,2,2,2,4,0.5,0.5,0.3333333333333333,0.6666666666666666
SF-K17,SF-Q21-1,3,9,0,3,3,6,0.0,1.0,0.3333333333333333,0.6666666666666666
SF-K17,SF-P21,10,9,2,2,8,7,0.2,0.8,0.2222222222222222,0.7777777777777778
SF-K17,SF-O18,10,12,4,2,6,10,0.4,0.6,0.16666666666666666,0.8333333333333334
SF-K17,SF-O19,24,20,6,10,18,10,0.25,0.75,0.5,0.5
SF-K17,SF-O21,108,87,3,36,105,51,0.027777777777777776,0.9722222222222222,0.41379310344827586,0.5862068965517241
SF-K17,SF-O22,13,18,2,5,11,13,0.15384615384615385,0.8461538461538461,0.2777777777777778,0.7222222222222222
SF-K17,SF-N21,27,15,9,7,18,8,0.3333333333333333,0.6666666666666666,0.4666666666666667,0.5333333333333333
SF-K17,SF-N20-2,10,4,3,2,7,2,0.3,0.7,0.5,0.5
SF-K17,SF-M21,19,15,10,8,9,7,0.5263157894736842,0.47368421052631576,0.5333333333333333,0.4666666666666667
SF-K17,SF-L21,56,49,11,10,45,39,0.19642857142857142,0.8035714285714286,0.20408163265306123,0.7959183673469388
SF-K17,SF-Q30,7,6,2,0,5,6,0.2857142857142857,0.7142857142857143,0.0,1.0
SF-K17,SF-P30,1,2,0,0,1,2,0.0,1.0,0.0,1.0
SF-K17,SF-O30-2,1,1,0,1,1,0,0.0,1.0,1.0,0.0
SF-K17,SF-O30,5,7,2,3,3,4,0.4,0.6,0.42857142857142855,0.5714285714285714
SF-K17,SF-N27,11,17,0,4,11,13,0.0,1.0,0.23529411764705882,0.7647058823529411
SF-K17,SF-N29,3,3,2,0,1,3,0.6666666666666666,0.3333333333333333,0.0,1.0
SF-K17,SF-N28,5,9,2,2,3,7,0.4,0.6,0.2222222222222222,0.7777777777777778
SF-K17,SF-L30-1,9,8,7,5,2,3,0.7777777777777778,0.2222222222222222,0.625,0.375
SF-K17,SF-L31-1,1,1,0,0,1,1,0.0,1.0,0.0,1.0
SF-K17,SF-K30-2,1,1,0,1,1,0,0.0,1.0,1.0,0.0
SF-K17,SF-L29,1,4,0,2,1,2,0.0,1.0,0.5,0.5
SF-K17,SF-J29-1,2,4,1,1,1,3,0.5,0.5,0.25,0.75
SF-K17,SF-I30,2,6,0,5,2,1,0.0,1.0,0.8333333333333334,0.16666666666666666
SF-K17,SF-I29-2,3,1,2,0,1,1,0.6666666666666666,0.3333333333333333,0.0,1.0
SF-K17,SF-I27,8,9,4,6,4,3,0.5,0.5,0.6666666666666666,0.3333333333333333
SF-K17,SF I29-1,1,1,0,1,1,0,0.0,1.0,1.0,0.0
SF-K17,SF-H28,2,4,0,3,2,1,0.0,1.0,0.75,0.25
SF-K17,SF-S24,12,7,9,5,3,2,0.75,0.25,0.7142857142857143,0.2857142857142857
SF-K17,SF-R24,12,9,2,1,10,8,0.16666666666666666,0.8333333333333334,0.1111111111111111,0.8888888888888888
SF-K17,SF-R26,4,3,0,1,4,2,0.0,1.0,0.3333333333333333,0.6666666666666666
SF-K17,SF-Q26,4,7,2,1,2,6,0.5,0.5,0.14285714285714285,0.8571428571428571
SF-K17,SF-P26,4,9,0,0,4,9,0.0,1.0,0.0,1.0
SF-K17,SF-O25-2,11,5,8,2,3,3,0.7272727272727273,0.2727272727272727,0.4,0.6
SF-K17,SF-N22-1B,3,14,0,12,3,2,0.0,1.0,0.8571428571428571,0.14285714285714285
SF-K17,SF-N26,5,4,1,0,4,4,0.2,0.8,0.0,1.0
SF-K17,SF-N25,4,5,0,0,4,5,0.0,1.0,0.0,1.0
SF-K17,SF-T22,3,1,1,0,2,1,0.3333333333333333,0.6666666666666666,0.0,1.0
SF-K17,SF-S22-2,3,3,0,0,3,3,0.0,1.0,0.0,1.0
SF-K17,SF-S22-1,13,8,5,3,8,5,0.38461538461538464,0.6153846153846154,0.375,0.625
SF-K17,SF-Q23-3,11,5,2,5,9,0,0.18181818181818182,0.8181818181818182,1.0,0.0
SF-K17,SF-Q22-1,11,9,1,3,10,6,0.09090909090909091,0.9090909090909091,0.3333333333333333,0.6666666666666666
SF-K17,SF-Q22-2,15,28,4,12,11,16,0.26666666666666666,0.7333333333333333,0.42857142857142855,0.5714285714285714
SF-K17,SF-P22,9,16,4,4,5,12,0.4444444444444444,0.5555555555555556,0.25,0.75
SF-K17,SF-U21,1,1,0,0,1,1,0.0,1.0,0.0,1.0
SF-K17,SF-T20,3,3,2,1,1,2,0.6666666666666666,0.3333333333333333,0.3333333333333333,0.6666666666666666
SF-K17,SF-S21,1,1,0,0,1,1,0.0,1.0,0.0,1.0
SF-J16,SF-L27,2,1,0,1,2,0,0.0,1.0,1.0,0.0
SF-J16,SF-J27,2,1,1,1,1,0,0.5,0.5,1.0,0.0
SF-J16,SF-M30,4,6,1,0,3,6,0.25,0.75,0.0,1.0
SF-J16,SF-L27-2,3,2,0,0,3,2,0.0,1.0,0.0,1.0
SF-J16,SF-J29,1,5,0,3,1,2,0.0,1.0,0.6,0.4
SF-J16,SF-L26,2,5,0,0,2,5,0.0,1.0,0.0,1.0
SF-J16,SF-L25,3,3,0,0,3,3,0.0,1.0,0.0,1.0
SF-J16,SF-M24,3,4,0,4,3,0,0.0,1.0,1.0,0.0
SF-J16,SF-L24,5,2,0,2,5,0,0.0,1.0,1.0,0.0
SF-J16,SF-N23,1,4,0,1,1,3,0.0,1.0,0.25,0.75
SF-J16,SF-N24-2,4,2,0,0,4,2,0.0,1.0,0.0,1.0
SF-J16,SF-K27-2,2,1,0,0,2,1,0.0,1.0,0.0,1.0
SF-J16,SF-J26-2,4,2,0,1,4,1,0.0,1.0,0.5,0.5
SF-J16,SF-J25,1,4,0,1,1,3,0.0,1.0,0.25,0.75
SF-J16,SF-H26-2,3,2,0,1,3,1,0.0,1.0,0.5,0.5
SF-J16,SF-P24,6,1,0,0,6,1,0.0,1.0,0.0,1.0
SF-J16,SF-N22-1A,1,3,0,0,1,3,0.0,1.0,0.0,1.0
SF-J16,SF-I25,6,6,0,1,6,5,0.0,1.0,0.16666666666666666,0.8333333333333334
SF-J16,SF-H26,9,10,1,1,8,9,0.1111111111111111,0.8888888888888888,0.1,0.9
SF-J16,SF-F28-2,12,3,1,0,11,3,0.08333333333333333,0.9166666666666666,0.0,1.0
SF-J16,SF-G27,3,17,0,9,3,8,0.0,1.0,0.5294117647058824,0.47058823529411764
SF-J16,SF-M22-2,8,10,0,5,8,5,0.0,1.0,0.5,0.5
SF-J16,SF-L22,10,13,1,3,9,10,0.1,0.9,0.23076923076923078,0.7692307692307693
SF-J16,SF-F27,2,4,1,0,1,4,0.5,0.5,0.0,1.0
SF-J16,SF-N22-2,12,24,1,5,11,19,0.08333333333333333,0.9166666666666666,0.20833333333333334,0.7916666666666666
SF-J16,SF-G28-2,2,1,0,1,2,0,0.0,1.0,1.0,0.0
SF-J16,SF-G28-1,1,2,1,0,0,2,1.0,0.0,0.0,1.0
SF-J16,SF-M22-1,7,8,1,6,6,2,0.14285714285714285,0.8571428571428571,0.75,0.25
SF-J16,SF-K22-2,3,5,1,2,2,3,0.3333333333333333,0.6666666666666666,0.4,0.6
SF-J16,SF-K24,1,1,0,0,1,1,0.0,1.0,0.0,1.0
SF-J16,SF-J23-2,5,3,1,1,4,2,0.2,0.8,0.3333333333333333,0.6666666666666666
SF-J16,SF-G23,9,3,0,0,9,3,0.0,1.0,0.0,1.0
SF-J16,SF-G24,22,2,0,0,22,2,0.0,1.0,0.0,1.0
SF-J16,SF-G25,36,36,0,0,36,36,0.0,1.0,0.0,1.0
SF-J16,SF-F23,59,28,1,5,58,23,0.01694915254237288,0.9830508474576272,0.17857142857142858,0.8214285714285714
SF-J16,SF-E23,6,20,3,3,3,17,0.5,0.5,0.15,0.85
SF-J16,SF-D24,3,7,1,1,2,6,0.3333333333333333,0.6666666666666666,0.14285714285714285,0.8571428571428571
SF-J16,SF-C22,9,9,1,0,8,9,0.1111111111111111,0.8888888888888888,0.0,1.0
SF-J16,SF-B22,3,4,0,0,3,4,0.0,1.0,0.0,1.0
SF-J16,SF-J17,24,21,11,9,13,12,0.4583333333333333,0.5416666666666666,0.42857142857142855,0.5714285714285714
SF-J16,SF-I19,3,7,1,3,2,4,0.3333333333333333,0.6666666666666666,0.42857142857142855,0.5714285714285714
SF-J16,SF-I20,2,2,2,1,0,1,1.0,0.0,0.5,0.5
SF-J16,SF-H16,99,60,66,19,33,41,0.6666666666666666,0.3333333333333333,0.31666666666666665,0.6833333333333333
SF-J16,SF-H20,5,4,1,3,4,1,0.2,0.8,0.75,0.25
SF-J16,SF-H18,4,6,0,1,4,5,0.0,1.0,0.16666666666666666,0.8333333333333334
SF-J16,SF-H17,7,12,0,0,7,12,0.0,1.0,0.0,1.0
SF-J16,SF-G19,5,15,1,10,4,5,0.2,0.8,0.6666666666666666,0.3333333333333333
SF-J16,SF-G17,4,1,0,0,4,1,0.0,1.0,0.0,1.0
SF-J16,SF-G18,9,11,1,6,8,5,0.1111111111111111,0.8888888888888888,0.5454545454545454,0.45454545454545453
SF-J16,SF-G20,13,8,5,2,8,6,0.38461538461538464,0.6153846153846154,0.25,0.75
SF-J16,SF-F19,51,66,2,12,49,54,0.0392156862745098,0.9607843137254902,0.18181818181818182,0.8181818181818182
SF-J16,SF-E18,5,3,3,1,2,2,0.6,0.4,0.3333333333333333,0.6666666666666666
SF-J16,SF-E20,18,8,0,1,18,7,0.0,1.0,0.125,0.875
SF-J16,SF-G30-2,5,4,1,1,4,3,0.2,0.8,0.25,0.75
SF-J16,SF-E29-2,3,3,1,3,2,0,0.3333333333333333,0.6666666666666666,1.0,0.0
SF-J16,SF-G29-2,1,7,0,0,1,7,0.0,1.0,0.0,1.0
SF-J16,SF-G29-1,4,6,0,0,4,6,0.0,1.0,0.0,1.0
SF-J16,SF-F30-2,1,2,0,1,1,1,0.0,1.0,0.5,0.5
SF-J16,SF-F29,1,3,0,1,1,2,0.0,1.0,0.3333333333333333,0.6666666666666666
SF-J16,SF-F28-1,3,7,0,3,3,4,0.0,1.0,0.42857142857142855,0.5714285714285714
SF-J16,SF-E28,1,4,0,4,1,0,0.0,1.0,1.0,0.0
SF-J16,SF-J10,6,26,5,13,1,13,0.8333333333333334,0.16666666666666666,0.5,0.5
SF-J16,SF-J12,11,11,3,4,8,7,0.2727272727272727,0.7272727272727273,0.36363636363636365,0.6363636363636364
SF-J16,SF-J13,7,7,3,4,4,3,0.42857142857142855,0.5714285714285714,0.5714285714285714,0.42857142857142855
SF-J16,SF-J15,15,9,9,3,6,6,0.6,0.4,0.3333333333333333,0.6666666666666666
SF-J16,SF-J14,3,8,0,0,3,8,0.0,1.0,0.0,1.0
SF-J16,SF-H13,1,2,0,1,1,1,0.0,1.0,0.5,0.5
SF-J16,SF-I16,57,14,44,1,13,13,0.7719298245614035,0.22807017543859648,0.07142857142857142,0.9285714285714286
SF-J16,SF-H12,12,16,2,2,10,14,0.16666666666666666,0.8333333333333334,0.125,0.875
SF-J16,SF-H15,9,8,6,5,3,3,0.6666666666666666,0.3333333333333333,0.625,0.375
SF-J16,SF-H14,8,7,3,0,5,7,0.375,0.625,0.0,1.0
SF-J16,SF-G13,10,11,2,1,8,10,0.2,0.8,0.09090909090909091,0.9090909090909091
SF-J16,SF-G11,6,6,0,1,6,5,0.0,1.0,0.16666666666666666,0.8333333333333334
SF-J16,SF-G12,6,8,0,4,6,4,0.0,1.0,0.5,0.5
SF-J16,SF-G10-1,2,4,0,0,2,4,0.0,1.0,0.0,1.0
SF-J16,SF-F15,17,5,2,0,15,5,0.11764705882352941,0.8823529411764706,0.0,1.0
SF-J16,SF-F16,3,10,0,4,3,6,0.0,1.0,0.4,0.6
SF-J16,SF-C21,14,8,1,0,13,8,0.07142857142857142,0.9285714285714286,0.0,1.0
SF-J16,SF-C20,3,2,0,0,3,2,0.0,1.0,0.0,1.0
SF-J16,SF-B21,1,4,0,0,1,4,0.0,1.0,0.0,1.0
SF-J16,SF-B19,5,8,0,6,5,2,0.0,1.0,0.75,0.25
SF-J16,SF-A20,5,2,0,1,5,1,0.0,1.0,0.5,0.5
SF-J16,SF-C26,11,7,0,0,11,7,0.0,1.0,0.0,1.0
SF-J16,SF-C25,17,27,0,4,17,23,0.0,1.0,0.14814814814814814,0.8518518518518519
SF-J16,SF-B25,8,13,1,0,7,13,0.125,0.875,0.0,1.0
SF-J16,SF-E27,3,33,0,29,3,4,0.0,1.0,0.8787878787878788,0.12121212121212122
SF-J16,SF-D27,1,3,1,3,0,0,1.0,0.0,1.0,0.0
SF-J16,SF-C28-2,1,1,0,0,1,1,0.0,1.0,0.0,1.0
SF-J16,SF-J1,49,73,10,28,39,45,0.20408163265306123,0.7959183673469388,0.3835616438356164,0.6164383561643836
SF-J16,SF-H0,5,8,0,4,5,4,0.0,1.0,0.5,0.5
SF-J16,SF-J3,6,5,0,2,6,3,0.0,1.0,0.4,0.6
SF-J16,SF-J5,3,10,0,4,3,6,0.0,1.0,0.4,0.6
SF-J16,SF-G6,1,2,0,0,1,2,0.0,1.0,0.0,1.0
SF-J16,SF-G8,6,10,0,1,6,9,0.0,1.0,0.1,0.9
SF-J16,SF-G5,1,3,0,2,1,1,0.0,1.0,0.6666666666666666,0.3333333333333333
SF-J16,SF-G7,15,28,0,7,15,21,0.0,1.0,0.25,0.75
SF-J16,SF-F9,4,10,0,0,4,10,0.0,1.0,0.0,1.0
SF-J16,SF-G26,10,6,0,0,10,6,0.0,1.0,0.0,1.0
SF-J16,SF-K21,7,3,3,1,4,2,0.42857142857142855,0.5714285714285714,0.3333333333333333,0.6666666666666666
SF-J16,SF-K22-1,15,8,1,1,14,7,0.06666666666666667,0.9333333333333333,0.125,0.875
SF-J16,SF-J23-1,16,14,0,1,16,13,0.0,1.0,0.07142857142857142,0.9285714285714286
SF-J16,SF-J22-1,25,34,1,6,24,28,0.04,0.96,0.17647058823529413,0.8235294117647058
SF-J16,SF-J22-2,15,11,0,2,15,9,0.0,1.0,0.18181818181818182,0.8181818181818182
SF-J16,SF-J21,36,53,0,4,36,49,0.0,1.0,0.07547169811320754,0.9245283018867925
SF-J16,SF-I21,13,21,5,12,8,9,0.38461538461538464,0.6153846153846154,0.5714285714285714,0.42857142857142855
SF-J16,SF-I22,3,3,1,0,2,3,0.3333333333333333,0.6666666666666666,0.0,1.0
SF-J16,SF-I23-2,8,8,1,2,7,6,0.125,0.875,0.25,0.75
SF-J16,SF-I24,14,23,3,8,11,15,0.21428571428571427,0.7857142857142857,0.34782608695652173,0.6521739130434783
SF-J16,SF-I23-1,12,8,2,1,10,7,0.16666666666666666,0.8333333333333334,0.125,0.875
SF-J16,SF-F26,9,9,1,1,8,8,0.1111111111111111,0.8888888888888888,0.1111111111111111,0.8888888888888888
SF-J16,SF-M13,202,186,60,10,142,176,0.297029702970297,0.7029702970297029,0.053763440860215055,0.946236559139785
SF-J16,SF-M15,17,21,7,7,10,14,0.4117647058823529,0.5882352941176471,0.3333333333333333,0.6666666666666666
SF-J16,SF-L19,5,12,0,5,5,7,0.0,1.0,0.4166666666666667,0.5833333333333334
SF-J16,SF-L20,5,6,1,0,4,6,0.2,0.8,0.0,1.0
SF-J16,SF-N20-1,6,10,1,1,5,9,0.16666666666666666,0.8333333333333334,0.1,0.9
SF-J16,SF-M20,14,26,1,8,13,18,0.07142857142857142,0.9285714285714286,0.3076923076923077,0.6923076923076923
SF-J16,SF-K17-2,2,10,1,5,1,5,0.5,0.5,0.5,0.5
SF-J16,SF-K20,25,11,7,5,18,6,0.28,0.72,0.45454545454545453,0.5454545454545454
SF-J16,SF-K15-,64,130,25,69,39,61,0.390625,0.609375,0.5307692307692308,0.46923076923076923
SF-J16,SF-K19,13,14,6,3,7,11,0.46153846153846156,0.5384615384615384,0.21428571428571427,0.7857142857142857
SF-J16,SF-K18,19,12,15,9,4,3,0.7894736842105263,0.21052631578947367,0.75,0.25
SF-J16,SF-K17,39,60,21,41,18,19,0.5384615384615384,0.46153846153846156,0.6833333333333333,0.31666666666666665
SF-J16,SF-J18,46,68,30,50,16,18,0.6521739130434783,0.34782608695652173,0.7352941176470589,0.2647058823529412
SF-J16,SF-J20,10,6,3,2,7,4,0.3,0.7,0.3333333333333333,0.6666666666666666
SF-J16,SF-J19,15,13,5,2,10,11,0.3333333333333333,0.6666666666666666,0.15384615384615385,0.8461538461538461
SF-J16,SF-M12,7,13,5,3,2,10,0.7142857142857143,0.2857142857142857,0.23076923076923078,0.7692307692307693
SF-J16,SF-M10,9,8,1,2,8,6,0.1111111111111111,0.8888888888888888,0.25,0.75
SF-J16,SF-M11,19,21,6,12,13,9,0.3157894736842105,0.6842105263157895,0.5714285714285714,0.42857142857142855
SF-J16,SF-R20,1,4,1,0,0,4,1.0,0.0,0.0,1.0
SF-J16,SF-Q21-2,1,2,0,0,1,2,0.0,1.0,0.0,1.0
SF-J16,SF-Q21-1,1,4,0,0,1,4,0.0,1.0,0.0,1.0
SF-J16,SF-P21,2,7,0,0,2,7,0.0,1.0,0.0,1.0
SF-J16,SF-O18,4,7,0,0,4,7,0.0,1.0,0.0,1.0
SF-J16,SF-O19,30,12,1,9,29,3,0.03333333333333333,0.9666666666666667,0.75,0.25
SF-J16,SF-O21,28,86,1,4,27,82,0.03571428571428571,0.9642857142857143,0.046511627906976744,0.9534883720930233
SF-J16,SF-O22,4,10,0,3,4,7,0.0,1.0,0.3,0.7
SF-J16,SF-N21,10,12,1,8,9,4,0.1,0.9,0.6666666666666666,0.3333333333333333
SF-J16,SF-N20-2,8,4,0,1,8,3,0.0,1.0,0.25,0.75
SF-J16,SF-M21,7,13,1,6,6,7,0.14285714285714285,0.8571428571428571,0.46153846153846156,0.5384615384615384
SF-J16,SF-L21,19,15,2,7,17,8,0.10526315789473684,0.8947368421052632,0.4666666666666667,0.5333333333333333
SF-J16,SF-O30,2,5,1,1,1,4,0.5,0.5,0.2,0.8
SF-J16,SF-L30-1,1,4,0,2,1,2,0.0,1.0,0.5,0.5
SF-J16,SF-K30-2,1,1,0,0,1,1,0.0,1.0,0.0,1.0
SF-J16,SF-L29,3,2,1,1,2,1,0.3333333333333333,0.6666666666666666,0.5,0.5
SF-J16,SF-H28,3,2,0,0,3,2,0.0,1.0,0.0,1.0
SF-J16,SF-S24,1,3,1,1,0,2,1.0,0.0,0.3333333333333333,0.6666666666666666
SF-J16,SF-R24,2,1,1,1,1,0,0.5,0.5,1.0,0.0
SF-J16,SF-O25-2,1,4,0,1,1,3,0.0,1.0,0.25,0.75
SF-J16,SF-N22-1B,3,3,0,1,3,2,0.0,1.0,0.3333333333333333,0.6666666666666666
SF-J16,SF-N25,8,4,0,1,8,3,0.0,1.0,0.25,0.75
SF-J16,SF-T21,1,1,0,1,1,0,0.0,1.0,1.0,0.0
SF-J16,SF-T22,2,2,0,1,2,1,0.0,1.0,0.5,0.5
SF-J16,SF-S22-1,1,2,0,0,1,2,0.0,1.0,0.0,1.0
SF-J16,SF-Q23-3,2,1,0,0,2,1,0.0,1.0,0.0,1.0
SF-J16,SF-Q22-1,5,5,0,1,5,4,0.0,1.0,0.2,0.8
SF-J16,SF-Q22-2,14,15,0,0,14,15,0.0,1.0,0.0,1.0
SF-J16,SF-P22,4,9,1,0,3,9,0.25,0.75,0.0,1.0
SF-J16,SF-W19,1,1,0,0,1,1,0.0,1.0,0.0,1.0
SF-J16,SF-S21,1,1,0,0,1,1,0.0,1.0,0.0,1.0
SF-J18,SF-M25,4,1,0,0,4,1,0.0,1.0,0.0,1.0
SF-J18,SF-M26-2,4,4,0,1,4,3,0.0,1.0,0.25,0.75
SF-J18,SF-K26,5,8,0,4,5,4,0.0,1.0,0.5,0.5
SF-J18,SF-J27,1,2,0,1,1,1,0.0,1.0,0.5,0.5
SF-J18,SF-M30,18,21,0,0,18,21,0.0,1.0,0.0,1.0
SF-J18,SF-L27-2,1,7,0,2,1,5,0.0,1.0,0.2857142857142857,0.7142857142857143
SF-J18,SF-J29-3,2,2,0,0,2,2,0.0,1.0,0.0,1.0
SF-J18,SF-J29,8,8,0,4,8,4,0.0,1.0,0.5,0.5
SF-J18,SF-L26,9,9,0,0,9,9,0.0,1.0,0.0,1.0
SF-J18,SF-M28,3,3,1,0,2,3,0.3333333333333333,0.6666666666666666,0.0,1.0
SF-J18,SF-L25,8,6,2,0,6,6,0.25,0.75,0.0,1.0
SF-J18,SF-M24,4,6,3,1,1,5,0.75,0.25,0.16666666666666666,0.8333333333333334
SF-J18,SF-L24,4,1,1,1,3,0,0.25,0.75,1.0,0.0
SF-J18,SF-N23,6,6,0,1,6,5,0.0,1.0,0.16666666666666666,0.8333333333333334
SF-J18,SF-N24-2,4,15,0,3,4,12,0.0,1.0,0.2,0.8
SF-J18,SF-K27-2,9,11,0,1,9,10,0.0,1.0,0.09090909090909091,0.9090909090909091
SF-J18,SF-J26-2,2,5,1,4,1,1,0.5,0.5,0.8,0.2
SF-J18,SF-L28,3,4,0,1,3,3,0.0,1.0,0.25,0.75
SF-J18,SF-K29-1,3,1,0,1,3,0,0.0,1.0,1.0,0.0
SF-J18,SF-J28-2,4,4,0,1,4,3,0.0,1.0,0.25,0.75
SF-J18,SF-K27,7,11,0,0,7,11,0.0,1.0,0.0,1.0
SF-J18,SF-K25,5,17,0,8,5,9,0.0,1.0,0.47058823529411764,0.5294117647058824
SF-J18,SF-J25,7,6,2,4,5,2,0.2857142857142857,0.7142857142857143,0.6666666666666666,0.3333333333333333
SF-J18,SF-H26-2,4,14,0,12,4,2,0.0,1.0,0.8571428571428571,0.14285714285714285
SF-J18,SF-P24,57,44,0,1,57,43,0.0,1.0,0.022727272727272728,0.9772727272727273
SF-J18,SF-J24,9,7,1,4,8,3,0.1111111111111111,0.8888888888888888,0.5714285714285714,0.42857142857142855
SF-J18,SF-O24,5,4,0,1,5,3,0.0,1.0,0.25,0.75
SF-J18,SF-I26-,1,1,0,1,1,0,0.0,1.0,1.0,0.0
SF-J18,SF-I25,10,38,1,26,9,12,0.1,0.9,0.6842105263157895,0.3157894736842105
SF-J18,SF-K23,3,3,0,0,3,3,0.0,1.0,0.0,1.0
SF-J18,SF-H26,16,20,0,6,16,14,0.0,1.0,0.3,0.7
SF-J18,SF-O23,20,14,2,6,18,8,0.1,0.9,0.42857142857142855,0.5714285714285714
SF-J18,SF-F28-2,15,27,0,0,15,27,0.0,1.0,0.0,1.0
SF-J18,SF-G27,23,40,1,14,22,26,0.043478260869565216,0.9565217391304348,0.35,0.65
SF-J18,SF-M22-2,17,36,1,19,16,17,0.058823529411764705,0.9411764705882353,0.5277777777777778,0.4722222222222222
SF-J18,SF-L22,22,33,6,7,16,26,0.2727272727272727,0.7272727272727273,0.21212121212121213,0.7878787878787878
SF-J18,SF-F27,10,5,2,2,8,3,0.2,0.8,0.4,0.6
SF-J18,SF-N22-2,31,29,2,7,29,22,0.06451612903225806,0.9354838709677419,0.2413793103448276,0.7586206896551724
SF-J18,SF-G28-2,2,2,0,0,2,2,0.0,1.0,0.0,1.0
SF-J18,SF-G28-1,1,1,0,0,1,1,0.0,1.0,0.0,1.0
SF-J18,SF-M22-1,14,82,4,21,10,61,0.2857142857142857,0.7142857142857143,0.25609756097560976,0.7439024390243902
SF-J18,SF-O25-1,4,2,1,1,3,1,0.25,0.75,0.5,0.5
SF-J18,SF-K22-2,5,15,2,4,3,11,0.4,0.6,0.26666666666666666,0.7333333333333333
SF-J18,SF-K24,1,2,0,1,1,1,0.0,1.0,0.5,0.5
SF-J18,SF-J23-2,10,5,1,2,9,3,0.1,0.9,0.4,0.6
SF-J18,SF-G23,7,6,1,2,6,4,0.14285714285714285,0.8571428571428571,0.3333333333333333,0.6666666666666666
SF-J18,SF-G24,8,21,0,7,8,14,0.0,1.0,0.3333333333333333,0.6666666666666666
SF-J18,SF-G25,12,21,1,5,11,16,0.08333333333333333,0.9166666666666666,0.23809523809523808,0.7619047619047619
SF-J18,SF-F23,23,21,1,8,22,13,0.043478260869565216,0.9565217391304348,0.38095238095238093,0.6190476190476191
SF-J18,SF-E23,41,31,8,13,33,18,0.1951219512195122,0.8048780487804879,0.41935483870967744,0.5806451612903226
SF-J18,SF-D24,6,10,1,2,5,8,0.16666666666666666,0.8333333333333334,0.2,0.8
SF-J18,SF-C22,5,14,0,1,5,13,0.0,1.0,0.07142857142857142,0.9285714285714286
SF-J18,SF-B22,7,13,1,5,6,8,0.14285714285714285,0.8571428571428571,0.38461538461538464,0.6153846153846154
SF-J18,SF-J17,77,43,59,9,18,34,0.7662337662337663,0.23376623376623376,0.20930232558139536,0.7906976744186046
SF-J18,SF-I19,18,29,3,22,15,7,0.16666666666666666,0.8333333333333334,0.7586206896551724,0.2413793103448276
SF-J18,SF-I20,13,5,7,1,6,4,0.5384615384615384,0.46153846153846156,0.2,0.8
SF-J18,SF-H16,62,46,19,5,43,41,0.3064516129032258,0.6935483870967742,0.10869565217391304,0.8913043478260869
SF-J18,SF-H19,12,13,5,8,7,5,0.4166666666666667,0.5833333333333334,0.6153846153846154,0.38461538461538464
SF-J18,SF-H20,21,22,3,11,18,11,0.14285714285714285,0.8571428571428571,0.5,0.5
SF-J18,SF-H18,51,32,12,7,39,25,0.23529411764705882,0.7647058823529411,0.21875,0.78125
SF-J18,SF-H17,28,12,3,0,25,12,0.10714285714285714,0.8928571428571429,0.0,1.0
SF-J18,SF-G19,26,27,9,4,17,23,0.34615384615384615,0.6538461538461539,0.14814814814814814,0.8518518518518519
SF-J18,SF-G17,15,13,7,2,8,11,0.4666666666666667,0.5333333333333333,0.15384615384615385,0.8461538461538461
SF-J18,SF-G18,162,157,13,33,149,124,0.08024691358024691,0.9197530864197531,0.21019108280254778,0.7898089171974523
SF-J18,SF-G20,39,24,3,9,36,15,0.07692307692307693,0.9230769230769231,0.375,0.625
SF-J18,SF-F19,20,51,5,15,15,36,0.25,0.75,0.29411764705882354,0.7058823529411765
SF-J18,SF-E18,48,36,16,7,32,29,0.3333333333333333,0.6666666666666666,0.19444444444444445,0.8055555555555556
SF-J18,SF-E20,19,21,0,1,19,20,0.0,1.0,0.047619047619047616,0.9523809523809523
SF-J18,SF-H30,3,1,0,0,3,1,0.0,1.0,0.0,1.0
SF-J18,SF-G30-2,15,23,6,12,9,11,0.4,0.6,0.5217391304347826,0.4782608695652174
SF-J18,SF-F30-1,2,4,0,2,2,2,0.0,1.0,0.5,0.5
SF-J18,SF-E29-2,12,17,1,2,11,15,0.08333333333333333,0.9166666666666666,0.11764705882352941,0.8823529411764706
SF-J18,SF-E29-1,5,7,2,0,3,7,0.4,0.6,0.0,1.0
SF-J18,SF-D29,2,2,1,1,1,1,0.5,0.5,0.5,0.5
SF-J18,SF-D28,3,5,0,1,3,4,0.0,1.0,0.2,0.8
SF-J18,SF-G29-2,9,3,0,0,9,3,0.0,1.0,0.0,1.0
SF-J18,SF-G29-1,3,10,0,1,3,9,0.0,1.0,0.1,0.9
SF-J18,SF-G30-1,5,4,1,3,4,1,0.2,0.8,0.75,0.25
SF-J18,SF-G29-3,4,5,1,0,3,5,0.25,0.75,0.0,1.0
SF-J18,SF-F30-2,1,3,0,1,1,2,0.0,1.0,0.3333333333333333,0.6666666666666666
SF-J18,SF-F29,4,8,1,1,3,7,0.25,0.75,0.125,0.875
SF-J18,SF-E29-3,30,34,0,3,30,31,0.0,1.0,0.08823529411764706,0.9117647058823529
SF-J18,SF-F28-1,11,9,2,4,9,5,0.18181818181818182,0.8181818181818182,0.4444444444444444,0.5555555555555556
SF-J18,SF-E28-2,5,1,0,0,5,1,0.0,1.0,0.0,1.0
SF-J18,SF-E28,5,6,2,1,3,5,0.4,0.6,0.16666666666666666,0.8333333333333334
SF-J18,SF-J10,31,31,11,16,20,15,0.3548387096774194,0.6451612903225806,0.5161290322580645,0.4838709677419355
SF-J18,SF-J12,43,37,14,13,29,24,0.32558139534883723,0.6744186046511628,0.35135135135135137,0.6486486486486487
SF-J18,SF-J13,38,27,7,7,31,20,0.18421052631578946,0.8157894736842105,0.25925925925925924,0.7407407407407407
SF-J18,SF-J15,16,9,4,5,12,4,0.25,0.75,0.5555555555555556,0.4444444444444444
SF-J18,SF-J14,3,4,0,1,3,3,0.0,1.0,0.25,0.75
SF-J18,SF-H13,18,5,1,3,17,2,0.05555555555555555,0.9444444444444444,0.6,0.4
SF-J18,SF-I16,18,6,9,3,9,3,0.5,0.5,0.5,0.5
SF-J18,SF-H12,26,36,3,1,23,35,0.11538461538461539,0.8846153846153846,0.027777777777777776,0.9722222222222222
SF-J18,SF-G10-2,10,9,3,3,7,6,0.3,0.7,0.3333333333333333,0.6666666666666666
SF-J18,SF-H15,12,11,2,1,10,10,0.16666666666666666,0.8333333333333334,0.09090909090909091,0.9090909090909091
SF-J18,SF-G9,5,3,2,1,3,2,0.4,0.6,0.3333333333333333,0.6666666666666666
SF-J18,SF-H14,6,4,2,0,4,4,0.3333333333333333,0.6666666666666666,0.0,1.0
SF-J18,SF-G13,16,28,3,3,13,25,0.1875,0.8125,0.10714285714285714,0.8928571428571429
SF-J18,SF-G11,17,16,9,10,8,6,0.5294117647058824,0.47058823529411764,0.625,0.375
SF-J18,SF-G12,35,29,8,4,27,25,0.22857142857142856,0.7714285714285715,0.13793103448275862,0.8620689655172413
SF-J18,SF-G10-1,7,6,2,0,5,6,0.2857142857142857,0.7142857142857143,0.0,1.0
SF-J18,SF-F15,9,10,3,3,6,7,0.3333333333333333,0.6666666666666666,0.3,0.7
SF-J18,SF-F16,11,9,5,4,6,5,0.45454545454545453,0.5454545454545454,0.4444444444444444,0.5555555555555556
SF-J18,SF-C21,6,3,0,0,6,3,0.0,1.0,0.0,1.0
SF-J18,SF-C20,4,18,1,1,3,17,0.25,0.75,0.05555555555555555,0.9444444444444444
SF-J18,SF-B21,4,8,0,2,4,6,0.0,1.0,0.25,0.75
SF-J18,SF-B19,4,8,0,0,4,8,0.0,1.0,0.0,1.0
SF-J18,SF-A20,7,8,1,1,6,7,0.14285714285714285,0.8571428571428571,0.125,0.875
SF-J18,SF-A19,2,3,0,0,2,3,0.0,1.0,0.0,1.0
SF-J18,SF-C26,3,6,0,0,3,6,0.0,1.0,0.0,1.0
SF-J18,SF-C25,11,15,0,2,11,13,0.0,1.0,0.13333333333333333,0.8666666666666667
SF-J18,SF-B25,5,13,0,3,5,10,0.0,1.0,0.23076923076923078,0.7692307692307693
SF-J18,SF-E27,4,2,1,2,3,0,0.25,0.75,1.0,0.0
SF-J18,SF-B28-2,16,12,0,1,16,11,0.0,1.0,0.08333333333333333,0.9166666666666666
SF-J18,SF-D27,3,4,0,0,3,4,0.0,1.0,0.0,1.0
SF-J18,SF-C28-2,2,3,1,0,1,3,0.5,0.5,0.0,1.0
SF-J18,SF-B28,2,3,0,0,2,3,0.0,1.0,0.0,1.0
SF-J18,SF-J1,50,70,25,34,25,36,0.5,0.5,0.4857142857142857,0.5142857142857142
SF-J18,SF-H0,7,19,5,8,2,11,0.7142857142857143,0.2857142857142857,0.42105263157894735,0.5789473684210527
SF-J18,SF-J3,12,14,2,9,10,5,0.16666666666666666,0.8333333333333334,0.6428571428571429,0.35714285714285715
SF-J18,SF-J5,8,13,1,4,7,9,0.125,0.875,0.3076923076923077,0.6923076923076923
SF-J18,SF-G6,3,14,0,5,3,9,0.0,1.0,0.35714285714285715,0.6428571428571429
SF-J18,SF-G8,4,6,0,2,4,4,0.0,1.0,0.3333333333333333,0.6666666666666666
SF-J18,SF-G5,6,9,0,2,6,7,0.0,1.0,0.2222222222222222,0.7777777777777778
SF-J18,SF-G7,17,15,4,5,13,10,0.23529411764705882,0.7647058823529411,0.3333333333333333,0.6666666666666666
SF-J18,SF-F9,6,5,5,3,1,2,0.8333333333333334,0.16666666666666666,0.6,0.4
SF-J18,SF-G26,9,13,1,5,8,8,0.1111111111111111,0.8888888888888888,0.38461538461538464,0.6153846153846154
SF-J18,SF-K21,27,29,6,9,21,20,0.2222222222222222,0.7777777777777778,0.3103448275862069,0.6896551724137931
SF-J18,SF-K22-1,6,14,1,2,5,12,0.16666666666666666,0.8333333333333334,0.14285714285714285,0.8571428571428571
SF-J18,SF-J23-1,27,35,0,4,27,31,0.0,1.0,0.11428571428571428,0.8857142857142857
SF-J18,SF-J22-1,24,18,1,5,23,13,0.041666666666666664,0.9583333333333334,0.2777777777777778,0.7222222222222222
SF-J18,SF-J22-2,29,30,2,11,27,19,0.06896551724137931,0.9310344827586207,0.36666666666666664,0.6333333333333333
SF-J18,SF-J21,54,89,6,36,48,53,0.1111111111111111,0.8888888888888888,0.4044943820224719,0.5955056179775281
SF-J18,SF-I21,10,17,0,5,10,12,0.0,1.0,0.29411764705882354,0.7058823529411765
SF-J18,SF-I22,7,81,0,19,7,62,0.0,1.0,0.2345679012345679,0.7654320987654321
SF-J18,SF-I23-2,20,24,3,6,17,18,0.15,0.85,0.25,0.75
SF-J18,SF-I24,11,20,2,12,9,8,0.18181818181818182,0.8181818181818182,0.6,0.4
SF-J18,SF-I23-1,9,16,0,2,9,14,0.0,1.0,0.125,0.875
SF-J18,SF-F26,24,30,3,5,21,25,0.125,0.875,0.16666666666666666,0.8333333333333334
SF-J18,SF-M13,40,41,9,18,31,23,0.225,0.775,0.43902439024390244,0.5609756097560976
SF-J18,SF-M15,103,95,41,18,62,77,0.39805825242718446,0.6019417475728155,0.18947368421052632,0.8105263157894737
SF-J18,SF-L19,22,20,2,9,20,11,0.09090909090909091,0.9090909090909091,0.45,0.55
SF-J18,SF-L20,53,54,4,12,49,42,0.07547169811320754,0.9245283018867925,0.2222222222222222,0.7777777777777778
SF-J18,SF-N20-1,14,13,0,4,14,9,0.0,1.0,0.3076923076923077,0.6923076923076923
SF-J18,SF-M20,67,75,8,20,59,55,0.11940298507462686,0.8805970149253731,0.26666666666666666,0.7333333333333333
SF-J18,SF-K17-2,39,26,19,6,20,20,0.48717948717948717,0.5128205128205128,0.23076923076923078,0.7692307692307693
SF-J18,SF-K20,44,30,18,14,26,16,0.4090909090909091,0.5909090909090909,0.4666666666666667,0.5333333333333333
SF-J18,SF-K15-,130,179,54,86,76,93,0.4153846153846154,0.5846153846153846,0.48044692737430167,0.5195530726256983
SF-J18,SF-K19,27,30,11,16,16,14,0.4074074074074074,0.5925925925925926,0.5333333333333333,0.4666666666666667
SF-J18,SF-K18,37,60,18,29,19,31,0.4864864864864865,0.5135135135135135,0.48333333333333334,0.5166666666666667
SF-J18,SF-K17,48,63,31,35,17,28,0.6458333333333334,0.3541666666666667,0.5555555555555556,0.4444444444444444
SF-J18,SF-J16,68,46,50,30,18,16,0.7352941176470589,0.2647058823529412,0.6521739130434783,0.34782608695652173
SF-J18,SF-J20,11,8,2,4,9,4,0.18181818181818182,0.8181818181818182,0.5,0.5
SF-J18,SF-J19,37,30,17,8,20,22,0.4594594594594595,0.5405405405405406,0.26666666666666666,0.7333333333333333
SF-J18,SF-O12,3,3,2,0,1,3,0.6666666666666666,0.3333333333333333,0.0,1.0
SF-J18,SF-M12,24,31,13,11,11,20,0.5416666666666666,0.4583333333333333,0.3548387096774194,0.6451612903225806
SF-J18,SF-M10,18,17,9,7,9,10,0.5,0.5,0.4117647058823529,0.5882352941176471
SF-J18,SF-M11,47,58,18,26,29,32,0.3829787234042553,0.6170212765957447,0.4482758620689655,0.5517241379310345
SF-J18,SF-R19,8,17,1,0,7,17,0.125,0.875,0.0,1.0
SF-J18,SF-R20,12,19,0,0,12,19,0.0,1.0,0.0,1.0
SF-J18,SF-Q21-2,20,5,0,0,20,5,0.0,1.0,0.0,1.0
SF-J18,SF-Q21-1,11,2,2,0,9,2,0.18181818181818182,0.8181818181818182,0.0,1.0
SF-J18,SF-P21,9,19,0,5,9,14,0.0,1.0,0.2631578947368421,0.7368421052631579
SF-J18,SF-O18,29,23,7,6,22,17,0.2413793103448276,0.7586206896551724,0.2608695652173913,0.7391304347826086
SF-J18,SF-O19,23,50,0,8,23,42,0.0,1.0,0.16,0.84
SF-J18,SF-O21,55,72,4,27,51,45,0.07272727272727272,0.9272727272727272,0.375,0.625
SF-J18,SF-O22,25,40,4,13,21,27,0.16,0.84,0.325,0.675
SF-J18,SF-N21,24,26,5,11,19,15,0.20833333333333334,0.7916666666666666,0.4230769230769231,0.5769230769230769
SF-J18,SF-N20-2,15,8,3,2,12,6,0.2,0.8,0.25,0.75
SF-J18,SF-M21,47,27,19,17,28,10,0.40425531914893614,0.5957446808510638,0.6296296296296297,0.37037037037037035
SF-J18,SF-L21,62,36,12,9,50,27,0.1935483870967742,0.8064516129032258,0.25,0.75
SF-J18,SF-S30,2,3,0,0,2,3,0.0,1.0,0.0,1.0
SF-J18,SF-Q30,3,1,0,0,3,1,0.0,1.0,0.0,1.0
SF-J18,SF-P30,2,3,0,1,2,2,0.0,1.0,0.3333333333333333,0.6666666666666666
SF-J18,SF-O30-2,14,25,1,4,13,21,0.07142857142857142,0.9285714285714286,0.16,0.84
SF-J18,SF-O30,23,41,3,23,20,18,0.13043478260869565,0.8695652173913043,0.5609756097560976,0.43902439024390244
SF-J18,SF-N27,5,8,0,2,5,6,0.0,1.0,0.25,0.75
SF-J18,SF-N29,20,6,0,0,20,6,0.0,1.0,0.0,1.0
SF-J18,SF-N28,5,7,1,0,4,7,0.2,0.8,0.0,1.0
SF-J18,SF-L30-1,6,23,0,6,6,17,0.0,1.0,0.2608695652173913,0.7391304347826086
SF-J18,SF-L31-1,3,1,1,1,2,0,0.3333333333333333,0.6666666666666666,1.0,0.0
SF-J18,SF-L29,9,8,1,0,8,8,0.1111111111111111,0.8888888888888888,0.0,1.0
SF-J18,SF-J29-1,6,5,0,0,6,5,0.0,1.0,0.0,1.0
SF-J18,SF-I30,3,1,0,0,3,1,0.0,1.0,0.0,1.0
SF-J18,SF-I29-2,1,1,1,0,0,1,1.0,0.0,0.0,1.0
SF-J18,SF-I27,4,4,0,0,4,4,0.0,1.0,0.0,1.0
SF-J18,SF-I28,7,1,0,1,7,0,0.0,1.0,1.0,0.0
SF-J18,SF-I30-2,2,5,0,2,2,3,0.0,1.0,0.4,0.6
SF-J18,SF I29-1,8,4,0,0,8,4,0.0,1.0,0.0,1.0
SF-J18,SF-H28,7,9,0,1,7,8,0.0,1.0,0.1111111111111111,0.8888888888888888
SF-J18,SF-H29,1,1,0,0,1,1,0.0,1.0,0.0,1.0
SF-J18,SF-S24,2,4,0,2,2,2,0.0,1.0,0.5,0.5
SF-J18,SF-R24,7,9,1,2,6,7,0.14285714285714285,0.8571428571428571,0.2222222222222222,0.7777777777777778
SF-J18,SF-R26,2,4,0,0,2,4,0.0,1.0,0.0,1.0
SF-J18,SF-Q26,2,1,1,1,1,0,0.5,0.5,1.0,0.0
SF-J18,SF-P26,4,8,2,1,2,7,0.5,0.5,0.125,0.875
SF-J18,SF-O25-2,13,8,1,5,12,3,0.07692307692307693,0.9230769230769231,0.625,0.375
SF-J18,SF-N22-1B,5,14,1,9,4,5,0.2,0.8,0.6428571428571429,0.35714285714285715
SF-J18,SF-N26,1,1,0,0,1,1,0.0,1.0,0.0,1.0
SF-J18,SF-N25,3,2,0,0,3,2,0.0,1.0,0.0,1.0
SF-J18,SF-T21,2,5,0,4,2,1,0.0,1.0,0.8,0.2
SF-J18,SF-T22,7,7,1,1,6,6,0.14285714285714285,0.8571428571428571,0.14285714285714285,0.8571428571428571
SF-J18,SF-S22-2,5,7,0,3,5,4,0.0,1.0,0.42857142857142855,0.5714285714285714
SF-J18,SF-S22-1,10,9,2,3,8,6,0.2,0.8,0.3333333333333333,0.6666666666666666
SF-J18,SF-Q23-3,3,16,1,5,2,11,0.3333333333333333,0.6666666666666666,0.3125,0.6875
SF-J18,SF-Q22-1,14,16,1,8,13,8,0.07142857142857142,0.9285714285714286,0.5,0.5
SF-J18,SF-Q22-2,6,19,0,3,6,16,0.0,1.0,0.15789473684210525,0.8421052631578947
SF-J18,SF-P22,14,10,3,7,11,3,0.21428571428571427,0.7857142857142857,0.7,0.3
SF-J18,SF-T20,7,9,1,0,6,9,0.14285714285714285,0.8571428571428571,0.0,1.0
SF-J18,SF-S21,5,3,0,1,5,2,0.0,1.0,0.3333333333333333,0.6666666666666666
SF-J18,SF-W14,1,1,0,0,1,1,0.0,1.0,0.0,1.0
SF-J18,SF-Z7,1,4,0,0,1,4,0.0,1.0,0.0,1.0
SF-J20,SF-M25,6,2,3,2,3,0,0.5,0.5,1.0,0.0
SF-J20,SF-M26-2,3,1,1,1,2,0,0.3333333333333333,0.6666666666666666,1.0,0.0
SF-J20,SF-L27,2,1,2,1,0,0,1.0,0.0,1.0,0.0
SF-J20,SF-K26,7,14,3,4,4,10,0.42857142857142855,0.5714285714285714,0.2857142857142857,0.7142857142857143
SF-J20,SF-J27,3,7,0,2,3,5,0.0,1.0,0.2857142857142857,0.7142857142857143
SF-J20,SF-M30,18,1,17,1,1,0,0.9444444444444444,0.05555555555555555,1.0,0.0
SF-J20,SF-J29-3,3,5,1,3,2,2,0.3333333333333333,0.6666666666666666,0.6,0.4
SF-J20,SF-J29,10,7,4,4,6,3,0.4,0.6,0.5714285714285714,0.42857142857142855
SF-J20,SF-L26,7,4,1,1,6,3,0.14285714285714285,0.8571428571428571,0.25,0.75
SF-J20,SF-L25,8,8,1,2,7,6,0.125,0.875,0.25,0.75
SF-J20,SF-M24,1,3,0,2,1,1,0.0,1.0,0.6666666666666666,0.3333333333333333
SF-J20,SF-L24,6,5,6,4,0,1,1.0,0.0,0.8,0.2
SF-J20,SF-K27-2,3,7,1,6,2,1,0.3333333333333333,0.6666666666666666,0.8571428571428571,0.14285714285714285
SF-J20,SF-J26-2,20,29,12,21,8,8,0.6,0.4,0.7241379310344828,0.27586206896551724
SF-J20,SF-K28,2,2,0,1,2,1,0.0,1.0,0.5,0.5
SF-J20,SF-K29-1,2,3,0,2,2,1,0.0,1.0,0.6666666666666666,0.3333333333333333
SF-J20,SF-K25,10,3,4,0,6,3,0.4,0.6,0.0,1.0
SF-J20,SF-J25,5,16,0,6,5,10,0.0,1.0,0.375,0.625
SF-J20,SF-H26-2,20,57,6,42,14,15,0.3,0.7,0.7368421052631579,0.2631578947368421
SF-J20,SF-P24,1,1,0,1,1,0,0.0,1.0,1.0,0.0
SF-J20,SF-J24,3,8,2,4,1,4,0.6666666666666666,0.3333333333333333,0.5,0.5
SF-J20,SF-J26,1,2,1,1,0,1,1.0,0.0,0.5,0.5
SF-J20,SF-I26-,3,1,2,0,1,1,0.6666666666666666,0.3333333333333333,0.0,1.0
SF-J20,SF-I25,21,34,17,26,4,8,0.8095238095238095,0.19047619047619047,0.7647058823529411,0.23529411764705882
SF-J20,SF-K23,2,2,0,1,2,1,0.0,1.0,0.5,0.5
SF-J20,SF-H26,27,24,13,17,14,7,0.48148148148148145,0.5185185185185185,0.7083333333333334,0.2916666666666667
SF-J20,SF-O23,8,8,3,6,5,2,0.375,0.625,0.75,0.25
SF-J20,SF-H27-1,3,4,2,3,1,1,0.6666666666666666,0.3333333333333333,0.75,0.25
SF-J20,SF-F28-2,13,15,4,8,9,7,0.3076923076923077,0.6923076923076923,0.5333333333333333,0.4666666666666667
SF-J20,SF-G27,40,28,26,19,14,9,0.65,0.35,0.6785714285714286,0.32142857142857145
SF-J20,SF-M22-2,5,11,1,4,4,7,0.2,0.8,0.36363636363636365,0.6363636363636364
SF-J20,SF-L22,13,10,1,4,12,6,0.07692307692307693,0.9230769230769231,0.4,0.6
SF-J20,SF-F27,9,3,3,1,6,2,0.3333333333333333,0.6666666666666666,0.3333333333333333,0.6666666666666666
SF-J20,SF-N22-2,4,10,2,5,2,5,0.5,0.5,0.5,0.5
SF-J20,SF-G28-2,1,6,1,3,0,3,1.0,0.0,0.5,0.5
SF-J20,SF-G28-1,1,2,1,0,0,2,1.0,0.0,0.0,1.0
SF-J20,SF-M22-1,5,10,0,6,5,4,0.0,1.0,0.6,0.4
SF-J20,SF-K22-2,6,7,2,6,4,1,0.3333333333333333,0.6666666666666666,0.8571428571428571,0.14285714285714285
SF-J20,SF-K24,9,9,7,6,2,3,0.7777777777777778,0.2222222222222222,0.6666666666666666,0.3333333333333333
SF-J20,SF-J23-2,5,4,2,3,3,1,0.4,0.6,0.75,0.25
SF-J20,SF-G23,12,8,5,2,7,6,0.4166666666666667,0.5833333333333334,0.25,0.75
SF-J20,SF-G24,9,11,3,4,6,7,0.3333333333333333,0.6666666666666666,0.36363636363636365,0.6363636363636364
SF-J20,SF-G25,16,18,9,3,7,15,0.5625,0.4375,0.16666666666666666,0.8333333333333334
SF-J20,SF-F23,22,20,11,4,11,16,0.5,0.5,0.2,0.8
SF-J20,SF-E23,34,27,13,5,21,22,0.38235294117647056,0.6176470588235294,0.18518518518518517,0.8148148148148148
SF-J20,SF-D24,1,3,1,0,0,3,1.0,0.0,0.0,1.0
SF-J20,SF-C22,1,2,0,0,1,2,0.0,1.0,0.0,1.0
SF-J20,SF-B22,3,12,1,5,2,7,0.3333333333333333,0.6666666666666666,0.4166666666666667,0.5833333333333334
SF-J20,SF-J17,3,8,2,4,1,4,0.6666666666666666,0.3333333333333333,0.5,0.5
SF-J20,SF-I19,5,6,4,1,1,5,0.8,0.2,0.16666666666666666,0.8333333333333334
SF-J20,SF-I20,10,23,7,14,3,9,0.7,0.3,0.6086956521739131,0.391304347826087
SF-J20,SF-H16,7,2,4,0,3,2,0.5714285714285714,0.42857142857142855,0.0,1.0
SF-J20,SF-H19,1,3,1,1,0,2,1.0,0.0,0.3333333333333333,0.6666666666666666
SF-J20,SF-H20,117,86,97,67,20,19,0.8290598290598291,0.17094017094017094,0.7790697674418605,0.22093023255813954
SF-J20,SF-H18,6,4,2,1,4,3,0.3333333333333333,0.6666666666666666,0.25,0.75
SF-J20,SF-H17,3,2,2,2,1,0,0.6666666666666666,0.3333333333333333,1.0,0.0
SF-J20,SF-G19,29,33,24,28,5,5,0.8275862068965517,0.1724137931034483,0.8484848484848485,0.15151515151515152
SF-J20,SF-G17,1,6,1,4,0,2,1.0,0.0,0.6666666666666666,0.3333333333333333
SF-J20,SF-G18,4,31,1,17,3,14,0.25,0.75,0.5483870967741935,0.45161290322580644
SF-J20,SF-G20,54,69,46,54,8,15,0.8518518518518519,0.14814814814814814,0.782608695652174,0.21739130434782608
SF-J20,SF-F19,13,15,9,10,4,5,0.6923076923076923,0.3076923076923077,0.6666666666666666,0.3333333333333333
SF-J20,SF-E18,6,6,6,2,0,4,1.0,0.0,0.3333333333333333,0.6666666666666666
SF-J20,SF-E20,30,9,26,4,4,5,0.8666666666666667,0.13333333333333333,0.4444444444444444,0.5555555555555556
SF-J20,SF-H30,4,3,2,3,2,0,0.5,0.5,1.0,0.0
SF-J20,SF-G30-2,4,4,1,2,3,2,0.25,0.75,0.5,0.5
SF-J20,SF-F30-1,1,1,0,0,1,1,0.0,1.0,0.0,1.0
SF-J20,SF-E29-2,14,25,3,8,11,17,0.21428571428571427,0.7857142857142857,0.32,0.68
SF-J20,SF-E29-1,4,7,2,4,2,3,0.5,0.5,0.5714285714285714,0.42857142857142855
SF-J20,SF-D29,3,8,1,5,2,3,0.3333333333333333,0.6666666666666666,0.625,0.375
SF-J20,SF-D28,21,24,13,12,8,12,0.6190476190476191,0.38095238095238093,0.5,0.5
SF-J20,SF-A27,3,4,3,3,0,1,1.0,0.0,0.75,0.25
SF-J20,SF-G29-2,1,4,0,0,1,4,0.0,1.0,0.0,1.0
SF-J20,SF-G29-1,5,5,2,3,3,2,0.4,0.6,0.6,0.4
SF-J20,SF-G29-3,4,5,0,2,4,3,0.0,1.0,0.4,0.6
SF-J20,SF-F30-2,1,3,0,1,1,2,0.0,1.0,0.3333333333333333,0.6666666666666666
SF-J20,SF-E29-3,6,4,3,2,3,2,0.5,0.5,0.5,0.5
SF-J20,SF-F28-1,14,7,11,4,3,3,0.7857142857142857,0.21428571428571427,0.5714285714285714,0.42857142857142855
SF-J20,SF-E28,6,4,0,2,6,2,0.0,1.0,0.5,0.5
SF-J20,SF-J12,3,4,0,0,3,4,0.0,1.0,0.0,1.0
SF-J20,SF-J13,1,2,1,1,0,1,1.0,0.0,0.5,0.5
SF-J20,SF-J15,3,3,2,1,1,2,0.6666666666666666,0.3333333333333333,0.3333333333333333,0.6666666666666666
SF-J20,SF-I16,3,2,2,0,1,2,0.6666666666666666,0.3333333333333333,0.0,1.0
SF-J20,SF-H12,2,2,0,0,2,2,0.0,1.0,0.0,1.0
SF-J20,SF-G10-2,5,3,2,0,3,3,0.4,0.6,0.0,1.0
SF-J20,SF-G9,3,2,0,1,3,1,0.0,1.0,0.5,0.5
SF-J20,SF-G13,2,5,1,0,1,5,0.5,0.5,0.0,1.0
SF-J20,SF-G11,1,1,1,0,0,1,1.0,0.0,0.0,1.0
SF-J20,SF-G12,2,5,1,1,1,4,0.5,0.5,0.2,0.8
SF-J20,SF-G10-1,1,2,0,1,1,1,0.0,1.0,0.5,0.5
SF-J20,SF-F15,6,2,5,1,1,1,0.8333333333333334,0.16666666666666666,0.5,0.5
SF-J20,SF-F16,7,8,6,1,1,7,0.8571428571428571,0.14285714285714285,0.125,0.875
SF-J20,SF-C20,2,5,0,1,2,4,0.0,1.0,0.2,0.8
SF-J20,SF-B19,7,10,3,1,4,9,0.42857142857142855,0.5714285714285714,0.1,0.9
SF-J20,SF-A20,2,1,0,0,2,1,0.0,1.0,0.0,1.0
SF-J20,SF-A19,1,3,0,1,1,2,0.0,1.0,0.3333333333333333,0.6666666666666666
SF-J20,SF-C26,6,8,2,7,4,1,0.3333333333333333,0.6666666666666666,0.875,0.125
SF-J20,SF-C25,3,6,0,3,3,3,0.0,1.0,0.5,0.5
SF-J20,SF-B25,3,8,1,4,2,4,0.3333333333333333,0.6666666666666666,0.5,0.5
SF-J20,SF-E27,2,1,1,0,1,1,0.5,0.5,0.0,1.0
SF-J20,SF-B28-2,1,2,0,0,1,2,0.0,1.0,0.0,1.0
SF-J20,SF-D27,5,9,2,6,3,3,0.4,0.6,0.6666666666666666,0.3333333333333333
SF-J20,SF-C28-1,2,3,1,3,1,0,0.5,0.5,1.0,0.0
SF-J20,SF-B28,1,3,1,3,0,0,1.0,0.0,1.0,0.0
SF-J20,SF-J1,10,10,1,2,9,8,0.1,0.9,0.2,0.8
SF-J20,SF-J3,1,3,1,2,0,1,1.0,0.0,0.6666666666666666,0.3333333333333333
SF-J20,SF-G7,2,8,0,1,2,7,0.0,1.0,0.125,0.875
SF-J20,SF-F9,1,3,1,0,0,3,1.0,0.0,0.0,1.0
SF-J20,SF-H25,7,4,4,4,3,0,0.5714285714285714,0.42857142857142855,1.0,0.0
SF-J20,SF-G26,11,12,8,8,3,4,0.7272727272727273,0.2727272727272727,0.6666666666666666,0.3333333333333333
SF-J20,SF-K21,16,8,11,4,5,4,0.6875,0.3125,0.5,0.5
SF-J20,SF-K22-1,3,3,1,1,2,2,0.3333333333333333,0.6666666666666666,0.3333333333333333,0.6666666666666666
SF-J20,SF-J23-1,17,18,13,14,4,4,0.7647058823529411,0.23529411764705882,0.7777777777777778,0.2222222222222222
SF-J20,SF-J22-1,7,3,3,2,4,1,0.42857142857142855,0.5714285714285714,0.6666666666666666,0.3333333333333333
SF-J20,SF-J22-2,32,34,19,23,13,11,0.59375,0.40625,0.6764705882352942,0.3235294117647059
SF-J20,SF-J21,36,31,18,21,18,10,0.5,0.5,0.6774193548387096,0.3225806451612903
SF-J20,SF-I21,11,12,8,9,3,3,0.7272727272727273,0.2727272727272727,0.75,0.25
SF-J20,SF-I22,11,8,8,5,3,3,0.7272727272727273,0.2727272727272727,0.625,0.375
SF-J20,SF-I23-2,31,21,15,12,16,9,0.4838709677419355,0.5161290322580645,0.5714285714285714,0.42857142857142855
SF-J20,SF-I24,31,55,18,27,13,28,0.5806451612903226,0.41935483870967744,0.4909090909090909,0.509090909090909
SF-J20,SF-I23-1,13,17,7,5,6,12,0.5384615384615384,0.46153846153846156,0.29411764705882354,0.7058823529411765
SF-J20,SF-F26,19,15,7,7,12,8,0.3684210526315789,0.631578947368421,0.4666666666666667,0.5333333333333333
SF-J20,SF-M13,45,40,1,0,44,40,0.022222222222222223,0.9777777777777777,0.0,1.0
SF-J20,SF-M15,11,9,2,1,9,8,0.18181818181818182,0.8181818181818182,0.1111111111111111,0.8888888888888888
SF-J20,SF-L19,7,9,2,0,5,9,0.2857142857142857,0.7142857142857143,0.0,1.0
SF-J20,SF-L20,11,9,2,5,9,4,0.18181818181818182,0.8181818181818182,0.5555555555555556,0.4444444444444444
SF-J20,SF-N20-1,3,1,0,0,3,1,0.0,1.0,0.0,1.0
SF-J20,SF-M20,9,4,3,0,6,4,0.3333333333333333,0.6666666666666666,0.0,1.0
SF-J20,SF-K17-2,4,2,2,1,2,1,0.5,0.5,0.5,0.5
SF-J20,SF-K20,2,5,0,2,2,3,0.0,1.0,0.4,0.6
SF-J20,SF-K15-,20,14,10,7,10,7,0.5,0.5,0.5,0.5
SF-J20,SF-K19,6,6,3,5,3,1,0.5,0.5,0.8333333333333334,0.16666666666666666
SF-J20,SF-K18,6,6,2,3,4,3,0.3333333333333333,0.6666666666666666,0.5,0.5
SF-J20,SF-K17,7,9,2,3,5,6,0.2857142857142857,0.7142857142857143,0.3333333333333333,0.6666666666666666
SF-J20,SF-J16,6,10,2,3,4,7,0.3333333333333333,0.6666666666666666,0.3,0.7
SF-J20,SF-J18,8,11,4,2,4,9,0.5,0.5,0.18181818181818182,0.8181818181818182
SF-J20,SF-J19,25,13,20,7,5,6,0.8,0.2,0.5384615384615384,0.46153846153846156
SF-J20,SF-M10,4,1,1,0,3,1,0.25,0.75,0.0,1.0
SF-J20,SF-M11,6,7,3,1,3,6,0.5,0.5,0.14285714285714285,0.8571428571428571
SF-J20,SF-R19,3,10,0,1,3,9,0.0,1.0,0.1,0.9
SF-J20,SF-P21,6,3,1,1,5,2,0.16666666666666666,0.8333333333333334,0.3333333333333333,0.6666666666666666
SF-J20,SF-O18,3,7,0,3,3,4,0.0,1.0,0.42857142857142855,0.5714285714285714
SF-J20,SF-O19,3,3,0,2,3,1,0.0,1.0,0.6666666666666666,0.3333333333333333
SF-J20,SF-O21,7,15,0,6,7,9,0.0,1.0,0.4,0.6
SF-J20,SF-O22,10,14,3,6,7,8,0.3,0.7,0.42857142857142855,0.5714285714285714
SF-J20,SF-N21,6,1,2,0,4,1,0.3333333333333333,0.6666666666666666,0.0,1.0
SF-J20,SF-M21,10,1,3,1,7,0,0.3,0.7,1.0,0.0
SF-J20,SF-L21,11,13,3,8,8,5,0.2727272727272727,0.7272727272727273,0.6153846153846154,0.38461538461538464
SF-J20,SF-Q30,28,19,0,1,28,18,0.0,1.0,0.05263157894736842,0.9473684210526315
SF-J20,SF-P30,12,1,9,0,3,1,0.75,0.25,0.0,1.0
SF-J20,SF-O30,2,3,0,2,2,1,0.0,1.0,0.6666666666666666,0.3333333333333333
SF-J20,SF-N27,2,3,0,0,2,3,0.0,1.0,0.0,1.0
SF-J20,SF-N29,5,4,1,0,4,4,0.2,0.8,0.0,1.0
SF-J20,SF-N28,4,1,0,0,4,1,0.0,1.0,0.0,1.0
SF-J20,SF-L30-1,7,8,4,6,3,2,0.5714285714285714,0.42857142857142855,0.75,0.25
SF-J20,SF-K30-2,2,1,0,1,2,0,0.0,1.0,1.0,0.0
SF-J20,SF-L29,5,2,5,1,0,1,1.0,0.0,0.5,0.5
SF-J20,SF-J29-1,2,3,2,0,0,3,1.0,0.0,0.0,1.0
SF-J20,SF-I30,4,2,2,2,2,0,0.5,0.5,1.0,0.0
SF-J20,SF-I29-2,2,3,1,3,1,0,0.5,0.5,1.0,0.0
SF-J20,SF-I27,4,3,1,2,3,1,0.25,0.75,0.6666666666666666,0.3333333333333333
SF-J20,SF I29-1,57,71,22,66,35,5,0.38596491228070173,0.6140350877192983,0.9295774647887324,0.07042253521126761
SF-J20,SF-S24,2,2,0,1,2,1,0.0,1.0,0.5,0.5
SF-J20,SF-R24,1,3,0,2,1,1,0.0,1.0,0.6666666666666666,0.3333333333333333
SF-J20,SF-P26,55,51,1,0,54,51,0.01818181818181818,0.9818181818181818,0.0,1.0
SF-J20,SF-O25-2,2,1,0,0,2,1,0.0,1.0,0.0,1.0
SF-J20,SF-N22-1B,3,3,0,1,3,2,0.0,1.0,0.3333333333333333,0.6666666666666666
SF-J20,SF-N26,2,1,1,1,1,0,0.5,0.5,1.0,0.0
SF-J20,SF-N25,1,2,1,2,0,0,1.0,0.0,1.0,0.0
SF-J20,SF-T22,4,2,2,0,2,2,0.5,0.5,0.0,1.0
SF-J20,SF-S22-1,22,63,8,11,14,52,0.36363636363636365,0.6363636363636364,0.1746031746031746,0.8253968253968254
SF-J20,SF-Q23-3,1,2,0,2,1,0,0.0,1.0,1.0,0.0
SF-J20,SF-Q22-1,3,6,0,3,3,3,0.0,1.0,0.5,0.5
SF-J20,SF-Q22-2,10,9,5,6,5,3,0.5,0.5,0.6666666666666666,0.3333333333333333
SF-J20,SF-P22,6,4,4,1,2,3,0.6666666666666666,0.3333333333333333,0.25,0.75
SF-J20,SF-U21,1,2,1,1,0,1,1.0,0.0,0.5,0.5
SF-J19,SF-M25,6,4,5,2,1,2,0.8333333333333334,0.16666666666666666,0.5,0.5
SF-J19,SF-M26-2,2,4,2,3,0,1,1.0,0.0,0.75,0.25
SF-J19,SF-L27,3,3,0,1,3,2,0.0,1.0,0.3333333333333333,0.6666666666666666
SF-J19,SF-K26,22,45,1,10,21,35,0.045454545454545456,0.9545454545454546,0.2222222222222222,0.7777777777777778
SF-J19,SF-J27,4,1,1,1,3,0,0.25,0.75,1.0,0.0
SF-J19,SF-M30,17,15,7,7,10,8,0.4117647058823529,0.5882352941176471,0.4666666666666667,0.5333333333333333
SF-J19,SF-J29-3,9,16,1,0,8,16,0.1111111111111111,0.8888888888888888,0.0,1.0
SF-J19,SF-J29,17,4,5,2,12,2,0.29411764705882354,0.7058823529411765,0.5,0.5
SF-J19,SF-L26,4,11,0,2,4,9,0.0,1.0,0.18181818181818182,0.8181818181818182
SF-J19,SF-M28,8,6,2,3,6,3,0.25,0.75,0.5,0.5
SF-J19,SF-L25,8,12,4,1,4,11,0.5,0.5,0.08333333333333333,0.9166666666666666
SF-J19,SF-M24,2,3,2,2,0,1,1.0,0.0,0.6666666666666666,0.3333333333333333
SF-J19,SF-L24,2,8,0,5,2,3,0.0,1.0,0.625,0.375
SF-J19,SF-N23,2,3,0,3,2,0,0.0,1.0,1.0,0.0
SF-J19,SF-N24-2,6,3,0,2,6,1,0.0,1.0,0.6666666666666666,0.3333333333333333
SF-J19,SF-K27-2,25,8,8,4,17,4,0.32,0.68,0.5,0.5
SF-J19,SF-J26-2,7,5,3,4,4,1,0.42857142857142855,0.5714285714285714,0.8,0.2
SF-J19,SF-L28,4,4,0,0,4,4,0.0,1.0,0.0,1.0
SF-J19,SF-K28,4,5,1,4,3,1,0.25,0.75,0.8,0.2
SF-J19,SF-K29-1,24,6,9,0,15,6,0.375,0.625,0.0,1.0
SF-J19,SF-K27,4,3,1,0,3,3,0.25,0.75,0.0,1.0
SF-J19,SF-K25,16,4,7,2,9,2,0.4375,0.5625,0.5,0.5
SF-J19,SF-J25,11,15,3,8,8,7,0.2727272727272727,0.7272727272727273,0.5333333333333333,0.4666666666666667
SF-J19,SF-H26-2,10,8,3,3,7,5,0.3,0.7,0.375,0.625
SF-J19,SF-P24,4,9,1,7,3,2,0.25,0.75,0.7777777777777778,0.2222222222222222
SF-J19,SF-N22-1A,1,2,0,0,1,2,0.0,1.0,0.0,1.0
SF-J19,SF-J24,7,10,1,5,6,5,0.14285714285714285,0.8571428571428571,0.5,0.5
SF-J19,SF-O24,6,6,0,4,6,2,0.0,1.0,0.6666666666666666,0.3333333333333333
SF-J19,SF-J26,7,8,2,2,5,6,0.2857142857142857,0.7142857142857143,0.25,0.75
SF-J19,SF-I26-,5,4,4,1,1,3,0.8,0.2,0.25,0.75
SF-J19,SF-I25,42,56,33,36,9,20,0.7857142857142857,0.21428571428571427,0.6428571428571429,0.35714285714285715
SF-J19,SF-K23,6,2,0,0,6,2,0.0,1.0,0.0,1.0
SF-J19,SF-H26,44,53,25,36,19,17,0.5681818181818182,0.4318181818181818,0.6792452830188679,0.32075471698113206
SF-J19,SF-O23,3,5,0,0,3,5,0.0,1.0,0.0,1.0
SF-J19,SF-H27-1,5,3,1,1,4,2,0.2,0.8,0.3333333333333333,0.6666666666666666
SF-J19,SF-F28-2,22,38,8,12,14,26,0.36363636363636365,0.6363636363636364,0.3157894736842105,0.6842105263157895
SF-J19,SF-G27,52,49,18,27,34,22,0.34615384615384615,0.6538461538461539,0.5510204081632653,0.4489795918367347
SF-J19,SF-M22-2,8,13,0,5,8,8,0.0,1.0,0.38461538461538464,0.6153846153846154
SF-J19,SF-L22,7,7,0,3,7,4,0.0,1.0,0.42857142857142855,0.5714285714285714
SF-J19,SF-F27,40,72,2,19,38,53,0.05,0.95,0.2638888888888889,0.7361111111111112
SF-J19,SF-N22-2,13,12,2,3,11,9,0.15384615384615385,0.8461538461538461,0.25,0.75
SF-J19,SF-G28-2,4,24,0,5,4,19,0.0,1.0,0.20833333333333334,0.7916666666666666
SF-J19,SF-G28-1,3,4,2,1,1,3,0.6666666666666666,0.3333333333333333,0.25,0.75
SF-J19,SF-M22-1,6,6,1,3,5,3,0.16666666666666666,0.8333333333333334,0.5,0.5
SF-J19,SF-O25-1,1,1,0,1,1,0,0.0,1.0,1.0,0.0
SF-J19,SF-K22-2,6,7,5,3,1,4,0.8333333333333334,0.16666666666666666,0.42857142857142855,0.5714285714285714
SF-J19,SF-K24,10,20,2,6,8,14,0.2,0.8,0.3,0.7
SF-J19,SF-J23-2,9,4,0,4,9,0,0.0,1.0,1.0,0.0
SF-J19,SF-G23,11,7,3,5,8,2,0.2727272727272727,0.7272727272727273,0.7142857142857143,0.2857142857142857
SF-J19,SF-G24,56,28,14,9,42,19,0.25,0.75,0.32142857142857145,0.6785714285714286
SF-J19,SF-G25,49,27,12,4,37,23,0.24489795918367346,0.7551020408163265,0.14814814814814814,0.8518518518518519
SF-J19,SF-F23,49,40,22,9,27,31,0.4489795918367347,0.5510204081632653,0.225,0.775
SF-J19,SF-E23,67,47,15,6,52,41,0.22388059701492538,0.7761194029850746,0.1276595744680851,0.8723404255319149
SF-J19,SF-D24,27,24,4,1,23,23,0.14814814814814814,0.8518518518518519,0.041666666666666664,0.9583333333333334
SF-J19,SF-C22,29,44,9,4,20,40,0.3103448275862069,0.6896551724137931,0.09090909090909091,0.9090909090909091
SF-J19,SF-B22,16,19,5,6,11,13,0.3125,0.6875,0.3157894736842105,0.6842105263157895
SF-J19,SF-J17,14,12,6,5,8,7,0.42857142857142855,0.5714285714285714,0.4166666666666667,0.5833333333333334
SF-J19,SF-I19,6,7,4,1,2,6,0.6666666666666666,0.3333333333333333,0.14285714285714285,0.8571428571428571
SF-J19,SF-I20,16,8,12,5,4,3,0.75,0.25,0.625,0.375
SF-J19,SF-H16,27,19,6,4,21,15,0.2222222222222222,0.7777777777777778,0.21052631578947367,0.7894736842105263
SF-J19,SF-H19,7,15,3,10,4,5,0.42857142857142855,0.5714285714285714,0.6666666666666666,0.3333333333333333
SF-J19,SF-H20,27,29,20,20,7,9,0.7407407407407407,0.25925925925925924,0.6896551724137931,0.3103448275862069
SF-J19,SF-H18,8,9,1,3,7,6,0.125,0.875,0.3333333333333333,0.6666666666666666
SF-J19,SF-H17,4,1,4,0,0,1,1.0,0.0,0.0,1.0
SF-J19,SF-G19,84,85,52,61,32,24,0.6190476190476191,0.38095238095238093,0.7176470588235294,0.2823529411764706
SF-J19,SF-G17,16,7,8,3,8,4,0.5,0.5,0.42857142857142855,0.5714285714285714
SF-J19,SF-G18,27,23,12,12,15,11,0.4444444444444444,0.5555555555555556,0.5217391304347826,0.4782608695652174
SF-J19,SF-G20,53,50,25,36,28,14,0.4716981132075472,0.5283018867924528,0.72,0.28
SF-J19,SF-F19,63,98,29,53,34,45,0.4603174603174603,0.5396825396825397,0.5408163265306123,0.45918367346938777
SF-J19,SF-E18,26,29,7,7,19,22,0.2692307692307692,0.7307692307692307,0.2413793103448276,0.7586206896551724
SF-J19,SF-E20,39,44,17,16,22,28,0.4358974358974359,0.5641025641025641,0.36363636363636365,0.6363636363636364
SF-J19,SF-H30,2,1,0,0,2,1,0.0,1.0,0.0,1.0
SF-J19,SF-G30-2,10,16,2,5,8,11,0.2,0.8,0.3125,0.6875
SF-J19,SF-F30-1,2,5,0,1,2,4,0.0,1.0,0.2,0.8
SF-J19,SF-E29-2,13,17,5,6,8,11,0.38461538461538464,0.6153846153846154,0.35294117647058826,0.6470588235294118
SF-J19,SF-E29-1,13,6,4,1,9,5,0.3076923076923077,0.6923076923076923,0.16666666666666666,0.8333333333333334
SF-J19,SF-D29,2,7,2,4,0,3,1.0,0.0,0.5714285714285714,0.42857142857142855
SF-J19,SF-D28,16,32,4,15,12,17,0.25,0.75,0.46875,0.53125
SF-J19,SF-A27,21,19,5,14,16,5,0.23809523809523808,0.7619047619047619,0.7368421052631579,0.2631578947368421
SF-J19,SF-G29-2,10,7,5,4,5,3,0.5,0.5,0.5714285714285714,0.42857142857142855
SF-J19,SF-G29-1,4,2,2,1,2,1,0.5,0.5,0.5,0.5
SF-J19,SF-G30-1,7,8,4,2,3,6,0.5714285714285714,0.42857142857142855,0.25,0.75
SF-J19,SF-G29-3,8,7,4,5,4,2,0.5,0.5,0.7142857142857143,0.2857142857142857
SF-J19,SF-F30-2,6,1,0,1,6,0,0.0,1.0,1.0,0.0
SF-J19,SF-E29-3,6,21,0,4,6,17,0.0,1.0,0.19047619047619047,0.8095238095238095
SF-J19,SF-F28-1,10,17,9,14,1,3,0.9,0.1,0.8235294117647058,0.17647058823529413
SF-J19,SF-E28-2,2,1,0,1,2,0,0.0,1.0,1.0,0.0
SF-J19,SF-E28,8,2,4,0,4,2,0.5,0.5,0.0,1.0
SF-J19,SF-J10,8,19,0,3,8,16,0.0,1.0,0.15789473684210525,0.8421052631578947
SF-J19,SF-J12,12,18,2,2,10,16,0.16666666666666666,0.8333333333333334,0.1111111111111111,0.8888888888888888
SF-J19,SF-J13,7,11,1,3,6,8,0.14285714285714285,0.8571428571428571,0.2727272727272727,0.7272727272727273
SF-J19,SF-J15,2,6,1,1,1,5,0.5,0.5,0.16666666666666666,0.8333333333333334
SF-J19,SF-J14,3,1,1,0,2,1,0.3333333333333333,0.6666666666666666,0.0,1.0
SF-J19,SF-H13,5,8,3,1,2,7,0.6,0.4,0.125,0.875
SF-J19,SF-I16,4,3,1,1,3,2,0.25,0.75,0.3333333333333333,0.6666666666666666
SF-J19,SF-H12,2,15,0,0,2,15,0.0,1.0,0.0,1.0
SF-J19,SF-G10-2,2,5,1,0,1,5,0.5,0.5,0.0,1.0
SF-J19,SF-H15,7,8,0,0,7,8,0.0,1.0,0.0,1.0
SF-J19,SF-G9,1,3,0,2,1,1,0.0,1.0,0.6666666666666666,0.3333333333333333
SF-J19,SF-H14,2,2,0,1,2,1,0.0,1.0,0.5,0.5
SF-J19,SF-G13,14,23,6,1,8,22,0.42857142857142855,0.5714285714285714,0.043478260869565216,0.9565217391304348
SF-J19,SF-G11,9,4,2,1,7,3,0.2222222222222222,0.7777777777777778,0.25,0.75
SF-J19,SF-G12,6,4,1,2,5,2,0.16666666666666666,0.8333333333333334,0.5,0.5
SF-J19,SF-F15,3,4,0,1,3,3,0.0,1.0,0.25,0.75
SF-J19,SF-F16,10,8,3,0,7,8,0.3,0.7,0.0,1.0
SF-J19,SF-C21,14,7,2,0,12,7,0.14285714285714285,0.8571428571428571,0.0,1.0
SF-J19,SF-C20,15,18,2,4,13,14,0.13333333333333333,0.8666666666666667,0.2222222222222222,0.7777777777777778
SF-J19,SF-B21,6,6,3,2,3,4,0.5,0.5,0.3333333333333333,0.6666666666666666
SF-J19,SF-B19,9,16,5,5,4,11,0.5555555555555556,0.4444444444444444,0.3125,0.6875
SF-J19,SF-A20,13,13,2,4,11,9,0.15384615384615385,0.8461538461538461,0.3076923076923077,0.6923076923076923
SF-J19,SF-A19,4,3,0,2,4,1,0.0,1.0,0.6666666666666666,0.3333333333333333
SF-J19,SF-C26,15,11,2,0,13,11,0.13333333333333333,0.8666666666666667,0.0,1.0
SF-J19,SF-C25,30,29,2,3,28,26,0.06666666666666667,0.9333333333333333,0.10344827586206896,0.896551724137931
SF-J19,SF-B25,14,15,0,4,14,11,0.0,1.0,0.26666666666666666,0.7333333333333333
SF-J19,SF-E27,5,5,1,2,4,3,0.2,0.8,0.4,0.6
SF-J19,SF-B28-2,16,19,1,9,15,10,0.0625,0.9375,0.47368421052631576,0.5263157894736842
SF-J19,SF-D27,10,9,7,4,3,5,0.7,0.3,0.4444444444444444,0.5555555555555556
SF-J19,SF-C28-2,11,1,5,1,6,0,0.45454545454545453,0.5454545454545454,1.0,0.0
SF-J19,SF-C28-1,1,6,1,6,0,0,1.0,0.0,1.0,0.0
SF-J19,SF-B28,9,5,4,1,5,4,0.4444444444444444,0.5555555555555556,0.2,0.8
SF-J19,SF-J1,21,41,5,10,16,31,0.23809523809523808,0.7619047619047619,0.24390243902439024,0.7560975609756098
SF-J19,SF-H0,4,3,1,1,3,2,0.25,0.75,0.3333333333333333,0.6666666666666666
SF-J19,SF-J3,5,3,0,1,5,2,0.0,1.0,0.3333333333333333,0.6666666666666666
SF-J19,SF-G5,4,9,2,4,2,5,0.5,0.5,0.4444444444444444,0.5555555555555556
SF-J19,SF-G7,3,10,1,2,2,8,0.3333333333333333,0.6666666666666666,0.2,0.8
SF-J19,SF-F9,2,2,0,0,2,2,0.0,1.0,0.0,1.0
SF-J19,SF-H25,6,5,1,4,5,1,0.16666666666666666,0.8333333333333334,0.8,0.2
SF-J19,SF-G26,23,16,6,8,17,8,0.2608695652173913,0.7391304347826086,0.5,0.5
SF-J19,SF-K21,17,10,7,5,10,5,0.4117647058823529,0.5882352941176471,0.5,0.5
SF-J19,SF-K22-1,8,6,3,3,5,3,0.375,0.625,0.5,0.5
SF-J19,SF-J23-1,36,33,16,20,20,13,0.4444444444444444,0.5555555555555556,0.6060606060606061,0.3939393939393939
SF-J19,SF-J22-1,22,13,5,6,17,7,0.22727272727272727,0.7727272727272727,0.46153846153846156,0.5384615384615384
SF-J19,SF-J22-2,10,19,1,15,9,4,0.1,0.9,0.7894736842105263,0.21052631578947367
SF-J19,SF-J21,48,59,17,39,31,20,0.3541666666666667,0.6458333333333334,0.6610169491525424,0.3389830508474576
SF-J19,SF-I21,20,40,15,29,5,11,0.75,0.25,0.725,0.275
SF-J19,SF-I22,31,13,19,7,12,6,0.6129032258064516,0.3870967741935484,0.5384615384615384,0.46153846153846156
SF-J19,SF-I23-2,24,25,15,19,9,6,0.625,0.375,0.76,0.24
SF-J19,SF-I24,19,26,13,12,6,14,0.6842105263157895,0.3157894736842105,0.46153846153846156,0.5384615384615384
SF-J19,SF-I23-1,30,30,16,13,14,17,0.5333333333333333,0.4666666666666667,0.43333333333333335,0.5666666666666667
SF-J19,SF-F26,47,32,16,12,31,20,0.3404255319148936,0.6595744680851063,0.375,0.625
SF-J19,SF-M13,18,34,2,0,16,34,0.1111111111111111,0.8888888888888888,0.0,1.0
SF-J19,SF-M15,22,17,9,7,13,10,0.4090909090909091,0.5909090909090909,0.4117647058823529,0.5882352941176471
SF-J19,SF-L19,5,17,1,4,4,13,0.2,0.8,0.23529411764705882,0.7647058823529411
SF-J19,SF-L20,16,31,1,3,15,28,0.0625,0.9375,0.0967741935483871,0.9032258064516129
SF-J19,SF-N20-1,11,15,0,0,11,15,0.0,1.0,0.0,1.0
SF-J19,SF-M20,29,33,9,8,20,25,0.3103448275862069,0.6896551724137931,0.24242424242424243,0.7575757575757576
SF-J19,SF-K17-2,8,13,3,1,5,12,0.375,0.625,0.07692307692307693,0.9230769230769231
SF-J19,SF-K20,14,20,1,5,13,15,0.07142857142857142,0.9285714285714286,0.25,0.75
SF-J19,SF-K15-,33,72,5,16,28,56,0.15151515151515152,0.8484848484848485,0.2222222222222222,0.7777777777777778
SF-J19,SF-K19,12,12,2,4,10,8,0.16666666666666666,0.8333333333333334,0.3333333333333333,0.6666666666666666
SF-J19,SF-K18,11,16,1,3,10,13,0.09090909090909091,0.9090909090909091,0.1875,0.8125
SF-J19,SF-K17,50,35,14,13,36,22,0.28,0.72,0.37142857142857144,0.6285714285714286
SF-J19,SF-J16,13,15,2,5,11,10,0.15384615384615385,0.8461538461538461,0.3333333333333333,0.6666666666666666
SF-J19,SF-J18,30,37,8,17,22,20,0.26666666666666666,0.7333333333333333,0.4594594594594595,0.5405405405405406
SF-J19,SF-J20,13,25,7,20,6,5,0.5384615384615384,0.46153846153846156,0.8,0.2
SF-J19,SF-M12,12,23,2,2,10,21,0.16666666666666666,0.8333333333333334,0.08695652173913043,0.9130434782608695
SF-J19,SF-M10,10,17,7,11,3,6,0.7,0.3,0.6470588235294118,0.35294117647058826
SF-J19,SF-M11,10,21,1,2,9,19,0.1,0.9,0.09523809523809523,0.9047619047619048
SF-J19,SF-R19,5,3,0,0,5,3,0.0,1.0,0.0,1.0
SF-J19,SF-R20,4,2,0,0,4,2,0.0,1.0,0.0,1.0
SF-J19,SF-Q21-2,10,6,2,0,8,6,0.2,0.8,0.0,1.0
SF-J19,SF-Q21-1,8,1,1,0,7,1,0.125,0.875,0.0,1.0
SF-J19,SF-P21,3,3,0,0,3,3,0.0,1.0,0.0,1.0
SF-J19,SF-O18,4,9,1,3,3,6,0.25,0.75,0.3333333333333333,0.6666666666666666
SF-J19,SF-O19,10,15,0,2,10,13,0.0,1.0,0.13333333333333333,0.8666666666666667
SF-J19,SF-O21,37,33,5,9,32,24,0.13513513513513514,0.8648648648648649,0.2727272727272727,0.7272727272727273
SF-J19,SF-O22,16,46,3,6,13,40,0.1875,0.8125,0.13043478260869565,0.8695652173913043
SF-J19,SF-N21,11,8,3,4,8,4,0.2727272727272727,0.7272727272727273,0.5,0.5
SF-J19,SF-N20-2,8,2,3,0,5,2,0.375,0.625,0.0,1.0
SF-J19,SF-M21,4,7,0,2,4,5,0.0,1.0,0.2857142857142857,0.7142857142857143
SF-J19,SF-L21,22,7,0,2,22,5,0.0,1.0,0.2857142857142857,0.7142857142857143
SF-J19,SF-P30,6,10,4,7,2,3,0.6666666666666666,0.3333333333333333,0.7,0.3
SF-J19,SF-O30-2,3,5,1,1,2,4,0.3333333333333333,0.6666666666666666,0.2,0.8
SF-J19,SF-O30,2,3,0,0,2,3,0.0,1.0,0.0,1.0
SF-J19,SF-N27,4,2,0,0,4,2,0.0,1.0,0.0,1.0
SF-J19,SF-N29,7,4,4,3,3,1,0.5714285714285714,0.42857142857142855,0.75,0.25
SF-J19,SF-N28,5,7,1,3,4,4,0.2,0.8,0.42857142857142855,0.5714285714285714
SF-J19,SF-L30-1,26,24,7,7,19,17,0.2692307692307692,0.7307692307692307,0.2916666666666667,0.7083333333333334
SF-J19,SF-K30-2,2,1,0,0,2,1,0.0,1.0,0.0,1.0
SF-J19,SF-L29,11,7,6,4,5,3,0.5454545454545454,0.45454545454545453,0.5714285714285714,0.42857142857142855
SF-J19,SF-J29-1,6,3,0,0,6,3,0.0,1.0,0.0,1.0
SF-J19,SF-I30,4,1,2,1,2,0,0.5,0.5,1.0,0.0
SF-J19,SF-I29-2,1,1,0,1,1,0,0.0,1.0,1.0,0.0
SF-J19,SF-I27,7,11,3,6,4,5,0.42857142857142855,0.5714285714285714,0.5454545454545454,0.45454545454545453
SF-J19,SF-I28,2,3,0,2,2,1,0.0,1.0,0.6666666666666666,0.3333333333333333
SF-J19,SF-I30-2,1,2,0,0,1,2,0.0,1.0,0.0,1.0
SF-J19,SF I29-1,5,1,1,0,4,1,0.2,0.8,0.0,1.0
SF-J19,SF-H28,5,6,5,6,0,0,1.0,0.0,1.0,0.0
SF-J19,SF-S24,7,11,0,3,7,8,0.0,1.0,0.2727272727272727,0.7272727272727273
SF-J19,SF-R24,2,5,2,0,0,5,1.0,0.0,0.0,1.0
SF-J19,SF-R26,4,1,2,0,2,1,0.5,0.5,0.0,1.0
SF-J19,SF-P26,31,10,0,3,31,7,0.0,1.0,0.3,0.7
SF-J19,SF-O25-2,7,10,1,5,6,5,0.14285714285714285,0.8571428571428571,0.5,0.5
SF-J19,SF-N22-1B,1,1,0,1,1,0,0.0,1.0,1.0,0.0
SF-J19,SF-N26,1,3,0,1,1,2,0.0,1.0,0.3333333333333333,0.6666666666666666
SF-J19,SF-N25,1,1,0,1,1,0,0.0,1.0,1.0,0.0
SF-J19,SF-T21,1,3,0,0,1,3,0.0,1.0,0.0,1.0
SF-J19,SF-T22,12,43,1,6,11,37,0.08333333333333333,0.9166666666666666,0.13953488372093023,0.8604651162790697
SF-J19,SF-S22-2,8,13,0,0,8,13,0.0,1.0,0.0,1.0
SF-J19,SF-S22-1,4,10,0,1,4,9,0.0,1.0,0.1,0.9
SF-J19,SF-Q23-3,8,11,1,1,7,10,0.125,0.875,0.09090909090909091,0.9090909090909091
SF-J19,SF-Q22-1,6,7,2,3,4,4,0.3333333333333333,0.6666666666666666,0.42857142857142855,0.5714285714285714
SF-J19,SF-Q22-2,12,6,3,2,9,4,0.25,0.75,0.3333333333333333,0.6666666666666666
SF-J19,SF-P22,11,15,3,8,8,7,0.2727272727272727,0.7272727272727273,0.5333333333333333,0.4666666666666667
SF-J19,SF-T20,9,1,0,1,9,0,0.0,1.0,1.0,0.0
SF-J19,SF-S21,3,2,0,1,3,1,0.0,1.0,0.5,0.5
SF-J19,SF-Y27,1,1,0,0,1,1,0.0,1.0,0.0,1.0
SF-J19,SF-V32,2,1,0,1,2,0,0.0,1.0,1.0,0.0
SF-O12,SF-N24-2,5,2,0,0,5,2,0.0,1.0,0.0,1.0
SF-O12,SF-P24,10,13,0,0,10,13,0.0,1.0,0.0,1.0
SF-O12,SF-H26,2,6,0,5,2,1,0.0,1.0,0.8333333333333334,0.16666666666666666
SF-O12,SF-F28-2,1,1,0,1,1,0,0.0,1.0,1.0,0.0
SF-O12,SF-G18,1,1,0,0,1,1,0.0,1.0,0.0,1.0
SF-O12,SF-G30-1,1,3,0,0,1,3,0.0,1.0,0.0,1.0
SF-O12,SF-G29-3,1,1,1,1,0,0,1.0,0.0,1.0,0.0
SF-O12,SF-J10,1,1,0,1,1,0,0.0,1.0,1.0,0.0
SF-O12,SF-J12,3,1,0,1,3,0,0.0,1.0,1.0,0.0
SF-O12,SF-H13,1,1,1,0,0,1,1.0,0.0,0.0,1.0
SF-O12,SF-G9,1,2,0,0,1,2,0.0,1.0,0.0,1.0
SF-O12,SF-G11,1,3,0,2,1,1,0.0,1.0,0.6666666666666666,0.3333333333333333
SF-O12,SF-G10-1,1,10,0,8,1,2,0.0,1.0,0.8,0.2
SF-O12,SF-C21,1,2,0,0,1,2,0.0,1.0,0.0,1.0
SF-O12,SF-A20,1,5,0,0,1,5,0.0,1.0,0.0,1.0
SF-O12,SF-H0,1,4,0,1,1,3,0.0,1.0,0.25,0.75
SF-O12,SF-J3,3,1,0,1,3,0,0.0,1.0,1.0,0.0
SF-O12,SF-F9,3,2,0,2,3,0,0.0,1.0,1.0,0.0
SF-O12,SF-J22-1,1,1,0,1,1,0,0.0,1.0,1.0,0.0
SF-O12,SF-J21,1,3,1,3,0,0,1.0,0.0,1.0,0.0
SF-O12,SF-M13,2,3,0,2,2,1,0.0,1.0,0.6666666666666666,0.3333333333333333
SF-O12,SF-M15,4,3,0,0,4,3,0.0,1.0,0.0,1.0
SF-O12,SF-K17-2,1,2,0,2,1,0,0.0,1.0,1.0,0.0
SF-O12,SF-K15-,4,2,3,2,1,0,0.75,0.25,1.0,0.0
SF-O12,SF-K18,4,3,0,1,4,2,0.0,1.0,0.3333333333333333,0.6666666666666666
SF-O12,SF-K17,4,4,0,0,4,4,0.0,1.0,0.0,1.0
SF-O12,SF-J18,3,3,0,2,3,1,0.0,1.0,0.6666666666666666,0.3333333333333333
SF-O12,SF-M12,12,26,7,22,5,4,0.5833333333333334,0.4166666666666667,0.8461538461538461,0.15384615384615385
SF-O12,SF-M10,9,4,5,3,4,1,0.5555555555555556,0.4444444444444444,0.75,0.25
SF-O12,SF-M11,3,2,0,0,3,2,0.0,1.0,0.0,1.0
SF-M12,SF-K26,3,4,0,0,3,4,0.0,1.0,0.0,1.0
SF-M12,SF-M30,13,26,1,8,12,18,0.07692307692307693,0.9230769230769231,0.3076923076923077,0.6923076923076923
SF-M12,SF-J29,1,3,0,1,1,2,0.0,1.0,0.3333333333333333,0.6666666666666666
SF-M12,SF-L25,7,1,0,0,7,1,0.0,1.0,0.0,1.0
SF-M12,SF-M24,19,2,1,1,18,1,0.05263157894736842,0.9473684210526315,0.5,0.5
SF-M12,SF-L24,32,3,0,0,32,3,0.0,1.0,0.0,1.0
SF-M12,SF-N23,2,1,2,0,0,1,1.0,0.0,0.0,1.0
SF-M12,SF-N24-2,7,7,0,1,7,6,0.0,1.0,0.14285714285714285,0.8571428571428571
SF-M12,SF-K27-2,2,1,0,1,2,0,0.0,1.0,1.0,0.0
SF-M12,SF-J26-2,2,8,1,2,1,6,0.5,0.5,0.25,0.75
SF-M12,SF-K25,8,5,1,1,7,4,0.125,0.875,0.2,0.8
SF-M12,SF-J25,13,8,0,4,13,4,0.0,1.0,0.5,0.5
SF-M12,SF-P24,5,23,0,1,5,22,0.0,1.0,0.043478260869565216,0.9565217391304348
SF-M12,SF-J24,15,10,0,0,15,10,0.0,1.0,0.0,1.0
SF-M12,SF-O24,2,4,0,1,2,3,0.0,1.0,0.25,0.75
SF-M12,SF-I26-,2,1,0,1,2,0,0.0,1.0,1.0,0.0
SF-M12,SF-I25,1,5,0,1,1,4,0.0,1.0,0.2,0.8
SF-M12,SF-H26,1,4,0,1,1,3,0.0,1.0,0.25,0.75
SF-M12,SF-O23,1,5,0,0,1,5,0.0,1.0,0.0,1.0
SF-M12,SF-G27,12,9,5,2,7,7,0.4166666666666667,0.5833333333333334,0.2222222222222222,0.7777777777777778
SF-M12,SF-M22-2,4,7,0,3,4,4,0.0,1.0,0.42857142857142855,0.5714285714285714
SF-M12,SF-L22,11,9,0,2,11,7,0.0,1.0,0.2222222222222222,0.7777777777777778
SF-M12,SF-F27,11,51,0,20,11,31,0.0,1.0,0.39215686274509803,0.6078431372549019
SF-M12,SF-N22-2,6,9,2,2,4,7,0.3333333333333333,0.6666666666666666,0.2222222222222222,0.7777777777777778
SF-M12,SF-M22-1,17,7,0,1,17,6,0.0,1.0,0.14285714285714285,0.8571428571428571
SF-M12,SF-O25-1,4,10,0,0,4,10,0.0,1.0,0.0,1.0
SF-M12,SF-K22-2,7,2,3,0,4,2,0.42857142857142855,0.5714285714285714,0.0,1.0
SF-M12,SF-K24,7,4,0,1,7,3,0.0,1.0,0.25,0.75
SF-M12,SF-J23-2,3,4,0,0,3,4,0.0,1.0,0.0,1.0
SF-M12,SF-G23,2,2,0,0,2,2,0.0,1.0,0.0,1.0
SF-M12,SF-G24,5,8,0,0,5,8,0.0,1.0,0.0,1.0
SF-M12,SF-G25,6,1,3,1,3,0,0.5,0.5,1.0,0.0
SF-M12,SF-F23,6,7,1,3,5,4,0.16666666666666666,0.8333333333333334,0.42857142857142855,0.5714285714285714
SF-M12,SF-E23,12,4,1,0,11,4,0.08333333333333333,0.9166666666666666,0.0,1.0
SF-M12,SF-D24,14,10,0,0,14,10,0.0,1.0,0.0,1.0
SF-M12,SF-C22,2,2,0,1,2,1,0.0,1.0,0.5,0.5
SF-M12,SF-B22,2,3,0,1,2,2,0.0,1.0,0.3333333333333333,0.6666666666666666
SF-M12,SF-J17,16,8,4,0,12,8,0.25,0.75,0.0,1.0
SF-M12,SF-I19,4,3,1,0,3,3,0.25,0.75,0.0,1.0
SF-M12,SF-H16,12,25,1,4,11,21,0.08333333333333333,0.9166666666666666,0.16,0.84
SF-M12,SF-H20,1,5,0,1,1,4,0.0,1.0,0.2,0.8
SF-M12,SF-H18,3,1,0,0,3,1,0.0,1.0,0.0,1.0
SF-M12,SF-H17,7,2,3,1,4,1,0.42857142857142855,0.5714285714285714,0.5,0.5
SF-M12,SF-G19,6,5,3,0,3,5,0.5,0.5,0.0,1.0
SF-M12,SF-G17,7,5,1,1,6,4,0.14285714285714285,0.8571428571428571,0.2,0.8
SF-M12,SF-G18,16,18,4,5,12,13,0.25,0.75,0.2777777777777778,0.7222222222222222
SF-M12,SF-G20,7,7,3,3,4,4,0.42857142857142855,0.5714285714285714,0.42857142857142855,0.5714285714285714
SF-M12,SF-F19,4,3,0,0,4,3,0.0,1.0,0.0,1.0
SF-M12,SF-E18,3,3,0,0,3,3,0.0,1.0,0.0,1.0
SF-M12,SF-E20,29,38,1,0,28,38,0.034482758620689655,0.9655172413793104,0.0,1.0
SF-M12,SF-E29-2,6,6,3,4,3,2,0.5,0.5,0.6666666666666666,0.3333333333333333
SF-M12,SF-E29-1,1,4,0,2,1,2,0.0,1.0,0.5,0.5
SF-M12,SF-A27,1,3,1,0,0,3,1.0,0.0,0.0,1.0
SF-M12,SF-F29,4,1,0,0,4,1,0.0,1.0,0.0,1.0
SF-M12,SF-E29-3,1,1,0,0,1,1,0.0,1.0,0.0,1.0
SF-M12,SF-F28-1,2,1,0,0,2,1,0.0,1.0,0.0,1.0
SF-M12,SF-J10,10,37,7,27,3,10,0.7,0.3,0.7297297297297297,0.2702702702702703
SF-M12,SF-J12,51,61,24,42,27,19,0.47058823529411764,0.5294117647058824,0.6885245901639344,0.3114754098360656
SF-M12,SF-J13,21,15,12,8,9,7,0.5714285714285714,0.42857142857142855,0.5333333333333333,0.4666666666666667
SF-M12,SF-J15,3,2,0,1,3,1,0.0,1.0,0.5,0.5
SF-M12,SF-H13,23,18,7,1,16,17,0.30434782608695654,0.6956521739130435,0.05555555555555555,0.9444444444444444
SF-M12,SF-I16,9,1,5,1,4,0,0.5555555555555556,0.4444444444444444,1.0,0.0
SF-M12,SF-H12,9,3,1,2,8,1,0.1111111111111111,0.8888888888888888,0.6666666666666666,0.3333333333333333
SF-M12,SF-G10-2,6,8,1,0,5,8,0.16666666666666666,0.8333333333333334,0.0,1.0
SF-M12,SF-H15,2,4,0,0,2,4,0.0,1.0,0.0,1.0
SF-M12,SF-G9,3,5,2,5,1,0,0.6666666666666666,0.3333333333333333,1.0,0.0
SF-M12,SF-H14,2,1,2,0,0,1,1.0,0.0,0.0,1.0
SF-M12,SF-G13,20,16,8,4,12,12,0.4,0.6,0.25,0.75
SF-M12,SF-G11,9,10,4,6,5,4,0.4444444444444444,0.5555555555555556,0.6,0.4
SF-M12,SF-G12,22,34,4,2,18,32,0.18181818181818182,0.8181818181818182,0.058823529411764705,0.9411764705882353
SF-M12,SF-G10-1,7,48,3,31,4,17,0.42857142857142855,0.5714285714285714,0.6458333333333334,0.3541666666666667
SF-M12,SF-F15,3,5,3,2,0,3,1.0,0.0,0.4,0.6
SF-M12,SF-F16,6,5,2,1,4,4,0.3333333333333333,0.6666666666666666,0.2,0.8
SF-M12,SF-A20,2,1,0,0,2,1,0.0,1.0,0.0,1.0
SF-M12,SF-C25,5,4,0,0,5,4,0.0,1.0,0.0,1.0
SF-M12,SF-B25,3,2,0,0,3,2,0.0,1.0,0.0,1.0
SF-M12,SF-J1,42,84,19,70,23,14,0.4523809523809524,0.5476190476190477,0.8333333333333334,0.16666666666666666
SF-M12,SF-H0,10,16,9,7,1,9,0.9,0.1,0.4375,0.5625
SF-M12,SF-J3,8,11,2,5,6,6,0.25,0.75,0.45454545454545453,0.5454545454545454
SF-M12,SF-J5,18,28,4,8,14,20,0.2222222222222222,0.7777777777777778,0.2857142857142857,0.7142857142857143
SF-M12,SF-G8,5,8,3,6,2,2,0.6,0.4,0.75,0.25
SF-M12,SF-G5,4,16,1,10,3,6,0.25,0.75,0.625,0.375
SF-M12,SF-G7,13,10,3,1,10,9,0.23076923076923078,0.7692307692307693,0.1,0.9
SF-M12,SF-F9,7,15,1,6,6,9,0.14285714285714285,0.8571428571428571,0.4,0.6
SF-M12,SF-H25,3,1,1,0,2,1,0.3333333333333333,0.6666666666666666,0.0,1.0
SF-M12,SF-G26,2,5,2,2,0,3,1.0,0.0,0.4,0.6
SF-M12,SF-K21,11,21,1,10,10,11,0.09090909090909091,0.9090909090909091,0.47619047619047616,0.5238095238095238
SF-M12,SF-K22-1,7,5,2,0,5,5,0.2857142857142857,0.7142857142857143,0.0,1.0
SF-M12,SF-J23-1,9,10,1,4,8,6,0.1111111111111111,0.8888888888888888,0.4,0.6
SF-M12,SF-J22-1,13,13,1,1,12,12,0.07692307692307693,0.9230769230769231,0.07692307692307693,0.9230769230769231
SF-M12,SF-J22-2,8,9,1,3,7,6,0.125,0.875,0.3333333333333333,0.6666666666666666
SF-M12,SF-J21,14,14,1,6,13,8,0.07142857142857142,0.9285714285714286,0.42857142857142855,0.5714285714285714
SF-M12,SF-I22,2,5,0,0,2,5,0.0,1.0,0.0,1.0
SF-M12,SF-I23-2,3,4,1,2,2,2,0.3333333333333333,0.6666666666666666,0.5,0.5
SF-M12,SF-I23-1,2,2,0,0,2,2,0.0,1.0,0.0,1.0
SF-M12,SF-F26,4,5,2,1,2,4,0.5,0.5,0.2,0.8
SF-M12,SF-M13,51,69,17,37,34,32,0.3333333333333333,0.6666666666666666,0.5362318840579711,0.463768115942029
SF-M12,SF-M15,73,71,22,14,51,57,0.3013698630136986,0.6986301369863014,0.19718309859154928,0.8028169014084507
SF-M12,SF-L19,8,9,1,1,7,8,0.125,0.875,0.1111111111111111,0.8888888888888888
SF-M12,SF-L20,31,12,1,1,30,11,0.03225806451612903,0.967741935483871,0.08333333333333333,0.9166666666666666
SF-M12,SF-N20-1,3,6,0,2,3,4,0.0,1.0,0.3333333333333333,0.6666666666666666
SF-M12,SF-M20,23,23,2,5,21,18,0.08695652173913043,0.9130434782608695,0.21739130434782608,0.782608695652174
SF-M12,SF-K17-2,10,14,6,6,4,8,0.6,0.4,0.42857142857142855,0.5714285714285714
SF-M12,SF-K20,31,16,12,5,19,11,0.3870967741935484,0.6129032258064516,0.3125,0.6875
SF-M12,SF-K15-,48,42,24,27,24,15,0.5,0.5,0.6428571428571429,0.35714285714285715
SF-M12,SF-K19,27,37,7,22,20,15,0.25925925925925924,0.7407407407407407,0.5945945945945946,0.40540540540540543
SF-M12,SF-K18,24,30,7,6,17,24,0.2916666666666667,0.7083333333333334,0.2,0.8
SF-M12,SF-K17,63,40,27,8,36,32,0.42857142857142855,0.5714285714285714,0.2,0.8
SF-M12,SF-J16,13,7,3,5,10,2,0.23076923076923078,0.7692307692307693,0.7142857142857143,0.2857142857142857
SF-M12,SF-J18,31,24,11,13,20,11,0.3548387096774194,0.6451612903225806,0.5416666666666666,0.4583333333333333
SF-M12,SF-J19,23,12,2,2,21,10,0.08695652173913043,0.9130434782608695,0.16666666666666666,0.8333333333333334
SF-M12,SF-O12,26,12,22,7,4,5,0.8461538461538461,0.15384615384615385,0.5833333333333334,0.4166666666666667
SF-M12,SF-M10,77,53,47,31,30,22,0.6103896103896104,0.38961038961038963,0.5849056603773585,0.41509433962264153
SF-M12,SF-M11,33,59,20,36,13,23,0.6060606060606061,0.3939393939393939,0.6101694915254238,0.3898305084745763
SF-M12,SF-R19,3,6,1,0,2,6,0.3333333333333333,0.6666666666666666,0.0,1.0
SF-M12,SF-R20,3,1,1,0,2,1,0.3333333333333333,0.6666666666666666,0.0,1.0
SF-M12,SF-Q21-2,3,4,2,0,1,4,0.6666666666666666,0.3333333333333333,0.0,1.0
SF-M12,SF-Q21-1,2,1,1,0,1,1,0.5,0.5,0.0,1.0
SF-M12,SF-P21,3,5,1,1,2,4,0.3333333333333333,0.6666666666666666,0.2,0.8
SF-M12,SF-O18,14,6,0,1,14,5,0.0,1.0,0.16666666666666666,0.8333333333333334
SF-M12,SF-O19,7,7,1,1,6,6,0.14285714285714285,0.8571428571428571,0.14285714285714285,0.8571428571428571
SF-M12,SF-O21,21,31,4,5,17,26,0.19047619047619047,0.8095238095238095,0.16129032258064516,0.8387096774193549
SF-M12,SF-O22,11,17,0,7,11,10,0.0,1.0,0.4117647058823529,0.5882352941176471
SF-M12,SF-N21,7,4,1,1,6,3,0.14285714285714285,0.8571428571428571,0.25,0.75
SF-M12,SF-N20-2,3,5,1,3,2,2,0.3333333333333333,0.6666666666666666,0.6,0.4
SF-M12,SF-M21,7,7,1,1,6,6,0.14285714285714285,0.8571428571428571,0.14285714285714285,0.8571428571428571
SF-M12,SF-L21,30,15,6,2,24,13,0.2,0.8,0.13333333333333333,0.8666666666666667
SF-M12,SF-O30,2,4,0,2,2,2,0.0,1.0,0.5,0.5
SF-M12,SF-N27,1,1,0,0,1,1,0.0,1.0,0.0,1.0
SF-M12,SF-N29,2,1,0,1,2,0,0.0,1.0,1.0,0.0
SF-M12,SF-L30-1,14,39,6,32,8,7,0.42857142857142855,0.5714285714285714,0.8205128205128205,0.1794871794871795
SF-M12,SF-L29,3,3,0,1,3,2,0.0,1.0,0.3333333333333333,0.6666666666666666
SF-M12,SF-I30-2,1,3,0,0,1,3,0.0,1.0,0.0,1.0
SF-M12,SF-S24,3,3,1,0,2,3,0.3333333333333333,0.6666666666666666,0.0,1.0
SF-M12,SF-R24,1,4,1,1,0,3,1.0,0.0,0.25,0.75
SF-M12,SF-R26,1,2,0,1,1,1,0.0,1.0,0.5,0.5
SF-M12,SF-Q26,6,28,1,13,5,15,0.16666666666666666,0.8333333333333334,0.4642857142857143,0.5357142857142857
SF-M12,SF-P26,21,31,3,17,18,14,0.14285714285714285,0.8571428571428571,0.5483870967741935,0.45161290322580644
SF-M12,SF-O25-2,3,2,0,0,3,2,0.0,1.0,0.0,1.0
SF-M12,SF-N22-1B,2,2,0,0,2,2,0.0,1.0,0.0,1.0
SF-M12,SF-N26,1,1,0,0,1,1,0.0,1.0,0.0,1.0
SF-M12,SF-T21,1,1,0,0,1,1,0.0,1.0,0.0,1.0
SF-M12,SF-T22,3,2,1,0,2,2,0.3333333333333333,0.6666666666666666,0.0,1.0
SF-M12,SF-S22-1,3,8,0,5,3,3,0.0,1.0,0.625,0.375
SF-M12,SF-Q23-3,4,3,1,2,3,1,0.25,0.75,0.6666666666666666,0.3333333333333333
SF-M12,SF-Q22-1,2,8,0,0,2,8,0.0,1.0,0.0,1.0
SF-M12,SF-Q22-2,9,3,0,0,9,3,0.0,1.0,0.0,1.0
SF-M12,SF-P22,1,11,1,0,0,11,1.0,0.0,0.0,1.0
SF-M12,SF-W19,8,8,0,0,8,8,0.0,1.0,0.0,1.0
SF-M12,SF-W19-2,25,19,0,0,25,19,0.0,1.0,0.0,1.0
SF-M12,SF-U21,4,2,0,0,4,2,0.0,1.0,0.0,1.0
SF-M12,SF-T20,1,3,0,0,1,3,0.0,1.0,0.0,1.0
SF-M12,SF-W14,3,3,0,1,3,2,0.0,1.0,0.3333333333333333,0.6666666666666666
SF-M12,SF-W8,1,3,1,2,0,1,1.0,0.0,0.6666666666666666,0.3333333333333333
SF-M12,SF-Y14,1,4,1,2,0,2,1.0,0.0,0.5,0.5
SF-M10,SF-M26-2,5,6,0,4,5,2,0.0,1.0,0.6666666666666666,0.3333333333333333
SF-M10,SF-K26,1,2,0,0,1,2,0.0,1.0,0.0,1.0
SF-M10,SF-J27,1,1,0,0,1,1,0.0,1.0,0.0,1.0
SF-M10,SF-M30,3,1,0,0,3,1,0.0,1.0,0.0,1.0
SF-M10,SF-L26,2,2,0,0,2,2,0.0,1.0,0.0,1.0
SF-M10,SF-L25,2,3,1,3,1,0,0.5,0.5,1.0,0.0
SF-M10,SF-M24,1,2,0,2,1,0,0.0,1.0,1.0,0.0
SF-M10,SF-L24,16,12,0,1,16,11,0.0,1.0,0.08333333333333333,0.9166666666666666
SF-M10,SF-N23,1,1,1,1,0,0,1.0,0.0,1.0,0.0
SF-M10,SF-K27-2,2,1,0,1,2,0,0.0,1.0,1.0,0.0
SF-M10,SF-J26-2,1,1,1,0,0,1,1.0,0.0,0.0,1.0
SF-M10,SF-K29-1,1,2,0,0,1,2,0.0,1.0,0.0,1.0
SF-M10,SF-K25,1,2,0,1,1,1,0.0,1.0,0.5,0.5
SF-M10,SF-J25,2,4,1,1,1,3,0.5,0.5,0.25,0.75
SF-M10,SF-P24,3,6,2,5,1,1,0.6666666666666666,0.3333333333333333,0.8333333333333334,0.16666666666666666
SF-M10,SF-J24,1,3,0,0,1,3,0.0,1.0,0.0,1.0
SF-M10,SF-I25,4,5,0,3,4,2,0.0,1.0,0.6,0.4
SF-M10,SF-K23,2,1,1,0,1,1,0.5,0.5,0.0,1.0
SF-M10,SF-H26,4,3,2,1,2,2,0.5,0.5,0.3333333333333333,0.6666666666666666
SF-M10,SF-G27,1,6,0,4,1,2,0.0,1.0,0.6666666666666666,0.3333333333333333
SF-M10,SF-M22-2,4,3,3,0,1,3,0.75,0.25,0.0,1.0
SF-M10,SF-L22,1,2,0,0,1,2,0.0,1.0,0.0,1.0
SF-M10,SF-F27,4,1,0,0,4,1,0.0,1.0,0.0,1.0
SF-M10,SF-N22-2,8,8,1,1,7,7,0.125,0.875,0.125,0.875
SF-M10,SF-M22-1,1,7,0,4,1,3,0.0,1.0,0.5714285714285714,0.42857142857142855
SF-M10,SF-J23-2,1,4,0,3,1,1,0.0,1.0,0.75,0.25
SF-M10,SF-G23,1,1,0,0,1,1,0.0,1.0,0.0,1.0
SF-M10,SF-G24,7,5,0,0,7,5,0.0,1.0,0.0,1.0
SF-M10,SF-G25,2,1,1,1,1,0,0.5,0.5,1.0,0.0
SF-M10,SF-F23,1,4,1,1,0,3,1.0,0.0,0.25,0.75
SF-M10,SF-E23,5,4,1,0,4,4,0.2,0.8,0.0,1.0
SF-M10,SF-D24,2,6,1,1,1,5,0.5,0.5,0.16666666666666666,0.8333333333333334
SF-M10,SF-C22,1,1,0,0,1,1,0.0,1.0,0.0,1.0
SF-M10,SF-B22,1,4,1,1,0,3,1.0,0.0,0.25,0.75
SF-M10,SF-J17,14,5,3,0,11,5,0.21428571428571427,0.7857142857142857,0.0,1.0
SF-M10,SF-I19,2,1,0,0,2,1,0.0,1.0,0.0,1.0
SF-M10,SF-I20,4,2,0,1,4,1,0.0,1.0,0.5,0.5
SF-M10,SF-H16,17,13,2,0,15,13,0.11764705882352941,0.8823529411764706,0.0,1.0
SF-M10,SF-H20,1,3,0,2,1,1,0.0,1.0,0.6666666666666666,0.3333333333333333
SF-M10,SF-G19,3,1,0,1,3,0,0.0,1.0,1.0,0.0
SF-M10,SF-G17,4,1,1,0,3,1,0.25,0.75,0.0,1.0
SF-M10,SF-G18,55,62,45,58,10,4,0.8181818181818182,0.18181818181818182,0.9354838709677419,0.06451612903225806
SF-M10,SF-G20,3,2,0,1,3,1,0.0,1.0,0.5,0.5
SF-M10,SF-F19,7,5,2,1,5,4,0.2857142857142857,0.7142857142857143,0.2,0.8
SF-M10,SF-E18,4,2,0,1,4,1,0.0,1.0,0.5,0.5
SF-M10,SF-E20,42,39,1,0,41,39,0.023809523809523808,0.9761904761904762,0.0,1.0
SF-M10,SF-G30-2,1,1,0,1,1,0,0.0,1.0,1.0,0.0
SF-M10,SF-E29-2,1,6,0,4,1,2,0.0,1.0,0.6666666666666666,0.3333333333333333
SF-M10,SF-G30-1,1,1,1,0,0,1,1.0,0.0,0.0,1.0
SF-M10,SF-F28-1,2,6,1,4,1,2,0.5,0.5,0.6666666666666666,0.3333333333333333
SF-M10,SF-J10,24,29,18,25,6,4,0.75,0.25,0.8620689655172413,0.13793103448275862
SF-M10,SF-J12,38,20,13,5,25,15,0.34210526315789475,0.6578947368421053,0.25,0.75
SF-M10,SF-J13,19,9,15,2,4,7,0.7894736842105263,0.21052631578947367,0.2222222222222222,0.7777777777777778
SF-M10,SF-J15,6,2,3,0,3,2,0.5,0.5,0.0,1.0
SF-M10,SF-J14,2,5,0,2,2,3,0.0,1.0,0.4,0.6
SF-M10,SF-H13,4,1,2,1,2,0,0.5,0.5,1.0,0.0
SF-M10,SF-I16,10,14,0,1,10,13,0.0,1.0,0.07142857142857142,0.9285714285714286
SF-M10,SF-H12,9,7,4,1,5,6,0.4444444444444444,0.5555555555555556,0.14285714285714285,0.8571428571428571
SF-M10,SF-G10-2,15,3,4,1,11,2,0.26666666666666666,0.7333333333333333,0.3333333333333333,0.6666666666666666
SF-M10,SF-G9,8,4,3,2,5,2,0.375,0.625,0.5,0.5
SF-M10,SF-H14,6,5,4,1,2,4,0.6666666666666666,0.3333333333333333,0.2,0.8
SF-M10,SF-G13,18,16,9,5,9,11,0.5,0.5,0.3125,0.6875
SF-M10,SF-G11,6,6,2,1,4,5,0.3333333333333333,0.6666666666666666,0.16666666666666666,0.8333333333333334
SF-M10,SF-G12,14,25,3,14,11,11,0.21428571428571427,0.7857142857142857,0.56,0.44
SF-M10,SF-F15,8,2,5,0,3,2,0.625,0.375,0.0,1.0
SF-M10,SF-F16,4,3,1,1,3,2,0.25,0.75,0.3333333333333333,0.6666666666666666
SF-M10,SF-C21,1,1,0,0,1,1,0.0,1.0,0.0,1.0
SF-M10,SF-C20,4,1,1,0,3,1,0.25,0.75,0.0,1.0
SF-M10,SF-B19,5,2,0,0,5,2,0.0,1.0,0.0,1.0
SF-M10,SF-C26,7,5,1,1,6,4,0.14285714285714285,0.8571428571428571,0.2,0.8
SF-M10,SF-C25,3,5,0,1,3,4,0.0,1.0,0.2,0.8
SF-M10,SF-J1,91,78,57,48,34,30,0.6263736263736264,0.37362637362637363,0.6153846153846154,0.38461538461538464
SF-M10,SF-H0,27,14,16,12,11,2,0.5925925925925926,0.4074074074074074,0.8571428571428571,0.14285714285714285
SF-M10,SF-J3,14,14,5,9,9,5,0.35714285714285715,0.6428571428571429,0.6428571428571429,0.35714285714285715
SF-M10,SF-J5,12,20,7,12,5,8,0.5833333333333334,0.4166666666666667,0.6,0.4
SF-M10,SF-G6,7,4,5,3,2,1,0.7142857142857143,0.2857142857142857,0.75,0.25
SF-M10,SF-G8,23,8,6,2,17,6,0.2608695652173913,0.7391304347826086,0.25,0.75
SF-M10,SF-G5,14,3,7,2,7,1,0.5,0.5,0.6666666666666666,0.3333333333333333
SF-M10,SF-G7,9,12,3,9,6,3,0.3333333333333333,0.6666666666666666,0.75,0.25
SF-M10,SF-F9,9,6,6,2,3,4,0.6666666666666666,0.3333333333333333,0.3333333333333333,0.6666666666666666
SF-M10,SF-H25,1,2,0,0,1,2,0.0,1.0,0.0,1.0
SF-M10,SF-G26,4,76,0,0,4,76,0.0,1.0,0.0,1.0
SF-M10,SF-K21,20,10,11,7,9,3,0.55,0.45,0.7,0.3
SF-M10,SF-K22-1,3,3,0,1,3,2,0.0,1.0,0.3333333333333333,0.6666666666666666
SF-M10,SF-J23-1,9,25,1,20,8,5,0.1111111111111111,0.8888888888888888,0.8,0.2
SF-M10,SF-J22-1,12,8,1,0,11,8,0.08333333333333333,0.9166666666666666,0.0,1.0
SF-M10,SF-J22-2,3,5,3,1,0,4,1.0,0.0,0.2,0.8
SF-M10,SF-J21,3,9,0,9,3,0,0.0,1.0,1.0,0.0
SF-M10,SF-I22,2,2,0,1,2,1,0.0,1.0,0.5,0.5
SF-M10,SF-I23-2,5,2,5,1,0,1,1.0,0.0,0.5,0.5
SF-M10,SF-I24,1,3,0,0,1,3,0.0,1.0,0.0,1.0
SF-M10,SF-I23-1,5,4,1,0,4,4,0.2,0.8,0.0,1.0
SF-M10,SF-F26,2,4,1,0,1,4,0.5,0.5,0.0,1.0
SF-M10,SF-M13,75,79,39,40,36,39,0.52,0.48,0.5063291139240507,0.4936708860759494
SF-M10,SF-M15,27,33,16,16,11,17,0.5925925925925926,0.4074074074074074,0.48484848484848486,0.5151515151515151
SF-M10,SF-L19,15,4,2,3,13,1,0.13333333333333333,0.8666666666666667,0.75,0.25
SF-M10,SF-L20,10,9,0,5,10,4,0.0,1.0,0.5555555555555556,0.4444444444444444
SF-M10,SF-N20-1,8,4,0,1,8,3,0.0,1.0,0.25,0.75
SF-M10,SF-M20,12,7,2,1,10,6,0.16666666666666666,0.8333333333333334,0.14285714285714285,0.8571428571428571
SF-M10,SF-K17-2,11,19,8,10,3,9,0.7272727272727273,0.2727272727272727,0.5263157894736842,0.47368421052631576
SF-M10,SF-K20,17,10,4,5,13,5,0.23529411764705882,0.7647058823529411,0.5,0.5
SF-M10,SF-K15-,92,72,47,39,45,33,0.5108695652173914,0.4891304347826087,0.5416666666666666,0.4583333333333333
SF-M10,SF-K19,23,11,11,6,12,5,0.4782608695652174,0.5217391304347826,0.5454545454545454,0.45454545454545453
SF-M10,SF-K18,34,22,18,10,16,12,0.5294117647058824,0.47058823529411764,0.45454545454545453,0.5454545454545454
SF-M10,SF-K17,46,15,29,6,17,9,0.6304347826086957,0.3695652173913043,0.4,0.6
SF-M10,SF-J16,8,9,2,1,6,8,0.25,0.75,0.1111111111111111,0.8888888888888888
SF-M10,SF-J18,17,18,7,9,10,9,0.4117647058823529,0.5882352941176471,0.5,0.5
SF-M10,SF-J20,1,4,0,1,1,3,0.0,1.0,0.25,0.75
SF-M10,SF-J19,17,10,11,7,6,3,0.6470588235294118,0.35294117647058826,0.7,0.3
SF-M10,SF-O12,4,9,3,5,1,4,0.75,0.25,0.5555555555555556,0.4444444444444444
SF-M10,SF-M12,53,77,31,47,22,30,0.5849056603773585,0.41509433962264153,0.6103896103896104,0.38961038961038963
SF-M10,SF-M11,81,78,51,54,30,24,0.6296296296296297,0.37037037037037035,0.6923076923076923,0.3076923076923077
SF-M10,SF-Q21-1,1,3,1,3,0,0,1.0,0.0,1.0,0.0
SF-M10,SF-P21,4,1,1,1,3,0,0.25,0.75,1.0,0.0
SF-M10,SF-O18,5,7,2,2,3,5,0.4,0.6,0.2857142857142857,0.7142857142857143
SF-M10,SF-O19,5,8,0,5,5,3,0.0,1.0,0.625,0.375
SF-M10,SF-O21,12,13,5,7,7,6,0.4166666666666667,0.5833333333333334,0.5384615384615384,0.46153846153846156
SF-M10,SF-O22,4,5,1,1,3,4,0.25,0.75,0.2,0.8
SF-M10,SF-N21,8,2,3,2,5,0,0.375,0.625,1.0,0.0
SF-M10,SF-N20-2,9,3,3,1,6,2,0.3333333333333333,0.6666666666666666,0.3333333333333333,0.6666666666666666
SF-M10,SF-M21,7,5,2,2,5,3,0.2857142857142857,0.7142857142857143,0.4,0.6
SF-M10,SF-L21,8,10,1,3,7,7,0.125,0.875,0.3,0.7
SF-M10,SF-Q30,1,1,0,1,1,0,0.0,1.0,1.0,0.0
SF-M10,SF-O30,3,9,0,5,3,4,0.0,1.0,0.5555555555555556,0.4444444444444444
SF-M10,SF-N27,1,3,0,1,1,2,0.0,1.0,0.3333333333333333,0.6666666666666666
SF-M10,SF-L30-1,1,14,0,10,1,4,0.0,1.0,0.7142857142857143,0.2857142857142857
SF-M10,SF I29-1,1,1,0,0,1,1,0.0,1.0,0.0,1.0
SF-M10,SF-H28,2,2,0,2,2,0,0.0,1.0,1.0,0.0
SF-M10,SF-R24,3,3,1,3,2,0,0.3333333333333333,0.6666666666666666,1.0,0.0
SF-M10,SF-Q26,3,3,0,0,3,3,0.0,1.0,0.0,1.0
SF-M10,SF-N25,4,2,4,0,0,2,1.0,0.0,0.0,1.0
SF-M10,SF-T22,1,2,0,0,1,2,0.0,1.0,0.0,1.0
SF-M10,SF-S22-1,2,1,1,1,1,0,0.5,0.5,1.0,0.0
SF-M10,SF-Q22-1,1,5,0,5,1,0,0.0,1.0,1.0,0.0
SF-M10,SF-Q22-2,2,2,1,0,1,2,0.5,0.5,0.0,1.0
SF-M10,SF-P22,4,9,1,5,3,4,0.25,0.75,0.5555555555555556,0.4444444444444444
SF-M10,SF-W19,3,1,0,0,3,1,0.0,1.0,0.0,1.0
SF-M10,SF-T20,2,1,0,0,2,1,0.0,1.0,0.0,1.0
SF-M10,SF-S21,1,1,0,1,1,0,0.0,1.0,1.0,0.0
SF-M10,SF-W8,8,4,4,1,4,3,0.5,0.5,0.25,0.75
SF-M11,SF-J27,2,17,0,16,2,1,0.0,1.0,0.9411764705882353,0.058823529411764705
SF-M11,SF-M30,6,5,0,1,6,4,0.0,1.0,0.2,0.8
SF-M11,SF-J29-3,1,3,1,0,0,3,1.0,0.0,0.0,1.0
SF-M11,SF-J29,2,3,0,1,2,2,0.0,1.0,0.3333333333333333,0.6666666666666666
SF-M11,SF-L26,3,7,0,0,3,7,0.0,1.0,0.0,1.0
SF-M11,SF-M28,2,2,1,2,1,0,0.5,0.5,1.0,0.0
SF-M11,SF-L25,3,4,0,1,3,3,0.0,1.0,0.25,0.75
SF-M11,SF-M24,3,2,0,1,3,1,0.0,1.0,0.5,0.5
SF-M11,SF-L24,1,6,0,5,1,1,0.0,1.0,0.8333333333333334,0.16666666666666666
SF-M11,SF-N23,1,1,0,0,1,1,0.0,1.0,0.0,1.0
SF-M11,SF-K27-2,2,5,2,3,0,2,1.0,0.0,0.6,0.4
SF-M11,SF-J26-2,2,6,0,2,2,4,0.0,1.0,0.3333333333333333,0.6666666666666666
SF-M11,SF-K29-1,3,16,2,15,1,1,0.6666666666666666,0.3333333333333333,0.9375,0.0625
SF-M11,SF-J25,7,6,0,3,7,3,0.0,1.0,0.5,0.5
SF-M11,SF-P24,4,5,0,3,4,2,0.0,1.0,0.6,0.4
SF-M11,SF-I25,4,2,2,0,2,2,0.5,0.5,0.0,1.0
SF-M11,SF-H26,11,7,0,2,11,5,0.0,1.0,0.2857142857142857,0.7142857142857143
SF-M11,SF-O23,4,2,0,0,4,2,0.0,1.0,0.0,1.0
SF-M11,SF-H27-1,1,1,0,0,1,1,0.0,1.0,0.0,1.0
SF-M11,SF-F28-2,6,3,1,0,5,3,0.16666666666666666,0.8333333333333334,0.0,1.0
SF-M11,SF-G27,5,4,0,1,5,3,0.0,1.0,0.25,0.75
SF-M11,SF-M22-2,10,8,4,4,6,4,0.4,0.6,0.5,0.5
SF-M11,SF-L22,6,9,0,1,6,8,0.0,1.0,0.1111111111111111,0.8888888888888888
SF-M11,SF-F27,1,2,0,0,1,2,0.0,1.0,0.0,1.0
SF-M11,SF-N22-2,16,32,2,13,14,19,0.125,0.875,0.40625,0.59375
SF-M11,SF-M22-1,4,6,0,3,4,3,0.0,1.0,0.5,0.5
SF-M11,SF-O25-1,2,2,0,1,2,1,0.0,1.0,0.5,0.5
SF-M11,SF-K22-2,2,1,2,0,0,1,1.0,0.0,0.0,1.0
SF-M11,SF-K24,1,1,0,0,1,1,0.0,1.0,0.0,1.0
SF-M11,SF-J23-2,8,12,2,2,6,10,0.25,0.75,0.16666666666666666,0.8333333333333334
SF-M11,SF-G24,6,8,1,0,5,8,0.16666666666666666,0.8333333333333334,0.0,1.0
SF-M11,SF-G25,3,10,0,1,3,9,0.0,1.0,0.1,0.9
SF-M11,SF-F23,9,9,0,0,9,9,0.0,1.0,0.0,1.0
SF-M11,SF-E23,17,15,0,0,17,15,0.0,1.0,0.0,1.0
SF-M11,SF-D24,18,27,0,0,18,27,0.0,1.0,0.0,1.0
SF-M11,SF-C22,1,3,0,1,1,2,0.0,1.0,0.3333333333333333,0.6666666666666666
SF-M11,SF-B22,3,4,0,1,3,3,0.0,1.0,0.25,0.75
SF-M11,SF-J17,33,41,7,7,26,34,0.21212121212121213,0.7878787878787878,0.17073170731707318,0.8292682926829268
SF-M11,SF-I19,11,5,1,2,10,3,0.09090909090909091,0.9090909090909091,0.4,0.6
SF-M11,SF-I20,3,5,2,2,1,3,0.6666666666666666,0.3333333333333333,0.4,0.6
SF-M11,SF-H16,18,16,2,0,16,16,0.1111111111111111,0.8888888888888888,0.0,1.0
SF-M11,SF-H19,4,2,1,1,3,1,0.25,0.75,0.5,0.5
SF-M11,SF-H20,9,6,5,5,4,1,0.5555555555555556,0.4444444444444444,0.8333333333333334,0.16666666666666666
SF-M11,SF-H18,12,12,3,1,9,11,0.25,0.75,0.08333333333333333,0.9166666666666666
SF-M11,SF-H17,5,3,0,1,5,2,0.0,1.0,0.3333333333333333,0.6666666666666666
SF-M11,SF-G19,10,7,6,1,4,6,0.6,0.4,0.14285714285714285,0.8571428571428571
SF-M11,SF-G17,6,5,2,1,4,4,0.3333333333333333,0.6666666666666666,0.2,0.8
SF-M11,SF-G18,37,50,1,1,36,49,0.02702702702702703,0.972972972972973,0.02,0.98
SF-M11,SF-G20,7,10,2,4,5,6,0.2857142857142857,0.7142857142857143,0.4,0.6
SF-M11,SF-F19,5,7,1,1,4,6,0.2,0.8,0.14285714285714285,0.8571428571428571
SF-M11,SF-E18,11,8,1,0,10,8,0.09090909090909091,0.9090909090909091,0.0,1.0
SF-M11,SF-E20,12,18,0,0,12,18,0.0,1.0,0.0,1.0
SF-M11,SF-G30-2,2,3,0,0,2,3,0.0,1.0,0.0,1.0
SF-M11,SF-E29-2,3,11,0,2,3,9,0.0,1.0,0.18181818181818182,0.8181818181818182
SF-M11,SF-D29,2,1,0,1,2,0,0.0,1.0,1.0,0.0
SF-M11,SF-D28,2,1,1,0,1,1,0.5,0.5,0.0,1.0
SF-M11,SF-G30-1,1,2,0,0,1,2,0.0,1.0,0.0,1.0
SF-M11,SF-F30-2,2,1,0,0,2,1,0.0,1.0,0.0,1.0
SF-M11,SF-F28-1,2,3,0,0,2,3,0.0,1.0,0.0,1.0
SF-M11,SF-J10,40,42,25,37,15,5,0.625,0.375,0.8809523809523809,0.11904761904761904
SF-M11,SF-J12,65,61,41,34,24,27,0.6307692307692307,0.36923076923076925,0.5573770491803278,0.4426229508196721
SF-M11,SF-J13,28,15,11,6,17,9,0.39285714285714285,0.6071428571428571,0.4,0.6
SF-M11,SF-J15,4,10,0,4,4,6,0.0,1.0,0.4,0.6
SF-M11,SF-H13,14,9,5,1,9,8,0.35714285714285715,0.6428571428571429,0.1111111111111111,0.8888888888888888
SF-M11,SF-I16,17,6,8,0,9,6,0.47058823529411764,0.5294117647058824,0.0,1.0
SF-M11,SF-H12,14,10,6,2,8,8,0.42857142857142855,0.5714285714285714,0.2,0.8
SF-M11,SF-G10-2,17,5,8,0,9,5,0.47058823529411764,0.5294117647058824,0.0,1.0
SF-M11,SF-H15,4,3,0,3,4,0,0.0,1.0,1.0,0.0
SF-M11,SF-G9,7,5,3,0,4,5,0.42857142857142855,0.5714285714285714,0.0,1.0
SF-M11,SF-G13,18,23,6,8,12,15,0.3333333333333333,0.6666666666666666,0.34782608695652173,0.6521739130434783
SF-M11,SF-G11,10,20,9,12,1,8,0.9,0.1,0.6,0.4
SF-M11,SF-G12,29,37,12,22,17,15,0.41379310344827586,0.5862068965517241,0.5945945945945946,0.40540540540540543
SF-M11,SF-G10-1,28,29,16,18,12,11,0.5714285714285714,0.42857142857142855,0.6206896551724138,0.3793103448275862
SF-M11,SF-F15,7,10,4,3,3,7,0.5714285714285714,0.42857142857142855,0.3,0.7
SF-M11,SF-F16,13,2,6,1,7,1,0.46153846153846156,0.5384615384615384,0.5,0.5
SF-M11,SF-C21,2,4,0,1,2,3,0.0,1.0,0.25,0.75
SF-M11,SF-B19,2,3,0,0,2,3,0.0,1.0,0.0,1.0
SF-M11,SF-A19,2,1,0,0,2,1,0.0,1.0,0.0,1.0
SF-M11,SF-C26,2,2,1,0,1,2,0.5,0.5,0.0,1.0
SF-M11,SF-C25,4,7,0,1,4,6,0.0,1.0,0.14285714285714285,0.8571428571428571
SF-M11,SF-B25,7,4,0,0,7,4,0.0,1.0,0.0,1.0
SF-M11,SF-E27,1,1,0,0,1,1,0.0,1.0,0.0,1.0
SF-M11,SF-C28-2,1,1,0,1,1,0,0.0,1.0,1.0,0.0
SF-M11,SF-J1,46,115,12,65,34,50,0.2608695652173913,0.7391304347826086,0.5652173913043478,0.43478260869565216
SF-M11,SF-H0,13,19,3,11,10,8,0.23076923076923078,0.7692307692307693,0.5789473684210527,0.42105263157894735
SF-M11,SF-J3,25,18,23,10,2,8,0.92,0.08,0.5555555555555556,0.4444444444444444
SF-M11,SF-J5,20,16,7,3,13,13,0.35,0.65,0.1875,0.8125
SF-M11,SF-G6,3,7,1,4,2,3,0.3333333333333333,0.6666666666666666,0.5714285714285714,0.42857142857142855
SF-M11,SF-G8,6,7,3,5,3,2,0.5,0.5,0.7142857142857143,0.2857142857142857
SF-M11,SF-G5,14,15,7,5,7,10,0.5,0.5,0.3333333333333333,0.6666666666666666
SF-M11,SF-G7,15,16,4,4,11,12,0.26666666666666666,0.7333333333333333,0.25,0.75
SF-M11,SF-F9,8,11,3,3,5,8,0.375,0.625,0.2727272727272727,0.7272727272727273
SF-M11,SF-G26,6,11,0,0,6,11,0.0,1.0,0.0,1.0
SF-M11,SF-K21,20,37,7,18,13,19,0.35,0.65,0.4864864864864865,0.5135135135135135
SF-M11,SF-K22-1,7,11,1,9,6,2,0.14285714285714285,0.8571428571428571,0.8181818181818182,0.18181818181818182
SF-M11,SF-J23-1,24,46,3,29,21,17,0.125,0.875,0.6304347826086957,0.3695652173913043
SF-M11,SF-J22-1,7,19,0,4,7,15,0.0,1.0,0.21052631578947367,0.7894736842105263
SF-M11,SF-J22-2,6,7,1,4,5,3,0.16666666666666666,0.8333333333333334,0.5714285714285714,0.42857142857142855
SF-M11,SF-J21,9,15,1,4,8,11,0.1111111111111111,0.8888888888888888,0.26666666666666666,0.7333333333333333
SF-M11,SF-I22,2,8,0,2,2,6,0.0,1.0,0.25,0.75
SF-M11,SF-I23-2,5,4,2,1,3,3,0.4,0.6,0.25,0.75
SF-M11,SF-I24,2,9,1,7,1,2,0.5,0.5,0.7777777777777778,0.2222222222222222
SF-M11,SF-I23-1,3,4,3,0,0,4,1.0,0.0,0.0,1.0
SF-M11,SF-F26,8,5,2,3,6,2,0.25,0.75,0.6,0.4
SF-M11,SF-M13,63,46,29,15,34,31,0.4603174603174603,0.5396825396825397,0.32608695652173914,0.6739130434782609
SF-M11,SF-M15,93,90,28,28,65,62,0.3010752688172043,0.6989247311827957,0.3111111111111111,0.6888888888888889
SF-M11,SF-L19,19,15,7,8,12,7,0.3684210526315789,0.631578947368421,0.5333333333333333,0.4666666666666667
SF-M11,SF-L20,13,16,4,8,9,8,0.3076923076923077,0.6923076923076923,0.5,0.5
SF-M11,SF-N20-1,14,12,3,1,11,11,0.21428571428571427,0.7857142857142857,0.08333333333333333,0.9166666666666666
SF-M11,SF-M20,18,30,4,4,14,26,0.2222222222222222,0.7777777777777778,0.13333333333333333,0.8666666666666667
SF-M11,SF-K17-2,15,20,5,7,10,13,0.3333333333333333,0.6666666666666666,0.35,0.65
SF-M11,SF-K20,33,21,14,9,19,12,0.42424242424242425,0.5757575757575758,0.42857142857142855,0.5714285714285714
SF-M11,SF-K15-,216,189,134,130,82,59,0.6203703703703703,0.37962962962962965,0.6878306878306878,0.31216931216931215
SF-M11,SF-K19,65,44,31,17,34,27,0.47692307692307695,0.5230769230769231,0.38636363636363635,0.6136363636363636
SF-M11,SF-K18,46,45,20,19,26,26,0.43478260869565216,0.5652173913043478,0.4222222222222222,0.5777777777777777
SF-M11,SF-K17,58,39,31,19,27,20,0.5344827586206896,0.46551724137931033,0.48717948717948717,0.5128205128205128
SF-M11,SF-J16,21,19,12,6,9,13,0.5714285714285714,0.42857142857142855,0.3157894736842105,0.6842105263157895
SF-M11,SF-J18,58,47,26,18,32,29,0.4482758620689655,0.5517241379310345,0.3829787234042553,0.6170212765957447
SF-M11,SF-J20,7,6,1,3,6,3,0.14285714285714285,0.8571428571428571,0.5,0.5
SF-M11,SF-J19,21,10,2,1,19,9,0.09523809523809523,0.9047619047619048,0.1,0.9
SF-M11,SF-O12,2,3,0,0,2,3,0.0,1.0,0.0,1.0
SF-M11,SF-M12,59,33,36,20,23,13,0.6101694915254238,0.3898305084745763,0.6060606060606061,0.3939393939393939
SF-M11,SF-M10,78,81,54,51,24,30,0.6923076923076923,0.3076923076923077,0.6296296296296297,0.37037037037037035
SF-M11,SF-R19,11,8,4,1,7,7,0.36363636363636365,0.6363636363636364,0.125,0.875
SF-M11,SF-R20,5,8,3,0,2,8,0.6,0.4,0.0,1.0
SF-M11,SF-Q21-2,9,3,0,0,9,3,0.0,1.0,0.0,1.0
SF-M11,SF-Q21-1,5,2,3,1,2,1,0.6,0.4,0.5,0.5
SF-M11,SF-P21,13,4,1,0,12,4,0.07692307692307693,0.9230769230769231,0.0,1.0
SF-M11,SF-O18,14,15,4,9,10,6,0.2857142857142857,0.7142857142857143,0.6,0.4
SF-M11,SF-O19,13,13,3,3,10,10,0.23076923076923078,0.7692307692307693,0.23076923076923078,0.7692307692307693
SF-M11,SF-O21,24,23,1,8,23,15,0.041666666666666664,0.9583333333333334,0.34782608695652173,0.6521739130434783
SF-M11,SF-O22,6,9,0,1,6,8,0.0,1.0,0.1111111111111111,0.8888888888888888
SF-M11,SF-N21,13,12,3,2,10,10,0.23076923076923078,0.7692307692307693,0.16666666666666666,0.8333333333333334
SF-M11,SF-N20-2,5,5,1,3,4,2,0.2,0.8,0.6,0.4
SF-M11,SF-M21,10,8,2,1,8,7,0.2,0.8,0.125,0.875
SF-M11,SF-L21,21,23,1,8,20,15,0.047619047619047616,0.9523809523809523,0.34782608695652173,0.6521739130434783
SF-M11,SF-O30,3,3,1,0,2,3,0.3333333333333333,0.6666666666666666,0.0,1.0
SF-M11,SF-N27,5,3,0,0,5,3,0.0,1.0,0.0,1.0
SF-M11,SF-N29,1,1,0,0,1,1,0.0,1.0,0.0,1.0
SF-M11,SF-N28,2,1,0,0,2,1,0.0,1.0,0.0,1.0
SF-M11,SF-L30-1,4,10,0,4,4,6,0.0,1.0,0.4,0.6
SF-M11,SF-L29,2,11,0,4,2,7,0.0,1.0,0.36363636363636365,0.6363636363636364
SF-M11,SF-I30-2,2,2,1,0,1,2,0.5,0.5,0.0,1.0
SF-M11,SF-S24,4,5,1,0,3,5,0.25,0.75,0.0,1.0
SF-M11,SF-R24,3,2,0,1,3,1,0.0,1.0,0.5,0.5
SF-M11,SF-Q26,4,1,0,0,4,1,0.0,1.0,0.0,1.0
SF-M11,SF-P26,3,5,0,0,3,5,0.0,1.0,0.0,1.0
SF-M11,SF-O25-2,1,1,1,0,0,1,1.0,0.0,0.0,1.0
SF-M11,SF-T22,3,2,0,0,3,2,0.0,1.0,0.0,1.0
SF-M11,SF-S22-1,5,2,2,0,3,2,0.4,0.6,0.0,1.0
SF-M11,SF-Q23-3,4,4,0,1,4,3,0.0,1.0,0.25,0.75
SF-M11,SF-Q22-1,6,5,3,3,3,2,0.5,0.5,0.6,0.4
SF-M11,SF-Q22-2,8,3,2,3,6,0,0.25,0.75,1.0,0.0
SF-M11,SF-P22,1,3,0,2,1,1,0.0,1.0,0.6666666666666666,0.3333333333333333
SF-M11,SF-W19,3,1,0,1,3,0,0.0,1.0,1.0,0.0
SF-M11,SF-W14,1,2,0,0,1,2,0.0,1.0,0.0,1.0
SF-M11,SF-Z6,2,3,1,3,1,0,0.5,0.5,1.0,0.0
SF-R19,SF-M25,8,4,1,0,7,4,0.125,0.875,0.0,1.0
SF-R19,SF-L27,4,2,0,0,4,2,0.0,1.0,0.0,1.0
SF-R19,SF-K26,3,2,0,1,3,1,0.0,1.0,0.5,0.5
SF-R19,SF-M30,15,42,0,3,15,39,0.0,1.0,0.07142857142857142,0.9285714285714286
SF-R19,SF-J29,7,4,1,2,6,2,0.14285714285714285,0.8571428571428571,0.5,0.5
SF-R19,SF-L26,5,33,0,6,5,27,0.0,1.0,0.18181818181818182,0.8181818181818182
SF-R19,SF-M28,3,3,0,2,3,1,0.0,1.0,0.6666666666666666,0.3333333333333333
SF-R19,SF-M27,1,1,0,0,1,1,0.0,1.0,0.0,1.0
SF-R19,SF-L25,1,6,0,2,1,4,0.0,1.0,0.3333333333333333,0.6666666666666666
SF-R19,SF-M24,4,8,0,1,4,7,0.0,1.0,0.125,0.875
SF-R19,SF-L24,5,4,0,0,5,4,0.0,1.0,0.0,1.0
SF-R19,SF-N23,4,4,0,1,4,3,0.0,1.0,0.25,0.75
SF-R19,SF-N24-2,2,5,0,0,2,5,0.0,1.0,0.0,1.0
SF-R19,SF-J26-2,3,6,0,1,3,5,0.0,1.0,0.16666666666666666,0.8333333333333334
SF-R19,SF-L28,1,1,0,0,1,1,0.0,1.0,0.0,1.0
SF-R19,SF-K29-1,1,5,0,3,1,2,0.0,1.0,0.6,0.4
SF-R19,SF-J28-2,1,1,0,0,1,1,0.0,1.0,0.0,1.0
SF-R19,SF-K25,5,25,0,5,5,20,0.0,1.0,0.2,0.8
SF-R19,SF-J25,6,5,2,0,4,5,0.3333333333333333,0.6666666666666666,0.0,1.0
SF-R19,SF-H26-2,6,2,0,0,6,2,0.0,1.0,0.0,1.0
SF-R19,SF-P24,5,14,3,8,2,6,0.6,0.4,0.5714285714285714,0.42857142857142855
SF-R19,SF-J24,5,1,2,0,3,1,0.4,0.6,0.0,1.0
SF-R19,SF-O24,3,3,2,2,1,1,0.6666666666666666,0.3333333333333333,0.6666666666666666,0.3333333333333333
SF-R19,SF-I25,8,18,0,3,8,15,0.0,1.0,0.16666666666666666,0.8333333333333334
SF-R19,SF-K23,1,2,1,0,0,2,1.0,0.0,0.0,1.0
SF-R19,SF-H26,7,27,2,22,5,5,0.2857142857142857,0.7142857142857143,0.8148148148148148,0.18518518518518517
SF-R19,SF-O23,2,12,0,6,2,6,0.0,1.0,0.5,0.5
SF-R19,SF-F28-2,32,23,1,0,31,23,0.03125,0.96875,0.0,1.0
SF-R19,SF-G27,11,9,3,1,8,8,0.2727272727272727,0.7272727272727273,0.1111111111111111,0.8888888888888888
SF-R19,SF-M22-2,12,15,2,4,10,11,0.16666666666666666,0.8333333333333334,0.26666666666666666,0.7333333333333333
SF-R19,SF-L22,23,23,4,4,19,19,0.17391304347826086,0.8260869565217391,0.17391304347826086,0.8260869565217391
SF-R19,SF-F27,3,2,0,1,3,1,0.0,1.0,0.5,0.5
SF-R19,SF-N22-2,15,26,0,12,15,14,0.0,1.0,0.46153846153846156,0.5384615384615384
SF-R19,SF-M22-1,6,3,1,0,5,3,0.16666666666666666,0.8333333333333334,0.0,1.0
SF-R19,SF-K22-2,16,13,3,3,13,10,0.1875,0.8125,0.23076923076923078,0.7692307692307693
SF-R19,SF-K24,3,2,1,0,2,2,0.3333333333333333,0.6666666666666666,0.0,1.0
SF-R19,SF-J23-2,7,14,4,4,3,10,0.5714285714285714,0.42857142857142855,0.2857142857142857,0.7142857142857143
SF-R19,SF-G24,3,1,0,0,3,1,0.0,1.0,0.0,1.0
SF-R19,SF-F23,2,3,1,1,1,2,0.5,0.5,0.3333333333333333,0.6666666666666666
SF-R19,SF-E23,3,7,1,0,2,7,0.3333333333333333,0.6666666666666666,0.0,1.0
SF-R19,SF-D24,2,1,0,0,2,1,0.0,1.0,0.0,1.0
SF-R19,SF-C22,2,3,2,2,0,1,1.0,0.0,0.6666666666666666,0.3333333333333333
SF-R19,SF-J17,4,2,0,0,4,2,0.0,1.0,0.0,1.0
SF-R19,SF-I19,1,2,0,0,1,2,0.0,1.0,0.0,1.0
SF-R19,SF-H16,7,1,0,0,7,1,0.0,1.0,0.0,1.0
SF-R19,SF-G19,2,1,0,0,2,1,0.0,1.0,0.0,1.0
SF-R19,SF-G18,5,5,0,0,5,5,0.0,1.0,0.0,1.0
SF-R19,SF-F19,5,10,0,0,5,10,0.0,1.0,0.0,1.0
SF-R19,SF-E18,1,4,0,0,1,4,0.0,1.0,0.0,1.0
SF-R19,SF-G30-2,2,6,0,2,2,4,0.0,1.0,0.3333333333333333,0.6666666666666666
SF-R19,SF-F30-1,3,4,0,0,3,4,0.0,1.0,0.0,1.0
SF-R19,SF-E29-2,2,13,1,4,1,9,0.5,0.5,0.3076923076923077,0.6923076923076923
SF-R19,SF-E29-1,2,4,0,2,2,2,0.0,1.0,0.5,0.5
SF-R19,SF-F29,2,1,1,0,1,1,0.5,0.5,0.0,1.0
SF-R19,SF-E29-3,2,3,1,1,1,2,0.5,0.5,0.3333333333333333,0.6666666666666666
SF-R19,SF-F28-1,1,6,0,2,1,4,0.0,1.0,0.3333333333333333,0.6666666666666666
SF-R19,SF-E28-2,1,9,0,5,1,4,0.0,1.0,0.5555555555555556,0.4444444444444444
SF-R19,SF-J10,4,3,0,0,4,3,0.0,1.0,0.0,1.0
SF-R19,SF-J12,2,5,0,0,2,5,0.0,1.0,0.0,1.0
SF-R19,SF-J13,1,1,0,0,1,1,0.0,1.0,0.0,1.0
SF-R19,SF-H12,1,34,0,2,1,32,0.0,1.0,0.058823529411764705,0.9411764705882353
SF-R19,SF-G10-2,3,2,0,0,3,2,0.0,1.0,0.0,1.0
SF-R19,SF-G9,2,2,0,0,2,2,0.0,1.0,0.0,1.0
SF-R19,SF-G13,3,2,0,1,3,1,0.0,1.0,0.5,0.5
SF-R19,SF-G11,1,1,0,0,1,1,0.0,1.0,0.0,1.0
SF-R19,SF-G10-1,1,1,0,0,1,1,0.0,1.0,0.0,1.0
SF-R19,SF-F15,2,1,0,0,2,1,0.0,1.0,0.0,1.0
SF-R19,SF-B21,2,1,0,0,2,1,0.0,1.0,0.0,1.0
SF-R19,SF-A19,1,3,0,0,1,3,0.0,1.0,0.0,1.0
SF-R19,SF-C26,2,3,1,1,1,2,0.5,0.5,0.3333333333333333,0.6666666666666666
SF-R19,SF-C25,2,8,0,5,2,3,0.0,1.0,0.625,0.375
SF-R19,SF-B25,1,2,0,0,1,2,0.0,1.0,0.0,1.0
SF-R19,SF-E27,2,2,0,0,2,2,0.0,1.0,0.0,1.0
SF-R19,SF-D27,1,1,0,0,1,1,0.0,1.0,0.0,1.0
SF-R19,SF-C28-2,1,2,1,0,0,2,1.0,0.0,0.0,1.0
SF-R19,SF-J1,1,8,0,4,1,4,0.0,1.0,0.5,0.5
SF-R19,SF-H0,1,2,0,1,1,1,0.0,1.0,0.5,0.5
SF-R19,SF-G5,2,2,0,0,2,2,0.0,1.0,0.0,1.0
SF-R19,SF-G7,5,7,4,2,1,5,0.8,0.2,0.2857142857142857,0.7142857142857143
SF-R19,SF-G26,17,1,13,0,4,1,0.7647058823529411,0.23529411764705882,0.0,1.0
SF-R19,SF-K21,2,7,0,1,2,6,0.0,1.0,0.14285714285714285,0.8571428571428571
SF-R19,SF-K22-1,10,5,0,2,10,3,0.0,1.0,0.4,0.6
SF-R19,SF-J23-1,11,9,0,4,11,5,0.0,1.0,0.4444444444444444,0.5555555555555556
SF-R19,SF-J22-1,7,11,0,4,7,7,0.0,1.0,0.36363636363636365,0.6363636363636364
SF-R19,SF-J22-2,10,3,0,0,10,3,0.0,1.0,0.0,1.0
SF-R19,SF-J21,10,7,0,1,10,6,0.0,1.0,0.14285714285714285,0.8571428571428571
SF-R19,SF-I21,1,1,0,0,1,1,0.0,1.0,0.0,1.0
SF-R19,SF-I23-2,24,22,24,22,0,0,1.0,0.0,1.0,0.0
SF-R19,SF-I24,1,3,0,0,1,3,0.0,1.0,0.0,1.0
SF-R19,SF-I23-1,1,24,0,0,1,24,0.0,1.0,0.0,1.0
SF-R19,SF-F26,12,4,4,0,8,4,0.3333333333333333,0.6666666666666666,0.0,1.0
SF-R19,SF-M13,6,9,0,0,6,9,0.0,1.0,0.0,1.0
SF-R19,SF-M15,21,10,1,0,20,10,0.047619047619047616,0.9523809523809523,0.0,1.0
SF-R19,SF-L19,7,13,1,3,6,10,0.14285714285714285,0.8571428571428571,0.23076923076923078,0.7692307692307693
SF-R19,SF-L20,8,6,1,1,7,5,0.125,0.875,0.16666666666666666,0.8333333333333334
SF-R19,SF-N20-1,5,3,0,1,5,2,0.0,1.0,0.3333333333333333,0.6666666666666666
SF-R19,SF-M20,24,19,0,1,24,18,0.0,1.0,0.05263157894736842,0.9473684210526315
SF-R19,SF-K20,9,7,0,1,9,6,0.0,1.0,0.14285714285714285,0.8571428571428571
SF-R19,SF-K15-,19,10,1,2,18,8,0.05263157894736842,0.9473684210526315,0.2,0.8
SF-R19,SF-K19,8,5,2,3,6,2,0.25,0.75,0.6,0.4
SF-R19,SF-K18,9,3,2,0,7,3,0.2222222222222222,0.7777777777777778,0.0,1.0
SF-R19,SF-K17,3,4,0,1,3,3,0.0,1.0,0.25,0.75
SF-R19,SF-J18,17,8,0,1,17,7,0.0,1.0,0.125,0.875
SF-R19,SF-J20,10,3,1,0,9,3,0.1,0.9,0.0,1.0
SF-R19,SF-J19,3,5,0,0,3,5,0.0,1.0,0.0,1.0
SF-R19,SF-M12,6,3,0,1,6,2,0.0,1.0,0.3333333333333333,0.6666666666666666
SF-R19,SF-M11,8,11,1,4,7,7,0.125,0.875,0.36363636363636365,0.6363636363636364
SF-R19,SF-R20,41,89,16,62,25,27,0.3902439024390244,0.6097560975609756,0.6966292134831461,0.30337078651685395
SF-R19,SF-Q21-2,55,40,19,25,36,15,0.34545454545454546,0.6545454545454545,0.625,0.375
SF-R19,SF-Q21-1,12,20,3,12,9,8,0.25,0.75,0.6,0.4
SF-R19,SF-P21,26,29,0,9,26,20,0.0,1.0,0.3103448275862069,0.6896551724137931
SF-R19,SF-O18,9,16,2,4,7,12,0.2222222222222222,0.7777777777777778,0.25,0.75
SF-R19,SF-O19,12,9,2,0,10,9,0.16666666666666666,0.8333333333333334,0.0,1.0
SF-R19,SF-O21,8,19,0,6,8,13,0.0,1.0,0.3157894736842105,0.6842105263157895
SF-R19,SF-O22,31,28,7,17,24,11,0.22580645161290322,0.7741935483870968,0.6071428571428571,0.39285714285714285
SF-R19,SF-N21,3,2,1,0,2,2,0.3333333333333333,0.6666666666666666,0.0,1.0
SF-R19,SF-N20-2,4,5,0,2,4,3,0.0,1.0,0.4,0.6
SF-R19,SF-M21,7,6,1,1,6,5,0.14285714285714285,0.8571428571428571,0.16666666666666666,0.8333333333333334
SF-R19,SF-L21,16,8,4,2,12,6,0.25,0.75,0.25,0.75
SF-R19,SF-S29,3,2,0,0,3,2,0.0,1.0,0.0,1.0
SF-R19,SF-S30,1,2,0,1,1,1,0.0,1.0,0.5,0.5
SF-R19,SF-P30,5,10,1,1,4,9,0.2,0.8,0.1,0.9
SF-R19,SF-O30-2,1,5,0,3,1,2,0.0,1.0,0.6,0.4
SF-R19,SF-O30,5,2,2,0,3,2,0.4,0.6,0.0,1.0
SF-R19,SF-N27,4,8,0,0,4,8,0.0,1.0,0.0,1.0
SF-R19,SF-N29,1,24,0,2,1,22,0.0,1.0,0.08333333333333333,0.9166666666666666
SF-R19,SF-N28,9,4,0,3,9,1,0.0,1.0,0.75,0.25
SF-R19,SF-L30-1,2,3,0,1,2,2,0.0,1.0,0.3333333333333333,0.6666666666666666
SF-R19,SF-I29-2,3,4,0,1,3,3,0.0,1.0,0.25,0.75
SF-R19,SF-I27,2,4,0,2,2,2,0.0,1.0,0.5,0.5
SF-R19,SF-H28,2,2,0,1,2,1,0.0,1.0,0.5,0.5
SF-R19,SF-S24,5,20,1,9,4,11,0.2,0.8,0.45,0.55
SF-R19,SF-R24,9,20,2,6,7,14,0.2222222222222222,0.7777777777777778,0.3,0.7
SF-R19,SF-Q26,5,1,0,0,5,1,0.0,1.0,0.0,1.0
SF-R19,SF-P26,5,19,0,2,5,17,0.0,1.0,0.10526315789473684,0.8947368421052632
SF-R19,SF-O25-2,3,11,2,5,1,6,0.6666666666666666,0.3333333333333333,0.45454545454545453,0.5454545454545454
SF-R19,SF-N22-1B,2,2,0,1,2,1,0.0,1.0,0.5,0.5
SF-R19,SF-N26,2,2,0,0,2,2,0.0,1.0,0.0,1.0
SF-R19,SF-N25,1,2,1,0,0,2,1.0,0.0,0.0,1.0
SF-R19,SF-T21,11,17,3,11,8,6,0.2727272727272727,0.7272727272727273,0.6470588235294118,0.35294117647058826
SF-R19,SF-T22,31,21,10,6,21,15,0.3225806451612903,0.6774193548387096,0.2857142857142857,0.7142857142857143
SF-R19,SF-S22-2,5,8,0,3,5,5,0.0,1.0,0.375,0.625
SF-R19,SF-S22-1,12,5,3,0,9,5,0.25,0.75,0.0,1.0
SF-R19,SF-Q23-3,26,44,10,16,16,28,0.38461538461538464,0.6153846153846154,0.36363636363636365,0.6363636363636364
SF-R19,SF-Q22-1,26,7,7,6,19,1,0.2692307692307692,0.7307692307692307,0.8571428571428571,0.14285714285714285
SF-R19,SF-Q22-2,23,14,5,8,18,6,0.21739130434782608,0.782608695652174,0.5714285714285714,0.42857142857142855
SF-R19,SF-P22,28,33,8,10,20,23,0.2857142857142857,0.7142857142857143,0.30303030303030304,0.696969696969697
SF-R19,SF-W19,13,11,0,2,13,9,0.0,1.0,0.18181818181818182,0.8181818181818182
SF-R19,SF-W19-2,6,2,2,0,4,2,0.3333333333333333,0.6666666666666666,0.0,1.0
SF-R19,SF-U21,13,13,4,2,9,11,0.3076923076923077,0.6923076923076923,0.15384615384615385,0.8461538461538461
SF-R19,SF-T20,39,26,10,13,29,13,0.2564102564102564,0.7435897435897436,0.5,0.5
SF-R19,SF-S21,7,6,3,3,4,3,0.42857142857142855,0.5714285714285714,0.5,0.5
SF-R19,SF-AA15,1,1,0,0,1,1,0.0,1.0,0.0,1.0
SF-R19,SF-X19,1,4,0,2,1,2,0.0,1.0,0.5,0.5
SF-R20,SF-M25,3,1,0,0,3,1,0.0,1.0,0.0,1.0
SF-R20,SF-K26,2,4,0,1,2,3,0.0,1.0,0.25,0.75
SF-R20,SF-J27,2,2,0,0,2,2,0.0,1.0,0.0,1.0
SF-R20,SF-J29,1,1,0,1,1,0,0.0,1.0,1.0,0.0
SF-R20,SF-M24,3,4,0,0,3,4,0.0,1.0,0.0,1.0
SF-R20,SF-L24,4,2,1,0,3,2,0.25,0.75,0.0,1.0
SF-R20,SF-N23,2,4,0,1,2,3,0.0,1.0,0.25,0.75
SF-R20,SF-K27-2,2,4,0,0,2,4,0.0,1.0,0.0,1.0
SF-R20,SF-K28,1,3,0,0,1,3,0.0,1.0,0.0,1.0
SF-R20,SF-K25,2,1,0,0,2,1,0.0,1.0,0.0,1.0
SF-R20,SF-J25,1,4,0,3,1,1,0.0,1.0,0.75,0.25
SF-R20,SF-P24,5,6,1,3,4,3,0.2,0.8,0.5,0.5
SF-R20,SF-I25,5,2,0,0,5,2,0.0,1.0,0.0,1.0
SF-R20,SF-H26,1,10,0,4,1,6,0.0,1.0,0.4,0.6
SF-R20,SF-O23,9,21,0,7,9,14,0.0,1.0,0.3333333333333333,0.6666666666666666
SF-R20,SF-F28-2,2,7,0,1,2,6,0.0,1.0,0.14285714285714285,0.8571428571428571
SF-R20,SF-G27,7,6,2,1,5,5,0.2857142857142857,0.7142857142857143,0.16666666666666666,0.8333333333333334
SF-R20,SF-M22-2,6,15,2,7,4,8,0.3333333333333333,0.6666666666666666,0.4666666666666667,0.5333333333333333
SF-R20,SF-L22,13,17,4,7,9,10,0.3076923076923077,0.6923076923076923,0.4117647058823529,0.5882352941176471
SF-R20,SF-F27,1,2,0,0,1,2,0.0,1.0,0.0,1.0
SF-R20,SF-N22-2,14,18,1,7,13,11,0.07142857142857142,0.9285714285714286,0.3888888888888889,0.6111111111111112
SF-R20,SF-K22-2,8,11,1,2,7,9,0.125,0.875,0.18181818181818182,0.8181818181818182
SF-R20,SF-K24,3,2,1,1,2,1,0.3333333333333333,0.6666666666666666,0.5,0.5
SF-R20,SF-J23-2,3,4,1,1,2,3,0.3333333333333333,0.6666666666666666,0.25,0.75
SF-R20,SF-G24,7,5,0,1,7,4,0.0,1.0,0.2,0.8
SF-R20,SF-G25,2,3,0,0,2,3,0.0,1.0,0.0,1.0
SF-R20,SF-F23,1,5,0,1,1,4,0.0,1.0,0.2,0.8
SF-R20,SF-E23,5,16,0,0,5,16,0.0,1.0,0.0,1.0
SF-R20,SF-D24,1,1,0,1,1,0,0.0,1.0,1.0,0.0
SF-R20,SF-J17,4,1,0,0,4,1,0.0,1.0,0.0,1.0
SF-R20,SF-H16,3,2,0,0,3,2,0.0,1.0,0.0,1.0
SF-R20,SF-G19,5,2,0,0,5,2,0.0,1.0,0.0,1.0
SF-R20,SF-G18,3,1,0,0,3,1,0.0,1.0,0.0,1.0
SF-R20,SF-G20,3,3,1,0,2,3,0.3333333333333333,0.6666666666666666,0.0,1.0
SF-R20,SF-E18,1,2,0,0,1,2,0.0,1.0,0.0,1.0
SF-R20,SF-G30-2,2,2,0,1,2,1,0.0,1.0,0.5,0.5
SF-R20,SF-E29-2,1,6,0,4,1,2,0.0,1.0,0.6666666666666666,0.3333333333333333
SF-R20,SF-G29-3,1,1,1,0,0,1,1.0,0.0,0.0,1.0
SF-R20,SF-J10,1,3,0,0,1,3,0.0,1.0,0.0,1.0
SF-R20,SF-J12,2,3,0,0,2,3,0.0,1.0,0.0,1.0
SF-R20,SF-J13,1,2,0,0,1,2,0.0,1.0,0.0,1.0
SF-R20,SF-J15,5,1,0,0,5,1,0.0,1.0,0.0,1.0
SF-R20,SF-J14,2,1,0,0,2,1,0.0,1.0,0.0,1.0
SF-R20,SF-H13,1,1,0,0,1,1,0.0,1.0,0.0,1.0
SF-R20,SF-G10-2,1,8,0,0,1,8,0.0,1.0,0.0,1.0
SF-R20,SF-G9,1,1,0,0,1,1,0.0,1.0,0.0,1.0
SF-R20,SF-B19,1,3,0,0,1,3,0.0,1.0,0.0,1.0
SF-R20,SF-C25,3,4,0,0,3,4,0.0,1.0,0.0,1.0
SF-R20,SF-E27,5,1,0,0,5,1,0.0,1.0,0.0,1.0
SF-R20,SF-D27,36,16,6,3,30,13,0.16666666666666666,0.8333333333333334,0.1875,0.8125
SF-R20,SF-J1,2,2,0,1,2,1,0.0,1.0,0.5,0.5
SF-R20,SF-G7,1,2,0,0,1,2,0.0,1.0,0.0,1.0
SF-R20,SF-G26,28,55,7,1,21,54,0.25,0.75,0.01818181818181818,0.9818181818181818
SF-R20,SF-K21,2,3,0,0,2,3,0.0,1.0,0.0,1.0
SF-R20,SF-K22-1,3,9,1,3,2,6,0.3333333333333333,0.6666666666666666,0.3333333333333333,0.6666666666666666
SF-R20,SF-J23-1,6,14,0,1,6,13,0.0,1.0,0.07142857142857142,0.9285714285714286
SF-R20,SF-J22-1,2,12,0,2,2,10,0.0,1.0,0.16666666666666666,0.8333333333333334
SF-R20,SF-J22-2,1,1,0,0,1,1,0.0,1.0,0.0,1.0
SF-R20,SF-J21,1,5,0,2,1,3,0.0,1.0,0.4,0.6
SF-R20,SF-I21,2,2,1,0,1,2,0.5,0.5,0.0,1.0
SF-R20,SF-F26,5,4,0,1,5,3,0.0,1.0,0.25,0.75
SF-R20,SF-M13,3,2,0,0,3,2,0.0,1.0,0.0,1.0
SF-R20,SF-M15,6,4,0,0,6,4,0.0,1.0,0.0,1.0
SF-R20,SF-L19,3,6,0,2,3,4,0.0,1.0,0.3333333333333333,0.6666666666666666
SF-R20,SF-L20,3,4,0,1,3,3,0.0,1.0,0.25,0.75
SF-R20,SF-N20-1,19,20,2,1,17,19,0.10526315789473684,0.8947368421052632,0.05,0.95
SF-R20,SF-M20,4,9,1,1,3,8,0.25,0.75,0.1111111111111111,0.8888888888888888
SF-R20,SF-K17-2,2,2,0,0,2,2,0.0,1.0,0.0,1.0
SF-R20,SF-K20,3,1,0,0,3,1,0.0,1.0,0.0,1.0
SF-R20,SF-K15-,4,4,0,0,4,4,0.0,1.0,0.0,1.0
SF-R20,SF-K19,7,5,1,0,6,5,0.14285714285714285,0.8571428571428571,0.0,1.0
SF-R20,SF-K18,6,7,0,0,6,7,0.0,1.0,0.0,1.0
SF-R20,SF-K17,4,2,0,0,4,2,0.0,1.0,0.0,1.0
SF-R20,SF-J16,4,1,0,1,4,0,0.0,1.0,1.0,0.0
SF-R20,SF-J18,19,12,0,0,19,12,0.0,1.0,0.0,1.0
SF-R20,SF-J19,2,4,0,0,2,4,0.0,1.0,0.0,1.0
SF-R20,SF-M12,1,3,0,1,1,2,0.0,1.0,0.3333333333333333,0.6666666666666666
SF-R20,SF-M11,8,5,0,3,8,2,0.0,1.0,0.6,0.4
SF-R20,SF-R19,89,41,62,16,27,25,0.6966292134831461,0.30337078651685395,0.3902439024390244,0.6097560975609756
SF-R20,SF-Q21-2,34,34,20,21,14,13,0.5882352941176471,0.4117647058823529,0.6176470588235294,0.38235294117647056
SF-R20,SF-Q21-1,5,23,1,18,4,5,0.2,0.8,0.782608695652174,0.21739130434782608
SF-R20,SF-P21,3,14,0,5,3,9,0.0,1.0,0.35714285714285715,0.6428571428571429
SF-R20,SF-O18,7,8,0,1,7,7,0.0,1.0,0.125,0.875
SF-R20,SF-O19,6,13,0,2,6,11,0.0,1.0,0.15384615384615385,0.8461538461538461
SF-R20,SF-O21,7,10,0,6,7,4,0.0,1.0,0.6,0.4
SF-R20,SF-O22,26,14,2,9,24,5,0.07692307692307693,0.9230769230769231,0.6428571428571429,0.35714285714285715
SF-R20,SF-N21,3,2,0,0,3,2,0.0,1.0,0.0,1.0
SF-R20,SF-N20-2,1,1,0,0,1,1,0.0,1.0,0.0,1.0
SF-R20,SF-M21,27,16,4,3,23,13,0.14814814814814814,0.8518518518518519,0.1875,0.8125
SF-R20,SF-L21,7,6,0,1,7,5,0.0,1.0,0.16666666666666666,0.8333333333333334
SF-R20,SF-P30,3,5,1,0,2,5,0.3333333333333333,0.6666666666666666,0.0,1.0
SF-R20,SF-O30,2,1,2,0,0,1,1.0,0.0,0.0,1.0
SF-R20,SF-N27,1,2,0,0,1,2,0.0,1.0,0.0,1.0
SF-R20,SF-N28,1,2,1,1,0,1,1.0,0.0,0.5,0.5
SF-R20,SF-H28,1,1,0,1,1,0,0.0,1.0,1.0,0.0
SF-R20,SF-S24,9,12,2,8,7,4,0.2222222222222222,0.7777777777777778,0.6666666666666666,0.3333333333333333
SF-R20,SF-R24,7,2,3,2,4,0,0.42857142857142855,0.5714285714285714,1.0,0.0
SF-R20,SF-Q26,1,2,0,1,1,1,0.0,1.0,0.5,0.5
SF-R20,SF-P26,3,8,0,1,3,7,0.0,1.0,0.125,0.875
SF-R20,SF-O25-2,1,5,0,2,1,3,0.0,1.0,0.4,0.6
SF-R20,SF-N22-1B,6,4,2,3,4,1,0.3333333333333333,0.6666666666666666,0.75,0.25
SF-R20,SF-T21,5,22,2,18,3,4,0.4,0.6,0.8181818181818182,0.18181818181818182
SF-R20,SF-T22,24,24,4,10,20,14,0.16666666666666666,0.8333333333333334,0.4166666666666667,0.5833333333333334
SF-R20,SF-S22-2,4,5,2,1,2,4,0.5,0.5,0.2,0.8
SF-R20,SF-S22-1,4,11,2,6,2,5,0.5,0.5,0.5454545454545454,0.45454545454545453
SF-R20,SF-Q23-3,9,21,1,14,8,7,0.1111111111111111,0.8888888888888888,0.6666666666666666,0.3333333333333333
SF-R20,SF-Q22-1,9,15,3,8,6,7,0.3333333333333333,0.6666666666666666,0.5333333333333333,0.4666666666666667
SF-R20,SF-Q22-2,5,10,1,8,4,2,0.2,0.8,0.8,0.2
SF-R20,SF-P22,5,26,0,13,5,13,0.0,1.0,0.5,0.5
SF-R20,SF-W19,7,5,0,1,7,4,0.0,1.0,0.2,0.8
SF-R20,SF-W19-2,4,5,0,1,4,4,0.0,1.0,0.2,0.8
SF-R20,SF-U21,7,13,3,2,4,11,0.42857142857142855,0.5714285714285714,0.15384615384615385,0.8461538461538461
SF-R20,SF-T20,36,43,20,27,16,16,0.5555555555555556,0.4444444444444444,0.627906976744186,0.37209302325581395
SF-R20,SF-S21,6,10,3,8,3,2,0.5,0.5,0.8,0.2
SF-Q21-2,SF-M25,5,5,0,1,5,4,0.0,1.0,0.2,0.8
SF-Q21-2,SF-M26-2,5,3,1,1,4,2,0.2,0.8,0.3333333333333333,0.6666666666666666
SF-Q21-2,SF-L27,1,2,1,1,0,1,1.0,0.0,0.5,0.5
SF-Q21-2,SF-K26,3,2,0,1,3,1,0.0,1.0,0.5,0.5
SF-Q21-2,SF-J27,2,2,0,0,2,2,0.0,1.0,0.0,1.0
SF-Q21-2,SF-M30,46,23,0,1,46,22,0.0,1.0,0.043478260869565216,0.9565217391304348
SF-Q21-2,SF-J29,1,2,0,0,1,2,0.0,1.0,0.0,1.0
SF-Q21-2,SF-L26,17,13,0,1,17,12,0.0,1.0,0.07692307692307693,0.9230769230769231
SF-Q21-2,SF-M28,19,1,0,0,19,1,0.0,1.0,0.0,1.0
SF-Q21-2,SF-L25,3,3,0,2,3,1,0.0,1.0,0.6666666666666666,0.3333333333333333
SF-Q21-2,SF-M24,5,3,1,0,4,3,0.2,0.8,0.0,1.0
SF-Q21-2,SF-L24,3,5,0,1,3,4,0.0,1.0,0.2,0.8
SF-Q21-2,SF-N23,4,11,1,4,3,7,0.25,0.75,0.36363636363636365,0.6363636363636364
SF-Q21-2,SF-N24-2,2,2,0,1,2,1,0.0,1.0,0.5,0.5
SF-Q21-2,SF-K27-2,5,14,0,1,5,13,0.0,1.0,0.07142857142857142,0.9285714285714286
SF-Q21-2,SF-L28,13,14,0,0,13,14,0.0,1.0,0.0,1.0
SF-Q21-2,SF-K29-1,2,1,1,0,1,1,0.5,0.5,0.0,1.0
SF-Q21-2,SF-K27,2,3,0,0,2,3,0.0,1.0,0.0,1.0
SF-Q21-2,SF-K25,8,13,0,3,8,10,0.0,1.0,0.23076923076923078,0.7692307692307693
SF-Q21-2,SF-J25,5,3,0,1,5,2,0.0,1.0,0.3333333333333333,0.6666666666666666
SF-Q21-2,SF-H26-2,3,2,0,1,3,1,0.0,1.0,0.5,0.5
SF-Q21-2,SF-P24,16,8,9,4,7,4,0.5625,0.4375,0.5,0.5
SF-Q21-2,SF-J24,3,2,0,1,3,1,0.0,1.0,0.5,0.5
SF-Q21-2,SF-O24,10,12,0,6,10,6,0.0,1.0,0.5,0.5
SF-Q21-2,SF-J26,1,1,0,0,1,1,0.0,1.0,0.0,1.0
SF-Q21-2,SF-I25,7,7,2,0,5,7,0.2857142857142857,0.7142857142857143,0.0,1.0
SF-Q21-2,SF-H26,6,12,1,7,5,5,0.16666666666666666,0.8333333333333334,0.5833333333333334,0.4166666666666667
SF-Q21-2,SF-O23,7,13,0,3,7,10,0.0,1.0,0.23076923076923078,0.7692307692307693
SF-Q21-2,SF-F28-2,12,18,1,1,11,17,0.08333333333333333,0.9166666666666666,0.05555555555555555,0.9444444444444444
SF-Q21-2,SF-G27,9,6,0,1,9,5,0.0,1.0,0.16666666666666666,0.8333333333333334
SF-Q21-2,SF-M22-2,19,26,1,10,18,16,0.05263157894736842,0.9473684210526315,0.38461538461538464,0.6153846153846154
SF-Q21-2,SF-L22,13,24,0,12,13,12,0.0,1.0,0.5,0.5
SF-Q21-2,SF-F27,5,9,0,3,5,6,0.0,1.0,0.3333333333333333,0.6666666666666666
SF-Q21-2,SF-N22-2,34,48,4,16,30,32,0.11764705882352941,0.8823529411764706,0.3333333333333333,0.6666666666666666
SF-Q21-2,SF-G28-1,1,1,0,0,1,1,0.0,1.0,0.0,1.0
SF-Q21-2,SF-M22-1,2,7,0,5,2,2,0.0,1.0,0.7142857142857143,0.2857142857142857
SF-Q21-2,SF-O25-1,7,7,4,6,3,1,0.5714285714285714,0.42857142857142855,0.8571428571428571,0.14285714285714285
SF-Q21-2,SF-K22-2,26,27,1,9,25,18,0.038461538461538464,0.9615384615384616,0.3333333333333333,0.6666666666666666
SF-Q21-2,SF-K24,7,1,2,0,5,1,0.2857142857142857,0.7142857142857143,0.0,1.0
SF-Q21-2,SF-J23-2,15,17,1,6,14,11,0.06666666666666667,0.9333333333333333,0.35294117647058826,0.6470588235294118
SF-Q21-2,SF-G23,7,2,0,1,7,1,0.0,1.0,0.5,0.5
SF-Q21-2,SF-G24,2,8,0,5,2,3,0.0,1.0,0.625,0.375
SF-Q21-2,SF-G25,1,8,0,0,1,8,0.0,1.0,0.0,1.0
SF-Q21-2,SF-F23,5,7,2,0,3,7,0.4,0.6,0.0,1.0
SF-Q21-2,SF-E23,19,13,0,0,19,13,0.0,1.0,0.0,1.0
SF-Q21-2,SF-D24,3,2,0,0,3,2,0.0,1.0,0.0,1.0
SF-Q21-2,SF-I19,1,2,0,0,1,2,0.0,1.0,0.0,1.0
SF-Q21-2,SF-H16,1,1,0,0,1,1,0.0,1.0,0.0,1.0
SF-Q21-2,SF-H20,1,1,1,0,0,1,1.0,0.0,0.0,1.0
SF-Q21-2,SF-G19,2,1,0,0,2,1,0.0,1.0,0.0,1.0
SF-Q21-2,SF-F19,1,1,0,0,1,1,0.0,1.0,0.0,1.0
SF-Q21-2,SF-E18,3,2,0,0,3,2,0.0,1.0,0.0,1.0
SF-Q21-2,SF-E20,2,4,1,0,1,4,0.5,0.5,0.0,1.0
SF-Q21-2,SF-H30,4,2,0,0,4,2,0.0,1.0,0.0,1.0
SF-Q21-2,SF-G30-2,4,4,0,0,4,4,0.0,1.0,0.0,1.0
SF-Q21-2,SF-E29-2,9,6,1,0,8,6,0.1111111111111111,0.8888888888888888,0.0,1.0
SF-Q21-2,SF-D28,3,1,0,0,3,1,0.0,1.0,0.0,1.0
SF-Q21-2,SF-G29-2,2,2,1,2,1,0,0.5,0.5,1.0,0.0
SF-Q21-2,SF-G29-1,1,7,0,2,1,5,0.0,1.0,0.2857142857142857,0.7142857142857143
SF-Q21-2,SF-F28-1,5,1,2,1,3,0,0.4,0.6,1.0,0.0
SF-Q21-2,SF-J10,3,1,0,0,3,1,0.0,1.0,0.0,1.0
SF-Q21-2,SF-J12,3,5,0,0,3,5,0.0,1.0,0.0,1.0
SF-Q21-2,SF-J13,1,3,0,0,1,3,0.0,1.0,0.0,1.0
SF-Q21-2,SF-J15,1,1,0,0,1,1,0.0,1.0,0.0,1.0
SF-Q21-2,SF-G10-2,1,3,0,0,1,3,0.0,1.0,0.0,1.0
SF-Q21-2,SF-C20,2,3,0,0,2,3,0.0,1.0,0.0,1.0
SF-Q21-2,SF-B19,4,2,0,0,4,2,0.0,1.0,0.0,1.0
SF-Q21-2,SF-A20,1,3,0,0,1,3,0.0,1.0,0.0,1.0
SF-Q21-2,SF-C26,1,4,0,3,1,1,0.0,1.0,0.75,0.25
SF-Q21-2,SF-C25,6,2,0,0,6,2,0.0,1.0,0.0,1.0
SF-Q21-2,SF-E27,3,2,1,1,2,1,0.3333333333333333,0.6666666666666666,0.5,0.5
SF-Q21-2,SF-D27,13,46,3,37,10,9,0.23076923076923078,0.7692307692307693,0.8043478260869565,0.1956521739130435
SF-Q21-2,SF-C28-2,2,2,1,0,1,2,0.5,0.5,0.0,1.0
SF-Q21-2,SF-J1,1,3,0,1,1,2,0.0,1.0,0.3333333333333333,0.6666666666666666
SF-Q21-2,SF-J5,1,2,0,0,1,2,0.0,1.0,0.0,1.0
SF-Q21-2,SF-G26,8,17,1,4,7,13,0.125,0.875,0.23529411764705882,0.7647058823529411
SF-Q21-2,SF-K21,9,3,1,0,8,3,0.1111111111111111,0.8888888888888888,0.0,1.0
SF-Q21-2,SF-K22-1,12,18,1,7,11,11,0.08333333333333333,0.9166666666666666,0.3888888888888889,0.6111111111111112
SF-Q21-2,SF-J23-1,49,84,3,18,46,66,0.061224489795918366,0.9387755102040817,0.21428571428571427,0.7857142857142857
SF-Q21-2,SF-J22-1,16,19,1,1,15,18,0.0625,0.9375,0.05263157894736842,0.9473684210526315
SF-Q21-2,SF-J22-2,3,1,0,0,3,1,0.0,1.0,0.0,1.0
SF-Q21-2,SF-J21,11,16,0,3,11,13,0.0,1.0,0.1875,0.8125
SF-Q21-2,SF-I22,2,2,0,0,2,2,0.0,1.0,0.0,1.0
SF-Q21-2,SF-I23-2,2,3,1,1,1,2,0.5,0.5,0.3333333333333333,0.6666666666666666
SF-Q21-2,SF-I23-1,2,74,0,15,2,59,0.0,1.0,0.20270270270270271,0.7972972972972973
SF-Q21-2,SF-F26,10,14,0,3,10,11,0.0,1.0,0.21428571428571427,0.7857142857142857
SF-Q21-2,SF-M13,6,8,0,0,6,8,0.0,1.0,0.0,1.0
SF-Q21-2,SF-M15,7,3,3,1,4,2,0.42857142857142855,0.5714285714285714,0.3333333333333333,0.6666666666666666
SF-Q21-2,SF-L19,16,16,2,3,14,13,0.125,0.875,0.1875,0.8125
SF-Q21-2,SF-L20,3,2,0,1,3,1,0.0,1.0,0.5,0.5
SF-Q21-2,SF-N20-1,12,11,0,2,12,9,0.0,1.0,0.18181818181818182,0.8181818181818182
SF-Q21-2,SF-M20,9,14,1,2,8,12,0.1111111111111111,0.8888888888888888,0.14285714285714285,0.8571428571428571
SF-Q21-2,SF-K17-2,6,11,0,0,6,11,0.0,1.0,0.0,1.0
SF-Q21-2,SF-K20,8,12,1,4,7,8,0.125,0.875,0.3333333333333333,0.6666666666666666
SF-Q21-2,SF-K15-,6,13,0,3,6,10,0.0,1.0,0.23076923076923078,0.7692307692307693
SF-Q21-2,SF-K19,6,4,2,1,4,3,0.3333333333333333,0.6666666666666666,0.25,0.75
SF-Q21-2,SF-K18,6,3,0,2,6,1,0.0,1.0,0.6666666666666666,0.3333333333333333
SF-Q21-2,SF-K17,6,4,2,2,4,2,0.3333333333333333,0.6666666666666666,0.5,0.5
SF-Q21-2,SF-J16,2,1,0,0,2,1,0.0,1.0,0.0,1.0
SF-Q21-2,SF-J18,5,20,0,0,5,20,0.0,1.0,0.0,1.0
SF-Q21-2,SF-J19,6,10,0,2,6,8,0.0,1.0,0.2,0.8
SF-Q21-2,SF-M12,4,3,0,2,4,1,0.0,1.0,0.6666666666666666,0.3333333333333333
SF-Q21-2,SF-M11,3,9,0,0,3,9,0.0,1.0,0.0,1.0
SF-Q21-2,SF-R19,40,55,25,19,15,36,0.625,0.375,0.34545454545454546,0.6545454545454545
SF-Q21-2,SF-R20,34,34,21,20,13,14,0.6176470588235294,0.38235294117647056,0.5882352941176471,0.4117647058823529
SF-Q21-2,SF-Q21-1,19,59,6,46,13,13,0.3157894736842105,0.6842105263157895,0.7796610169491526,0.22033898305084745
SF-Q21-2,SF-P21,26,56,3,17,23,39,0.11538461538461539,0.8846153846153846,0.30357142857142855,0.6964285714285714
SF-Q21-2,SF-O18,9,5,2,0,7,5,0.2222222222222222,0.7777777777777778,0.0,1.0
SF-Q21-2,SF-O19,5,7,0,1,5,6,0.0,1.0,0.14285714285714285,0.8571428571428571
SF-Q21-2,SF-O21,25,15,3,8,22,7,0.12,0.88,0.5333333333333333,0.4666666666666667
SF-Q21-2,SF-O22,38,68,4,49,34,19,0.10526315789473684,0.8947368421052632,0.7205882352941176,0.27941176470588236
SF-Q21-2,SF-N21,4,7,2,4,2,3,0.5,0.5,0.5714285714285714,0.42857142857142855
SF-Q21-2,SF-N20-2,3,1,0,0,3,1,0.0,1.0,0.0,1.0
SF-Q21-2,SF-M21,16,12,2,1,14,11,0.125,0.875,0.08333333333333333,0.9166666666666666
SF-Q21-2,SF-L21,11,13,0,2,11,11,0.0,1.0,0.15384615384615385,0.8461538461538461
SF-Q21-2,SF-P30,3,3,0,0,3,3,0.0,1.0,0.0,1.0
SF-Q21-2,SF-O30,3,2,2,0,1,2,0.6666666666666666,0.3333333333333333,0.0,1.0
SF-Q21-2,SF-N27,4,8,0,1,4,7,0.0,1.0,0.125,0.875
SF-Q21-2,SF-N29,37,86,3,2,34,84,0.08108108108108109,0.918918918918919,0.023255813953488372,0.9767441860465116
SF-Q21-2,SF-L30-1,6,7,1,2,5,5,0.16666666666666666,0.8333333333333334,0.2857142857142857,0.7142857142857143
SF-Q21-2,SF-L29,1,3,0,0,1,3,0.0,1.0,0.0,1.0
SF-Q21-2,SF-J29-1,1,2,0,0,1,2,0.0,1.0,0.0,1.0
SF-Q21-2,SF-I30,1,5,0,0,1,5,0.0,1.0,0.0,1.0
SF-Q21-2,SF-I29-2,3,3,0,0,3,3,0.0,1.0,0.0,1.0
SF-Q21-2,SF I29-1,2,2,0,0,2,2,0.0,1.0,0.0,1.0
SF-Q21-2,SF-S24,5,18,1,8,4,10,0.2,0.8,0.4444444444444444,0.5555555555555556
SF-Q21-2,SF-R24,30,23,7,15,23,8,0.23333333333333334,0.7666666666666667,0.6521739130434783,0.34782608695652173
SF-Q21-2,SF-R26,1,5,0,4,1,1,0.0,1.0,0.8,0.2
SF-Q21-2,SF-Q26,10,8,4,4,6,4,0.4,0.6,0.5,0.5
SF-Q21-2,SF-P26,17,19,0,2,17,17,0.0,1.0,0.10526315789473684,0.8947368421052632
SF-Q21-2,SF-O25-2,4,7,2,3,2,4,0.5,0.5,0.42857142857142855,0.5714285714285714
SF-Q21-2,SF-N22-1B,2,6,0,3,2,3,0.0,1.0,0.5,0.5
SF-Q21-2,SF-N26,1,1,0,0,1,1,0.0,1.0,0.0,1.0
SF-Q21-2,SF-N25,3,1,0,1,3,0,0.0,1.0,1.0,0.0
SF-Q21-2,SF-T21,8,4,4,1,4,3,0.5,0.5,0.25,0.75
SF-Q21-2,SF-T22,13,17,2,8,11,9,0.15384615384615385,0.8461538461538461,0.47058823529411764,0.5294117647058824
SF-Q21-2,SF-S22-2,1,2,1,0,0,2,1.0,0.0,0.0,1.0
SF-Q21-2,SF-S22-1,10,9,1,7,9,2,0.1,0.9,0.7777777777777778,0.2222222222222222
SF-Q21-2,SF-Q23-3,31,52,1,31,30,21,0.03225806451612903,0.967741935483871,0.5961538461538461,0.40384615384615385
SF-Q21-2,SF-Q22-1,18,37,2,18,16,19,0.1111111111111111,0.8888888888888888,0.4864864864864865,0.5135135135135135
SF-Q21-2,SF-Q22-2,30,43,3,32,27,11,0.1,0.9,0.7441860465116279,0.2558139534883721
SF-Q21-2,SF-P22,23,55,2,38,21,17,0.08695652173913043,0.9130434782608695,0.6909090909090909,0.3090909090909091
SF-Q21-2,SF-W19,2,3,0,0,2,3,0.0,1.0,0.0,1.0
SF-Q21-2,SF-U21,7,4,3,0,4,4,0.42857142857142855,0.5714285714285714,0.0,1.0
SF-Q21-2,SF-T20,22,14,3,10,19,4,0.13636363636363635,0.8636363636363636,0.7142857142857143,0.2857142857142857
SF-Q21-2,SF-S21,7,2,4,1,3,1,0.5714285714285714,0.42857142857142855,0.5,0.5
SF-Q21-2,SF-Y14,1,1,1,0,0,1,1.0,0.0,0.0,1.0
SF-Q21-1,SF-M26,2,2,0,0,2,2,0.0,1.0,0.0,1.0
SF-Q21-1,SF-M25,4,7,0,4,4,3,0.0,1.0,0.5714285714285714,0.42857142857142855
SF-Q21-1,SF-M26-2,1,2,0,0,1,2,0.0,1.0,0.0,1.0
SF-Q21-1,SF-K26,11,4,4,1,7,3,0.36363636363636365,0.6363636363636364,0.25,0.75
SF-Q21-1,SF-J27,1,1,0,0,1,1,0.0,1.0,0.0,1.0
SF-Q21-1,SF-M30,20,10,3,1,17,9,0.15,0.85,0.1,0.9
SF-Q21-1,SF-J29-3,1,1,0,1,1,0,0.0,1.0,1.0,0.0
SF-Q21-1,SF-J29,4,8,0,2,4,6,0.0,1.0,0.25,0.75
SF-Q21-1,SF-L26,5,8,0,3,5,5,0.0,1.0,0.375,0.625
SF-Q21-1,SF-M28,4,3,0,0,4,3,0.0,1.0,0.0,1.0
SF-Q21-1,SF-L25,11,9,7,6,4,3,0.6363636363636364,0.36363636363636365,0.6666666666666666,0.3333333333333333
SF-Q21-1,SF-M24,3,10,1,4,2,6,0.3333333333333333,0.6666666666666666,0.4,0.6
SF-Q21-1,SF-L24,1,5,1,3,0,2,1.0,0.0,0.6,0.4
SF-Q21-1,SF-N23,13,46,3,9,10,37,0.23076923076923078,0.7692307692307693,0.1956521739130435,0.8043478260869565
SF-Q21-1,SF-N24-2,5,28,0,22,5,6,0.0,1.0,0.7857142857142857,0.21428571428571427
SF-Q21-1,SF-K27-2,4,4,3,3,1,1,0.75,0.25,0.75,0.25
SF-Q21-1,SF-K28,4,8,0,0,4,8,0.0,1.0,0.0,1.0
SF-Q21-1,SF-K29-1,7,3,3,0,4,3,0.42857142857142855,0.5714285714285714,0.0,1.0
SF-Q21-1,SF-K25,2,7,0,4,2,3,0.0,1.0,0.5714285714285714,0.42857142857142855
SF-Q21-1,SF-J25,1,1,1,0,0,1,1.0,0.0,0.0,1.0
SF-Q21-1,SF-H26-2,1,1,1,1,0,0,1.0,0.0,1.0,0.0
SF-Q21-1,SF-P24,100,125,94,119,6,6,0.94,0.06,0.952,0.048
SF-Q21-1,SF-J24,4,7,4,6,0,1,1.0,0.0,0.8571428571428571,0.14285714285714285
SF-Q21-1,SF-O24,9,8,7,7,2,1,0.7777777777777778,0.2222222222222222,0.875,0.125
SF-Q21-1,SF-I25,2,2,1,2,1,0,0.5,0.5,1.0,0.0
SF-Q21-1,SF-K23,3,1,1,0,2,1,0.3333333333333333,0.6666666666666666,0.0,1.0
SF-Q21-1,SF-H26,17,13,13,6,4,7,0.7647058823529411,0.23529411764705882,0.46153846153846156,0.5384615384615384
SF-Q21-1,SF-O23,11,2,3,2,8,0,0.2727272727272727,0.7272727272727273,1.0,0.0
SF-Q21-1,SF-H27-1,4,1,3,0,1,1,0.75,0.25,0.0,1.0
SF-Q21-1,SF-F28-2,10,9,1,1,9,8,0.1,0.9,0.1111111111111111,0.8888888888888888
SF-Q21-1,SF-G27,8,11,2,4,6,7,0.25,0.75,0.36363636363636365,0.6363636363636364
SF-Q21-1,SF-M22-2,16,16,8,5,8,11,0.5,0.5,0.3125,0.6875
SF-Q21-1,SF-L22,15,22,10,10,5,12,0.6666666666666666,0.3333333333333333,0.45454545454545453,0.5454545454545454
SF-Q21-1,SF-F27,14,12,4,9,10,3,0.2857142857142857,0.7142857142857143,0.75,0.25
SF-Q21-1,SF-N22-2,61,51,22,13,39,38,0.36065573770491804,0.639344262295082,0.2549019607843137,0.7450980392156863
SF-Q21-1,SF-M22-1,4,21,1,8,3,13,0.25,0.75,0.38095238095238093,0.6190476190476191
SF-Q21-1,SF-O25-1,3,2,0,0,3,2,0.0,1.0,0.0,1.0
SF-Q21-1,SF-K22-2,11,30,1,3,10,27,0.09090909090909091,0.9090909090909091,0.1,0.9
SF-Q21-1,SF-K24,4,18,4,15,0,3,1.0,0.0,0.8333333333333334,0.16666666666666666
SF-Q21-1,SF-J23-2,45,52,45,49,0,3,1.0,0.0,0.9423076923076923,0.057692307692307696
SF-Q21-1,SF-G23,6,3,0,1,6,2,0.0,1.0,0.3333333333333333,0.6666666666666666
SF-Q21-1,SF-G24,16,15,3,0,13,15,0.1875,0.8125,0.0,1.0
SF-Q21-1,SF-F23,2,4,1,2,1,2,0.5,0.5,0.5,0.5
SF-Q21-1,SF-E23,8,6,4,5,4,1,0.5,0.5,0.8333333333333334,0.16666666666666666
SF-Q21-1,SF-C22,5,2,1,0,4,2,0.2,0.8,0.0,1.0
SF-Q21-1,SF-J17,1,5,1,5,0,0,1.0,0.0,1.0,0.0
SF-Q21-1,SF-I20,2,1,1,1,1,0,0.5,0.5,1.0,0.0
SF-Q21-1,SF-G17,1,1,0,0,1,1,0.0,1.0,0.0,1.0
SF-Q21-1,SF-G18,5,3,0,0,5,3,0.0,1.0,0.0,1.0
SF-Q21-1,SF-G20,5,3,3,2,2,1,0.6,0.4,0.6666666666666666,0.3333333333333333
SF-Q21-1,SF-F19,2,2,0,0,2,2,0.0,1.0,0.0,1.0
SF-Q21-1,SF-E18,2,4,0,3,2,1,0.0,1.0,0.75,0.25
SF-Q21-1,SF-E20,2,4,0,0,2,4,0.0,1.0,0.0,1.0
SF-Q21-1,SF-H30,2,1,0,1,2,0,0.0,1.0,1.0,0.0
SF-Q21-1,SF-G30-2,1,4,0,0,1,4,0.0,1.0,0.0,1.0
SF-Q21-1,SF-F30-1,1,1,0,0,1,1,0.0,1.0,0.0,1.0
SF-Q21-1,SF-E29-2,11,9,7,1,4,8,0.6363636363636364,0.36363636363636365,0.1111111111111111,0.8888888888888888
SF-Q21-1,SF-E29-1,6,5,2,5,4,0,0.3333333333333333,0.6666666666666666,1.0,0.0
SF-Q21-1,SF-D28,9,17,0,0,9,17,0.0,1.0,0.0,1.0
SF-Q21-1,SF-G29-2,1,2,0,0,1,2,0.0,1.0,0.0,1.0
SF-Q21-1,SF-G29-1,2,2,1,0,1,2,0.5,0.5,0.0,1.0
SF-Q21-1,SF-E29-3,3,5,1,2,2,3,0.3333333333333333,0.6666666666666666,0.4,0.6
SF-Q21-1,SF-F28-1,1,3,0,0,1,3,0.0,1.0,0.0,1.0
SF-Q21-1,SF-E28-2,2,4,0,2,2,2,0.0,1.0,0.5,0.5
SF-Q21-1,SF-J10,3,3,0,1,3,2,0.0,1.0,0.3333333333333333,0.6666666666666666
SF-Q21-1,SF-J13,1,2,1,2,0,0,1.0,0.0,1.0,0.0
SF-Q21-1,SF-H12,1,1,1,0,0,1,1.0,0.0,0.0,1.0
SF-Q21-1,SF-G9,3,7,3,6,0,1,1.0,0.0,0.8571428571428571,0.14285714285714285
SF-Q21-1,SF-G11,2,4,1,1,1,3,0.5,0.5,0.25,0.75
SF-Q21-1,SF-F15,1,1,0,1,1,0,0.0,1.0,1.0,0.0
SF-Q21-1,SF-C20,1,12,0,0,1,12,0.0,1.0,0.0,1.0
SF-Q21-1,SF-A20,2,2,0,0,2,2,0.0,1.0,0.0,1.0
SF-Q21-1,SF-C25,7,2,2,1,5,1,0.2857142857142857,0.7142857142857143,0.5,0.5
SF-Q21-1,SF-B25,1,5,0,2,1,3,0.0,1.0,0.4,0.6
SF-Q21-1,SF-E27,4,10,1,0,3,10,0.25,0.75,0.0,1.0
SF-Q21-1,SF-D27,3,5,3,2,0,3,1.0,0.0,0.4,0.6
SF-Q21-1,SF-J1,3,6,2,2,1,4,0.6666666666666666,0.3333333333333333,0.3333333333333333,0.6666666666666666
SF-Q21-1,SF-H0,1,1,0,0,1,1,0.0,1.0,0.0,1.0
SF-Q21-1,SF-J5,1,2,0,1,1,1,0.0,1.0,0.5,0.5
SF-Q21-1,SF-G26,11,21,4,4,7,17,0.36363636363636365,0.6363636363636364,0.19047619047619047,0.8095238095238095
SF-Q21-1,SF-K22-1,2,4,2,2,0,2,1.0,0.0,0.5,0.5
SF-Q21-1,SF-J23-1,9,13,5,6,4,7,0.5555555555555556,0.4444444444444444,0.46153846153846156,0.5384615384615384
SF-Q21-1,SF-J22-1,5,5,1,1,4,4,0.2,0.8,0.2,0.8
SF-Q21-1,SF-J22-2,2,1,0,0,2,1,0.0,1.0,0.0,1.0
SF-Q21-1,SF-J21,7,8,0,0,7,8,0.0,1.0,0.0,1.0
SF-Q21-1,SF-I21,1,5,0,1,1,4,0.0,1.0,0.2,0.8
SF-Q21-1,SF-I24,3,1,1,1,2,0,0.3333333333333333,0.6666666666666666,1.0,0.0
SF-Q21-1,SF-I23-1,2,17,2,13,0,4,1.0,0.0,0.7647058823529411,0.23529411764705882
SF-Q21-1,SF-F26,8,3,2,0,6,3,0.25,0.75,0.0,1.0
SF-Q21-1,SF-M13,6,6,1,0,5,6,0.16666666666666666,0.8333333333333334,0.0,1.0
SF-Q21-1,SF-M15,7,3,0,0,7,3,0.0,1.0,0.0,1.0
SF-Q21-1,SF-L19,9,18,4,11,5,7,0.4444444444444444,0.5555555555555556,0.6111111111111112,0.3888888888888889
SF-Q21-1,SF-L20,3,4,1,1,2,3,0.3333333333333333,0.6666666666666666,0.25,0.75
SF-Q21-1,SF-N20-1,2,8,1,1,1,7,0.5,0.5,0.125,0.875
SF-Q21-1,SF-M20,7,12,2,7,5,5,0.2857142857142857,0.7142857142857143,0.5833333333333334,0.4166666666666667
SF-Q21-1,SF-K17-2,5,5,4,1,1,4,0.8,0.2,0.2,0.8
SF-Q21-1,SF-K20,7,16,2,11,5,5,0.2857142857142857,0.7142857142857143,0.6875,0.3125
SF-Q21-1,SF-K15-,7,14,2,8,5,6,0.2857142857142857,0.7142857142857143,0.5714285714285714,0.42857142857142855
SF-Q21-1,SF-K19,3,3,0,1,3,2,0.0,1.0,0.3333333333333333,0.6666666666666666
SF-Q21-1,SF-K18,15,12,4,5,11,7,0.26666666666666666,0.7333333333333333,0.4166666666666667,0.5833333333333334
SF-Q21-1,SF-K17,9,3,3,0,6,3,0.3333333333333333,0.6666666666666666,0.0,1.0
SF-Q21-1,SF-J16,4,1,0,0,4,1,0.0,1.0,0.0,1.0
SF-Q21-1,SF-J18,2,11,0,2,2,9,0.0,1.0,0.18181818181818182,0.8181818181818182
SF-Q21-1,SF-J19,1,8,0,1,1,7,0.0,1.0,0.125,0.875
SF-Q21-1,SF-M12,1,2,0,1,1,1,0.0,1.0,0.5,0.5
SF-Q21-1,SF-M10,3,1,3,1,0,0,1.0,0.0,1.0,0.0
SF-Q21-1,SF-M11,2,5,1,3,1,2,0.5,0.5,0.6,0.4
SF-Q21-1,SF-R19,20,12,12,3,8,9,0.6,0.4,0.25,0.75
SF-Q21-1,SF-R20,23,5,18,1,5,4,0.782608695652174,0.21739130434782608,0.2,0.8
SF-Q21-1,SF-Q21-2,59,19,46,6,13,13,0.7796610169491526,0.22033898305084745,0.3157894736842105,0.6842105263157895
SF-Q21-1,SF-P21,4,18,0,3,4,15,0.0,1.0,0.16666666666666666,0.8333333333333334
SF-Q21-1,SF-O18,2,5,0,1,2,4,0.0,1.0,0.2,0.8
SF-Q21-1,SF-O19,3,16,1,3,2,13,0.3333333333333333,0.6666666666666666,0.1875,0.8125
SF-Q21-1,SF-O21,10,15,3,4,7,11,0.3,0.7,0.26666666666666666,0.7333333333333333
SF-Q21-1,SF-O22,40,21,9,10,31,11,0.225,0.775,0.47619047619047616,0.5238095238095238
SF-Q21-1,SF-N21,2,6,2,2,0,4,1.0,0.0,0.3333333333333333,0.6666666666666666
SF-Q21-1,SF-N20-2,4,5,2,2,2,3,0.5,0.5,0.4,0.6
SF-Q21-1,SF-M21,18,8,4,0,14,8,0.2222222222222222,0.7777777777777778,0.0,1.0
SF-Q21-1,SF-L21,21,4,6,0,15,4,0.2857142857142857,0.7142857142857143,0.0,1.0
SF-Q21-1,SF-P30,4,2,2,0,2,2,0.5,0.5,0.0,1.0
SF-Q21-1,SF-O30-2,3,3,1,0,2,3,0.3333333333333333,0.6666666666666666,0.0,1.0
SF-Q21-1,SF-O30,22,16,2,3,20,13,0.09090909090909091,0.9090909090909091,0.1875,0.8125
SF-Q21-1,SF-N27,8,47,3,42,5,5,0.375,0.625,0.8936170212765957,0.10638297872340426
SF-Q21-1,SF-N29,87,81,1,49,86,32,0.011494252873563218,0.9885057471264368,0.6049382716049383,0.3950617283950617
SF-Q21-1,SF-N28,17,6,3,5,14,1,0.17647058823529413,0.8235294117647058,0.8333333333333334,0.16666666666666666
SF-Q21-1,SF-L30-1,6,11,0,1,6,10,0.0,1.0,0.09090909090909091,0.9090909090909091
SF-Q21-1,SF-J29-1,1,3,0,2,1,1,0.0,1.0,0.6666666666666666,0.3333333333333333
SF-Q21-1,SF-I30,5,5,1,2,4,3,0.2,0.8,0.4,0.6
SF-Q21-1,SF-I29-2,17,11,0,0,17,11,0.0,1.0,0.0,1.0
SF-Q21-1,SF-I30-2,12,7,0,0,12,7,0.0,1.0,0.0,1.0
SF-Q21-1,SF I29-1,51,70,0,0,51,70,0.0,1.0,0.0,1.0
SF-Q21-1,SF-H28,2,2,0,0,2,2,0.0,1.0,0.0,1.0
SF-Q21-1,SF-S24,7,15,1,7,6,8,0.14285714285714285,0.8571428571428571,0.4666666666666667,0.5333333333333333
SF-Q21-1,SF-R24,6,8,3,5,3,3,0.5,0.5,0.625,0.375
SF-Q21-1,SF-R26,3,1,0,0,3,1,0.0,1.0,0.0,1.0
SF-Q21-1,SF-Q26,11,6,8,6,3,0,0.7272727272727273,0.2727272727272727,1.0,0.0
SF-Q21-1,SF-P26,70,62,11,30,59,32,0.15714285714285714,0.8428571428571429,0.4838709677419355,0.5161290322580645
SF-Q21-1,SF-O25-2,3,3,1,2,2,1,0.3333333333333333,0.6666666666666666,0.6666666666666666,0.3333333333333333
SF-Q21-1,SF-N26,4,8,0,2,4,6,0.0,1.0,0.25,0.75
SF-Q21-1,SF-N25,4,3,1,1,3,2,0.25,0.75,0.3333333333333333,0.6666666666666666
SF-Q21-1,SF-T21,6,14,6,12,0,2,1.0,0.0,0.8571428571428571,0.14285714285714285
SF-Q21-1,SF-T22,11,9,5,4,6,5,0.45454545454545453,0.5454545454545454,0.4444444444444444,0.5555555555555556
SF-Q21-1,SF-S22-1,17,21,16,18,1,3,0.9411764705882353,0.058823529411764705,0.8571428571428571,0.14285714285714285
SF-Q21-1,SF-Q23-3,10,8,7,6,3,2,0.7,0.3,0.75,0.25
SF-Q21-1,SF-Q22-1,12,37,5,20,7,17,0.4166666666666667,0.5833333333333334,0.5405405405405406,0.4594594594594595
SF-Q21-1,SF-Q22-2,3,10,1,4,2,6,0.3333333333333333,0.6666666666666666,0.4,0.6
SF-Q21-1,SF-P22,21,39,15,21,6,18,0.7142857142857143,0.2857142857142857,0.5384615384615384,0.46153846153846156
SF-Q21-1,SF-W19-2,2,3,0,0,2,3,0.0,1.0,0.0,1.0
SF-Q21-1,SF-U21,10,6,2,1,8,5,0.2,0.8,0.16666666666666666,0.8333333333333334
SF-Q21-1,SF-T20,11,12,7,3,4,9,0.6363636363636364,0.36363636363636365,0.25,0.75
SF-Q21-1,SF-S21,3,2,3,0,0,2,1.0,0.0,0.0,1.0
SF-Q21-1,SF-X29,1,2,1,2,0,0,1.0,0.0,1.0,0.0
SF-Q21-1,SF-V29,1,1,1,1,0,0,1.0,0.0,1.0,0.0
SF-Q21-1,SF-AA15,3,2,3,2,0,0,1.0,0.0,1.0,0.0
SF-P21,SF-M26,2,2,0,0,2,2,0.0,1.0,0.0,1.0
SF-P21,SF-M25,7,13,0,12,7,1,0.0,1.0,0.9230769230769231,0.07692307692307693
SF-P21,SF-M26-2,2,7,0,1,2,6,0.0,1.0,0.14285714285714285,0.8571428571428571
SF-P21,SF-K26,3,13,0,5,3,8,0.0,1.0,0.38461538461538464,0.6153846153846154
SF-P21,SF-M30,5,11,0,2,5,9,0.0,1.0,0.18181818181818182,0.8181818181818182
SF-P21,SF-J29,3,4,1,2,2,2,0.3333333333333333,0.6666666666666666,0.5,0.5
SF-P21,SF-L26,16,24,2,11,14,13,0.125,0.875,0.4583333333333333,0.5416666666666666
SF-P21,SF-M28,5,7,1,0,4,7,0.2,0.8,0.0,1.0
SF-P21,SF-M27,1,1,0,0,1,1,0.0,1.0,0.0,1.0
SF-P21,SF-L25,5,2,1,0,4,2,0.2,0.8,0.0,1.0
SF-P21,SF-M24,4,12,0,6,4,6,0.0,1.0,0.5,0.5
SF-P21,SF-L24,6,2,2,1,4,1,0.3333333333333333,0.6666666666666666,0.5,0.5
SF-P21,SF-N23,5,6,0,2,5,4,0.0,1.0,0.3333333333333333,0.6666666666666666
SF-P21,SF-N24-2,6,8,0,3,6,5,0.0,1.0,0.375,0.625
SF-P21,SF-J26-2,4,7,0,3,4,4,0.0,1.0,0.42857142857142855,0.5714285714285714
SF-P21,SF-L28,1,2,0,2,1,0,0.0,1.0,1.0,0.0
SF-P21,SF-K28,4,19,1,2,3,17,0.25,0.75,0.10526315789473684,0.8947368421052632
SF-P21,SF-K29-1,2,3,2,1,0,2,1.0,0.0,0.3333333333333333,0.6666666666666666
SF-P21,SF-K25,8,2,4,1,4,1,0.5,0.5,0.5,0.5
SF-P21,SF-J25,19,9,5,5,14,4,0.2631578947368421,0.7368421052631579,0.5555555555555556,0.4444444444444444
SF-P21,SF-H26-2,2,3,1,0,1,3,0.5,0.5,0.0,1.0
SF-P21,SF-P24,17,16,5,7,12,9,0.29411764705882354,0.7058823529411765,0.4375,0.5625
SF-P21,SF-N22-1A,7,4,3,1,4,3,0.42857142857142855,0.5714285714285714,0.25,0.75
SF-P21,SF-J24,5,5,0,3,5,2,0.0,1.0,0.6,0.4
SF-P21,SF-O24,2,2,0,2,2,0,0.0,1.0,1.0,0.0
SF-P21,SF-I26-,1,1,1,0,0,1,1.0,0.0,0.0,1.0
SF-P21,SF-I25,26,36,8,24,18,12,0.3076923076923077,0.6923076923076923,0.6666666666666666,0.3333333333333333
SF-P21,SF-H26,10,30,1,6,9,24,0.1,0.9,0.2,0.8
SF-P21,SF-O23,22,18,5,10,17,8,0.22727272727272727,0.7727272727272727,0.5555555555555556,0.4444444444444444
SF-P21,SF-F28-2,2,2,1,1,1,1,0.5,0.5,0.5,0.5
SF-P21,SF-G27,12,10,0,2,12,8,0.0,1.0,0.2,0.8
SF-P21,SF-M22-2,23,17,2,7,21,10,0.08695652173913043,0.9130434782608695,0.4117647058823529,0.5882352941176471
SF-P21,SF-L22,16,9,4,3,12,6,0.25,0.75,0.3333333333333333,0.6666666666666666
SF-P21,SF-F27,6,4,1,0,5,4,0.16666666666666666,0.8333333333333334,0.0,1.0
SF-P21,SF-N22-2,14,19,2,17,12,2,0.14285714285714285,0.8571428571428571,0.8947368421052632,0.10526315789473684
SF-P21,SF-G28-2,1,1,0,0,1,1,0.0,1.0,0.0,1.0
SF-P21,SF-M22-1,7,31,1,3,6,28,0.14285714285714285,0.8571428571428571,0.0967741935483871,0.9032258064516129
SF-P21,SF-O25-1,8,14,4,2,4,12,0.5,0.5,0.14285714285714285,0.8571428571428571
SF-P21,SF-K22-2,12,21,2,9,10,12,0.16666666666666666,0.8333333333333334,0.42857142857142855,0.5714285714285714
SF-P21,SF-K24,10,9,3,1,7,8,0.3,0.7,0.1111111111111111,0.8888888888888888
SF-P21,SF-J23-2,9,8,2,5,7,3,0.2222222222222222,0.7777777777777778,0.625,0.375
SF-P21,SF-G23,1,5,0,2,1,3,0.0,1.0,0.4,0.6
SF-P21,SF-G24,35,26,0,0,35,26,0.0,1.0,0.0,1.0
SF-P21,SF-G25,2,6,0,1,2,5,0.0,1.0,0.16666666666666666,0.8333333333333334
SF-P21,SF-F23,10,21,0,1,10,20,0.0,1.0,0.047619047619047616,0.9523809523809523
SF-P21,SF-E23,11,8,2,0,9,8,0.18181818181818182,0.8181818181818182,0.0,1.0
SF-P21,SF-C22,9,3,1,0,8,3,0.1111111111111111,0.8888888888888888,0.0,1.0
SF-P21,SF-J17,10,10,3,1,7,9,0.3,0.7,0.1,0.9
SF-P21,SF-H16,6,3,1,0,5,3,0.16666666666666666,0.8333333333333334,0.0,1.0
SF-P21,SF-H20,4,9,0,0,4,9,0.0,1.0,0.0,1.0
SF-P21,SF-H18,2,5,0,2,2,3,0.0,1.0,0.4,0.6
SF-P21,SF-H17,4,2,0,0,4,2,0.0,1.0,0.0,1.0
SF-P21,SF-G19,2,3,1,0,1,3,0.5,0.5,0.0,1.0
SF-P21,SF-G17,1,3,0,1,1,2,0.0,1.0,0.3333333333333333,0.6666666666666666
SF-P21,SF-G18,3,5,0,0,3,5,0.0,1.0,0.0,1.0
SF-P21,SF-G20,8,3,2,1,6,2,0.25,0.75,0.3333333333333333,0.6666666666666666
SF-P21,SF-F19,2,6,0,1,2,5,0.0,1.0,0.16666666666666666,0.8333333333333334
SF-P21,SF-E18,1,4,0,1,1,3,0.0,1.0,0.25,0.75
SF-P21,SF-E20,1,3,0,0,1,3,0.0,1.0,0.0,1.0
SF-P21,SF-G30-2,4,3,0,1,4,2,0.0,1.0,0.3333333333333333,0.6666666666666666
SF-P21,SF-F30-1,1,4,0,0,1,4,0.0,1.0,0.0,1.0
SF-P21,SF-E29-2,5,5,1,5,4,0,0.2,0.8,1.0,0.0
SF-P21,SF-E29-1,2,4,2,0,0,4,1.0,0.0,0.0,1.0
SF-P21,SF-D29,1,3,0,2,1,1,0.0,1.0,0.6666666666666666,0.3333333333333333
SF-P21,SF-D28,2,7,0,0,2,7,0.0,1.0,0.0,1.0
SF-P21,SF-G29-2,4,6,2,2,2,4,0.5,0.5,0.3333333333333333,0.6666666666666666
SF-P21,SF-G29-1,7,1,1,1,6,0,0.14285714285714285,0.8571428571428571,1.0,0.0
SF-P21,SF-G30-1,1,2,0,0,1,2,0.0,1.0,0.0,1.0
SF-P21,SF-F29,2,1,2,0,0,1,1.0,0.0,0.0,1.0
SF-P21,SF-E29-3,2,1,0,1,2,0,0.0,1.0,1.0,0.0
SF-P21,SF-F28-1,2,2,0,0,2,2,0.0,1.0,0.0,1.0
SF-P21,SF-E28-2,1,2,1,1,0,1,1.0,0.0,0.5,0.5
SF-P21,SF-J10,5,4,2,0,3,4,0.4,0.6,0.0,1.0
SF-P21,SF-J12,6,9,1,1,5,8,0.16666666666666666,0.8333333333333334,0.1111111111111111,0.8888888888888888
SF-P21,SF-J13,2,4,0,2,2,2,0.0,1.0,0.5,0.5
SF-P21,SF-H13,3,1,2,0,1,1,0.6666666666666666,0.3333333333333333,0.0,1.0
SF-P21,SF-I16,2,1,0,0,2,1,0.0,1.0,0.0,1.0
SF-P21,SF-H12,4,4,0,0,4,4,0.0,1.0,0.0,1.0
SF-P21,SF-H14,1,1,0,0,1,1,0.0,1.0,0.0,1.0
SF-P21,SF-G13,1,6,0,0,1,6,0.0,1.0,0.0,1.0
SF-P21,SF-G12,8,8,0,2,8,6,0.0,1.0,0.25,0.75
SF-P21,SF-F15,3,1,1,0,2,1,0.3333333333333333,0.6666666666666666,0.0,1.0
SF-P21,SF-B21,1,3,0,3,1,0,0.0,1.0,1.0,0.0
SF-P21,SF-B19,1,2,0,0,1,2,0.0,1.0,0.0,1.0
SF-P21,SF-A20,8,5,0,0,8,5,0.0,1.0,0.0,1.0
SF-P21,SF-C26,2,6,0,3,2,3,0.0,1.0,0.5,0.5
SF-P21,SF-C25,6,13,2,3,4,10,0.3333333333333333,0.6666666666666666,0.23076923076923078,0.7692307692307693
SF-P21,SF-B25,6,1,0,0,6,1,0.0,1.0,0.0,1.0
SF-P21,SF-E27,1,2,0,0,1,2,0.0,1.0,0.0,1.0
SF-P21,SF-B28-2,11,12,0,0,11,12,0.0,1.0,0.0,1.0
SF-P21,SF-D27,2,3,1,1,1,2,0.5,0.5,0.3333333333333333,0.6666666666666666
SF-P21,SF-J1,8,3,0,0,8,3,0.0,1.0,0.0,1.0
SF-P21,SF-H0,1,3,0,0,1,3,0.0,1.0,0.0,1.0
SF-P21,SF-G5,3,1,0,0,3,1,0.0,1.0,0.0,1.0
SF-P21,SF-G7,3,4,0,0,3,4,0.0,1.0,0.0,1.0
SF-P21,SF-F9,1,1,0,0,1,1,0.0,1.0,0.0,1.0
SF-P21,SF-H25,2,3,0,0,2,3,0.0,1.0,0.0,1.0
SF-P21,SF-G26,5,14,0,2,5,12,0.0,1.0,0.14285714285714285,0.8571428571428571
SF-P21,SF-K21,7,8,6,0,1,8,0.8571428571428571,0.14285714285714285,0.0,1.0
SF-P21,SF-K22-1,11,7,8,1,3,6,0.7272727272727273,0.2727272727272727,0.14285714285714285,0.8571428571428571
SF-P21,SF-J23-1,27,28,3,6,24,22,0.1111111111111111,0.8888888888888888,0.21428571428571427,0.7857142857142857
SF-P21,SF-J22-1,3,14,1,2,2,12,0.3333333333333333,0.6666666666666666,0.14285714285714285,0.8571428571428571
SF-P21,SF-J22-2,4,3,2,2,2,1,0.5,0.5,0.6666666666666666,0.3333333333333333
SF-P21,SF-J21,5,5,0,4,5,1,0.0,1.0,0.8,0.2
SF-P21,SF-I21,4,2,2,1,2,1,0.5,0.5,0.5,0.5
SF-P21,SF-I22,2,1,1,1,1,0,0.5,0.5,1.0,0.0
SF-P21,SF-I23-2,8,18,2,1,6,17,0.25,0.75,0.05555555555555555,0.9444444444444444
SF-P21,SF-I24,5,1,0,1,5,0,0.0,1.0,1.0,0.0
SF-P21,SF-F26,15,10,2,2,13,8,0.13333333333333333,0.8666666666666667,0.2,0.8
SF-P21,SF-M13,10,20,0,3,10,17,0.0,1.0,0.15,0.85
SF-P21,SF-M15,9,10,0,1,9,9,0.0,1.0,0.1,0.9
SF-P21,SF-L19,22,17,14,3,8,14,0.6363636363636364,0.36363636363636365,0.17647058823529413,0.8235294117647058
SF-P21,SF-L20,14,9,2,1,12,8,0.14285714285714285,0.8571428571428571,0.1111111111111111,0.8888888888888888
SF-P21,SF-N20-1,7,19,0,8,7,11,0.0,1.0,0.42105263157894735,0.5789473684210527
SF-P21,SF-M20,36,24,14,5,22,19,0.3888888888888889,0.6111111111111112,0.20833333333333334,0.7916666666666666
SF-P21,SF-K17-2,8,3,0,0,8,3,0.0,1.0,0.0,1.0
SF-P21,SF-K20,10,13,3,7,7,6,0.3,0.7,0.5384615384615384,0.46153846153846156
SF-P21,SF-K15-,28,26,3,3,25,23,0.10714285714285714,0.8928571428571429,0.11538461538461539,0.8846153846153846
SF-P21,SF-K19,22,30,7,8,15,22,0.3181818181818182,0.6818181818181818,0.26666666666666666,0.7333333333333333
SF-P21,SF-K18,21,20,12,7,9,13,0.5714285714285714,0.42857142857142855,0.35,0.65
SF-P21,SF-K17,9,10,2,2,7,8,0.2222222222222222,0.7777777777777778,0.2,0.8
SF-P21,SF-J16,7,2,0,0,7,2,0.0,1.0,0.0,1.0
SF-P21,SF-J18,19,9,5,0,14,9,0.2631578947368421,0.7368421052631579,0.0,1.0
SF-P21,SF-J20,3,6,1,1,2,5,0.3333333333333333,0.6666666666666666,0.16666666666666666,0.8333333333333334
SF-P21,SF-J19,3,3,0,0,3,3,0.0,1.0,0.0,1.0
SF-P21,SF-M12,5,3,1,1,4,2,0.2,0.8,0.3333333333333333,0.6666666666666666
SF-P21,SF-M10,1,4,1,1,0,3,1.0,0.0,0.25,0.75
SF-P21,SF-M11,4,13,0,1,4,12,0.0,1.0,0.07692307692307693,0.9230769230769231
SF-P21,SF-R19,29,26,9,0,20,26,0.3103448275862069,0.6896551724137931,0.0,1.0
SF-P21,SF-R20,14,3,5,0,9,3,0.35714285714285715,0.6428571428571429,0.0,1.0
SF-P21,SF-Q21-2,56,26,17,3,39,23,0.30357142857142855,0.6964285714285714,0.11538461538461539,0.8846153846153846
SF-P21,SF-Q21-1,18,4,3,0,15,4,0.16666666666666666,0.8333333333333334,0.0,1.0
SF-P21,SF-O18,28,17,11,4,17,13,0.39285714285714285,0.6071428571428571,0.23529411764705882,0.7647058823529411
SF-P21,SF-O19,14,14,1,6,13,8,0.07142857142857142,0.9285714285714286,0.42857142857142855,0.5714285714285714
SF-P21,SF-O21,23,74,8,47,15,27,0.34782608695652173,0.6521739130434783,0.6351351351351351,0.36486486486486486
SF-P21,SF-O22,21,27,6,18,15,9,0.2857142857142857,0.7142857142857143,0.6666666666666666,0.3333333333333333
SF-P21,SF-N21,5,17,1,12,4,5,0.2,0.8,0.7058823529411765,0.29411764705882354
SF-P21,SF-N20-2,4,5,2,3,2,2,0.5,0.5,0.6,0.4
SF-P21,SF-M21,29,21,6,15,23,6,0.20689655172413793,0.7931034482758621,0.7142857142857143,0.2857142857142857
SF-P21,SF-L21,57,50,4,13,53,37,0.07017543859649122,0.9298245614035088,0.26,0.74
SF-P21,SF-Q30,10,13,0,0,10,13,0.0,1.0,0.0,1.0
SF-P21,SF-P30,2,5,1,0,1,5,0.5,0.5,0.0,1.0
SF-P21,SF-O30-2,2,1,0,0,2,1,0.0,1.0,0.0,1.0
SF-P21,SF-O30,4,17,0,8,4,9,0.0,1.0,0.47058823529411764,0.5294117647058824
SF-P21,SF-N27,9,11,1,6,8,5,0.1111111111111111,0.8888888888888888,0.5454545454545454,0.45454545454545453
SF-P21,SF-N29,3,5,1,0,2,5,0.3333333333333333,0.6666666666666666,0.0,1.0
SF-P21,SF-N28,6,9,1,0,5,9,0.16666666666666666,0.8333333333333334,0.0,1.0
SF-P21,SF-L30-1,4,10,0,2,4,8,0.0,1.0,0.2,0.8
SF-P21,SF-L31-1,2,1,0,1,2,0,0.0,1.0,1.0,0.0
SF-P21,SF-L29,9,2,4,1,5,1,0.4444444444444444,0.5555555555555556,0.5,0.5
SF-P21,SF-I27,3,6,1,1,2,5,0.3333333333333333,0.6666666666666666,0.16666666666666666,0.8333333333333334
SF-P21,SF I29-1,4,2,0,0,4,2,0.0,1.0,0.0,1.0
SF-P21,SF-H28,4,3,2,3,2,0,0.5,0.5,1.0,0.0
SF-P21,SF-S24,19,22,4,8,15,14,0.21052631578947367,0.7894736842105263,0.36363636363636365,0.6363636363636364
SF-P21,SF-R24,31,20,10,12,21,8,0.3225806451612903,0.6774193548387096,0.6,0.4
SF-P21,SF-R26,8,7,2,4,6,3,0.25,0.75,0.5714285714285714,0.42857142857142855
SF-P21,SF-Q26,10,4,4,2,6,2,0.4,0.6,0.5,0.5
SF-P21,SF-P26,29,29,4,14,25,15,0.13793103448275862,0.8620689655172413,0.4827586206896552,0.5172413793103449
SF-P21,SF-O25-2,19,18,9,6,10,12,0.47368421052631576,0.5263157894736842,0.3333333333333333,0.6666666666666666
SF-P21,SF-N22-1B,16,28,7,12,9,16,0.4375,0.5625,0.42857142857142855,0.5714285714285714
SF-P21,SF-N26,4,4,0,0,4,4,0.0,1.0,0.0,1.0
SF-P21,SF-N25,6,4,0,4,6,0,0.0,1.0,1.0,0.0
SF-P21,SF-T21,10,4,3,2,7,2,0.3,0.7,0.5,0.5
SF-P21,SF-T22,52,72,5,44,47,28,0.09615384615384616,0.9038461538461539,0.6111111111111112,0.3888888888888889
SF-P21,SF-S22-2,13,11,3,1,10,10,0.23076923076923078,0.7692307692307693,0.09090909090909091,0.9090909090909091
SF-P21,SF-S22-1,32,18,15,8,17,10,0.46875,0.53125,0.4444444444444444,0.5555555555555556
SF-P21,SF-Q23-3,43,21,19,7,24,14,0.4418604651162791,0.5581395348837209,0.3333333333333333,0.6666666666666666
SF-P21,SF-Q22-1,18,26,11,19,7,7,0.6111111111111112,0.3888888888888889,0.7307692307692307,0.2692307692307692
SF-P21,SF-Q22-2,23,22,8,14,15,8,0.34782608695652173,0.6521739130434783,0.6363636363636364,0.36363636363636365
SF-P21,SF-P22,20,35,6,15,14,20,0.3,0.7,0.42857142857142855,0.5714285714285714
SF-P21,SF-W19,11,5,9,4,2,1,0.8181818181818182,0.18181818181818182,0.8,0.2
SF-P21,SF-W19-2,4,1,1,0,3,1,0.25,0.75,0.0,1.0
SF-P21,SF-U21,19,11,1,1,18,10,0.05263157894736842,0.9473684210526315,0.09090909090909091,0.9090909090909091
SF-P21,SF-T20,22,23,7,4,15,19,0.3181818181818182,0.6818181818181818,0.17391304347826086,0.8260869565217391
SF-P21,SF-S21,5,5,0,3,5,2,0.0,1.0,0.6,0.4
SF-P21,SF-Y30,4,5,0,0,4,5,0.0,1.0,0.0,1.0
SF-P21,SF-X29,4,2,0,0,4,2,0.0,1.0,0.0,1.0
SF-P21,SF-W29,1,1,0,0,1,1,0.0,1.0,0.0,1.0
SF-P21,SF-V28,3,4,0,2,3,2,0.0,1.0,0.5,0.5
SF-P21,SF-W14,5,3,0,0,5,3,0.0,1.0,0.0,1.0
SF-P21,SF-X19,2,4,0,0,2,4,0.0,1.0,0.0,1.0
SF-P21,SF-Y25,1,1,0,0,1,1,0.0,1.0,0.0,1.0
SF-O18,SF-M25,11,7,0,3,11,4,0.0,1.0,0.42857142857142855,0.5714285714285714
SF-O18,SF-M26-2,10,6,1,6,9,0,0.1,0.9,1.0,0.0
SF-O18,SF-L27,13,3,1,0,12,3,0.07692307692307693,0.9230769230769231,0.0,1.0
SF-O18,SF-K26,76,26,1,18,75,8,0.013157894736842105,0.9868421052631579,0.6923076923076923,0.3076923076923077
SF-O18,SF-J27,1,2,0,1,1,1,0.0,1.0,0.5,0.5
SF-O18,SF-M30,10,12,1,3,9,9,0.1,0.9,0.25,0.75
SF-O18,SF-J29,6,11,2,2,4,9,0.3333333333333333,0.6666666666666666,0.18181818181818182,0.8181818181818182
SF-O18,SF-L26,72,173,3,71,69,102,0.041666666666666664,0.9583333333333334,0.41040462427745666,0.5895953757225434
SF-O18,SF-M28,5,2,2,1,3,1,0.4,0.6,0.5,0.5
SF-O18,SF-L25,23,23,0,1,23,22,0.0,1.0,0.043478260869565216,0.9565217391304348
SF-O18,SF-M24,4,5,1,2,3,3,0.25,0.75,0.4,0.6
SF-O18,SF-L24,10,7,2,1,8,6,0.2,0.8,0.14285714285714285,0.8571428571428571
SF-O18,SF-N23,17,61,2,50,15,11,0.11764705882352941,0.8823529411764706,0.819672131147541,0.18032786885245902
SF-O18,SF-N24-2,5,5,0,3,5,2,0.0,1.0,0.6,0.4
SF-O18,SF-K27-2,13,12,2,2,11,10,0.15384615384615385,0.8461538461538461,0.16666666666666666,0.8333333333333334
SF-O18,SF-J26-2,6,2,2,1,4,1,0.3333333333333333,0.6666666666666666,0.5,0.5
SF-O18,SF-K28-3,1,1,0,0,1,1,0.0,1.0,0.0,1.0
SF-O18,SF-L28,1,3,0,0,1,3,0.0,1.0,0.0,1.0
SF-O18,SF-K28,1,2,0,0,1,2,0.0,1.0,0.0,1.0
SF-O18,SF-K29-1,6,1,1,0,5,1,0.16666666666666666,0.8333333333333334,0.0,1.0
SF-O18,SF-J28-2,5,5,0,0,5,5,0.0,1.0,0.0,1.0
SF-O18,SF-K27,5,1,1,0,4,1,0.2,0.8,0.0,1.0
SF-O18,SF-J25,11,8,4,2,7,6,0.36363636363636365,0.6363636363636364,0.25,0.75
SF-O18,SF-H26-2,1,1,0,0,1,1,0.0,1.0,0.0,1.0
SF-O18,SF-P24,8,12,2,4,6,8,0.25,0.75,0.3333333333333333,0.6666666666666666
SF-O18,SF-N22-1A,1,2,0,2,1,0,0.0,1.0,1.0,0.0
SF-O18,SF-J24,3,5,1,1,2,4,0.3333333333333333,0.6666666666666666,0.2,0.8
SF-O18,SF-O24,2,10,0,5,2,5,0.0,1.0,0.5,0.5
SF-O18,SF-J26,1,4,0,1,1,3,0.0,1.0,0.25,0.75
SF-O18,SF-I26-,3,2,1,0,2,2,0.3333333333333333,0.6666666666666666,0.0,1.0
SF-O18,SF-I25,13,10,2,3,11,7,0.15384615384615385,0.8461538461538461,0.3,0.7
SF-O18,SF-K23,3,2,3,1,0,1,1.0,0.0,0.5,0.5
SF-O18,SF-H26,47,38,27,18,20,20,0.574468085106383,0.425531914893617,0.47368421052631576,0.5263157894736842
SF-O18,SF-O23,8,22,0,13,8,9,0.0,1.0,0.5909090909090909,0.4090909090909091
SF-O18,SF-H27-1,3,4,1,0,2,4,0.3333333333333333,0.6666666666666666,0.0,1.0
SF-O18,SF-F28-2,30,51,1,9,29,42,0.03333333333333333,0.9666666666666667,0.17647058823529413,0.8235294117647058
SF-O18,SF-G27,19,24,5,4,14,20,0.2631578947368421,0.7368421052631579,0.16666666666666666,0.8333333333333334
SF-O18,SF-M22-2,28,37,5,6,23,31,0.17857142857142858,0.8214285714285714,0.16216216216216217,0.8378378378378378
SF-O18,SF-L22,17,20,0,5,17,15,0.0,1.0,0.25,0.75
SF-O18,SF-F27,29,16,7,3,22,13,0.2413793103448276,0.7586206896551724,0.1875,0.8125
SF-O18,SF-N22-2,116,76,89,43,27,33,0.7672413793103449,0.23275862068965517,0.5657894736842105,0.4342105263157895
SF-O18,SF-G28-2,1,2,0,0,1,2,0.0,1.0,0.0,1.0
SF-O18,SF-M22-1,12,12,1,3,11,9,0.08333333333333333,0.9166666666666666,0.25,0.75
SF-O18,SF-O25-1,2,12,1,5,1,7,0.5,0.5,0.4166666666666667,0.5833333333333334
SF-O18,SF-K22-2,12,12,4,5,8,7,0.3333333333333333,0.6666666666666666,0.4166666666666667,0.5833333333333334
SF-O18,SF-K24,1,6,0,1,1,5,0.0,1.0,0.16666666666666666,0.8333333333333334
SF-O18,SF-J23-2,8,9,3,1,5,8,0.375,0.625,0.1111111111111111,0.8888888888888888
SF-O18,SF-G23,1,7,0,1,1,6,0.0,1.0,0.14285714285714285,0.8571428571428571
SF-O18,SF-G24,15,14,0,1,15,13,0.0,1.0,0.07142857142857142,0.9285714285714286
SF-O18,SF-G25,8,6,2,0,6,6,0.25,0.75,0.0,1.0
SF-O18,SF-F23,9,5,4,0,5,5,0.4444444444444444,0.5555555555555556,0.0,1.0
SF-O18,SF-E23,9,4,1,0,8,4,0.1111111111111111,0.8888888888888888,0.0,1.0
SF-O18,SF-D24,2,2,1,0,1,2,0.5,0.5,0.0,1.0
SF-O18,SF-C22,6,4,0,0,6,4,0.0,1.0,0.0,1.0
SF-O18,SF-B22,6,3,3,0,3,3,0.5,0.5,0.0,1.0
SF-O18,SF-J17,33,13,4,1,29,12,0.12121212121212122,0.8787878787878788,0.07692307692307693,0.9230769230769231
SF-O18,SF-I19,5,10,0,1,5,9,0.0,1.0,0.1,0.9
SF-O18,SF-I20,3,9,3,2,0,7,1.0,0.0,0.2222222222222222,0.7777777777777778
SF-O18,SF-H16,3,1,0,0,3,1,0.0,1.0,0.0,1.0
SF-O18,SF-H19,3,1,0,0,3,1,0.0,1.0,0.0,1.0
SF-O18,SF-H20,5,8,0,0,5,8,0.0,1.0,0.0,1.0
SF-O18,SF-H18,10,1,0,0,10,1,0.0,1.0,0.0,1.0
SF-O18,SF-H17,3,6,0,0,3,6,0.0,1.0,0.0,1.0
SF-O18,SF-G19,12,4,0,0,12,4,0.0,1.0,0.0,1.0
SF-O18,SF-G17,4,5,0,0,4,5,0.0,1.0,0.0,1.0
SF-O18,SF-G18,28,17,3,1,25,16,0.10714285714285714,0.8928571428571429,0.058823529411764705,0.9411764705882353
SF-O18,SF-G20,9,11,3,0,6,11,0.3333333333333333,0.6666666666666666,0.0,1.0
SF-O18,SF-F19,38,52,1,1,37,51,0.02631578947368421,0.9736842105263158,0.019230769230769232,0.9807692307692307
SF-O18,SF-E18,11,5,0,1,11,4,0.0,1.0,0.2,0.8
SF-O18,SF-E20,6,5,0,0,6,5,0.0,1.0,0.0,1.0
SF-O18,SF-H30,3,1,1,0,2,1,0.3333333333333333,0.6666666666666666,0.0,1.0
SF-O18,SF-G30-2,4,5,0,1,4,4,0.0,1.0,0.2,0.8
SF-O18,SF-E29-2,20,22,6,4,14,18,0.3,0.7,0.18181818181818182,0.8181818181818182
SF-O18,SF-E29-1,7,2,3,2,4,0,0.42857142857142855,0.5714285714285714,1.0,0.0
SF-O18,SF-D29,4,5,0,2,4,3,0.0,1.0,0.4,0.6
SF-O18,SF-D28,6,2,1,1,5,1,0.16666666666666666,0.8333333333333334,0.5,0.5
SF-O18,SF-A27,2,1,0,0,2,1,0.0,1.0,0.0,1.0
SF-O18,SF-G29-2,16,9,5,4,11,5,0.3125,0.6875,0.4444444444444444,0.5555555555555556
SF-O18,SF-G29-1,2,2,0,1,2,1,0.0,1.0,0.5,0.5
SF-O18,SF-G30-1,2,4,0,2,2,2,0.0,1.0,0.5,0.5
SF-O18,SF-G29-3,3,3,0,0,3,3,0.0,1.0,0.0,1.0
SF-O18,SF-F30-2,2,3,0,0,2,3,0.0,1.0,0.0,1.0
SF-O18,SF-F29,3,5,1,1,2,4,0.3333333333333333,0.6666666666666666,0.2,0.8
SF-O18,SF-E29-3,6,11,2,0,4,11,0.3333333333333333,0.6666666666666666,0.0,1.0
SF-O18,SF-F28-1,20,9,4,1,16,8,0.2,0.8,0.1111111111111111,0.8888888888888888
SF-O18,SF-E28-2,6,6,1,1,5,5,0.16666666666666666,0.8333333333333334,0.16666666666666666,0.8333333333333334
SF-O18,SF-E28,3,3,1,1,2,2,0.3333333333333333,0.6666666666666666,0.3333333333333333,0.6666666666666666
SF-O18,SF-J10,7,13,0,0,7,13,0.0,1.0,0.0,1.0
SF-O18,SF-J12,6,6,2,0,4,6,0.3333333333333333,0.6666666666666666,0.0,1.0
SF-O18,SF-J13,4,7,0,1,4,6,0.0,1.0,0.14285714285714285,0.8571428571428571
SF-O18,SF-J15,7,3,1,0,6,3,0.14285714285714285,0.8571428571428571,0.0,1.0
SF-O18,SF-I16,3,2,0,0,3,2,0.0,1.0,0.0,1.0
SF-O18,SF-H12,5,1,0,0,5,1,0.0,1.0,0.0,1.0
SF-O18,SF-G10-2,3,1,0,0,3,1,0.0,1.0,0.0,1.0
SF-O18,SF-H15,2,2,2,1,0,1,1.0,0.0,0.5,0.5
SF-O18,SF-G9,1,1,0,0,1,1,0.0,1.0,0.0,1.0
SF-O18,SF-G13,20,4,6,1,14,3,0.3,0.7,0.25,0.75
SF-O18,SF-G11,5,14,0,3,5,11,0.0,1.0,0.21428571428571427,0.7857142857142857
SF-O18,SF-G12,4,4,0,0,4,4,0.0,1.0,0.0,1.0
SF-O18,SF-F16,5,9,2,2,3,7,0.4,0.6,0.2222222222222222,0.7777777777777778
SF-O18,SF-C21,6,2,3,0,3,2,0.5,0.5,0.0,1.0
SF-O18,SF-C20,5,10,0,0,5,10,0.0,1.0,0.0,1.0
SF-O18,SF-A20,8,7,0,2,8,5,0.0,1.0,0.2857142857142857,0.7142857142857143
SF-O18,SF-A19,1,3,0,0,1,3,0.0,1.0,0.0,1.0
SF-O18,SF-C26,5,3,1,0,4,3,0.2,0.8,0.0,1.0
SF-O18,SF-C25,7,6,1,0,6,6,0.14285714285714285,0.8571428571428571,0.0,1.0
SF-O18,SF-E27,6,3,2,1,4,2,0.3333333333333333,0.6666666666666666,0.3333333333333333,0.6666666666666666
SF-O18,SF-D27,13,8,5,0,8,8,0.38461538461538464,0.6153846153846154,0.0,1.0
SF-O18,SF-J1,5,19,0,3,5,16,0.0,1.0,0.15789473684210525,0.8421052631578947
SF-O18,SF-J3,1,2,1,0,0,2,1.0,0.0,0.0,1.0
SF-O18,SF-J5,3,2,0,1,3,1,0.0,1.0,0.5,0.5
SF-O18,SF-G5,2,4,0,0,2,4,0.0,1.0,0.0,1.0
SF-O18,SF-G7,1,2,0,0,1,2,0.0,1.0,0.0,1.0
SF-O18,SF-F9,7,5,0,0,7,5,0.0,1.0,0.0,1.0
SF-O18,SF-G26,6,5,3,2,3,3,0.5,0.5,0.4,0.6
SF-O18,SF-K21,9,7,3,0,6,7,0.3333333333333333,0.6666666666666666,0.0,1.0
SF-O18,SF-K22-1,29,30,11,6,18,24,0.3793103448275862,0.6206896551724138,0.2,0.8
SF-O18,SF-J23-1,39,38,14,8,25,30,0.358974358974359,0.6410256410256411,0.21052631578947367,0.7894736842105263
SF-O18,SF-J22-1,17,21,5,9,12,12,0.29411764705882354,0.7058823529411765,0.42857142857142855,0.5714285714285714
SF-O18,SF-J22-2,8,28,1,2,7,26,0.125,0.875,0.07142857142857142,0.9285714285714286
SF-O18,SF-J21,20,17,5,2,15,15,0.25,0.75,0.11764705882352941,0.8823529411764706
SF-O18,SF-I21,2,1,0,0,2,1,0.0,1.0,0.0,1.0
SF-O18,SF-I22,9,7,0,0,9,7,0.0,1.0,0.0,1.0
SF-O18,SF-I23-2,6,2,4,0,2,2,0.6666666666666666,0.3333333333333333,0.0,1.0
SF-O18,SF-I24,7,5,5,1,2,4,0.7142857142857143,0.2857142857142857,0.2,0.8
SF-O18,SF-I23-1,6,2,2,1,4,1,0.3333333333333333,0.6666666666666666,0.5,0.5
SF-O18,SF-F26,30,19,6,3,24,16,0.2,0.8,0.15789473684210525,0.8421052631578947
SF-O18,SF-M13,31,92,6,3,25,89,0.1935483870967742,0.8064516129032258,0.03260869565217391,0.967391304347826
SF-O18,SF-M15,10,16,2,4,8,12,0.2,0.8,0.25,0.75
SF-O18,SF-L19,31,43,8,8,23,35,0.25806451612903225,0.7419354838709677,0.18604651162790697,0.813953488372093
SF-O18,SF-L20,26,18,4,6,22,12,0.15384615384615385,0.8461538461538461,0.3333333333333333,0.6666666666666666
SF-O18,SF-N20-1,18,21,6,8,12,13,0.3333333333333333,0.6666666666666666,0.38095238095238093,0.6190476190476191
SF-O18,SF-M20,57,29,14,14,43,15,0.24561403508771928,0.7543859649122807,0.4827586206896552,0.5172413793103449
SF-O18,SF-K17-2,14,6,2,1,12,5,0.14285714285714285,0.8571428571428571,0.16666666666666666,0.8333333333333334
SF-O18,SF-K20,38,31,8,11,30,20,0.21052631578947367,0.7894736842105263,0.3548387096774194,0.6451612903225806
SF-O18,SF-K15-,36,44,9,15,27,29,0.25,0.75,0.3409090909090909,0.6590909090909091
SF-O18,SF-K19,42,51,4,1,38,50,0.09523809523809523,0.9047619047619048,0.0196078431372549,0.9803921568627451
SF-O18,SF-K18,24,22,2,3,22,19,0.08333333333333333,0.9166666666666666,0.13636363636363635,0.8636363636363636
SF-O18,SF-K17,12,10,2,4,10,6,0.16666666666666666,0.8333333333333334,0.4,0.6
SF-O18,SF-J16,7,4,0,0,7,4,0.0,1.0,0.0,1.0
SF-O18,SF-J18,23,29,6,7,17,22,0.2608695652173913,0.7391304347826086,0.2413793103448276,0.7586206896551724
SF-O18,SF-J20,7,3,3,0,4,3,0.42857142857142855,0.5714285714285714,0.0,1.0
SF-O18,SF-J19,9,4,3,1,6,3,0.3333333333333333,0.6666666666666666,0.25,0.75
SF-O18,SF-M12,6,14,1,0,5,14,0.16666666666666666,0.8333333333333334,0.0,1.0
SF-O18,SF-M10,7,5,2,2,5,3,0.2857142857142857,0.7142857142857143,0.4,0.6
SF-O18,SF-M11,15,14,9,4,6,10,0.6,0.4,0.2857142857142857,0.7142857142857143
SF-O18,SF-R19,16,9,4,2,12,7,0.25,0.75,0.2222222222222222,0.7777777777777778
SF-O18,SF-R20,8,7,1,0,7,7,0.125,0.875,0.0,1.0
SF-O18,SF-Q21-2,5,9,0,2,5,7,0.0,1.0,0.2222222222222222,0.7777777777777778
SF-O18,SF-Q21-1,5,2,1,0,4,2,0.2,0.8,0.0,1.0
SF-O18,SF-P21,17,28,4,11,13,17,0.23529411764705882,0.7647058823529411,0.39285714285714285,0.6071428571428571
SF-O18,SF-O19,39,76,5,52,34,24,0.1282051282051282,0.8717948717948718,0.6842105263157895,0.3157894736842105
SF-O18,SF-O21,54,57,10,27,44,30,0.18518518518518517,0.8148148148148148,0.47368421052631576,0.5263157894736842
SF-O18,SF-O22,25,36,2,15,23,21,0.08,0.92,0.4166666666666667,0.5833333333333334
SF-O18,SF-N21,24,31,9,22,15,9,0.375,0.625,0.7096774193548387,0.2903225806451613
SF-O18,SF-N20-2,6,10,2,7,4,3,0.3333333333333333,0.6666666666666666,0.7,0.3
SF-O18,SF-M21,33,30,3,9,30,21,0.09090909090909091,0.9090909090909091,0.3,0.7
SF-O18,SF-L21,89,53,15,15,74,38,0.16853932584269662,0.8314606741573034,0.2830188679245283,0.7169811320754716
SF-O18,SF-Q30,3,1,0,0,3,1,0.0,1.0,0.0,1.0
SF-O18,SF-P30,6,9,0,5,6,4,0.0,1.0,0.5555555555555556,0.4444444444444444
SF-O18,SF-O30-2,1,1,0,0,1,1,0.0,1.0,0.0,1.0
SF-O18,SF-O30,21,20,1,5,20,15,0.047619047619047616,0.9523809523809523,0.25,0.75
SF-O18,SF-N27,7,7,1,1,6,6,0.14285714285714285,0.8571428571428571,0.14285714285714285,0.8571428571428571
SF-O18,SF-N29,4,12,0,3,4,9,0.0,1.0,0.25,0.75
SF-O18,SF-N28,11,7,2,2,9,5,0.18181818181818182,0.8181818181818182,0.2857142857142857,0.7142857142857143
SF-O18,SF-L30-1,12,10,1,3,11,7,0.08333333333333333,0.9166666666666666,0.3,0.7
SF-O18,SF-L31-1,2,4,0,0,2,4,0.0,1.0,0.0,1.0
SF-O18,SF-K30-2,2,1,0,0,2,1,0.0,1.0,0.0,1.0
SF-O18,SF-L29,4,2,1,2,3,0,0.25,0.75,1.0,0.0
SF-O18,SF-J29-1,1,1,0,0,1,1,0.0,1.0,0.0,1.0
SF-O18,SF-I30,3,1,1,0,2,1,0.3333333333333333,0.6666666666666666,0.0,1.0
SF-O18,SF-I27,4,7,1,2,3,5,0.25,0.75,0.2857142857142857,0.7142857142857143
SF-O18,SF-I28,1,2,1,1,0,1,1.0,0.0,0.5,0.5
SF-O18,SF-I30-2,1,1,1,0,0,1,1.0,0.0,0.0,1.0
SF-O18,SF I29-1,9,2,1,0,8,2,0.1111111111111111,0.8888888888888888,0.0,1.0
SF-O18,SF-H28,55,58,51,54,4,4,0.9272727272727272,0.07272727272727272,0.9310344827586207,0.06896551724137931
SF-O18,SF-S24,7,11,0,3,7,8,0.0,1.0,0.2727272727272727,0.7272727272727273
SF-O18,SF-R24,6,11,3,2,3,9,0.5,0.5,0.18181818181818182,0.8181818181818182
SF-O18,SF-R26,2,2,0,2,2,0,0.0,1.0,1.0,0.0
SF-O18,SF-Q26,2,34,0,28,2,6,0.0,1.0,0.8235294117647058,0.17647058823529413
SF-O18,SF-P26,20,44,1,0,19,44,0.05,0.95,0.0,1.0
SF-O18,SF-O25-2,5,5,2,1,3,4,0.4,0.6,0.2,0.8
SF-O18,SF-N22-1B,2,12,0,7,2,5,0.0,1.0,0.5833333333333334,0.4166666666666667
SF-O18,SF-N26,3,1,1,0,2,1,0.3333333333333333,0.6666666666666666,0.0,1.0
SF-O18,SF-N25,27,63,18,55,9,8,0.6666666666666666,0.3333333333333333,0.873015873015873,0.12698412698412698
SF-O18,SF-T21,2,2,0,0,2,2,0.0,1.0,0.0,1.0
SF-O18,SF-T22,10,9,2,5,8,4,0.2,0.8,0.5555555555555556,0.4444444444444444
SF-O18,SF-S22-2,1,1,0,1,1,0,0.0,1.0,1.0,0.0
SF-O18,SF-S22-1,6,12,2,10,4,2,0.3333333333333333,0.6666666666666666,0.8333333333333334,0.16666666666666666
SF-O18,SF-Q23-3,5,11,0,1,5,10,0.0,1.0,0.09090909090909091,0.9090909090909091
SF-O18,SF-Q22-1,11,18,3,4,8,14,0.2727272727272727,0.7272727272727273,0.2222222222222222,0.7777777777777778
SF-O18,SF-Q22-2,11,7,3,1,8,6,0.2727272727272727,0.7272727272727273,0.14285714285714285,0.8571428571428571
SF-O18,SF-P22,14,25,7,10,7,15,0.5,0.5,0.4,0.6
SF-O18,SF-W19,5,4,0,0,5,4,0.0,1.0,0.0,1.0
SF-O18,SF-U21,1,2,0,1,1,1,0.0,1.0,0.5,0.5
SF-O18,SF-T20,15,19,0,2,15,17,0.0,1.0,0.10526315789473684,0.8947368421052632
SF-O18,SF-S21,2,4,0,0,2,4,0.0,1.0,0.0,1.0
SF-O18,SF-BB17,1,3,0,0,1,3,0.0,1.0,0.0,1.0
SF-O18,SF-Y25,3,2,1,0,2,2,0.3333333333333333,0.6666666666666666,0.0,1.0
SF-O19,SF-M26,5,3,1,1,4,2,0.2,0.8,0.3333333333333333,0.6666666666666666
SF-O19,SF-M25,19,14,9,4,10,10,0.47368421052631576,0.5263157894736842,0.2857142857142857,0.7142857142857143
SF-O19,SF-M26-2,4,10,0,0,4,10,0.0,1.0,0.0,1.0
SF-O19,SF-K26,7,9,3,3,4,6,0.42857142857142855,0.5714285714285714,0.3333333333333333,0.6666666666666666
SF-O19,SF-M30,8,8,1,2,7,6,0.125,0.875,0.25,0.75
SF-O19,SF-L27-2,1,1,1,1,0,0,1.0,0.0,1.0,0.0
SF-O19,SF-J29,4,25,2,19,2,6,0.5,0.5,0.76,0.24
SF-O19,SF-L26,66,77,19,24,47,53,0.2878787878787879,0.7121212121212122,0.3116883116883117,0.6883116883116883
SF-O19,SF-M28,5,2,2,0,3,2,0.4,0.6,0.0,1.0
SF-O19,SF-L25,20,18,1,4,19,14,0.05,0.95,0.2222222222222222,0.7777777777777778
SF-O19,SF-M24,10,10,4,3,6,7,0.4,0.6,0.3,0.7
SF-O19,SF-L24,19,30,7,9,12,21,0.3684210526315789,0.631578947368421,0.3,0.7
SF-O19,SF-N23,14,27,6,17,8,10,0.42857142857142855,0.5714285714285714,0.6296296296296297,0.37037037037037035
SF-O19,SF-N24-2,12,7,4,2,8,5,0.3333333333333333,0.6666666666666666,0.2857142857142857,0.7142857142857143
SF-O19,SF-K27-2,11,18,1,1,10,17,0.09090909090909091,0.9090909090909091,0.05555555555555555,0.9444444444444444
SF-O19,SF-J26-2,9,22,0,3,9,19,0.0,1.0,0.13636363636363635,0.8636363636363636
SF-O19,SF-L28,2,5,1,2,1,3,0.5,0.5,0.4,0.6
SF-O19,SF-K28,1,1,0,1,1,0,0.0,1.0,1.0,0.0
SF-O19,SF-K29-1,5,3,1,1,4,2,0.2,0.8,0.3333333333333333,0.6666666666666666
SF-O19,SF-K25,35,41,16,24,19,17,0.45714285714285713,0.5428571428571428,0.5853658536585366,0.4146341463414634
SF-O19,SF-J25,19,6,7,5,12,1,0.3684210526315789,0.631578947368421,0.8333333333333334,0.16666666666666666
SF-O19,SF-H26-2,4,4,3,0,1,4,0.75,0.25,0.0,1.0
SF-O19,SF-P24,21,17,7,7,14,10,0.3333333333333333,0.6666666666666666,0.4117647058823529,0.5882352941176471
SF-O19,SF-N22-1A,2,3,1,2,1,1,0.5,0.5,0.6666666666666666,0.3333333333333333
SF-O19,SF-J24,13,7,3,1,10,6,0.23076923076923078,0.7692307692307693,0.14285714285714285,0.8571428571428571
SF-O19,SF-O24,12,6,2,2,10,4,0.16666666666666666,0.8333333333333334,0.3333333333333333,0.6666666666666666
SF-O19,SF-J26,10,13,4,4,6,9,0.4,0.6,0.3076923076923077,0.6923076923076923
SF-O19,SF-I26-,3,6,0,2,3,4,0.0,1.0,0.3333333333333333,0.6666666666666666
SF-O19,SF-I25,18,19,4,6,14,13,0.2222222222222222,0.7777777777777778,0.3157894736842105,0.6842105263157895
SF-O19,SF-K23,1,3,0,1,1,2,0.0,1.0,0.3333333333333333,0.6666666666666666
SF-O19,SF-H26,39,45,13,9,26,36,0.3333333333333333,0.6666666666666666,0.2,0.8
SF-O19,SF-O23,42,45,16,23,26,22,0.38095238095238093,0.6190476190476191,0.5111111111111111,0.4888888888888889
SF-O19,SF-H27-1,4,2,1,1,3,1,0.25,0.75,0.5,0.5
SF-O19,SF-F28-2,25,12,9,5,16,7,0.36,0.64,0.4166666666666667,0.5833333333333334
SF-O19,SF-G27,34,53,11,13,23,40,0.3235294117647059,0.6764705882352942,0.24528301886792453,0.7547169811320755
SF-O19,SF-M22-2,38,26,19,14,19,12,0.5,0.5,0.5384615384615384,0.46153846153846156
SF-O19,SF-L22,34,27,4,12,30,15,0.11764705882352941,0.8823529411764706,0.4444444444444444,0.5555555555555556
SF-O19,SF-F27,28,7,17,1,11,6,0.6071428571428571,0.39285714285714285,0.14285714285714285,0.8571428571428571
SF-O19,SF-N22-2,70,55,22,24,48,31,0.3142857142857143,0.6857142857142857,0.43636363636363634,0.5636363636363636
SF-O19,SF-G28-2,2,2,2,0,0,2,1.0,0.0,0.0,1.0
SF-O19,SF-M22-1,123,67,7,7,116,60,0.056910569105691054,0.943089430894309,0.1044776119402985,0.8955223880597015
SF-O19,SF-O25-1,6,14,0,3,6,11,0.0,1.0,0.21428571428571427,0.7857142857142857
SF-O19,SF-K22-2,12,7,5,3,7,4,0.4166666666666667,0.5833333333333334,0.42857142857142855,0.5714285714285714
SF-O19,SF-K24,11,10,3,4,8,6,0.2727272727272727,0.7272727272727273,0.4,0.6
SF-O19,SF-J23-2,11,5,4,3,7,2,0.36363636363636365,0.6363636363636364,0.6,0.4
SF-O19,SF-G23,8,7,2,1,6,6,0.25,0.75,0.14285714285714285,0.8571428571428571
SF-O19,SF-G24,39,25,7,2,32,23,0.1794871794871795,0.8205128205128205,0.08,0.92
SF-O19,SF-G25,17,6,6,1,11,5,0.35294117647058826,0.6470588235294118,0.16666666666666666,0.8333333333333334
SF-O19,SF-F23,55,35,15,21,40,14,0.2727272727272727,0.7272727272727273,0.6,0.4
SF-O19,SF-E23,18,15,8,4,10,11,0.4444444444444444,0.5555555555555556,0.26666666666666666,0.7333333333333333
SF-O19,SF-D24,8,4,2,2,6,2,0.25,0.75,0.5,0.5
SF-O19,SF-C22,3,5,0,0,3,5,0.0,1.0,0.0,1.0
SF-O19,SF-B22,2,3,1,0,1,3,0.5,0.5,0.0,1.0
SF-O19,SF-J17,27,11,6,1,21,10,0.2222222222222222,0.7777777777777778,0.09090909090909091,0.9090909090909091
SF-O19,SF-I19,8,11,0,0,8,11,0.0,1.0,0.0,1.0
SF-O19,SF-I20,5,1,2,0,3,1,0.4,0.6,0.0,1.0
SF-O19,SF-H16,3,2,1,0,2,2,0.3333333333333333,0.6666666666666666,0.0,1.0
SF-O19,SF-H19,5,11,0,0,5,11,0.0,1.0,0.0,1.0
SF-O19,SF-H20,10,6,2,0,8,6,0.2,0.8,0.0,1.0
SF-O19,SF-H18,5,3,0,0,5,3,0.0,1.0,0.0,1.0
SF-O19,SF-H17,6,12,0,0,6,12,0.0,1.0,0.0,1.0
SF-O19,SF-G19,9,7,3,0,6,7,0.3333333333333333,0.6666666666666666,0.0,1.0
SF-O19,SF-G17,2,3,0,0,2,3,0.0,1.0,0.0,1.0
SF-O19,SF-G18,12,15,1,0,11,15,0.08333333333333333,0.9166666666666666,0.0,1.0
SF-O19,SF-G20,4,5,2,1,2,4,0.5,0.5,0.2,0.8
SF-O19,SF-F19,7,12,0,0,7,12,0.0,1.0,0.0,1.0
SF-O19,SF-E18,9,3,4,0,5,3,0.4444444444444444,0.5555555555555556,0.0,1.0
SF-O19,SF-E20,19,18,2,0,17,18,0.10526315789473684,0.8947368421052632,0.0,1.0
SF-O19,SF-H30,2,7,0,5,2,2,0.0,1.0,0.7142857142857143,0.2857142857142857
SF-O19,SF-G30-2,12,19,1,2,11,17,0.08333333333333333,0.9166666666666666,0.10526315789473684,0.8947368421052632
SF-O19,SF-E29-2,11,18,6,6,5,12,0.5454545454545454,0.45454545454545453,0.3333333333333333,0.6666666666666666
SF-O19,SF-E29-1,13,10,5,2,8,8,0.38461538461538464,0.6153846153846154,0.2,0.8
SF-O19,SF-D29,2,1,2,0,0,1,1.0,0.0,0.0,1.0
SF-O19,SF-D28,2,4,0,2,2,2,0.0,1.0,0.5,0.5
SF-O19,SF-A27,3,2,2,0,1,2,0.6666666666666666,0.3333333333333333,0.0,1.0
SF-O19,SF-G29-2,4,4,2,0,2,4,0.5,0.5,0.0,1.0
SF-O19,SF-G30-1,5,7,1,2,4,5,0.2,0.8,0.2857142857142857,0.7142857142857143
SF-O19,SF-G29-3,7,11,4,0,3,11,0.5714285714285714,0.42857142857142855,0.0,1.0
SF-O19,SF-F29,4,1,0,0,4,1,0.0,1.0,0.0,1.0
SF-O19,SF-E29-3,3,3,0,3,3,0,0.0,1.0,1.0,0.0
SF-O19,SF-F28-1,4,7,1,3,3,4,0.25,0.75,0.42857142857142855,0.5714285714285714
SF-O19,SF-E28-2,2,1,2,0,0,1,1.0,0.0,0.0,1.0
SF-O19,SF-E28,9,23,2,0,7,23,0.2222222222222222,0.7777777777777778,0.0,1.0
SF-O19,SF-J10,12,13,4,5,8,8,0.3333333333333333,0.6666666666666666,0.38461538461538464,0.6153846153846154
SF-O19,SF-J12,13,4,3,0,10,4,0.23076923076923078,0.7692307692307693,0.0,1.0
SF-O19,SF-J13,6,9,1,1,5,8,0.16666666666666666,0.8333333333333334,0.1111111111111111,0.8888888888888888
SF-O19,SF-J15,6,3,0,1,6,2,0.0,1.0,0.3333333333333333,0.6666666666666666
SF-O19,SF-J14,1,1,0,0,1,1,0.0,1.0,0.0,1.0
SF-O19,SF-H13,3,8,0,0,3,8,0.0,1.0,0.0,1.0
SF-O19,SF-I16,5,1,3,0,2,1,0.6,0.4,0.0,1.0
SF-O19,SF-H12,8,9,1,0,7,9,0.125,0.875,0.0,1.0
SF-O19,SF-G10-2,5,1,2,0,3,1,0.4,0.6,0.0,1.0
SF-O19,SF-G13,4,2,0,0,4,2,0.0,1.0,0.0,1.0
SF-O19,SF-G11,3,1,3,1,0,0,1.0,0.0,1.0,0.0
SF-O19,SF-G12,5,6,2,0,3,6,0.4,0.6,0.0,1.0
SF-O19,SF-G10-1,2,4,0,2,2,2,0.0,1.0,0.5,0.5
SF-O19,SF-F15,6,3,2,3,4,0,0.3333333333333333,0.6666666666666666,1.0,0.0
SF-O19,SF-F16,3,2,1,0,2,2,0.3333333333333333,0.6666666666666666,0.0,1.0
SF-O19,SF-C20,1,3,0,2,1,1,0.0,1.0,0.6666666666666666,0.3333333333333333
SF-O19,SF-B19,8,3,0,0,8,3,0.0,1.0,0.0,1.0
SF-O19,SF-A20,1,5,0,3,1,2,0.0,1.0,0.6,0.4
SF-O19,SF-A19,3,4,0,1,3,3,0.0,1.0,0.25,0.75
SF-O19,SF-C26,3,10,0,1,3,9,0.0,1.0,0.1,0.9
SF-O19,SF-C25,11,7,0,0,11,7,0.0,1.0,0.0,1.0
SF-O19,SF-B25,2,4,0,0,2,4,0.0,1.0,0.0,1.0
SF-O19,SF-E27,46,4,15,0,31,4,0.32608695652173914,0.6739130434782609,0.0,1.0
SF-O19,SF-B28-2,2,1,2,0,0,1,1.0,0.0,0.0,1.0
SF-O19,SF-D27,4,15,2,4,2,11,0.5,0.5,0.26666666666666666,0.7333333333333333
SF-O19,SF-J1,28,30,22,12,6,18,0.7857142857142857,0.21428571428571427,0.4,0.6
SF-O19,SF-H0,9,7,2,2,7,5,0.2222222222222222,0.7777777777777778,0.2857142857142857,0.7142857142857143
SF-O19,SF-J5,6,5,4,0,2,5,0.6666666666666666,0.3333333333333333,0.0,1.0
SF-O19,SF-G5,5,2,3,0,2,2,0.6,0.4,0.0,1.0
SF-O19,SF-G7,3,2,1,0,2,2,0.3333333333333333,0.6666666666666666,0.0,1.0
SF-O19,SF-H25,1,2,0,1,1,1,0.0,1.0,0.5,0.5
SF-O19,SF-G26,10,19,0,11,10,8,0.0,1.0,0.5789473684210527,0.42105263157894735
SF-O19,SF-K21,8,13,3,0,5,13,0.375,0.625,0.0,1.0
SF-O19,SF-K22-1,27,31,9,16,18,15,0.3333333333333333,0.6666666666666666,0.5161290322580645,0.4838709677419355
SF-O19,SF-J23-1,49,47,10,10,39,37,0.20408163265306123,0.7959183673469388,0.2127659574468085,0.7872340425531915
SF-O19,SF-J22-1,16,18,2,2,14,16,0.125,0.875,0.1111111111111111,0.8888888888888888
SF-O19,SF-J22-2,7,7,1,2,6,5,0.14285714285714285,0.8571428571428571,0.2857142857142857,0.7142857142857143
SF-O19,SF-J21,25,12,7,1,18,11,0.28,0.72,0.08333333333333333,0.9166666666666666
SF-O19,SF-I21,2,1,1,0,1,1,0.5,0.5,0.0,1.0
SF-O19,SF-I22,6,1,1,0,5,1,0.16666666666666666,0.8333333333333334,0.0,1.0
SF-O19,SF-I23-2,10,8,3,1,7,7,0.3,0.7,0.125,0.875
SF-O19,SF-I24,10,3,2,1,8,2,0.2,0.8,0.3333333333333333,0.6666666666666666
SF-O19,SF-I23-1,7,6,0,2,7,4,0.0,1.0,0.3333333333333333,0.6666666666666666
SF-O19,SF-F26,21,21,3,3,18,18,0.14285714285714285,0.8571428571428571,0.14285714285714285,0.8571428571428571
SF-O19,SF-M13,30,12,10,1,20,11,0.3333333333333333,0.6666666666666666,0.08333333333333333,0.9166666666666666
SF-O19,SF-M15,26,29,4,4,22,25,0.15384615384615385,0.8461538461538461,0.13793103448275862,0.8620689655172413
SF-O19,SF-L19,27,47,11,10,16,37,0.4074074074074074,0.5925925925925926,0.2127659574468085,0.7872340425531915
SF-O19,SF-L20,32,9,17,3,15,6,0.53125,0.46875,0.3333333333333333,0.6666666666666666
SF-O19,SF-N20-1,17,12,12,5,5,7,0.7058823529411765,0.29411764705882354,0.4166666666666667,0.5833333333333334
SF-O19,SF-M20,35,29,19,12,16,17,0.5428571428571428,0.45714285714285713,0.41379310344827586,0.5862068965517241
SF-O19,SF-K17-2,51,32,27,2,24,30,0.5294117647058824,0.47058823529411764,0.0625,0.9375
SF-O19,SF-K20,32,20,16,9,16,11,0.5,0.5,0.45,0.55
SF-O19,SF-K15-,53,68,17,3,36,65,0.32075471698113206,0.6792452830188679,0.04411764705882353,0.9558823529411765
SF-O19,SF-K19,16,20,10,7,6,13,0.625,0.375,0.35,0.65
SF-O19,SF-K18,33,26,20,5,13,21,0.6060606060606061,0.3939393939393939,0.19230769230769232,0.8076923076923077
SF-O19,SF-K17,20,24,10,6,10,18,0.5,0.5,0.25,0.75
SF-O19,SF-J16,12,30,9,1,3,29,0.75,0.25,0.03333333333333333,0.9666666666666667
SF-O19,SF-J18,50,23,8,0,42,23,0.16,0.84,0.0,1.0
SF-O19,SF-J20,3,3,2,0,1,3,0.6666666666666666,0.3333333333333333,0.0,1.0
SF-O19,SF-J19,15,10,2,0,13,10,0.13333333333333333,0.8666666666666667,0.0,1.0
SF-O19,SF-M12,7,7,1,1,6,6,0.14285714285714285,0.8571428571428571,0.14285714285714285,0.8571428571428571
SF-O19,SF-M10,8,5,5,0,3,5,0.625,0.375,0.0,1.0
SF-O19,SF-M11,13,13,3,3,10,10,0.23076923076923078,0.7692307692307693,0.23076923076923078,0.7692307692307693
SF-O19,SF-R19,9,12,0,2,9,10,0.0,1.0,0.16666666666666666,0.8333333333333334
SF-O19,SF-R20,13,6,2,0,11,6,0.15384615384615385,0.8461538461538461,0.0,1.0
SF-O19,SF-Q21-2,7,5,1,0,6,5,0.14285714285714285,0.8571428571428571,0.0,1.0
SF-O19,SF-Q21-1,16,3,3,1,13,2,0.1875,0.8125,0.3333333333333333,0.6666666666666666
SF-O19,SF-P21,14,14,6,1,8,13,0.42857142857142855,0.5714285714285714,0.07142857142857142,0.9285714285714286
SF-O19,SF-O18,76,39,52,5,24,34,0.6842105263157895,0.3157894736842105,0.1282051282051282,0.8717948717948718
SF-O19,SF-O21,87,111,43,69,44,42,0.4942528735632184,0.5057471264367817,0.6216216216216216,0.3783783783783784
SF-O19,SF-O22,66,94,21,36,45,58,0.3181818181818182,0.6818181818181818,0.3829787234042553,0.6170212765957447
SF-O19,SF-N21,48,25,21,12,27,13,0.4375,0.5625,0.48,0.52
SF-O19,SF-N20-2,12,19,10,13,2,6,0.8333333333333334,0.16666666666666666,0.6842105263157895,0.3157894736842105
SF-O19,SF-M21,48,21,17,2,31,19,0.3541666666666667,0.6458333333333334,0.09523809523809523,0.9047619047619048
SF-O19,SF-L21,98,37,31,10,67,27,0.3163265306122449,0.6836734693877551,0.2702702702702703,0.7297297297297297
SF-O19,SF-Q30,46,23,0,1,46,22,0.0,1.0,0.043478260869565216,0.9565217391304348
SF-O19,SF-P30,27,11,0,3,27,8,0.0,1.0,0.2727272727272727,0.7272727272727273
SF-O19,SF-O30-2,4,8,1,2,3,6,0.25,0.75,0.25,0.75
SF-O19,SF-O30,20,12,0,0,20,12,0.0,1.0,0.0,1.0
SF-O19,SF-N27,10,12,3,3,7,9,0.3,0.7,0.25,0.75
SF-O19,SF-N29,11,10,6,4,5,6,0.5454545454545454,0.45454545454545453,0.4,0.6
SF-O19,SF-N28,15,14,6,5,9,9,0.4,0.6,0.35714285714285715,0.6428571428571429
SF-O19,SF-L30-1,7,13,3,2,4,11,0.42857142857142855,0.5714285714285714,0.15384615384615385,0.8461538461538461
SF-O19,SF-L31-1,3,5,2,2,1,3,0.6666666666666666,0.3333333333333333,0.4,0.6
SF-O19,SF-L29,8,4,0,1,8,3,0.0,1.0,0.25,0.75
SF-O19,SF-J29-1,1,2,0,0,1,2,0.0,1.0,0.0,1.0
SF-O19,SF-I27,6,6,1,1,5,5,0.16666666666666666,0.8333333333333334,0.16666666666666666,0.8333333333333334
SF-O19,SF-I30-2,4,3,0,0,4,3,0.0,1.0,0.0,1.0
SF-O19,SF I29-1,5,1,0,0,5,1,0.0,1.0,0.0,1.0
SF-O19,SF-H28,1,5,0,0,1,5,0.0,1.0,0.0,1.0
SF-O19,SF-H29,1,1,1,1,0,0,1.0,0.0,1.0,0.0
SF-O19,SF-S24,14,18,5,8,9,10,0.35714285714285715,0.6428571428571429,0.4444444444444444,0.5555555555555556
SF-O19,SF-R24,60,18,19,8,41,10,0.31666666666666665,0.6833333333333333,0.4444444444444444,0.5555555555555556
SF-O19,SF-R26,8,6,1,3,7,3,0.125,0.875,0.5,0.5
SF-O19,SF-Q26,6,7,1,0,5,7,0.16666666666666666,0.8333333333333334,0.0,1.0
SF-O19,SF-P26,15,12,2,1,13,11,0.13333333333333333,0.8666666666666667,0.08333333333333333,0.9166666666666666
SF-O19,SF-O25-2,8,9,3,4,5,5,0.375,0.625,0.4444444444444444,0.5555555555555556
SF-O19,SF-N22-1B,24,39,8,11,16,28,0.3333333333333333,0.6666666666666666,0.28205128205128205,0.717948717948718
SF-O19,SF-N26,2,2,0,0,2,2,0.0,1.0,0.0,1.0
SF-O19,SF-N25,56,22,46,10,10,12,0.8214285714285714,0.17857142857142858,0.45454545454545453,0.5454545454545454
SF-O19,SF-T21,11,8,4,0,7,8,0.36363636363636365,0.6363636363636364,0.0,1.0
SF-O19,SF-T22,14,19,4,7,10,12,0.2857142857142857,0.7142857142857143,0.3684210526315789,0.631578947368421
SF-O19,SF-S22-2,17,8,2,0,15,8,0.11764705882352941,0.8823529411764706,0.0,1.0
SF-O19,SF-S22-1,23,22,6,7,17,15,0.2608695652173913,0.7391304347826086,0.3181818181818182,0.6818181818181818
SF-O19,SF-Q23-3,25,20,7,7,18,13,0.28,0.72,0.35,0.65
SF-O19,SF-Q22-1,30,27,10,14,20,13,0.3333333333333333,0.6666666666666666,0.5185185185185185,0.48148148148148145
SF-O19,SF-Q22-2,49,38,21,11,28,27,0.42857142857142855,0.5714285714285714,0.2894736842105263,0.7105263157894737
SF-O19,SF-P22,18,40,10,17,8,23,0.5555555555555556,0.4444444444444444,0.425,0.575
SF-O19,SF-W19,5,6,2,0,3,6,0.4,0.6,0.0,1.0
SF-O19,SF-W19-2,1,1,0,0,1,1,0.0,1.0,0.0,1.0
SF-O19,SF-U21,5,3,2,1,3,2,0.4,0.6,0.3333333333333333,0.6666666666666666
SF-O19,SF-T20,9,9,4,2,5,7,0.4444444444444444,0.5555555555555556,0.2222222222222222,0.7777777777777778
SF-O19,SF-S21,9,10,0,0,9,10,0.0,1.0,0.0,1.0
SF-O19,SF-V28,5,1,2,0,3,1,0.4,0.6,0.0,1.0
SF-O19,SF-V32,1,20,0,18,1,2,0.0,1.0,0.9,0.1
SF-O19,SF-W14,6,6,0,0,6,6,0.0,1.0,0.0,1.0
SF-O19,SF-X19,2,3,1,0,1,3,0.5,0.5,0.0,1.0
SF-O21,SF-M26,1,2,0,0,1,2,0.0,1.0,0.0,1.0
SF-O21,SF-M25,26,12,11,3,15,9,0.4230769230769231,0.5769230769230769,0.25,0.75
SF-O21,SF-M26-2,12,7,5,2,7,5,0.4166666666666667,0.5833333333333334,0.2857142857142857,0.7142857142857143
SF-O21,SF-L27,4,1,3,1,1,0,0.75,0.25,1.0,0.0
SF-O21,SF-K26,20,23,7,2,13,21,0.35,0.65,0.08695652173913043,0.9130434782608695
SF-O21,SF-J27,3,2,1,1,2,1,0.3333333333333333,0.6666666666666666,0.5,0.5
SF-O21,SF-M30,73,99,6,11,67,88,0.0821917808219178,0.9178082191780822,0.1111111111111111,0.8888888888888888
SF-O21,SF-J29-3,9,7,2,2,7,5,0.2222222222222222,0.7777777777777778,0.2857142857142857,0.7142857142857143
SF-O21,SF-J29,23,29,3,8,20,21,0.13043478260869565,0.8695652173913043,0.27586206896551724,0.7241379310344828
SF-O21,SF-L26,29,55,6,15,23,40,0.20689655172413793,0.7931034482758621,0.2727272727272727,0.7272727272727273
SF-O21,SF-M28,28,25,11,9,17,16,0.39285714285714285,0.6071428571428571,0.36,0.64
SF-O21,SF-M27,2,3,2,0,0,3,1.0,0.0,0.0,1.0
SF-O21,SF-L25,16,17,8,10,8,7,0.5,0.5,0.5882352941176471,0.4117647058823529
SF-O21,SF-M24,35,32,23,25,12,7,0.6571428571428571,0.34285714285714286,0.78125,0.21875
SF-O21,SF-L24,27,32,11,16,16,16,0.4074074074074074,0.5925925925925926,0.5,0.5
SF-O21,SF-N23,24,19,9,10,15,9,0.375,0.625,0.5263157894736842,0.47368421052631576
SF-O21,SF-N24-2,27,30,8,20,19,10,0.2962962962962963,0.7037037037037037,0.6666666666666666,0.3333333333333333
SF-O21,SF-K27-2,22,25,12,11,10,14,0.5454545454545454,0.45454545454545453,0.44,0.56
SF-O21,SF-J26-2,21,28,5,2,16,26,0.23809523809523808,0.7619047619047619,0.07142857142857142,0.9285714285714286
SF-O21,SF-K28-3,3,2,2,0,1,2,0.6666666666666666,0.3333333333333333,0.0,1.0
SF-O21,SF-L28,15,13,11,4,4,9,0.7333333333333333,0.26666666666666666,0.3076923076923077,0.6923076923076923
SF-O21,SF-K28,9,5,5,1,4,4,0.5555555555555556,0.4444444444444444,0.2,0.8
SF-O21,SF-K29-1,26,28,8,4,18,24,0.3076923076923077,0.6923076923076923,0.14285714285714285,0.8571428571428571
SF-O21,SF-J28-2,23,12,10,6,13,6,0.43478260869565216,0.5652173913043478,0.5,0.5
SF-O21,SF-K27,3,2,1,1,2,1,0.3333333333333333,0.6666666666666666,0.5,0.5
SF-O21,SF-K25,42,49,20,22,22,27,0.47619047619047616,0.5238095238095238,0.4489795918367347,0.5510204081632653
SF-O21,SF-J25,90,68,37,40,53,28,0.4111111111111111,0.5888888888888889,0.5882352941176471,0.4117647058823529
SF-O21,SF-H26-2,18,13,8,9,10,4,0.4444444444444444,0.5555555555555556,0.6923076923076923,0.3076923076923077
SF-O21,SF-P24,35,19,18,7,17,12,0.5142857142857142,0.4857142857142857,0.3684210526315789,0.631578947368421
SF-O21,SF-N22-1A,10,8,1,4,9,4,0.1,0.9,0.5,0.5
SF-O21,SF-J24,39,35,5,24,34,11,0.1282051282051282,0.8717948717948718,0.6857142857142857,0.3142857142857143
SF-O21,SF-O24,24,17,14,14,10,3,0.5833333333333334,0.4166666666666667,0.8235294117647058,0.17647058823529413
SF-O21,SF-J26,11,47,7,6,4,41,0.6363636363636364,0.36363636363636365,0.1276595744680851,0.8723404255319149
SF-O21,SF-I26-,13,4,7,1,6,3,0.5384615384615384,0.46153846153846156,0.25,0.75
SF-O21,SF-I25,48,41,29,13,19,28,0.6041666666666666,0.3958333333333333,0.3170731707317073,0.6829268292682927
SF-O21,SF-K23,10,11,7,7,3,4,0.7,0.3,0.6363636363636364,0.36363636363636365
SF-O21,SF-H26,57,49,37,22,20,27,0.6491228070175439,0.3508771929824561,0.4489795918367347,0.5510204081632653
SF-O21,SF-O23,26,17,16,8,10,9,0.6153846153846154,0.38461538461538464,0.47058823529411764,0.5294117647058824
SF-O21,SF-H27-1,10,6,3,4,7,2,0.3,0.7,0.6666666666666666,0.3333333333333333
SF-O21,SF-F28-2,38,30,20,13,18,17,0.5263157894736842,0.47368421052631576,0.43333333333333335,0.5666666666666667
SF-O21,SF-G27,30,42,8,11,22,31,0.26666666666666666,0.7333333333333333,0.2619047619047619,0.7380952380952381
SF-O21,SF-M22-2,35,39,21,27,14,12,0.6,0.4,0.6923076923076923,0.3076923076923077
SF-O21,SF-L22,42,54,19,21,23,33,0.4523809523809524,0.5476190476190477,0.3888888888888889,0.6111111111111112
SF-O21,SF-F27,8,9,1,6,7,3,0.125,0.875,0.6666666666666666,0.3333333333333333
SF-O21,SF-N22-2,45,52,30,33,15,19,0.6666666666666666,0.3333333333333333,0.6346153846153846,0.36538461538461536
SF-O21,SF-G28-2,7,3,3,0,4,3,0.42857142857142855,0.5714285714285714,0.0,1.0
SF-O21,SF-G28-1,6,5,3,2,3,3,0.5,0.5,0.4,0.6
SF-O21,SF-M22-1,27,30,9,3,18,27,0.3333333333333333,0.6666666666666666,0.1,0.9
SF-O21,SF-O25-1,24,25,9,5,15,20,0.375,0.625,0.2,0.8
SF-O21,SF-K22-2,49,38,20,14,29,24,0.40816326530612246,0.5918367346938775,0.3684210526315789,0.631578947368421
SF-O21,SF-K24,22,15,6,3,16,12,0.2727272727272727,0.7272727272727273,0.2,0.8
SF-O21,SF-J23-2,22,18,16,6,6,12,0.7272727272727273,0.2727272727272727,0.3333333333333333,0.6666666666666666
SF-O21,SF-G23,27,15,11,3,16,12,0.4074074074074074,0.5925925925925926,0.2,0.8
SF-O21,SF-G24,32,34,7,3,25,31,0.21875,0.78125,0.08823529411764706,0.9117647058823529
SF-O21,SF-G25,27,17,11,2,16,15,0.4074074074074074,0.5925925925925926,0.11764705882352941,0.8823529411764706
SF-O21,SF-F23,22,24,9,5,13,19,0.4090909090909091,0.5909090909090909,0.20833333333333334,0.7916666666666666
SF-O21,SF-E23,34,35,4,3,30,32,0.11764705882352941,0.8823529411764706,0.08571428571428572,0.9142857142857143
SF-O21,SF-D24,7,9,1,0,6,9,0.14285714285714285,0.8571428571428571,0.0,1.0
SF-O21,SF-C22,22,11,2,0,20,11,0.09090909090909091,0.9090909090909091,0.0,1.0
SF-O21,SF-B22,10,15,0,6,10,9,0.0,1.0,0.4,0.6
SF-O21,SF-J17,65,34,26,1,39,33,0.4,0.6,0.029411764705882353,0.9705882352941176
SF-O21,SF-I19,15,7,4,1,11,6,0.26666666666666666,0.7333333333333333,0.14285714285714285,0.8571428571428571
SF-O21,SF-I20,11,3,3,0,8,3,0.2727272727272727,0.7272727272727273,0.0,1.0
SF-O21,SF-H16,17,7,2,0,15,7,0.11764705882352941,0.8823529411764706,0.0,1.0
SF-O21,SF-H19,5,1,2,0,3,1,0.4,0.6,0.0,1.0
SF-O21,SF-H20,12,19,3,9,9,10,0.25,0.75,0.47368421052631576,0.5263157894736842
SF-O21,SF-H18,11,3,0,0,11,3,0.0,1.0,0.0,1.0
SF-O21,SF-H17,10,16,0,0,10,16,0.0,1.0,0.0,1.0
SF-O21,SF-G19,6,5,2,1,4,4,0.3333333333333333,0.6666666666666666,0.2,0.8
SF-O21,SF-G17,8,5,1,0,7,5,0.125,0.875,0.0,1.0
SF-O21,SF-G18,27,27,1,1,26,26,0.037037037037037035,0.9629629629629629,0.037037037037037035,0.9629629629629629
SF-O21,SF-G20,24,16,8,1,16,15,0.3333333333333333,0.6666666666666666,0.0625,0.9375
SF-O21,SF-F19,13,15,2,3,11,12,0.15384615384615385,0.8461538461538461,0.2,0.8
SF-O21,SF-E18,13,8,1,2,12,6,0.07692307692307693,0.9230769230769231,0.25,0.75
SF-O21,SF-E20,12,13,2,0,10,13,0.16666666666666666,0.8333333333333334,0.0,1.0
SF-O21,SF-H30,12,12,3,4,9,8,0.25,0.75,0.3333333333333333,0.6666666666666666
SF-O21,SF-G30-2,11,10,4,1,7,9,0.36363636363636365,0.6363636363636364,0.1,0.9
SF-O21,SF-F30-1,3,1,1,0,2,1,0.3333333333333333,0.6666666666666666,0.0,1.0
SF-O21,SF-E29-2,7,39,1,14,6,25,0.14285714285714285,0.8571428571428571,0.358974358974359,0.6410256410256411
SF-O21,SF-E29-1,10,15,1,3,9,12,0.1,0.9,0.2,0.8
SF-O21,SF-D29,1,6,0,0,1,6,0.0,1.0,0.0,1.0
SF-O21,SF-D28,7,12,3,8,4,4,0.42857142857142855,0.5714285714285714,0.6666666666666666,0.3333333333333333
SF-O21,SF-A27,5,6,3,0,2,6,0.6,0.4,0.0,1.0
SF-O21,SF-G29-2,15,23,8,9,7,14,0.5333333333333333,0.4666666666666667,0.391304347826087,0.6086956521739131
SF-O21,SF-G29-1,8,4,1,2,7,2,0.125,0.875,0.5,0.5
SF-O21,SF-G30-1,10,18,2,6,8,12,0.2,0.8,0.3333333333333333,0.6666666666666666
SF-O21,SF-G29-3,16,11,5,1,11,10,0.3125,0.6875,0.09090909090909091,0.9090909090909091
SF-O21,SF-F30-2,5,6,0,2,5,4,0.0,1.0,0.3333333333333333,0.6666666666666666
SF-O21,SF-F29,7,4,6,2,1,2,0.8571428571428571,0.14285714285714285,0.5,0.5
SF-O21,SF-E29-3,11,3,5,0,6,3,0.45454545454545453,0.5454545454545454,0.0,1.0
SF-O21,SF-F28-1,10,4,2,2,8,2,0.2,0.8,0.5,0.5
SF-O21,SF-E28,4,1,1,0,3,1,0.25,0.75,0.0,1.0
SF-O21,SF-J10,21,9,8,2,13,7,0.38095238095238093,0.6190476190476191,0.2222222222222222,0.7777777777777778
SF-O21,SF-J12,21,19,3,3,18,16,0.14285714285714285,0.8571428571428571,0.15789473684210525,0.8421052631578947
SF-O21,SF-J13,15,14,5,0,10,14,0.3333333333333333,0.6666666666666666,0.0,1.0
SF-O21,SF-J15,6,4,1,0,5,4,0.16666666666666666,0.8333333333333334,0.0,1.0
SF-O21,SF-J14,1,1,0,0,1,1,0.0,1.0,0.0,1.0
SF-O21,SF-H13,6,5,3,0,3,5,0.5,0.5,0.0,1.0
SF-O21,SF-I16,4,4,0,1,4,3,0.0,1.0,0.25,0.75
SF-O21,SF-H12,4,5,3,0,1,5,0.75,0.25,0.0,1.0
SF-O21,SF-G10-2,3,1,0,0,3,1,0.0,1.0,0.0,1.0
SF-O21,SF-H15,5,4,2,1,3,3,0.4,0.6,0.25,0.75
SF-O21,SF-G9,2,1,0,0,2,1,0.0,1.0,0.0,1.0
SF-O21,SF-G13,6,3,1,1,5,2,0.16666666666666666,0.8333333333333334,0.3333333333333333,0.6666666666666666
SF-O21,SF-G11,2,1,0,0,2,1,0.0,1.0,0.0,1.0
SF-O21,SF-G12,6,6,4,2,2,4,0.6666666666666666,0.3333333333333333,0.3333333333333333,0.6666666666666666
SF-O21,SF-G10-1,5,6,0,0,5,6,0.0,1.0,0.0,1.0
SF-O21,SF-F15,7,2,1,0,6,2,0.14285714285714285,0.8571428571428571,0.0,1.0
SF-O21,SF-F16,6,1,1,0,5,1,0.16666666666666666,0.8333333333333334,0.0,1.0
SF-O21,SF-C20,8,9,0,0,8,9,0.0,1.0,0.0,1.0
SF-O21,SF-B21,3,3,1,0,2,3,0.3333333333333333,0.6666666666666666,0.0,1.0
SF-O21,SF-B19,7,14,1,3,6,11,0.14285714285714285,0.8571428571428571,0.21428571428571427,0.7857142857142857
SF-O21,SF-A20,11,9,0,2,11,7,0.0,1.0,0.2222222222222222,0.7777777777777778
SF-O21,SF-C26,7,11,2,2,5,9,0.2857142857142857,0.7142857142857143,0.18181818181818182,0.8181818181818182
SF-O21,SF-C25,29,21,5,5,24,16,0.1724137931034483,0.8275862068965517,0.23809523809523808,0.7619047619047619
SF-O21,SF-B25,8,5,0,1,8,4,0.0,1.0,0.2,0.8
SF-O21,SF-E27,5,4,2,1,3,3,0.4,0.6,0.25,0.75
SF-O21,SF-B28-2,1,4,0,0,1,4,0.0,1.0,0.0,1.0
SF-O21,SF-D27,13,11,3,3,10,8,0.23076923076923078,0.7692307692307693,0.2727272727272727,0.7272727272727273
SF-O21,SF-C28-2,1,3,0,2,1,1,0.0,1.0,0.6666666666666666,0.3333333333333333
SF-O21,SF-B28,3,6,1,1,2,5,0.3333333333333333,0.6666666666666666,0.16666666666666666,0.8333333333333334
SF-O21,SF-J1,7,22,1,6,6,16,0.14285714285714285,0.8571428571428571,0.2727272727272727,0.7272727272727273
SF-O21,SF-H0,6,6,0,0,6,6,0.0,1.0,0.0,1.0
SF-O21,SF-J3,4,5,2,3,2,2,0.5,0.5,0.6,0.4
SF-O21,SF-J5,1,4,0,2,1,2,0.0,1.0,0.5,0.5
SF-O21,SF-G5,2,2,0,0,2,2,0.0,1.0,0.0,1.0
SF-O21,SF-G7,7,6,1,2,6,4,0.14285714285714285,0.8571428571428571,0.3333333333333333,0.6666666666666666
SF-O21,SF-F9,4,5,2,0,2,5,0.5,0.5,0.0,1.0
SF-O21,SF-H25,12,7,2,2,10,5,0.16666666666666666,0.8333333333333334,0.2857142857142857,0.7142857142857143
SF-O21,SF-G26,21,15,10,7,11,8,0.47619047619047616,0.5238095238095238,0.4666666666666667,0.5333333333333333
SF-O21,SF-K21,60,32,30,3,30,29,0.5,0.5,0.09375,0.90625
SF-O21,SF-K22-1,64,29,35,10,29,19,0.546875,0.453125,0.3448275862068966,0.6551724137931034
SF-O21,SF-J23-1,130,94,67,34,63,60,0.5153846153846153,0.4846153846153846,0.3617021276595745,0.6382978723404256
SF-O21,SF-J22-1,48,28,16,5,32,23,0.3333333333333333,0.6666666666666666,0.17857142857142858,0.8214285714285714
SF-O21,SF-J22-2,27,22,9,8,18,14,0.3333333333333333,0.6666666666666666,0.36363636363636365,0.6363636363636364
SF-O21,SF-J21,30,56,15,16,15,40,0.5,0.5,0.2857142857142857,0.7142857142857143
SF-O21,SF-I21,7,5,4,2,3,3,0.5714285714285714,0.42857142857142855,0.4,0.6
SF-O21,SF-I22,31,27,11,5,20,22,0.3548387096774194,0.6451612903225806,0.18518518518518517,0.8148148148148148
SF-O21,SF-I23-2,16,25,6,8,10,17,0.375,0.625,0.32,0.68
SF-O21,SF-I24,21,6,7,1,14,5,0.3333333333333333,0.6666666666666666,0.16666666666666666,0.8333333333333334
SF-O21,SF-I23-1,24,12,7,1,17,11,0.2916666666666667,0.7083333333333334,0.08333333333333333,0.9166666666666666
SF-O21,SF-F26,42,23,14,12,28,11,0.3333333333333333,0.6666666666666666,0.5217391304347826,0.4782608695652174
SF-O21,SF-M13,50,52,10,9,40,43,0.2,0.8,0.17307692307692307,0.8269230769230769
SF-O21,SF-M15,80,51,24,2,56,49,0.3,0.7,0.0392156862745098,0.9607843137254902
SF-O21,SF-L19,66,44,21,4,45,40,0.3181818181818182,0.6818181818181818,0.09090909090909091,0.9090909090909091
SF-O21,SF-L20,90,66,38,15,52,51,0.4222222222222222,0.5777777777777777,0.22727272727272727,0.7727272727272727
SF-O21,SF-N20-1,32,22,19,7,13,15,0.59375,0.40625,0.3181818181818182,0.6818181818181818
SF-O21,SF-M20,65,57,35,19,30,38,0.5384615384615384,0.46153846153846156,0.3333333333333333,0.6666666666666666
SF-O21,SF-K17-2,116,45,58,3,58,42,0.5,0.5,0.06666666666666667,0.9333333333333333
SF-O21,SF-K20,100,74,51,23,49,51,0.51,0.49,0.3108108108108108,0.6891891891891891
SF-O21,SF-K15-,96,72,21,13,75,59,0.21875,0.78125,0.18055555555555555,0.8194444444444444
SF-O21,SF-K19,123,67,68,12,55,55,0.5528455284552846,0.44715447154471544,0.1791044776119403,0.8208955223880597
SF-O21,SF-K18,77,37,30,8,47,29,0.38961038961038963,0.6103896103896104,0.21621621621621623,0.7837837837837838
SF-O21,SF-K17,87,108,36,3,51,105,0.41379310344827586,0.5862068965517241,0.027777777777777776,0.9722222222222222
SF-O21,SF-J16,86,28,4,1,82,27,0.046511627906976744,0.9534883720930233,0.03571428571428571,0.9642857142857143
SF-O21,SF-J18,72,55,27,4,45,51,0.375,0.625,0.07272727272727272,0.9272727272727272
SF-O21,SF-J20,15,7,6,0,9,7,0.4,0.6,0.0,1.0
SF-O21,SF-J19,33,37,9,5,24,32,0.2727272727272727,0.7272727272727273,0.13513513513513514,0.8648648648648649
SF-O21,SF-M12,31,21,5,4,26,17,0.16129032258064516,0.8387096774193549,0.19047619047619047,0.8095238095238095
SF-O21,SF-M10,13,12,7,5,6,7,0.5384615384615384,0.46153846153846156,0.4166666666666667,0.5833333333333334
SF-O21,SF-M11,23,24,8,1,15,23,0.34782608695652173,0.6521739130434783,0.041666666666666664,0.9583333333333334
SF-O21,SF-R19,19,8,6,0,13,8,0.3157894736842105,0.6842105263157895,0.0,1.0
SF-O21,SF-R20,10,7,6,0,4,7,0.6,0.4,0.0,1.0
SF-O21,SF-Q21-2,15,25,8,3,7,22,0.5333333333333333,0.4666666666666667,0.12,0.88
SF-O21,SF-Q21-1,15,10,4,3,11,7,0.26666666666666666,0.7333333333333333,0.3,0.7
SF-O21,SF-P21,74,23,47,8,27,15,0.6351351351351351,0.36486486486486486,0.34782608695652173,0.6521739130434783
SF-O21,SF-O18,57,54,27,10,30,44,0.47368421052631576,0.5263157894736842,0.18518518518518517,0.8148148148148148
SF-O21,SF-O19,111,87,69,43,42,44,0.6216216216216216,0.3783783783783784,0.4942528735632184,0.5057471264367817
SF-O21,SF-O22,35,82,19,46,16,36,0.5428571428571428,0.45714285714285713,0.5609756097560976,0.43902439024390244
SF-O21,SF-N21,16,52,9,21,7,31,0.5625,0.4375,0.40384615384615385,0.5961538461538461
SF-O21,SF-N20-2,10,34,7,25,3,9,0.7,0.3,0.7352941176470589,0.2647058823529412
SF-O21,SF-M21,91,44,53,16,38,28,0.5824175824175825,0.4175824175824176,0.36363636363636365,0.6363636363636364
SF-O21,SF-L21,124,89,58,19,66,70,0.46774193548387094,0.532258064516129,0.21348314606741572,0.7865168539325843
SF-O21,SF-S30,2,3,2,1,0,2,1.0,0.0,0.3333333333333333,0.6666666666666666
SF-O21,SF-Q30,10,8,2,1,8,7,0.2,0.8,0.125,0.875
SF-O21,SF-P30,10,22,4,2,6,20,0.4,0.6,0.09090909090909091,0.9090909090909091
SF-O21,SF-O30-2,14,12,1,2,13,10,0.07142857142857142,0.9285714285714286,0.16666666666666666,0.8333333333333334
SF-O21,SF-O30,30,25,9,13,21,12,0.3,0.7,0.52,0.48
SF-O21,SF-N27,26,24,10,5,16,19,0.38461538461538464,0.6153846153846154,0.20833333333333334,0.7916666666666666
SF-O21,SF-N29,18,13,3,4,15,9,0.16666666666666666,0.8333333333333334,0.3076923076923077,0.6923076923076923
SF-O21,SF-N28,27,31,8,11,19,20,0.2962962962962963,0.7037037037037037,0.3548387096774194,0.6451612903225806
SF-O21,SF-L30-1,39,27,10,7,29,20,0.2564102564102564,0.7435897435897436,0.25925925925925924,0.7407407407407407
SF-O21,SF-L31-1,3,5,1,0,2,5,0.3333333333333333,0.6666666666666666,0.0,1.0
SF-O21,SF-K30-2,2,5,0,2,2,3,0.0,1.0,0.4,0.6
SF-O21,SF-L29,25,26,6,5,19,21,0.24,0.76,0.19230769230769232,0.8076923076923077
SF-O21,SF-J29-1,12,13,5,2,7,11,0.4166666666666667,0.5833333333333334,0.15384615384615385,0.8461538461538461
SF-O21,SF-I30,9,11,6,3,3,8,0.6666666666666666,0.3333333333333333,0.2727272727272727,0.7272727272727273
SF-O21,SF-I29-2,10,5,0,2,10,3,0.0,1.0,0.4,0.6
SF-O21,SF-I27,22,36,13,16,9,20,0.5909090909090909,0.4090909090909091,0.4444444444444444,0.5555555555555556
SF-O21,SF-I28,6,8,2,3,4,5,0.3333333333333333,0.6666666666666666,0.375,0.625
SF-O21,SF-I30-2,12,6,1,4,11,2,0.08333333333333333,0.9166666666666666,0.6666666666666666,0.3333333333333333
SF-O21,SF I29-1,13,1,2,0,11,1,0.15384615384615385,0.8461538461538461,0.0,1.0
SF-O21,SF-H28,24,27,13,17,11,10,0.5416666666666666,0.4583333333333333,0.6296296296296297,0.37037037037037035
SF-O21,SF-H29,2,2,0,0,2,2,0.0,1.0,0.0,1.0
SF-O21,SF-S24,42,29,13,9,29,20,0.30952380952380953,0.6904761904761905,0.3103448275862069,0.6896551724137931
SF-O21,SF-R24,80,64,42,22,38,42,0.525,0.475,0.34375,0.65625
SF-O21,SF-R26,15,9,12,8,3,1,0.8,0.2,0.8888888888888888,0.1111111111111111
SF-O21,SF-Q26,30,14,9,1,21,13,0.3,0.7,0.07142857142857142,0.9285714285714286
SF-O21,SF-P26,48,15,16,7,32,8,0.3333333333333333,0.6666666666666666,0.4666666666666667,0.5333333333333333
SF-O21,SF-O25-2,29,20,20,10,9,10,0.6896551724137931,0.3103448275862069,0.5,0.5
SF-O21,SF-N22-1B,29,41,16,11,13,30,0.5517241379310345,0.4482758620689655,0.2682926829268293,0.7317073170731707
SF-O21,SF-N26,29,28,15,15,14,13,0.5172413793103449,0.4827586206896552,0.5357142857142857,0.4642857142857143
SF-O21,SF-N25,12,15,6,5,6,10,0.5,0.5,0.3333333333333333,0.6666666666666666
SF-O21,SF-T21,22,20,9,3,13,17,0.4090909090909091,0.5909090909090909,0.15,0.85
SF-O21,SF-T22,50,47,18,14,32,33,0.36,0.64,0.2978723404255319,0.7021276595744681
SF-O21,SF-S22-2,25,19,7,2,18,17,0.28,0.72,0.10526315789473684,0.8947368421052632
SF-O21,SF-S22-1,48,47,21,19,27,28,0.4375,0.5625,0.40425531914893614,0.5957446808510638
SF-O21,SF-Q23-3,62,49,34,26,28,23,0.5483870967741935,0.45161290322580644,0.5306122448979592,0.46938775510204084
SF-O21,SF-Q22-1,30,41,19,24,11,17,0.6333333333333333,0.36666666666666664,0.5853658536585366,0.4146341463414634
SF-O21,SF-Q22-2,74,36,48,14,26,22,0.6486486486486487,0.35135135135135137,0.3888888888888889,0.6111111111111112
SF-O21,SF-P22,67,56,53,38,14,18,0.7910447761194029,0.208955223880597,0.6785714285714286,0.32142857142857145
SF-O21,SF-W19,5,11,3,0,2,11,0.6,0.4,0.0,1.0
SF-O21,SF-W19-2,2,6,0,0,2,6,0.0,1.0,0.0,1.0
SF-O21,SF-U21,3,5,0,0,3,5,0.0,1.0,0.0,1.0
SF-O21,SF-T20,58,41,30,13,28,28,0.5172413793103449,0.4827586206896552,0.3170731707317073,0.6829268292682927
SF-O21,SF-S21,12,9,5,2,7,7,0.4166666666666667,0.5833333333333334,0.2222222222222222,0.7777777777777778
SF-O21,SF-Y30,4,6,0,0,4,6,0.0,1.0,0.0,1.0
SF-O21,SF-V28,3,1,0,0,3,1,0.0,1.0,0.0,1.0
SF-O21,SF-V29,2,3,0,0,2,3,0.0,1.0,0.0,1.0
SF-O21,SF-W14,11,4,5,0,6,4,0.45454545454545453,0.5454545454545454,0.0,1.0
SF-O21,SF-Z7,1,1,1,1,0,0,1.0,0.0,1.0,0.0
SF-O21,SF-Y14,2,1,1,0,1,1,0.5,0.5,0.0,1.0
SF-O21,SF-X19,2,6,0,0,2,6,0.0,1.0,0.0,1.0
SF-O22,SF-M25,17,20,6,3,11,17,0.35294117647058826,0.6470588235294118,0.15,0.85
SF-O22,SF-M26-2,14,3,6,1,8,2,0.42857142857142855,0.5714285714285714,0.3333333333333333,0.6666666666666666
SF-O22,SF-L27,6,2,2,0,4,2,0.3333333333333333,0.6666666666666666,0.0,1.0
SF-O22,SF-K26,14,20,1,4,13,16,0.07142857142857142,0.9285714285714286,0.2,0.8
SF-O22,SF-J27,6,11,1,1,5,10,0.16666666666666666,0.8333333333333334,0.09090909090909091,0.9090909090909091
SF-O22,SF-M30,34,40,10,7,24,33,0.29411764705882354,0.7058823529411765,0.175,0.825
SF-O22,SF-J29,28,12,9,4,19,8,0.32142857142857145,0.6785714285714286,0.3333333333333333,0.6666666666666666
SF-O22,SF-L26,189,209,68,70,121,139,0.35978835978835977,0.6402116402116402,0.3349282296650718,0.6650717703349283
SF-O22,SF-M28,31,15,6,3,25,12,0.1935483870967742,0.8064516129032258,0.2,0.8
SF-O22,SF-M27,4,11,1,2,3,9,0.25,0.75,0.18181818181818182,0.8181818181818182
SF-O22,SF-L25,10,5,1,1,9,4,0.1,0.9,0.2,0.8
SF-O22,SF-M24,21,24,14,14,7,10,0.6666666666666666,0.3333333333333333,0.5833333333333334,0.4166666666666667
SF-O22,SF-L24,10,33,6,12,4,21,0.6,0.4,0.36363636363636365,0.6363636363636364
SF-O22,SF-N23,13,15,8,7,5,8,0.6153846153846154,0.38461538461538464,0.4666666666666667,0.5333333333333333
SF-O22,SF-N24-2,15,9,8,7,7,2,0.5333333333333333,0.4666666666666667,0.7777777777777778,0.2222222222222222
SF-O22,SF-K27-2,15,20,10,9,5,11,0.6666666666666666,0.3333333333333333,0.45,0.55
SF-O22,SF-J26-2,17,20,4,4,13,16,0.23529411764705882,0.7647058823529411,0.2,0.8
SF-O22,SF-L28,12,8,2,3,10,5,0.16666666666666666,0.8333333333333334,0.375,0.625
SF-O22,SF-K28,8,3,3,1,5,2,0.375,0.625,0.3333333333333333,0.6666666666666666
SF-O22,SF-K29-1,14,10,5,4,9,6,0.35714285714285715,0.6428571428571429,0.4,0.6
SF-O22,SF-J28-2,2,2,0,2,2,0,0.0,1.0,1.0,0.0
SF-O22,SF-K27,8,5,3,0,5,5,0.375,0.625,0.0,1.0
SF-O22,SF-K25,18,17,11,4,7,13,0.6111111111111112,0.3888888888888889,0.23529411764705882,0.7647058823529411
SF-O22,SF-J25,35,16,21,6,14,10,0.6,0.4,0.375,0.625
SF-O22,SF-H26-2,10,6,2,2,8,4,0.2,0.8,0.3333333333333333,0.6666666666666666
SF-O22,SF-P24,40,179,33,173,7,6,0.825,0.175,0.9664804469273743,0.0335195530726257
SF-O22,SF-N22-1A,5,5,4,5,1,0,0.8,0.2,1.0,0.0
SF-O22,SF-J24,23,25,10,14,13,11,0.43478260869565216,0.5652173913043478,0.56,0.44
SF-O22,SF-O24,18,28,11,16,7,12,0.6111111111111112,0.3888888888888889,0.5714285714285714,0.42857142857142855
SF-O22,SF-J26,6,7,2,1,4,6,0.3333333333333333,0.6666666666666666,0.14285714285714285,0.8571428571428571
SF-O22,SF-I26-,9,6,4,1,5,5,0.4444444444444444,0.5555555555555556,0.16666666666666666,0.8333333333333334
SF-O22,SF-I25,32,19,19,7,13,12,0.59375,0.40625,0.3684210526315789,0.631578947368421
SF-O22,SF-K23,13,3,10,2,3,1,0.7692307692307693,0.23076923076923078,0.6666666666666666,0.3333333333333333
SF-O22,SF-H26,66,31,35,12,31,19,0.5303030303030303,0.4696969696969697,0.3870967741935484,0.6129032258064516
SF-O22,SF-O23,29,26,15,14,14,12,0.5172413793103449,0.4827586206896552,0.5384615384615384,0.46153846153846156
SF-O22,SF-H27-1,27,8,16,4,11,4,0.5925925925925926,0.4074074074074074,0.5,0.5
SF-O22,SF-F28-2,30,22,17,7,13,15,0.5666666666666667,0.43333333333333335,0.3181818181818182,0.6818181818181818
SF-O22,SF-G27,50,38,14,7,36,31,0.28,0.72,0.18421052631578946,0.8157894736842105
SF-O22,SF-M22-2,72,67,51,39,21,28,0.7083333333333334,0.2916666666666667,0.582089552238806,0.417910447761194
SF-O22,SF-L22,98,79,53,33,45,46,0.5408163265306123,0.45918367346938777,0.4177215189873418,0.5822784810126582
SF-O22,SF-F27,51,39,8,7,43,32,0.1568627450980392,0.8431372549019608,0.1794871794871795,0.8205128205128205
SF-O22,SF-N22-2,63,58,40,35,23,23,0.6349206349206349,0.36507936507936506,0.603448275862069,0.39655172413793105
SF-O22,SF-G28-2,9,15,3,5,6,10,0.3333333333333333,0.6666666666666666,0.3333333333333333,0.6666666666666666
SF-O22,SF-M22-1,35,66,19,13,16,53,0.5428571428571428,0.45714285714285713,0.19696969696969696,0.803030303030303
SF-O22,SF-O25-1,20,12,10,4,10,8,0.5,0.5,0.3333333333333333,0.6666666666666666
SF-O22,SF-K22-2,54,37,34,14,20,23,0.6296296296296297,0.37037037037037035,0.3783783783783784,0.6216216216216216
SF-O22,SF-K24,8,9,5,2,3,7,0.625,0.375,0.2222222222222222,0.7777777777777778
SF-O22,SF-J23-2,16,10,8,3,8,7,0.5,0.5,0.3,0.7
SF-O22,SF-G23,11,6,3,2,8,4,0.2727272727272727,0.7272727272727273,0.3333333333333333,0.6666666666666666
SF-O22,SF-G24,121,25,17,1,104,24,0.14049586776859505,0.859504132231405,0.04,0.96
SF-O22,SF-G25,26,13,7,5,19,8,0.2692307692307692,0.7307692307692307,0.38461538461538464,0.6153846153846154
SF-O22,SF-F23,22,10,6,0,16,10,0.2727272727272727,0.7272727272727273,0.0,1.0
SF-O22,SF-E23,105,38,18,5,87,33,0.17142857142857143,0.8285714285714286,0.13157894736842105,0.868421052631579
SF-O22,SF-D24,5,12,1,2,4,10,0.2,0.8,0.16666666666666666,0.8333333333333334
SF-O22,SF-C22,25,11,2,0,23,11,0.08,0.92,0.0,1.0
SF-O22,SF-B22,3,6,1,3,2,3,0.3333333333333333,0.6666666666666666,0.5,0.5
SF-O22,SF-J17,31,22,4,1,27,21,0.12903225806451613,0.8709677419354839,0.045454545454545456,0.9545454545454546
SF-O22,SF-I19,20,9,2,0,18,9,0.1,0.9,0.0,1.0
SF-O22,SF-I20,3,9,1,3,2,6,0.3333333333333333,0.6666666666666666,0.3333333333333333,0.6666666666666666
SF-O22,SF-H16,6,9,3,3,3,6,0.5,0.5,0.3333333333333333,0.6666666666666666
SF-O22,SF-H19,1,2,0,1,1,1,0.0,1.0,0.5,0.5
SF-O22,SF-H20,14,10,5,1,9,9,0.35714285714285715,0.6428571428571429,0.1,0.9
SF-O22,SF-H18,5,2,2,0,3,2,0.4,0.6,0.0,1.0
SF-O22,SF-G19,11,2,7,0,4,2,0.6363636363636364,0.36363636363636365,0.0,1.0
SF-O22,SF-G17,7,10,0,2,7,8,0.0,1.0,0.2,0.8
SF-O22,SF-G18,16,8,2,0,14,8,0.125,0.875,0.0,1.0
SF-O22,SF-G20,32,22,11,11,21,11,0.34375,0.65625,0.5,0.5
SF-O22,SF-F19,19,18,1,0,18,18,0.05263157894736842,0.9473684210526315,0.0,1.0
SF-O22,SF-E18,8,7,0,0,8,7,0.0,1.0,0.0,1.0
SF-O22,SF-E20,15,12,3,0,12,12,0.2,0.8,0.0,1.0
SF-O22,SF-H30,5,4,0,0,5,4,0.0,1.0,0.0,1.0
SF-O22,SF-G30-2,12,3,5,0,7,3,0.4166666666666667,0.5833333333333334,0.0,1.0
SF-O22,SF-F30-1,5,3,1,0,4,3,0.2,0.8,0.0,1.0
SF-O22,SF-E29-2,22,12,5,1,17,11,0.22727272727272727,0.7727272727272727,0.08333333333333333,0.9166666666666666
SF-O22,SF-E29-1,15,3,10,2,5,1,0.6666666666666666,0.3333333333333333,0.6666666666666666,0.3333333333333333
SF-O22,SF-D29,15,11,3,1,12,10,0.2,0.8,0.09090909090909091,0.9090909090909091
SF-O22,SF-D28,4,3,2,0,2,3,0.5,0.5,0.0,1.0
SF-O22,SF-A27,7,1,5,0,2,1,0.7142857142857143,0.2857142857142857,0.0,1.0
SF-O22,SF-G29-2,21,17,11,2,10,15,0.5238095238095238,0.47619047619047616,0.11764705882352941,0.8823529411764706
SF-O22,SF-G29-1,10,15,5,6,5,9,0.5,0.5,0.4,0.6
SF-O22,SF-G30-1,7,9,2,1,5,8,0.2857142857142857,0.7142857142857143,0.1111111111111111,0.8888888888888888
SF-O22,SF-G29-3,6,6,2,1,4,5,0.3333333333333333,0.6666666666666666,0.16666666666666666,0.8333333333333334
SF-O22,SF-F29,4,2,2,0,2,2,0.5,0.5,0.0,1.0
SF-O22,SF-E29-3,11,7,7,2,4,5,0.6363636363636364,0.36363636363636365,0.2857142857142857,0.7142857142857143
SF-O22,SF-F28-1,16,7,7,2,9,5,0.4375,0.5625,0.2857142857142857,0.7142857142857143
SF-O22,SF-E28-2,4,1,1,0,3,1,0.25,0.75,0.0,1.0
SF-O22,SF-E28,7,4,2,2,5,2,0.2857142857142857,0.7142857142857143,0.5,0.5
SF-O22,SF-J10,8,8,3,1,5,7,0.375,0.625,0.125,0.875
SF-O22,SF-J12,13,11,1,0,12,11,0.07692307692307693,0.9230769230769231,0.0,1.0
SF-O22,SF-J13,12,7,1,0,11,7,0.08333333333333333,0.9166666666666666,0.0,1.0
SF-O22,SF-J15,4,4,2,1,2,3,0.5,0.5,0.25,0.75
SF-O22,SF-H13,1,1,0,0,1,1,0.0,1.0,0.0,1.0
SF-O22,SF-I16,4,1,0,0,4,1,0.0,1.0,0.0,1.0
SF-O22,SF-H12,9,2,1,0,8,2,0.1111111111111111,0.8888888888888888,0.0,1.0
SF-O22,SF-G10-2,4,2,1,0,3,2,0.25,0.75,0.0,1.0
SF-O22,SF-H14,1,1,0,0,1,1,0.0,1.0,0.0,1.0
SF-O22,SF-G13,2,2,0,0,2,2,0.0,1.0,0.0,1.0
SF-O22,SF-G11,2,2,0,0,2,2,0.0,1.0,0.0,1.0
SF-O22,SF-G12,10,2,0,0,10,2,0.0,1.0,0.0,1.0
SF-O22,SF-G10-1,1,5,0,1,1,4,0.0,1.0,0.2,0.8
SF-O22,SF-F15,3,3,1,0,2,3,0.3333333333333333,0.6666666666666666,0.0,1.0
SF-O22,SF-F16,8,4,1,0,7,4,0.125,0.875,0.0,1.0
SF-O22,SF-C21,3,1,0,0,3,1,0.0,1.0,0.0,1.0
SF-O22,SF-C20,15,6,0,1,15,5,0.0,1.0,0.16666666666666666,0.8333333333333334
SF-O22,SF-B21,3,1,0,0,3,1,0.0,1.0,0.0,1.0
SF-O22,SF-B19,4,3,0,0,4,3,0.0,1.0,0.0,1.0
SF-O22,SF-A20,1,4,0,1,1,3,0.0,1.0,0.25,0.75
SF-O22,SF-A19,5,4,0,2,5,2,0.0,1.0,0.5,0.5
SF-O22,SF-C26,11,10,4,2,7,8,0.36363636363636365,0.6363636363636364,0.2,0.8
SF-O22,SF-C25,18,11,3,2,15,9,0.16666666666666666,0.8333333333333334,0.18181818181818182,0.8181818181818182
SF-O22,SF-B25,1,5,0,3,1,2,0.0,1.0,0.6,0.4
SF-O22,SF-E27,43,11,5,6,38,5,0.11627906976744186,0.8837209302325582,0.5454545454545454,0.45454545454545453
SF-O22,SF-D27,19,7,9,2,10,5,0.47368421052631576,0.5263157894736842,0.2857142857142857,0.7142857142857143
SF-O22,SF-C28-2,4,2,0,1,4,1,0.0,1.0,0.5,0.5
SF-O22,SF-C28-1,1,3,0,1,1,2,0.0,1.0,0.3333333333333333,0.6666666666666666
SF-O22,SF-B28,5,9,0,1,5,8,0.0,1.0,0.1111111111111111,0.8888888888888888
SF-O22,SF-J1,7,12,2,1,5,11,0.2857142857142857,0.7142857142857143,0.08333333333333333,0.9166666666666666
SF-O22,SF-J3,2,2,1,1,1,1,0.5,0.5,0.5,0.5
SF-O22,SF-J5,5,2,1,0,4,2,0.2,0.8,0.0,1.0
SF-O22,SF-G6,3,5,2,0,1,5,0.6666666666666666,0.3333333333333333,0.0,1.0
SF-O22,SF-G8,1,2,0,0,1,2,0.0,1.0,0.0,1.0
SF-O22,SF-G5,2,4,1,0,1,4,0.5,0.5,0.0,1.0
SF-O22,SF-G7,6,3,1,0,5,3,0.16666666666666666,0.8333333333333334,0.0,1.0
SF-O22,SF-F9,3,3,0,0,3,3,0.0,1.0,0.0,1.0
SF-O22,SF-H25,29,14,19,5,10,9,0.6551724137931034,0.3448275862068966,0.35714285714285715,0.6428571428571429
SF-O22,SF-G26,25,14,8,3,17,11,0.32,0.68,0.21428571428571427,0.7857142857142857
SF-O22,SF-K21,33,13,17,1,16,12,0.5151515151515151,0.48484848484848486,0.07692307692307693,0.9230769230769231
SF-O22,SF-K22-1,61,9,39,6,22,3,0.639344262295082,0.36065573770491804,0.6666666666666666,0.3333333333333333
SF-O22,SF-J23-1,125,89,63,34,62,55,0.504,0.496,0.38202247191011235,0.6179775280898876
SF-O22,SF-J22-1,58,45,30,6,28,39,0.5172413793103449,0.4827586206896552,0.13333333333333333,0.8666666666666667
SF-O22,SF-J22-2,29,17,11,8,18,9,0.3793103448275862,0.6206896551724138,0.47058823529411764,0.5294117647058824
SF-O22,SF-J21,44,24,19,6,25,18,0.4318181818181818,0.5681818181818182,0.25,0.75
SF-O22,SF-I21,6,4,6,1,0,3,1.0,0.0,0.25,0.75
SF-O22,SF-I22,7,6,5,2,2,4,0.7142857142857143,0.2857142857142857,0.3333333333333333,0.6666666666666666
SF-O22,SF-I23-2,28,19,24,6,4,13,0.8571428571428571,0.14285714285714285,0.3157894736842105,0.6842105263157895
SF-O22,SF-I24,16,7,11,4,5,3,0.6875,0.3125,0.5714285714285714,0.42857142857142855
SF-O22,SF-I23-1,22,27,11,12,11,15,0.5,0.5,0.4444444444444444,0.5555555555555556
SF-O22,SF-F26,49,26,22,7,27,19,0.4489795918367347,0.5510204081632653,0.2692307692307692,0.7307692307692307
SF-O22,SF-M13,79,14,21,3,58,11,0.26582278481012656,0.7341772151898734,0.21428571428571427,0.7857142857142857
SF-O22,SF-M15,48,17,22,5,26,12,0.4583333333333333,0.5416666666666666,0.29411764705882354,0.7058823529411765
SF-O22,SF-L19,49,29,17,2,32,27,0.3469387755102041,0.6530612244897959,0.06896551724137931,0.9310344827586207
SF-O22,SF-L20,64,42,17,14,47,28,0.265625,0.734375,0.3333333333333333,0.6666666666666666
SF-O22,SF-N20-1,51,44,20,11,31,33,0.39215686274509803,0.6078431372549019,0.25,0.75
SF-O22,SF-M20,83,44,37,7,46,37,0.4457831325301205,0.5542168674698795,0.1590909090909091,0.8409090909090909
SF-O22,SF-K17-2,21,16,7,1,14,15,0.3333333333333333,0.6666666666666666,0.0625,0.9375
SF-O22,SF-K20,50,38,27,5,23,33,0.54,0.46,0.13157894736842105,0.868421052631579
SF-O22,SF-K15-,54,27,22,9,32,18,0.4074074074074074,0.5925925925925926,0.3333333333333333,0.6666666666666666
SF-O22,SF-K19,40,30,24,10,16,20,0.6,0.4,0.3333333333333333,0.6666666666666666
SF-O22,SF-K18,56,24,18,0,38,24,0.32142857142857145,0.6785714285714286,0.0,1.0
SF-O22,SF-K17,18,13,5,2,13,11,0.2777777777777778,0.7222222222222222,0.15384615384615385,0.8461538461538461
SF-O22,SF-J16,10,4,3,0,7,4,0.3,0.7,0.0,1.0
SF-O22,SF-J18,40,25,13,4,27,21,0.325,0.675,0.16,0.84
SF-O22,SF-J20,14,10,6,3,8,7,0.42857142857142855,0.5714285714285714,0.3,0.7
SF-O22,SF-J19,46,16,6,3,40,13,0.13043478260869565,0.8695652173913043,0.1875,0.8125
SF-O22,SF-M12,17,11,7,0,10,11,0.4117647058823529,0.5882352941176471,0.0,1.0
SF-O22,SF-M10,5,4,1,1,4,3,0.2,0.8,0.25,0.75
SF-O22,SF-M11,9,6,1,0,8,6,0.1111111111111111,0.8888888888888888,0.0,1.0
SF-O22,SF-R19,28,31,17,7,11,24,0.6071428571428571,0.39285714285714285,0.22580645161290322,0.7741935483870968
SF-O22,SF-R20,14,26,9,2,5,24,0.6428571428571429,0.35714285714285715,0.07692307692307693,0.9230769230769231
SF-O22,SF-Q21-2,68,38,49,4,19,34,0.7205882352941176,0.27941176470588236,0.10526315789473684,0.8947368421052632
SF-O22,SF-Q21-1,21,40,10,9,11,31,0.47619047619047616,0.5238095238095238,0.225,0.775
SF-O22,SF-P21,27,21,18,6,9,15,0.6666666666666666,0.3333333333333333,0.2857142857142857,0.7142857142857143
SF-O22,SF-O18,36,25,15,2,21,23,0.4166666666666667,0.5833333333333334,0.08,0.92
SF-O22,SF-O19,94,66,36,21,58,45,0.3829787234042553,0.6170212765957447,0.3181818181818182,0.6818181818181818
SF-O22,SF-O21,82,35,46,19,36,16,0.5609756097560976,0.43902439024390244,0.5428571428571428,0.45714285714285713
SF-O22,SF-N21,30,16,17,8,13,8,0.5666666666666667,0.43333333333333335,0.5,0.5
SF-O22,SF-N20-2,27,21,18,3,9,18,0.6666666666666666,0.3333333333333333,0.14285714285714285,0.8571428571428571
SF-O22,SF-M21,75,36,46,13,29,23,0.6133333333333333,0.38666666666666666,0.3611111111111111,0.6388888888888888
SF-O22,SF-L21,69,55,36,12,33,43,0.5217391304347826,0.4782608695652174,0.21818181818181817,0.7818181818181819
SF-O22,SF-S30,5,4,1,0,4,4,0.2,0.8,0.0,1.0
SF-O22,SF-Q30,7,6,0,0,7,6,0.0,1.0,0.0,1.0
SF-O22,SF-P30,8,6,1,0,7,6,0.125,0.875,0.0,1.0
SF-O22,SF-O30-2,2,8,0,0,2,8,0.0,1.0,0.0,1.0
SF-O22,SF-O30,17,21,5,2,12,19,0.29411764705882354,0.7058823529411765,0.09523809523809523,0.9047619047619048
SF-O22,SF-N27,17,11,8,3,9,8,0.47058823529411764,0.5294117647058824,0.2727272727272727,0.7272727272727273
SF-O22,SF-N29,15,3,5,0,10,3,0.3333333333333333,0.6666666666666666,0.0,1.0
SF-O22,SF-N28,27,28,11,2,16,26,0.4074074074074074,0.5925925925925926,0.07142857142857142,0.9285714285714286
SF-O22,SF-L30-1,40,26,11,3,29,23,0.275,0.725,0.11538461538461539,0.8846153846153846
SF-O22,SF-L31-1,2,3,2,0,0,3,1.0,0.0,0.0,1.0
SF-O22,SF-K30-2,7,1,3,0,4,1,0.42857142857142855,0.5714285714285714,0.0,1.0
SF-O22,SF-L29,5,5,2,0,3,5,0.4,0.6,0.0,1.0
SF-O22,SF-J29-1,10,10,0,1,10,9,0.0,1.0,0.1,0.9
SF-O22,SF-I30,10,4,6,2,4,2,0.6,0.4,0.5,0.5
SF-O22,SF-I27,14,16,7,6,7,10,0.5,0.5,0.375,0.625
SF-O22,SF-I28,13,16,8,3,5,13,0.6153846153846154,0.38461538461538464,0.1875,0.8125
SF-O22,SF-I30-2,1,3,0,0,1,3,0.0,1.0,0.0,1.0
SF-O22,SF I29-1,5,25,1,8,4,17,0.2,0.8,0.32,0.68
SF-O22,SF-H28,7,7,3,3,4,4,0.42857142857142855,0.5714285714285714,0.42857142857142855,0.5714285714285714
SF-O22,SF-S24,33,60,7,8,26,52,0.21212121212121213,0.7878787878787878,0.13333333333333333,0.8666666666666667
SF-O22,SF-R24,53,78,30,34,23,44,0.5660377358490566,0.4339622641509434,0.4358974358974359,0.5641025641025641
SF-O22,SF-R26,7,15,7,5,0,10,1.0,0.0,0.3333333333333333,0.6666666666666666
SF-O22,SF-Q26,15,22,7,7,8,15,0.4666666666666667,0.5333333333333333,0.3181818181818182,0.6818181818181818
SF-O22,SF-P26,12,22,4,6,8,16,0.3333333333333333,0.6666666666666666,0.2727272727272727,0.7272727272727273
SF-O22,SF-O25-2,49,38,27,22,22,16,0.5510204081632653,0.4489795918367347,0.5789473684210527,0.42105263157894735
SF-O22,SF-N22-1B,20,24,13,15,7,9,0.65,0.35,0.625,0.375
SF-O22,SF-N26,22,18,7,1,15,17,0.3181818181818182,0.6818181818181818,0.05555555555555555,0.9444444444444444
SF-O22,SF-N25,14,11,3,1,11,10,0.21428571428571427,0.7857142857142857,0.09090909090909091,0.9090909090909091
SF-O22,SF-T21,23,28,8,6,15,22,0.34782608695652173,0.6521739130434783,0.21428571428571427,0.7857142857142857
SF-O22,SF-T22,57,125,32,54,25,71,0.5614035087719298,0.43859649122807015,0.432,0.568
SF-O22,SF-S22-2,21,26,10,4,11,22,0.47619047619047616,0.5238095238095238,0.15384615384615385,0.8461538461538461
SF-O22,SF-S22-1,66,100,40,43,26,57,0.6060606060606061,0.3939393939393939,0.43,0.57
SF-O22,SF-Q23-3,39,59,23,26,16,33,0.5897435897435898,0.41025641025641024,0.4406779661016949,0.559322033898305
SF-O22,SF-Q22-1,55,55,43,38,12,17,0.7818181818181819,0.21818181818181817,0.6909090909090909,0.3090909090909091
SF-O22,SF-Q22-2,96,120,71,91,25,29,0.7395833333333334,0.2604166666666667,0.7583333333333333,0.24166666666666667
SF-O22,SF-P22,76,70,45,42,31,28,0.5921052631578947,0.40789473684210525,0.6,0.4
SF-O22,SF-W19,5,14,2,8,3,6,0.4,0.6,0.5714285714285714,0.42857142857142855
SF-O22,SF-W19-2,3,6,0,0,3,6,0.0,1.0,0.0,1.0
SF-O22,SF-U21,9,20,4,3,5,17,0.4444444444444444,0.5555555555555556,0.15,0.85
SF-O22,SF-T20,40,71,7,23,33,48,0.175,0.825,0.323943661971831,0.676056338028169
SF-O22,SF-S21,16,19,10,3,6,16,0.625,0.375,0.15789473684210525,0.8421052631578947
SF-O22,SF-V32,1,4,1,4,0,0,1.0,0.0,1.0,0.0
SF-O22,SF-W14,12,17,8,0,4,17,0.6666666666666666,0.3333333333333333,0.0,1.0
SF-O22,SF-Y14,3,2,0,0,3,2,0.0,1.0,0.0,1.0
SF-O22,SF-X19,3,6,1,1,2,5,0.3333333333333333,0.6666666666666666,0.16666666666666666,0.8333333333333334
SF-N21,SF-M26,1,3,1,2,0,1,1.0,0.0,0.6666666666666666,0.3333333333333333
SF-N21,SF-M25,12,9,6,6,6,3,0.5,0.5,0.6666666666666666,0.3333333333333333
SF-N21,SF-M26-2,12,3,5,2,7,1,0.4166666666666667,0.5833333333333334,0.6666666666666666,0.3333333333333333
SF-N21,SF-L27,6,2,2,1,4,1,0.3333333333333333,0.6666666666666666,0.5,0.5
SF-N21,SF-K26,23,12,7,11,16,1,0.30434782608695654,0.6956521739130435,0.9166666666666666,0.08333333333333333
SF-N21,SF-J27,5,1,0,0,5,1,0.0,1.0,0.0,1.0
SF-N21,SF-M30,43,71,13,16,30,55,0.3023255813953488,0.6976744186046512,0.22535211267605634,0.7746478873239436
SF-N21,SF-J29-3,4,3,2,1,2,2,0.5,0.5,0.3333333333333333,0.6666666666666666
SF-N21,SF-J29,10,6,4,0,6,6,0.4,0.6,0.0,1.0
SF-N21,SF-L26,48,48,3,4,45,44,0.0625,0.9375,0.08333333333333333,0.9166666666666666
SF-N21,SF-M28,14,6,4,4,10,2,0.2857142857142857,0.7142857142857143,0.6666666666666666,0.3333333333333333
SF-N21,SF-M27,2,5,0,0,2,5,0.0,1.0,0.0,1.0
SF-N21,SF-L25,5,9,1,7,4,2,0.2,0.8,0.7777777777777778,0.2222222222222222
SF-N21,SF-M24,13,29,7,16,6,13,0.5384615384615384,0.46153846153846156,0.5517241379310345,0.4482758620689655
SF-N21,SF-L24,16,8,9,4,7,4,0.5625,0.4375,0.5,0.5
SF-N21,SF-N23,10,19,4,16,6,3,0.4,0.6,0.8421052631578947,0.15789473684210525
SF-N21,SF-N24-2,19,19,11,9,8,10,0.5789473684210527,0.42105263157894735,0.47368421052631576,0.5263157894736842
SF-N21,SF-K27-2,14,9,3,5,11,4,0.21428571428571427,0.7857142857142857,0.5555555555555556,0.4444444444444444
SF-N21,SF-J26-2,25,11,1,4,24,7,0.04,0.96,0.36363636363636365,0.6363636363636364
SF-N21,SF-L28,7,5,1,1,6,4,0.14285714285714285,0.8571428571428571,0.2,0.8
SF-N21,SF-K28,3,1,0,0,3,1,0.0,1.0,0.0,1.0
SF-N21,SF-K29-1,7,11,1,2,6,9,0.14285714285714285,0.8571428571428571,0.18181818181818182,0.8181818181818182
SF-N21,SF-J28-2,8,3,1,1,7,2,0.125,0.875,0.3333333333333333,0.6666666666666666
SF-N21,SF-K27,1,2,1,2,0,0,1.0,0.0,1.0,0.0
SF-N21,SF-K25,9,11,4,5,5,6,0.4444444444444444,0.5555555555555556,0.45454545454545453,0.5454545454545454
SF-N21,SF-J25,19,10,9,5,10,5,0.47368421052631576,0.5263157894736842,0.5,0.5
SF-N21,SF-H26-2,4,2,2,2,2,0,0.5,0.5,1.0,0.0
SF-N21,SF-P24,10,10,6,5,4,5,0.6,0.4,0.5,0.5
SF-N21,SF-N22-1A,3,1,3,0,0,1,1.0,0.0,0.0,1.0
SF-N21,SF-J24,13,6,5,5,8,1,0.38461538461538464,0.6153846153846154,0.8333333333333334,0.16666666666666666
SF-N21,SF-O24,3,4,1,2,2,2,0.3333333333333333,0.6666666666666666,0.5,0.5
SF-N21,SF-J26,50,71,2,4,48,67,0.04,0.96,0.056338028169014086,0.9436619718309859
SF-N21,SF-I26-,5,4,4,0,1,4,0.8,0.2,0.0,1.0
SF-N21,SF-I25,10,4,1,1,9,3,0.1,0.9,0.25,0.75
SF-N21,SF-K23,4,2,3,2,1,0,0.75,0.25,1.0,0.0
SF-N21,SF-H26,16,15,7,8,9,7,0.4375,0.5625,0.5333333333333333,0.4666666666666667
SF-N21,SF-O23,5,8,2,5,3,3,0.4,0.6,0.625,0.375
SF-N21,SF-H27-1,3,6,1,3,2,3,0.3333333333333333,0.6666666666666666,0.5,0.5
SF-N21,SF-F28-2,10,12,4,0,6,12,0.4,0.6,0.0,1.0
SF-N21,SF-G27,14,16,7,9,7,7,0.5,0.5,0.5625,0.4375
SF-N21,SF-M22-2,9,25,7,18,2,7,0.7777777777777778,0.2222222222222222,0.72,0.28
SF-N21,SF-L22,12,8,7,4,5,4,0.5833333333333334,0.4166666666666667,0.5,0.5
SF-N21,SF-F27,5,17,3,14,2,3,0.6,0.4,0.8235294117647058,0.17647058823529413
SF-N21,SF-N22-2,68,51,53,41,15,10,0.7794117647058824,0.22058823529411764,0.803921568627451,0.19607843137254902
SF-N21,SF-G28-2,4,3,0,2,4,1,0.0,1.0,0.6666666666666666,0.3333333333333333
SF-N21,SF-M22-1,5,5,4,2,1,3,0.8,0.2,0.4,0.6
SF-N21,SF-O25-1,5,2,4,1,1,1,0.8,0.2,0.5,0.5
SF-N21,SF-K22-2,6,11,4,8,2,3,0.6666666666666666,0.3333333333333333,0.7272727272727273,0.2727272727272727
SF-N21,SF-K24,7,2,3,1,4,1,0.42857142857142855,0.5714285714285714,0.5,0.5
SF-N21,SF-J23-2,10,18,4,7,6,11,0.4,0.6,0.3888888888888889,0.6111111111111112
SF-N21,SF-G23,4,8,0,0,4,8,0.0,1.0,0.0,1.0
SF-N21,SF-G24,13,9,3,1,10,8,0.23076923076923078,0.7692307692307693,0.1111111111111111,0.8888888888888888
SF-N21,SF-G25,9,3,5,2,4,1,0.5555555555555556,0.4444444444444444,0.6666666666666666,0.3333333333333333
SF-N21,SF-F23,4,4,1,1,3,3,0.25,0.75,0.25,0.75
SF-N21,SF-E23,7,11,5,4,2,7,0.7142857142857143,0.2857142857142857,0.36363636363636365,0.6363636363636364
SF-N21,SF-D24,2,2,0,0,2,2,0.0,1.0,0.0,1.0
SF-N21,SF-C22,2,4,2,0,0,4,1.0,0.0,0.0,1.0
SF-N21,SF-J17,13,5,9,2,4,3,0.6923076923076923,0.3076923076923077,0.4,0.6
SF-N21,SF-I19,3,6,3,2,0,4,1.0,0.0,0.3333333333333333,0.6666666666666666
SF-N21,SF-H16,6,8,3,5,3,3,0.5,0.5,0.625,0.375
SF-N21,SF-H20,5,2,1,0,4,2,0.2,0.8,0.0,1.0
SF-N21,SF-H18,3,4,1,0,2,4,0.3333333333333333,0.6666666666666666,0.0,1.0
SF-N21,SF-H17,1,1,0,0,1,1,0.0,1.0,0.0,1.0
SF-N21,SF-G17,2,1,1,0,1,1,0.5,0.5,0.0,1.0
SF-N21,SF-G18,9,31,1,1,8,30,0.1111111111111111,0.8888888888888888,0.03225806451612903,0.967741935483871
SF-N21,SF-G20,19,8,5,2,14,6,0.2631578947368421,0.7368421052631579,0.25,0.75
SF-N21,SF-F19,1,7,0,0,1,7,0.0,1.0,0.0,1.0
SF-N21,SF-E18,4,4,0,2,4,2,0.0,1.0,0.5,0.5
SF-N21,SF-E20,1,1,0,0,1,1,0.0,1.0,0.0,1.0
SF-N21,SF-H30,2,2,0,1,2,1,0.0,1.0,0.5,0.5
SF-N21,SF-G30-2,2,4,1,0,1,4,0.5,0.5,0.0,1.0
SF-N21,SF-E29-2,5,11,3,2,2,9,0.6,0.4,0.18181818181818182,0.8181818181818182
SF-N21,SF-E29-1,5,7,1,6,4,1,0.2,0.8,0.8571428571428571,0.14285714285714285
SF-N21,SF-D29,1,6,0,0,1,6,0.0,1.0,0.0,1.0
SF-N21,SF-D28,3,3,2,0,1,3,0.6666666666666666,0.3333333333333333,0.0,1.0
SF-N21,SF-G29-2,1,4,1,1,0,3,1.0,0.0,0.25,0.75
SF-N21,SF-G30-1,2,1,0,0,2,1,0.0,1.0,0.0,1.0
SF-N21,SF-G29-3,2,2,0,0,2,2,0.0,1.0,0.0,1.0
SF-N21,SF-F30-2,2,3,1,1,1,2,0.5,0.5,0.3333333333333333,0.6666666666666666
SF-N21,SF-E29-3,1,1,0,0,1,1,0.0,1.0,0.0,1.0
SF-N21,SF-F28-1,4,1,0,0,4,1,0.0,1.0,0.0,1.0
SF-N21,SF-E28,2,2,0,0,2,2,0.0,1.0,0.0,1.0
SF-N21,SF-J10,5,8,1,4,4,4,0.2,0.8,0.5,0.5
SF-N21,SF-J12,5,9,0,3,5,6,0.0,1.0,0.3333333333333333,0.6666666666666666
SF-N21,SF-J13,3,4,0,0,3,4,0.0,1.0,0.0,1.0
SF-N21,SF-H13,2,1,0,0,2,1,0.0,1.0,0.0,1.0
SF-N21,SF-H12,2,1,1,0,1,1,0.5,0.5,0.0,1.0
SF-N21,SF-G10-2,1,3,0,0,1,3,0.0,1.0,0.0,1.0
SF-N21,SF-H14,29,2,29,2,0,0,1.0,0.0,1.0,0.0
SF-N21,SF-G13,131,153,129,152,2,1,0.9847328244274809,0.015267175572519083,0.9934640522875817,0.006535947712418301
SF-N21,SF-G12,3,4,0,3,3,1,0.0,1.0,0.75,0.25
SF-N21,SF-G10-1,1,1,0,0,1,1,0.0,1.0,0.0,1.0
SF-N21,SF-F15,2,1,0,1,2,0,0.0,1.0,1.0,0.0
SF-N21,SF-F16,8,5,2,3,6,2,0.25,0.75,0.6,0.4
SF-N21,SF-A20,4,7,1,5,3,2,0.25,0.75,0.7142857142857143,0.2857142857142857
SF-N21,SF-C26,5,5,1,1,4,4,0.2,0.8,0.2,0.8
SF-N21,SF-C25,7,5,1,2,6,3,0.14285714285714285,0.8571428571428571,0.4,0.6
SF-N21,SF-E27,1,4,0,0,1,4,0.0,1.0,0.0,1.0
SF-N21,SF-D27,2,3,2,2,0,1,1.0,0.0,0.6666666666666666,0.3333333333333333
SF-N21,SF-B28,1,2,0,2,1,0,0.0,1.0,1.0,0.0
SF-N21,SF-J1,3,12,1,9,2,3,0.3333333333333333,0.6666666666666666,0.75,0.25
SF-N21,SF-H0,1,4,0,3,1,1,0.0,1.0,0.75,0.25
SF-N21,SF-J3,10,1,0,0,10,1,0.0,1.0,0.0,1.0
SF-N21,SF-J5,7,5,0,3,7,2,0.0,1.0,0.6,0.4
SF-N21,SF-G5,1,2,0,0,1,2,0.0,1.0,0.0,1.0
SF-N21,SF-G26,7,6,5,0,2,6,0.7142857142857143,0.2857142857142857,0.0,1.0
SF-N21,SF-K21,7,6,5,3,2,3,0.7142857142857143,0.2857142857142857,0.5,0.5
SF-N21,SF-K22-1,11,4,7,3,4,1,0.6363636363636364,0.36363636363636365,0.75,0.25
SF-N21,SF-J23-1,31,31,10,12,21,19,0.3225806451612903,0.6774193548387096,0.3870967741935484,0.6129032258064516
SF-N21,SF-J22-1,7,8,4,3,3,5,0.5714285714285714,0.42857142857142855,0.375,0.625
SF-N21,SF-J22-2,1,7,0,1,1,6,0.0,1.0,0.14285714285714285,0.8571428571428571
SF-N21,SF-J21,10,20,5,5,5,15,0.5,0.5,0.25,0.75
SF-N21,SF-I21,1,1,1,0,0,1,1.0,0.0,0.0,1.0
SF-N21,SF-I22,9,4,1,0,8,4,0.1111111111111111,0.8888888888888888,0.0,1.0
SF-N21,SF-I23-2,12,8,1,1,11,7,0.08333333333333333,0.9166666666666666,0.125,0.875
SF-N21,SF-I24,4,2,1,1,3,1,0.25,0.75,0.5,0.5
SF-N21,SF-I23-1,4,7,0,2,4,5,0.0,1.0,0.2857142857142857,0.7142857142857143
SF-N21,SF-F26,22,10,8,5,14,5,0.36363636363636365,0.6363636363636364,0.5,0.5
SF-N21,SF-M13,17,16,9,4,8,12,0.5294117647058824,0.47058823529411764,0.25,0.75
SF-N21,SF-M15,13,10,7,1,6,9,0.5384615384615384,0.46153846153846156,0.1,0.9
SF-N21,SF-L19,104,86,21,20,83,66,0.20192307692307693,0.7980769230769231,0.23255813953488372,0.7674418604651163
SF-N21,SF-L20,6,19,4,10,2,9,0.6666666666666666,0.3333333333333333,0.5263157894736842,0.47368421052631576
SF-N21,SF-N20-1,16,19,11,8,5,11,0.6875,0.3125,0.42105263157894735,0.5789473684210527
SF-N21,SF-M20,64,45,31,13,33,32,0.484375,0.515625,0.28888888888888886,0.7111111111111111
SF-N21,SF-K17-2,11,11,6,2,5,9,0.5454545454545454,0.45454545454545453,0.18181818181818182,0.8181818181818182
SF-N21,SF-K20,19,25,10,8,9,17,0.5263157894736842,0.47368421052631576,0.32,0.68
SF-N21,SF-K15-,43,47,21,25,22,22,0.4883720930232558,0.5116279069767442,0.5319148936170213,0.46808510638297873
SF-N21,SF-K19,23,43,10,10,13,33,0.43478260869565216,0.5652173913043478,0.23255813953488372,0.7674418604651163
SF-N21,SF-K18,39,23,12,3,27,20,0.3076923076923077,0.6923076923076923,0.13043478260869565,0.8695652173913043
SF-N21,SF-K17,15,27,7,9,8,18,0.4666666666666667,0.5333333333333333,0.3333333333333333,0.6666666666666666
SF-N21,SF-J16,12,10,8,1,4,9,0.6666666666666666,0.3333333333333333,0.1,0.9
SF-N21,SF-J18,26,24,11,5,15,19,0.4230769230769231,0.5769230769230769,0.20833333333333334,0.7916666666666666
SF-N21,SF-J20,1,6,0,2,1,4,0.0,1.0,0.3333333333333333,0.6666666666666666
SF-N21,SF-J19,8,11,4,3,4,8,0.5,0.5,0.2727272727272727,0.7272727272727273
SF-N21,SF-M12,4,7,1,1,3,6,0.25,0.75,0.14285714285714285,0.8571428571428571
SF-N21,SF-M10,2,8,2,3,0,5,1.0,0.0,0.375,0.625
SF-N21,SF-M11,12,13,2,3,10,10,0.16666666666666666,0.8333333333333334,0.23076923076923078,0.7692307692307693
SF-N21,SF-R19,2,3,0,1,2,2,0.0,1.0,0.3333333333333333,0.6666666666666666
SF-N21,SF-R20,2,3,0,0,2,3,0.0,1.0,0.0,1.0
SF-N21,SF-Q21-2,7,4,4,2,3,2,0.5714285714285714,0.42857142857142855,0.5,0.5
SF-N21,SF-Q21-1,6,2,2,2,4,0,0.3333333333333333,0.6666666666666666,1.0,0.0
SF-N21,SF-P21,17,5,12,1,5,4,0.7058823529411765,0.29411764705882354,0.2,0.8
SF-N21,SF-O18,31,24,22,9,9,15,0.7096774193548387,0.2903225806451613,0.375,0.625
SF-N21,SF-O19,25,48,12,21,13,27,0.48,0.52,0.4375,0.5625
SF-N21,SF-O21,52,16,21,9,31,7,0.40384615384615385,0.5961538461538461,0.5625,0.4375
SF-N21,SF-O22,16,30,8,17,8,13,0.5,0.5,0.5666666666666667,0.43333333333333335
SF-N21,SF-N20-2,28,44,19,33,9,11,0.6785714285714286,0.32142857142857145,0.75,0.25
SF-N21,SF-M21,45,22,30,12,15,10,0.6666666666666666,0.3333333333333333,0.5454545454545454,0.45454545454545453
SF-N21,SF-L21,53,32,40,14,13,18,0.7547169811320755,0.24528301886792453,0.4375,0.5625
SF-N21,SF-Q30,6,1,2,1,4,0,0.3333333333333333,0.6666666666666666,1.0,0.0
SF-N21,SF-P30,32,31,1,14,31,17,0.03125,0.96875,0.45161290322580644,0.5483870967741935
SF-N21,SF-O30-2,7,2,2,2,5,0,0.2857142857142857,0.7142857142857143,1.0,0.0
SF-N21,SF-O30,22,6,4,3,18,3,0.18181818181818182,0.8181818181818182,0.5,0.5
SF-N21,SF-N27,26,4,8,3,18,1,0.3076923076923077,0.6923076923076923,0.75,0.25
SF-N21,SF-N29,26,49,7,31,19,18,0.2692307692307692,0.7307692307692307,0.6326530612244898,0.3673469387755102
SF-N21,SF-N28,20,14,4,6,16,8,0.2,0.8,0.42857142857142855,0.5714285714285714
SF-N21,SF-L30-1,38,21,8,5,30,16,0.21052631578947367,0.7894736842105263,0.23809523809523808,0.7619047619047619
SF-N21,SF-L31-1,4,7,2,3,2,4,0.5,0.5,0.42857142857142855,0.5714285714285714
SF-N21,SF-K30-2,2,2,0,1,2,1,0.0,1.0,0.5,0.5
SF-N21,SF-L29,12,9,6,2,6,7,0.5,0.5,0.2222222222222222,0.7777777777777778
SF-N21,SF-J29-1,4,2,2,0,2,2,0.5,0.5,0.0,1.0
SF-N21,SF-I30,5,10,3,5,2,5,0.6,0.4,0.5,0.5
SF-N21,SF-I27,10,12,0,4,10,8,0.0,1.0,0.3333333333333333,0.6666666666666666
SF-N21,SF-I28,2,2,2,2,0,0,1.0,0.0,1.0,0.0
SF-N21,SF-I30-2,4,2,1,0,3,2,0.25,0.75,0.0,1.0
SF-N21,SF-H28,4,5,2,5,2,0,0.5,0.5,1.0,0.0
SF-N21,SF-H29,2,2,1,1,1,1,0.5,0.5,0.5,0.5
SF-N21,SF-S24,18,20,7,5,11,15,0.3888888888888889,0.6111111111111112,0.25,0.75
SF-N21,SF-R24,20,8,10,0,10,8,0.5,0.5,0.0,1.0
SF-N21,SF-R26,1,1,0,0,1,1,0.0,1.0,0.0,1.0
SF-N21,SF-Q26,4,5,1,1,3,4,0.25,0.75,0.2,0.8
SF-N21,SF-P26,21,35,11,14,10,21,0.5238095238095238,0.47619047619047616,0.4,0.6
SF-N21,SF-O25-2,8,10,2,8,6,2,0.25,0.75,0.8,0.2
SF-N21,SF-N22-1B,17,8,12,5,5,3,0.7058823529411765,0.29411764705882354,0.625,0.375
SF-N21,SF-N26,3,1,2,1,1,0,0.6666666666666666,0.3333333333333333,1.0,0.0
SF-N21,SF-N25,13,9,5,5,8,4,0.38461538461538464,0.6153846153846154,0.5555555555555556,0.4444444444444444
SF-N21,SF-T21,9,2,8,2,1,0,0.8888888888888888,0.1111111111111111,1.0,0.0
SF-N21,SF-T22,30,19,21,9,9,10,0.7,0.3,0.47368421052631576,0.5263157894736842
SF-N21,SF-S22-2,8,9,3,0,5,9,0.375,0.625,0.0,1.0
SF-N21,SF-S22-1,17,27,9,21,8,6,0.5294117647058824,0.47058823529411764,0.7777777777777778,0.2222222222222222
SF-N21,SF-Q23-3,15,23,11,15,4,8,0.7333333333333333,0.26666666666666666,0.6521739130434783,0.34782608695652173
SF-N21,SF-Q22-1,8,23,4,17,4,6,0.5,0.5,0.7391304347826086,0.2608695652173913
SF-N21,SF-Q22-2,29,23,25,19,4,4,0.8620689655172413,0.13793103448275862,0.8260869565217391,0.17391304347826086
SF-N21,SF-P22,31,26,21,16,10,10,0.6774193548387096,0.3225806451612903,0.6153846153846154,0.38461538461538464
SF-N21,SF-U21,1,1,1,0,0,1,1.0,0.0,0.0,1.0
SF-N21,SF-T20,7,11,0,4,7,7,0.0,1.0,0.36363636363636365,0.6363636363636364
SF-N21,SF-S21,6,9,3,4,3,5,0.5,0.5,0.4444444444444444,0.5555555555555556
SF-N21,SF-Z16,48,17,19,0,29,17,0.3958333333333333,0.6041666666666666,0.0,1.0
SF-N21,SF-X14,3,1,1,1,2,0,0.3333333333333333,0.6666666666666666,1.0,0.0
SF-N21,SF-X19,2,4,0,0,2,4,0.0,1.0,0.0,1.0
SF-N21,SF-Y25,1,1,0,0,1,1,0.0,1.0,0.0,1.0
SF-N20-2,SF-M26,2,2,0,0,2,2,0.0,1.0,0.0,1.0
SF-N20-2,SF-M25,4,3,1,2,3,1,0.25,0.75,0.6666666666666666,0.3333333333333333
SF-N20-2,SF-M26-2,8,5,3,2,5,3,0.375,0.625,0.4,0.6
SF-N20-2,SF-K26,4,3,0,1,4,2,0.0,1.0,0.3333333333333333,0.6666666666666666
SF-N20-2,SF-M30,64,62,5,12,59,50,0.078125,0.921875,0.1935483870967742,0.8064516129032258
SF-N20-2,SF-L27-2,2,1,1,1,1,0,0.5,0.5,1.0,0.0
SF-N20-2,SF-L26,59,49,7,6,52,43,0.11864406779661017,0.8813559322033898,0.12244897959183673,0.8775510204081632
SF-N20-2,SF-M28,10,1,2,0,8,1,0.2,0.8,0.0,1.0
SF-N20-2,SF-L25,5,7,3,4,2,3,0.6,0.4,0.5714285714285714,0.42857142857142855
SF-N20-2,SF-M24,8,3,0,2,8,1,0.0,1.0,0.6666666666666666,0.3333333333333333
SF-N20-2,SF-L24,7,4,1,3,6,1,0.14285714285714285,0.8571428571428571,0.75,0.25
SF-N20-2,SF-N23,20,36,14,32,6,4,0.7,0.3,0.8888888888888888,0.1111111111111111
SF-N20-2,SF-N24-2,32,8,2,1,30,7,0.0625,0.9375,0.125,0.875
SF-N20-2,SF-K27-2,8,7,2,1,6,6,0.25,0.75,0.14285714285714285,0.8571428571428571
SF-N20-2,SF-J26-2,1,2,0,0,1,2,0.0,1.0,0.0,1.0
SF-N20-2,SF-K28-3,2,2,2,0,0,2,1.0,0.0,0.0,1.0
SF-N20-2,SF-L28,5,1,1,0,4,1,0.2,0.8,0.0,1.0
SF-N20-2,SF-K28,4,1,2,0,2,1,0.5,0.5,0.0,1.0
SF-N20-2,SF-K29-1,2,2,0,2,2,0,0.0,1.0,1.0,0.0
SF-N20-2,SF-J28-2,4,2,1,0,3,2,0.25,0.75,0.0,1.0
SF-N20-2,SF-K25,1,4,1,2,0,2,1.0,0.0,0.5,0.5
SF-N20-2,SF-J25,4,2,1,0,3,2,0.25,0.75,0.0,1.0
SF-N20-2,SF-H26-2,1,1,0,0,1,1,0.0,1.0,0.0,1.0
SF-N20-2,SF-P24,13,8,9,2,4,6,0.6923076923076923,0.3076923076923077,0.25,0.75
SF-N20-2,SF-N22-1A,9,1,0,0,9,1,0.0,1.0,0.0,1.0
SF-N20-2,SF-J24,5,8,0,3,5,5,0.0,1.0,0.375,0.625
SF-N20-2,SF-O24,5,3,3,2,2,1,0.6,0.4,0.6666666666666666,0.3333333333333333
SF-N20-2,SF-I25,5,13,2,10,3,3,0.4,0.6,0.7692307692307693,0.23076923076923078
SF-N20-2,SF-H26,8,17,0,8,8,9,0.0,1.0,0.47058823529411764,0.5294117647058824
SF-N20-2,SF-O23,20,18,11,14,9,4,0.55,0.45,0.7777777777777778,0.2222222222222222
SF-N20-2,SF-H27-1,4,2,1,1,3,1,0.25,0.75,0.5,0.5
SF-N20-2,SF-F28-2,9,7,1,4,8,3,0.1111111111111111,0.8888888888888888,0.5714285714285714,0.42857142857142855
SF-N20-2,SF-G27,6,12,3,7,3,5,0.5,0.5,0.5833333333333334,0.4166666666666667
SF-N20-2,SF-M22-2,9,7,2,6,7,1,0.2222222222222222,0.7777777777777778,0.8571428571428571,0.14285714285714285
SF-N20-2,SF-L22,6,12,2,5,4,7,0.3333333333333333,0.6666666666666666,0.4166666666666667,0.5833333333333334
SF-N20-2,SF-F27,4,6,3,5,1,1,0.75,0.25,0.8333333333333334,0.16666666666666666
SF-N20-2,SF-N22-2,63,73,29,64,34,9,0.4603174603174603,0.5396825396825397,0.8767123287671232,0.1232876712328767
SF-N20-2,SF-G28-1,2,2,2,2,0,0,1.0,0.0,1.0,0.0
SF-N20-2,SF-M22-1,5,3,3,2,2,1,0.6,0.4,0.6666666666666666,0.3333333333333333
SF-N20-2,SF-O25-1,5,9,3,9,2,0,0.6,0.4,1.0,0.0
SF-N20-2,SF-K22-2,3,6,1,1,2,5,0.3333333333333333,0.6666666666666666,0.16666666666666666,0.8333333333333334
SF-N20-2,SF-J23-2,4,6,4,4,0,2,1.0,0.0,0.6666666666666666,0.3333333333333333
SF-N20-2,SF-G23,2,2,0,0,2,2,0.0,1.0,0.0,1.0
SF-N20-2,SF-G24,1,5,1,0,0,5,1.0,0.0,0.0,1.0
SF-N20-2,SF-G25,12,11,0,0,12,11,0.0,1.0,0.0,1.0
SF-N20-2,SF-F23,4,3,1,0,3,3,0.25,0.75,0.0,1.0
SF-N20-2,SF-E23,12,11,2,5,10,6,0.16666666666666666,0.8333333333333334,0.45454545454545453,0.5454545454545454
SF-N20-2,SF-C22,2,3,0,0,2,3,0.0,1.0,0.0,1.0
SF-N20-2,SF-B22,1,2,0,0,1,2,0.0,1.0,0.0,1.0
SF-N20-2,SF-J17,11,10,4,3,7,7,0.36363636363636365,0.6363636363636364,0.3,0.7
SF-N20-2,SF-I19,1,3,1,0,0,3,1.0,0.0,0.0,1.0
SF-N20-2,SF-H16,1,3,0,0,1,3,0.0,1.0,0.0,1.0
SF-N20-2,SF-H20,1,4,1,4,0,0,1.0,0.0,1.0,0.0
SF-N20-2,SF-H18,3,5,0,1,3,4,0.0,1.0,0.2,0.8
SF-N20-2,SF-H17,5,6,0,0,5,6,0.0,1.0,0.0,1.0
SF-N20-2,SF-G19,5,2,0,0,5,2,0.0,1.0,0.0,1.0
SF-N20-2,SF-G18,20,85,1,2,19,83,0.05,0.95,0.023529411764705882,0.9764705882352941
SF-N20-2,SF-G20,2,2,1,1,1,1,0.5,0.5,0.5,0.5
SF-N20-2,SF-F19,2,3,0,0,2,3,0.0,1.0,0.0,1.0
SF-N20-2,SF-E20,2,2,1,0,1,2,0.5,0.5,0.0,1.0
SF-N20-2,SF-G30-2,7,8,0,3,7,5,0.0,1.0,0.375,0.625
SF-N20-2,SF-E29-2,3,7,1,5,2,2,0.3333333333333333,0.6666666666666666,0.7142857142857143,0.2857142857142857
SF-N20-2,SF-E29-1,4,5,0,2,4,3,0.0,1.0,0.4,0.6
SF-N20-2,SF-G29-2,1,2,0,1,1,1,0.0,1.0,0.5,0.5
SF-N20-2,SF-G30-1,2,1,0,0,2,1,0.0,1.0,0.0,1.0
SF-N20-2,SF-G29-3,1,1,0,0,1,1,0.0,1.0,0.0,1.0
SF-N20-2,SF-F29,1,2,0,2,1,0,0.0,1.0,1.0,0.0
SF-N20-2,SF-F28-1,2,3,1,2,1,1,0.5,0.5,0.6666666666666666,0.3333333333333333
SF-N20-2,SF-E28,3,1,0,0,3,1,0.0,1.0,0.0,1.0
SF-N20-2,SF-J10,3,6,1,4,2,2,0.3333333333333333,0.6666666666666666,0.6666666666666666,0.3333333333333333
SF-N20-2,SF-J12,7,4,2,0,5,4,0.2857142857142857,0.7142857142857143,0.0,1.0
SF-N20-2,SF-J13,5,1,2,1,3,0,0.4,0.6,1.0,0.0
SF-N20-2,SF-H13,2,3,1,0,1,3,0.5,0.5,0.0,1.0
SF-N20-2,SF-H12,2,3,0,0,2,3,0.0,1.0,0.0,1.0
SF-N20-2,SF-G13,3,3,1,2,2,1,0.3333333333333333,0.6666666666666666,0.6666666666666666,0.3333333333333333
SF-N20-2,SF-G11,1,3,0,2,1,1,0.0,1.0,0.6666666666666666,0.3333333333333333
SF-N20-2,SF-G12,3,1,0,0,3,1,0.0,1.0,0.0,1.0
SF-N20-2,SF-G10-1,1,2,0,0,1,2,0.0,1.0,0.0,1.0
SF-N20-2,SF-C20,1,1,0,0,1,1,0.0,1.0,0.0,1.0
SF-N20-2,SF-B19,5,3,1,0,4,3,0.2,0.8,0.0,1.0
SF-N20-2,SF-A20,2,4,0,2,2,2,0.0,1.0,0.5,0.5
SF-N20-2,SF-A19,2,2,0,0,2,2,0.0,1.0,0.0,1.0
SF-N20-2,SF-C26,2,1,0,0,2,1,0.0,1.0,0.0,1.0
SF-N20-2,SF-C25,2,6,1,1,1,5,0.5,0.5,0.16666666666666666,0.8333333333333334
SF-N20-2,SF-B25,2,5,0,0,2,5,0.0,1.0,0.0,1.0
SF-N20-2,SF-E27,4,2,1,0,3,2,0.25,0.75,0.0,1.0
SF-N20-2,SF-J1,7,12,3,2,4,10,0.42857142857142855,0.5714285714285714,0.16666666666666666,0.8333333333333334
SF-N20-2,SF-J3,2,1,2,0,0,1,1.0,0.0,0.0,1.0
SF-N20-2,SF-J5,3,5,1,0,2,5,0.3333333333333333,0.6666666666666666,0.0,1.0
SF-N20-2,SF-F9,1,1,1,1,0,0,1.0,0.0,1.0,0.0
SF-N20-2,SF-H25,4,2,1,1,3,1,0.25,0.75,0.5,0.5
SF-N20-2,SF-K21,9,2,5,0,4,2,0.5555555555555556,0.4444444444444444,0.0,1.0
SF-N20-2,SF-K22-1,12,9,3,5,9,4,0.25,0.75,0.5555555555555556,0.4444444444444444
SF-N20-2,SF-J23-1,20,15,9,3,11,12,0.45,0.55,0.2,0.8
SF-N20-2,SF-J22-1,9,9,3,4,6,5,0.3333333333333333,0.6666666666666666,0.4444444444444444,0.5555555555555556
SF-N20-2,SF-J22-2,5,3,0,0,5,3,0.0,1.0,0.0,1.0
SF-N20-2,SF-J21,11,8,5,3,6,5,0.45454545454545453,0.5454545454545454,0.375,0.625
SF-N20-2,SF-I21,1,2,1,1,0,1,1.0,0.0,0.5,0.5
SF-N20-2,SF-I23-2,1,3,1,2,0,1,1.0,0.0,0.6666666666666666,0.3333333333333333
SF-N20-2,SF-I24,2,2,1,1,1,1,0.5,0.5,0.5,0.5
SF-N20-2,SF-I23-1,1,2,1,0,0,2,1.0,0.0,0.0,1.0
SF-N20-2,SF-F26,7,7,2,3,5,4,0.2857142857142857,0.7142857142857143,0.42857142857142855,0.5714285714285714
SF-N20-2,SF-M13,11,18,8,6,3,12,0.7272727272727273,0.2727272727272727,0.3333333333333333,0.6666666666666666
SF-N20-2,SF-M15,3,10,0,1,3,9,0.0,1.0,0.1,0.9
SF-N20-2,SF-L19,10,12,9,1,1,11,0.9,0.1,0.08333333333333333,0.9166666666666666
SF-N20-2,SF-L20,7,10,2,1,5,9,0.2857142857142857,0.7142857142857143,0.1,0.9
SF-N20-2,SF-N20-1,16,9,10,4,6,5,0.625,0.375,0.4444444444444444,0.5555555555555556
SF-N20-2,SF-M20,10,25,7,15,3,10,0.7,0.3,0.6,0.4
SF-N20-2,SF-K17-2,11,6,6,3,5,3,0.5454545454545454,0.45454545454545453,0.5,0.5
SF-N20-2,SF-K20,3,18,2,7,1,11,0.6666666666666666,0.3333333333333333,0.3888888888888889,0.6111111111111112
SF-N20-2,SF-K15-,23,34,10,12,13,22,0.43478260869565216,0.5652173913043478,0.35294117647058826,0.6470588235294118
SF-N20-2,SF-K19,10,27,5,5,5,22,0.5,0.5,0.18518518518518517,0.8148148148148148
SF-N20-2,SF-K18,9,13,5,8,4,5,0.5555555555555556,0.4444444444444444,0.6153846153846154,0.38461538461538464
SF-N20-2,SF-K17,4,10,2,3,2,7,0.5,0.5,0.3,0.7
SF-N20-2,SF-J16,4,8,1,0,3,8,0.25,0.75,0.0,1.0
SF-N20-2,SF-J18,8,15,2,3,6,12,0.25,0.75,0.2,0.8
SF-N20-2,SF-J19,2,8,0,3,2,5,0.0,1.0,0.375,0.625
SF-N20-2,SF-M12,5,3,3,1,2,2,0.6,0.4,0.3333333333333333,0.6666666666666666
SF-N20-2,SF-M10,3,9,1,3,2,6,0.3333333333333333,0.6666666666666666,0.3333333333333333,0.6666666666666666
SF-N20-2,SF-M11,5,5,3,1,2,4,0.6,0.4,0.2,0.8
SF-N20-2,SF-R19,5,4,2,0,3,4,0.4,0.6,0.0,1.0
SF-N20-2,SF-R20,1,1,0,0,1,1,0.0,1.0,0.0,1.0
SF-N20-2,SF-Q21-2,1,3,0,0,1,3,0.0,1.0,0.0,1.0
SF-N20-2,SF-Q21-1,5,4,2,2,3,2,0.4,0.6,0.5,0.5
SF-N20-2,SF-P21,5,4,3,2,2,2,0.6,0.4,0.5,0.5
SF-N20-2,SF-O18,10,6,7,2,3,4,0.7,0.3,0.3333333333333333,0.6666666666666666
SF-N20-2,SF-O19,19,12,13,10,6,2,0.6842105263157895,0.3157894736842105,0.8333333333333334,0.16666666666666666
SF-N20-2,SF-O21,34,10,25,7,9,3,0.7352941176470589,0.2647058823529412,0.7,0.3
SF-N20-2,SF-O22,21,27,3,18,18,9,0.14285714285714285,0.8571428571428571,0.6666666666666666,0.3333333333333333
SF-N20-2,SF-N21,44,28,33,19,11,9,0.75,0.25,0.6785714285714286,0.32142857142857145
SF-N20-2,SF-M21,5,9,2,2,3,7,0.4,0.6,0.2222222222222222,0.7777777777777778
SF-N20-2,SF-L21,26,23,6,13,20,10,0.23076923076923078,0.7692307692307693,0.5652173913043478,0.43478260869565216
SF-N20-2,SF-S30,2,1,0,1,2,0,0.0,1.0,1.0,0.0
SF-N20-2,SF-Q30,12,12,10,9,2,3,0.8333333333333334,0.16666666666666666,0.75,0.25
SF-N20-2,SF-P30,44,24,44,24,0,0,1.0,0.0,1.0,0.0
SF-N20-2,SF-O30-2,3,3,2,2,1,1,0.6666666666666666,0.3333333333333333,0.6666666666666666,0.3333333333333333
SF-N20-2,SF-O30,10,1,4,0,6,1,0.4,0.6,0.0,1.0
SF-N20-2,SF-N27,15,5,4,2,11,3,0.26666666666666666,0.7333333333333333,0.4,0.6
SF-N20-2,SF-N29,13,5,5,2,8,3,0.38461538461538464,0.6153846153846154,0.4,0.6
SF-N20-2,SF-N28,14,6,2,3,12,3,0.14285714285714285,0.8571428571428571,0.5,0.5
SF-N20-2,SF-L30-1,37,30,1,1,36,29,0.02702702702702703,0.972972972972973,0.03333333333333333,0.9666666666666667
SF-N20-2,SF-L31-1,8,13,0,1,8,12,0.0,1.0,0.07692307692307693,0.9230769230769231
SF-N20-2,SF-K30-2,2,1,0,0,2,1,0.0,1.0,0.0,1.0
SF-N20-2,SF-L29,4,4,0,0,4,4,0.0,1.0,0.0,1.0
SF-N20-2,SF-I30,10,7,5,5,5,2,0.5,0.5,0.7142857142857143,0.2857142857142857
SF-N20-2,SF-I30-2,1,1,1,0,0,1,1.0,0.0,0.0,1.0
SF-N20-2,SF-H28,1,2,0,2,1,0,0.0,1.0,1.0,0.0
SF-N20-2,SF-S24,6,8,2,3,4,5,0.3333333333333333,0.6666666666666666,0.375,0.625
SF-N20-2,SF-R24,19,30,5,6,14,24,0.2631578947368421,0.7368421052631579,0.2,0.8
SF-N20-2,SF-R26,8,5,1,1,7,4,0.125,0.875,0.2,0.8
SF-N20-2,SF-Q26,24,9,0,1,24,8,0.0,1.0,0.1111111111111111,0.8888888888888888
SF-N20-2,SF-P26,3,3,1,0,2,3,0.3333333333333333,0.6666666666666666,0.0,1.0
SF-N20-2,SF-O25-2,5,5,2,3,3,2,0.4,0.6,0.6,0.4
SF-N20-2,SF-N22-1B,29,62,9,32,20,30,0.3103448275862069,0.6896551724137931,0.5161290322580645,0.4838709677419355
SF-N20-2,SF-N26,14,13,1,1,13,12,0.07142857142857142,0.9285714285714286,0.07692307692307693,0.9230769230769231
SF-N20-2,SF-N25,11,3,7,0,4,3,0.6363636363636364,0.36363636363636365,0.0,1.0
SF-N20-2,SF-T21,8,14,8,12,0,2,1.0,0.0,0.8571428571428571,0.14285714285714285
SF-N20-2,SF-T22,7,8,3,2,4,6,0.42857142857142855,0.5714285714285714,0.25,0.75
SF-N20-2,SF-S22-2,4,1,0,0,4,1,0.0,1.0,0.0,1.0
SF-N20-2,SF-S22-1,13,3,9,1,4,2,0.6923076923076923,0.3076923076923077,0.3333333333333333,0.6666666666666666
SF-N20-2,SF-Q23-3,11,14,3,8,8,6,0.2727272727272727,0.7272727272727273,0.5714285714285714,0.42857142857142855
SF-N20-2,SF-Q22-1,17,40,10,24,7,16,0.5882352941176471,0.4117647058823529,0.6,0.4
SF-N20-2,SF-Q22-2,21,10,9,7,12,3,0.42857142857142855,0.5714285714285714,0.7,0.3
SF-N20-2,SF-P22,13,12,5,6,8,6,0.38461538461538464,0.6153846153846154,0.5,0.5
SF-N20-2,SF-U21,3,3,0,1,3,2,0.0,1.0,0.3333333333333333,0.6666666666666666
SF-M21,SF-M26,4,6,1,1,3,5,0.25,0.75,0.16666666666666666,0.8333333333333334
SF-M21,SF-M25,34,38,9,8,25,30,0.2647058823529412,0.7352941176470589,0.21052631578947367,0.7894736842105263
SF-M21,SF-M26-2,4,10,0,2,4,8,0.0,1.0,0.2,0.8
SF-M21,SF-L27,4,3,2,2,2,1,0.5,0.5,0.6666666666666666,0.3333333333333333
SF-M21,SF-K26,13,13,5,4,8,9,0.38461538461538464,0.6153846153846154,0.3076923076923077,0.6923076923076923
SF-M21,SF-J27,6,9,0,1,6,8,0.0,1.0,0.1111111111111111,0.8888888888888888
SF-M21,SF-M30,105,98,55,36,50,62,0.5238095238095238,0.47619047619047616,0.3673469387755102,0.6326530612244898
SF-M21,SF-J29-3,5,3,1,1,4,2,0.2,0.8,0.3333333333333333,0.6666666666666666
SF-M21,SF-J29,13,14,2,8,11,6,0.15384615384615385,0.8461538461538461,0.5714285714285714,0.42857142857142855
SF-M21,SF-L26,291,290,84,132,207,158,0.28865979381443296,0.711340206185567,0.45517241379310347,0.5448275862068965
SF-M21,SF-M28,6,4,3,2,3,2,0.5,0.5,0.5,0.5
SF-M21,SF-L25,19,12,4,4,15,8,0.21052631578947367,0.7894736842105263,0.3333333333333333,0.6666666666666666
SF-M21,SF-M24,21,7,14,6,7,1,0.6666666666666666,0.3333333333333333,0.8571428571428571,0.14285714285714285
SF-M21,SF-L24,26,24,14,12,12,12,0.5384615384615384,0.46153846153846156,0.5,0.5
SF-M21,SF-N23,10,18,2,8,8,10,0.2,0.8,0.4444444444444444,0.5555555555555556
SF-M21,SF-N24-2,5,9,0,3,5,6,0.0,1.0,0.3333333333333333,0.6666666666666666
SF-M21,SF-K27-2,11,10,5,3,6,7,0.45454545454545453,0.5454545454545454,0.3,0.7
SF-M21,SF-J26-2,2,14,0,5,2,9,0.0,1.0,0.35714285714285715,0.6428571428571429
SF-M21,SF-K28-3,1,1,1,0,0,1,1.0,0.0,0.0,1.0
SF-M21,SF-L28,7,5,5,1,2,4,0.7142857142857143,0.2857142857142857,0.2,0.8
SF-M21,SF-K29-1,16,12,11,10,5,2,0.6875,0.3125,0.8333333333333334,0.16666666666666666
SF-M21,SF-J28-2,3,2,3,1,0,1,1.0,0.0,0.5,0.5
SF-M21,SF-K27,8,1,1,1,7,0,0.125,0.875,1.0,0.0
SF-M21,SF-K25,8,6,7,2,1,4,0.875,0.125,0.3333333333333333,0.6666666666666666
SF-M21,SF-J25,11,3,2,1,9,2,0.18181818181818182,0.8181818181818182,0.3333333333333333,0.6666666666666666
SF-M21,SF-H26-2,5,2,2,1,3,1,0.4,0.6,0.5,0.5
SF-M21,SF-P24,15,27,4,12,11,15,0.26666666666666666,0.7333333333333333,0.4444444444444444,0.5555555555555556
SF-M21,SF-N22-1A,6,3,0,1,6,2,0.0,1.0,0.3333333333333333,0.6666666666666666
SF-M21,SF-J24,8,10,2,4,6,6,0.25,0.75,0.4,0.6
SF-M21,SF-O24,8,13,4,8,4,5,0.5,0.5,0.6153846153846154,0.38461538461538464
SF-M21,SF-J26,9,7,1,2,8,5,0.1111111111111111,0.8888888888888888,0.2857142857142857,0.7142857142857143
SF-M21,SF-I26-,6,1,3,0,3,1,0.5,0.5,0.0,1.0
SF-M21,SF-I25,9,8,2,3,7,5,0.2222222222222222,0.7777777777777778,0.375,0.625
SF-M21,SF-K23,13,2,8,1,5,1,0.6153846153846154,0.38461538461538464,0.5,0.5
SF-M21,SF-H26,22,19,5,4,17,15,0.22727272727272727,0.7727272727272727,0.21052631578947367,0.7894736842105263
SF-M21,SF-O23,12,22,3,7,9,15,0.25,0.75,0.3181818181818182,0.6818181818181818
SF-M21,SF-H27-1,3,2,2,2,1,0,0.6666666666666666,0.3333333333333333,1.0,0.0
SF-M21,SF-F28-2,23,56,9,50,14,6,0.391304347826087,0.6086956521739131,0.8928571428571429,0.10714285714285714
SF-M21,SF-G27,53,29,11,13,42,16,0.20754716981132076,0.7924528301886793,0.4482758620689655,0.5517241379310345
SF-M21,SF-M22-2,18,19,6,14,12,5,0.3333333333333333,0.6666666666666666,0.7368421052631579,0.2631578947368421
SF-M21,SF-L22,10,18,4,11,6,7,0.4,0.6,0.6111111111111112,0.3888888888888889
SF-M21,SF-F27,2,9,1,3,1,6,0.5,0.5,0.3333333333333333,0.6666666666666666
SF-M21,SF-N22-2,28,44,13,30,15,14,0.4642857142857143,0.5357142857142857,0.6818181818181818,0.3181818181818182
SF-M21,SF-M22-1,7,10,6,7,1,3,0.8571428571428571,0.14285714285714285,0.7,0.3
SF-M21,SF-O25-1,5,14,3,5,2,9,0.6,0.4,0.35714285714285715,0.6428571428571429
SF-M21,SF-K22-2,7,7,0,4,7,3,0.0,1.0,0.5714285714285714,0.42857142857142855
SF-M21,SF-K24,4,3,1,2,3,1,0.25,0.75,0.6666666666666666,0.3333333333333333
SF-M21,SF-J23-2,2,5,0,3,2,2,0.0,1.0,0.6,0.4
SF-M21,SF-G23,6,7,3,3,3,4,0.5,0.5,0.42857142857142855,0.5714285714285714
SF-M21,SF-G24,9,13,6,0,3,13,0.6666666666666666,0.3333333333333333,0.0,1.0
SF-M21,SF-G25,9,5,3,2,6,3,0.3333333333333333,0.6666666666666666,0.4,0.6
SF-M21,SF-F23,8,11,3,3,5,8,0.375,0.625,0.2727272727272727,0.7272727272727273
SF-M21,SF-E23,8,7,2,1,6,6,0.25,0.75,0.14285714285714285,0.8571428571428571
SF-M21,SF-D24,4,2,2,0,2,2,0.5,0.5,0.0,1.0
SF-M21,SF-C22,2,3,1,1,1,2,0.5,0.5,0.3333333333333333,0.6666666666666666
SF-M21,SF-B22,6,3,0,1,6,2,0.0,1.0,0.3333333333333333,0.6666666666666666
SF-M21,SF-J17,8,8,3,2,5,6,0.375,0.625,0.25,0.75
SF-M21,SF-I19,3,1,1,1,2,0,0.3333333333333333,0.6666666666666666,1.0,0.0
SF-M21,SF-H16,5,5,3,0,2,5,0.6,0.4,0.0,1.0
SF-M21,SF-H20,43,16,29,6,14,10,0.6744186046511628,0.32558139534883723,0.375,0.625
SF-M21,SF-H18,2,4,0,0,2,4,0.0,1.0,0.0,1.0
SF-M21,SF-H17,2,5,0,0,2,5,0.0,1.0,0.0,1.0
SF-M21,SF-G19,6,13,1,11,5,2,0.16666666666666666,0.8333333333333334,0.8461538461538461,0.15384615384615385
SF-M21,SF-G17,2,3,0,2,2,1,0.0,1.0,0.6666666666666666,0.3333333333333333
SF-M21,SF-G18,5,3,0,0,5,3,0.0,1.0,0.0,1.0
SF-M21,SF-G20,8,8,1,2,7,6,0.125,0.875,0.25,0.75
SF-M21,SF-F19,6,8,2,1,4,7,0.3333333333333333,0.6666666666666666,0.125,0.875
SF-M21,SF-E18,3,2,1,1,2,1,0.3333333333333333,0.6666666666666666,0.5,0.5
SF-M21,SF-E20,6,27,3,0,3,27,0.5,0.5,0.0,1.0
SF-M21,SF-H30,2,3,0,1,2,2,0.0,1.0,0.3333333333333333,0.6666666666666666
SF-M21,SF-G30-2,9,8,2,2,7,6,0.2222222222222222,0.7777777777777778,0.25,0.75
SF-M21,SF-F30-1,2,4,0,0,2,4,0.0,1.0,0.0,1.0
SF-M21,SF-E29-2,7,20,0,7,7,13,0.0,1.0,0.35,0.65
SF-M21,SF-E29-1,12,6,5,1,7,5,0.4166666666666667,0.5833333333333334,0.16666666666666666,0.8333333333333334
SF-M21,SF-D29,2,2,0,0,2,2,0.0,1.0,0.0,1.0
SF-M21,SF-G29-2,11,9,2,2,9,7,0.18181818181818182,0.8181818181818182,0.2222222222222222,0.7777777777777778
SF-M21,SF-G29-1,2,2,1,1,1,1,0.5,0.5,0.5,0.5
SF-M21,SF-G30-1,2,2,0,0,2,2,0.0,1.0,0.0,1.0
SF-M21,SF-G29-3,6,3,2,1,4,2,0.3333333333333333,0.6666666666666666,0.3333333333333333,0.6666666666666666
SF-M21,SF-F30-2,21,19,19,19,2,0,0.9047619047619048,0.09523809523809523,1.0,0.0
SF-M21,SF-E29-3,8,15,3,7,5,8,0.375,0.625,0.4666666666666667,0.5333333333333333
SF-M21,SF-F28-1,48,67,33,59,15,8,0.6875,0.3125,0.8805970149253731,0.11940298507462686
SF-M21,SF-E28,4,1,0,0,4,1,0.0,1.0,0.0,1.0
SF-M21,SF-J10,1,2,0,2,1,0,0.0,1.0,1.0,0.0
SF-M21,SF-J12,13,13,2,5,11,8,0.15384615384615385,0.8461538461538461,0.38461538461538464,0.6153846153846154
SF-M21,SF-J13,5,1,0,0,5,1,0.0,1.0,0.0,1.0
SF-M21,SF-I16,4,4,0,0,4,4,0.0,1.0,0.0,1.0
SF-M21,SF-H12,2,2,0,1,2,1,0.0,1.0,0.5,0.5
SF-M21,SF-G9,5,3,0,0,5,3,0.0,1.0,0.0,1.0
SF-M21,SF-H14,2,1,2,1,0,0,1.0,0.0,1.0,0.0
SF-M21,SF-G11,1,3,0,0,1,3,0.0,1.0,0.0,1.0
SF-M21,SF-G12,7,6,2,0,5,6,0.2857142857142857,0.7142857142857143,0.0,1.0
SF-M21,SF-F15,3,6,1,2,2,4,0.3333333333333333,0.6666666666666666,0.3333333333333333,0.6666666666666666
SF-M21,SF-F16,3,2,1,1,2,1,0.3333333333333333,0.6666666666666666,0.5,0.5
SF-M21,SF-C20,4,1,0,0,4,1,0.0,1.0,0.0,1.0
SF-M21,SF-B21,5,2,1,1,4,1,0.2,0.8,0.5,0.5
SF-M21,SF-A20,1,1,0,0,1,1,0.0,1.0,0.0,1.0
SF-M21,SF-A19,2,4,2,1,0,3,1.0,0.0,0.25,0.75
SF-M21,SF-C26,5,3,1,1,4,2,0.2,0.8,0.3333333333333333,0.6666666666666666
SF-M21,SF-C25,22,14,0,0,22,14,0.0,1.0,0.0,1.0
SF-M21,SF-B25,4,3,1,1,3,2,0.25,0.75,0.3333333333333333,0.6666666666666666
SF-M21,SF-D27,12,2,2,1,10,1,0.16666666666666666,0.8333333333333334,0.5,0.5
SF-M21,SF-B28,1,3,0,2,1,1,0.0,1.0,0.6666666666666666,0.3333333333333333
SF-M21,SF-J1,6,4,4,2,2,2,0.6666666666666666,0.3333333333333333,0.5,0.5
SF-M21,SF-H0,2,2,1,0,1,2,0.5,0.5,0.0,1.0
SF-M21,SF-J5,1,1,0,0,1,1,0.0,1.0,0.0,1.0
SF-M21,SF-G7,7,9,4,0,3,9,0.5714285714285714,0.42857142857142855,0.0,1.0
SF-M21,SF-F9,2,6,0,0,2,6,0.0,1.0,0.0,1.0
SF-M21,SF-G26,14,6,5,1,9,5,0.35714285714285715,0.6428571428571429,0.16666666666666666,0.8333333333333334
SF-M21,SF-K21,11,6,2,0,9,6,0.18181818181818182,0.8181818181818182,0.0,1.0
SF-M21,SF-K22-1,5,7,4,3,1,4,0.8,0.2,0.42857142857142855,0.5714285714285714
SF-M21,SF-J23-1,28,30,6,6,22,24,0.21428571428571427,0.7857142857142857,0.2,0.8
SF-M21,SF-J22-1,12,9,2,1,10,8,0.16666666666666666,0.8333333333333334,0.1111111111111111,0.8888888888888888
SF-M21,SF-J22-2,23,15,4,2,19,13,0.17391304347826086,0.8260869565217391,0.13333333333333333,0.8666666666666667
SF-M21,SF-J21,18,13,3,3,15,10,0.16666666666666666,0.8333333333333334,0.23076923076923078,0.7692307692307693
SF-M21,SF-I21,3,1,0,0,3,1,0.0,1.0,0.0,1.0
SF-M21,SF-I22,5,3,1,1,4,2,0.2,0.8,0.3333333333333333,0.6666666666666666
SF-M21,SF-I23-2,5,5,2,2,3,3,0.4,0.6,0.4,0.6
SF-M21,SF-I24,2,4,2,0,0,4,1.0,0.0,0.0,1.0
SF-M21,SF-I23-1,11,10,1,1,10,9,0.09090909090909091,0.9090909090909091,0.1,0.9
SF-M21,SF-F26,20,18,4,6,16,12,0.2,0.8,0.3333333333333333,0.6666666666666666
SF-M21,SF-M13,30,8,7,1,23,7,0.23333333333333334,0.7666666666666667,0.125,0.875
SF-M21,SF-M15,14,22,4,9,10,13,0.2857142857142857,0.7142857142857143,0.4090909090909091,0.5909090909090909
SF-M21,SF-L19,9,12,5,6,4,6,0.5555555555555556,0.4444444444444444,0.5,0.5
SF-M21,SF-L20,15,25,7,13,8,12,0.4666666666666667,0.5333333333333333,0.52,0.48
SF-M21,SF-N20-1,15,18,8,7,7,11,0.5333333333333333,0.4666666666666667,0.3888888888888889,0.6111111111111112
SF-M21,SF-M20,13,24,6,10,7,14,0.46153846153846156,0.5384615384615384,0.4166666666666667,0.5833333333333334
SF-M21,SF-K17-2,9,6,3,1,6,5,0.3333333333333333,0.6666666666666666,0.16666666666666666,0.8333333333333334
SF-M21,SF-K20,24,34,11,19,13,15,0.4583333333333333,0.5416666666666666,0.5588235294117647,0.4411764705882353
SF-M21,SF-K15-,52,42,17,17,35,25,0.3269230769230769,0.6730769230769231,0.40476190476190477,0.5952380952380952
SF-M21,SF-K19,79,55,63,41,16,14,0.7974683544303798,0.20253164556962025,0.7454545454545455,0.2545454545454545
SF-M21,SF-K18,59,25,46,0,13,25,0.7796610169491526,0.22033898305084745,0.0,1.0
SF-M21,SF-K17,15,19,8,10,7,9,0.5333333333333333,0.4666666666666667,0.5263157894736842,0.47368421052631576
SF-M21,SF-J16,13,7,6,1,7,6,0.46153846153846156,0.5384615384615384,0.14285714285714285,0.8571428571428571
SF-M21,SF-J18,27,47,17,19,10,28,0.6296296296296297,0.37037037037037035,0.40425531914893614,0.5957446808510638
SF-M21,SF-J20,1,10,1,3,0,7,1.0,0.0,0.3,0.7
SF-M21,SF-J19,7,4,2,0,5,4,0.2857142857142857,0.7142857142857143,0.0,1.0
SF-M21,SF-M12,7,7,1,1,6,6,0.14285714285714285,0.8571428571428571,0.14285714285714285,0.8571428571428571
SF-M21,SF-M10,5,7,2,2,3,5,0.4,0.6,0.2857142857142857,0.7142857142857143
SF-M21,SF-M11,8,10,1,2,7,8,0.125,0.875,0.2,0.8
SF-M21,SF-R19,6,7,1,1,5,6,0.16666666666666666,0.8333333333333334,0.14285714285714285,0.8571428571428571
SF-M21,SF-R20,16,27,3,4,13,23,0.1875,0.8125,0.14814814814814814,0.8518518518518519
SF-M21,SF-Q21-2,12,16,1,2,11,14,0.08333333333333333,0.9166666666666666,0.125,0.875
SF-M21,SF-Q21-1,8,18,0,4,8,14,0.0,1.0,0.2222222222222222,0.7777777777777778
SF-M21,SF-P21,21,29,15,6,6,23,0.7142857142857143,0.2857142857142857,0.20689655172413793,0.7931034482758621
SF-M21,SF-O18,30,33,9,3,21,30,0.3,0.7,0.09090909090909091,0.9090909090909091
SF-M21,SF-O19,21,48,2,17,19,31,0.09523809523809523,0.9047619047619048,0.3541666666666667,0.6458333333333334
SF-M21,SF-O21,44,91,16,53,28,38,0.36363636363636365,0.6363636363636364,0.5824175824175825,0.4175824175824176
SF-M21,SF-O22,36,75,13,46,23,29,0.3611111111111111,0.6388888888888888,0.6133333333333333,0.38666666666666666
SF-M21,SF-N21,22,45,12,30,10,15,0.5454545454545454,0.45454545454545453,0.6666666666666666,0.3333333333333333
SF-M21,SF-N20-2,9,5,2,2,7,3,0.2222222222222222,0.7777777777777778,0.4,0.6
SF-M21,SF-L21,59,51,33,22,26,29,0.559322033898305,0.4406779661016949,0.43137254901960786,0.5686274509803921
SF-M21,SF-Q30,4,3,0,1,4,2,0.0,1.0,0.3333333333333333,0.6666666666666666
SF-M21,SF-P30,6,6,0,4,6,2,0.0,1.0,0.6666666666666666,0.3333333333333333
SF-M21,SF-O30-2,4,5,0,2,4,3,0.0,1.0,0.4,0.6
SF-M21,SF-O30,8,10,5,8,3,2,0.625,0.375,0.8,0.2
SF-M21,SF-N27,8,13,1,3,7,10,0.125,0.875,0.23076923076923078,0.7692307692307693
SF-M21,SF-N29,6,3,0,2,6,1,0.0,1.0,0.6666666666666666,0.3333333333333333
SF-M21,SF-N28,13,21,4,6,9,15,0.3076923076923077,0.6923076923076923,0.2857142857142857,0.7142857142857143
SF-M21,SF-L30-1,16,58,3,42,13,16,0.1875,0.8125,0.7241379310344828,0.27586206896551724
SF-M21,SF-K30-2,3,4,0,2,3,2,0.0,1.0,0.5,0.5
SF-M21,SF-L29,6,5,3,2,3,3,0.5,0.5,0.4,0.6
SF-M21,SF-J29-1,5,2,2,2,3,0,0.4,0.6,1.0,0.0
SF-M21,SF-I30,11,2,8,1,3,1,0.7272727272727273,0.2727272727272727,0.5,0.5
SF-M21,SF-I27,2,8,0,5,2,3,0.0,1.0,0.625,0.375
SF-M21,SF-I30-2,6,2,1,0,5,2,0.16666666666666666,0.8333333333333334,0.0,1.0
SF-M21,SF-H28,3,6,0,1,3,5,0.0,1.0,0.16666666666666666,0.8333333333333334
SF-M21,SF-S24,32,45,1,8,31,37,0.03125,0.96875,0.17777777777777778,0.8222222222222222
SF-M21,SF-R24,18,19,6,5,12,14,0.3333333333333333,0.6666666666666666,0.2631578947368421,0.7368421052631579
SF-M21,SF-R26,5,5,2,4,3,1,0.4,0.6,0.8,0.2
SF-M21,SF-Q26,14,73,0,2,14,71,0.0,1.0,0.0273972602739726,0.9726027397260274
SF-M21,SF-P26,131,75,4,7,127,68,0.030534351145038167,0.9694656488549618,0.09333333333333334,0.9066666666666666
SF-M21,SF-O25-2,22,11,8,6,14,5,0.36363636363636365,0.6363636363636364,0.5454545454545454,0.45454545454545453
SF-M21,SF-N22-1B,14,23,6,12,8,11,0.42857142857142855,0.5714285714285714,0.5217391304347826,0.4782608695652174
SF-M21,SF-N26,6,4,2,2,4,2,0.3333333333333333,0.6666666666666666,0.5,0.5
SF-M21,SF-N25,13,17,5,6,8,11,0.38461538461538464,0.6153846153846154,0.35294117647058826,0.6470588235294118
SF-M21,SF-T21,2,9,0,3,2,6,0.0,1.0,0.3333333333333333,0.6666666666666666
SF-M21,SF-T22,12,15,7,6,5,9,0.5833333333333334,0.4166666666666667,0.4,0.6
SF-M21,SF-S22-2,12,6,1,0,11,6,0.08333333333333333,0.9166666666666666,0.0,1.0
SF-M21,SF-S22-1,15,20,9,7,6,13,0.6,0.4,0.35,0.65
SF-M21,SF-Q23-3,16,23,5,12,11,11,0.3125,0.6875,0.5217391304347826,0.4782608695652174
SF-M21,SF-Q22-1,19,30,8,19,11,11,0.42105263157894735,0.5789473684210527,0.6333333333333333,0.36666666666666664
SF-M21,SF-Q22-2,22,28,10,18,12,10,0.45454545454545453,0.5454545454545454,0.6428571428571429,0.35714285714285715
SF-M21,SF-P22,33,40,15,21,18,19,0.45454545454545453,0.5454545454545454,0.525,0.475
SF-M21,SF-U21,3,1,1,0,2,1,0.3333333333333333,0.6666666666666666,0.0,1.0
SF-M21,SF-T20,7,10,3,3,4,7,0.42857142857142855,0.5714285714285714,0.3,0.7
SF-M21,SF-S21,13,10,2,4,11,6,0.15384615384615385,0.8461538461538461,0.4,0.6
SF-M21,SF-Z16,4,17,0,0,4,17,0.0,1.0,0.0,1.0
SF-L21,SF-M26,3,3,0,1,3,2,0.0,1.0,0.3333333333333333,0.6666666666666666
SF-L21,SF-M25,17,10,4,3,13,7,0.23529411764705882,0.7647058823529411,0.3,0.7
SF-L21,SF-M26-2,9,9,2,0,7,9,0.2222222222222222,0.7777777777777778,0.0,1.0
SF-L21,SF-L27,3,2,0,0,3,2,0.0,1.0,0.0,1.0
SF-L21,SF-K26,10,19,2,9,8,10,0.2,0.8,0.47368421052631576,0.5263157894736842
SF-L21,SF-J27,15,6,1,1,14,5,0.06666666666666667,0.9333333333333333,0.16666666666666666,0.8333333333333334
SF-L21,SF-M30,53,51,4,27,49,24,0.07547169811320754,0.9245283018867925,0.5294117647058824,0.47058823529411764
SF-L21,SF-L27-2,6,1,5,0,1,1,0.8333333333333334,0.16666666666666666,0.0,1.0
SF-L21,SF-J29-3,8,6,1,2,7,4,0.125,0.875,0.3333333333333333,0.6666666666666666
SF-L21,SF-J29,20,37,6,5,14,32,0.3,0.7,0.13513513513513514,0.8648648648648649
SF-L21,SF-L26,87,91,21,24,66,67,0.2413793103448276,0.7586206896551724,0.26373626373626374,0.7362637362637363
SF-L21,SF-M28,5,4,1,1,4,3,0.2,0.8,0.25,0.75
SF-L21,SF-M27,1,2,0,2,1,0,0.0,1.0,1.0,0.0
SF-L21,SF-L25,25,24,4,13,21,11,0.16,0.84,0.5416666666666666,0.4583333333333333
SF-L21,SF-M24,30,16,4,2,26,14,0.13333333333333333,0.8666666666666667,0.125,0.875
SF-L21,SF-L24,26,18,6,7,20,11,0.23076923076923078,0.7692307692307693,0.3888888888888889,0.6111111111111112
SF-L21,SF-N23,13,14,3,2,10,12,0.23076923076923078,0.7692307692307693,0.14285714285714285,0.8571428571428571
SF-L21,SF-N24-2,14,11,1,1,13,10,0.07142857142857142,0.9285714285714286,0.09090909090909091,0.9090909090909091
SF-L21,SF-K27-2,11,10,5,5,6,5,0.45454545454545453,0.5454545454545454,0.5,0.5
SF-L21,SF-J26-2,34,63,6,11,28,52,0.17647058823529413,0.8235294117647058,0.1746031746031746,0.8253968253968254
SF-L21,SF-L28,5,7,1,1,4,6,0.2,0.8,0.14285714285714285,0.8571428571428571
SF-L21,SF-K28,8,3,1,1,7,2,0.125,0.875,0.3333333333333333,0.6666666666666666
SF-L21,SF-K29-1,13,16,1,4,12,12,0.07692307692307693,0.9230769230769231,0.25,0.75
SF-L21,SF-J28-2,4,5,0,1,4,4,0.0,1.0,0.2,0.8
SF-L21,SF-K27,9,9,4,5,5,4,0.4444444444444444,0.5555555555555556,0.5555555555555556,0.4444444444444444
SF-L21,SF-K25,24,23,14,10,10,13,0.5833333333333334,0.4166666666666667,0.43478260869565216,0.5652173913043478
SF-L21,SF-J25,37,66,17,43,20,23,0.4594594594594595,0.5405405405405406,0.6515151515151515,0.3484848484848485
SF-L21,SF-H26-2,24,10,6,3,18,7,0.25,0.75,0.3,0.7
SF-L21,SF-P24,8,13,1,9,7,4,0.125,0.875,0.6923076923076923,0.3076923076923077
SF-L21,SF-N22-1A,11,10,2,6,9,4,0.18181818181818182,0.8181818181818182,0.6,0.4
SF-L21,SF-J24,6,22,1,10,5,12,0.16666666666666666,0.8333333333333334,0.45454545454545453,0.5454545454545454
SF-L21,SF-O24,6,8,1,2,5,6,0.16666666666666666,0.8333333333333334,0.25,0.75
SF-L21,SF-J26,11,30,4,16,7,14,0.36363636363636365,0.6363636363636364,0.5333333333333333,0.4666666666666667
SF-L21,SF-I26-,29,5,18,1,11,4,0.6206896551724138,0.3793103448275862,0.2,0.8
SF-L21,SF-I25,124,104,62,70,62,34,0.5,0.5,0.6730769230769231,0.3269230769230769
SF-L21,SF-K23,9,5,5,4,4,1,0.5555555555555556,0.4444444444444444,0.8,0.2
SF-L21,SF-H26,176,139,58,61,118,78,0.32954545454545453,0.6704545454545454,0.43884892086330934,0.5611510791366906
SF-L21,SF-O23,10,48,2,28,8,20,0.2,0.8,0.5833333333333334,0.4166666666666667
SF-L21,SF-H27-1,7,12,0,5,7,7,0.0,1.0,0.4166666666666667,0.5833333333333334
SF-L21,SF-F28-2,73,51,13,18,60,33,0.1780821917808219,0.821917808219178,0.35294117647058826,0.6470588235294118
SF-L21,SF-G27,128,91,31,44,97,47,0.2421875,0.7578125,0.4835164835164835,0.5164835164835165
SF-L21,SF-M22-2,58,26,19,10,39,16,0.3275862068965517,0.6724137931034483,0.38461538461538464,0.6153846153846154
SF-L21,SF-L22,45,75,9,11,36,64,0.2,0.8,0.14666666666666667,0.8533333333333334
SF-L21,SF-F27,78,137,16,11,62,126,0.20512820512820512,0.7948717948717948,0.08029197080291971,0.9197080291970803
SF-L21,SF-N22-2,56,60,17,32,39,28,0.30357142857142855,0.6964285714285714,0.5333333333333333,0.4666666666666667
SF-L21,SF-G28-2,10,19,0,1,10,18,0.0,1.0,0.05263157894736842,0.9473684210526315
SF-L21,SF-G28-1,9,3,8,1,1,2,0.8888888888888888,0.1111111111111111,0.3333333333333333,0.6666666666666666
SF-L21,SF-M22-1,29,42,3,17,26,25,0.10344827586206896,0.896551724137931,0.40476190476190477,0.5952380952380952
SF-L21,SF-O25-1,2,4,1,1,1,3,0.5,0.5,0.25,0.75
SF-L21,SF-K22-2,34,29,12,11,22,18,0.35294117647058826,0.6470588235294118,0.3793103448275862,0.6206896551724138
SF-L21,SF-K24,18,21,5,8,13,13,0.2777777777777778,0.7222222222222222,0.38095238095238093,0.6190476190476191
SF-L21,SF-J23-2,55,101,23,66,32,35,0.41818181818181815,0.5818181818181818,0.6534653465346535,0.3465346534653465
SF-L21,SF-G23,26,12,11,4,15,8,0.4230769230769231,0.5769230769230769,0.3333333333333333,0.6666666666666666
SF-L21,SF-G24,89,98,18,10,71,88,0.20224719101123595,0.797752808988764,0.10204081632653061,0.8979591836734694
SF-L21,SF-G25,119,18,25,3,94,15,0.21008403361344538,0.7899159663865546,0.16666666666666666,0.8333333333333334
SF-L21,SF-F23,45,28,14,3,31,25,0.3111111111111111,0.6888888888888889,0.10714285714285714,0.8928571428571429
SF-L21,SF-E23,29,17,11,2,18,15,0.3793103448275862,0.6206896551724138,0.11764705882352941,0.8823529411764706
SF-L21,SF-D24,8,5,3,0,5,5,0.375,0.625,0.0,1.0
SF-L21,SF-C22,9,8,1,0,8,8,0.1111111111111111,0.8888888888888888,0.0,1.0
SF-L21,SF-B22,4,13,3,2,1,11,0.75,0.25,0.15384615384615385,0.8461538461538461
SF-L21,SF-J17,22,34,7,3,15,31,0.3181818181818182,0.6818181818181818,0.08823529411764706,0.9117647058823529
SF-L21,SF-I19,19,24,3,1,16,23,0.15789473684210525,0.8421052631578947,0.041666666666666664,0.9583333333333334
SF-L21,SF-I20,6,6,4,4,2,2,0.6666666666666666,0.3333333333333333,0.6666666666666666,0.3333333333333333
SF-L21,SF-H16,7,9,4,0,3,9,0.5714285714285714,0.42857142857142855,0.0,1.0
SF-L21,SF-H19,2,5,0,1,2,4,0.0,1.0,0.2,0.8
SF-L21,SF-H20,15,8,1,0,14,8,0.06666666666666667,0.9333333333333333,0.0,1.0
SF-L21,SF-H18,9,5,3,0,6,5,0.3333333333333333,0.6666666666666666,0.0,1.0
SF-L21,SF-H17,4,1,0,0,4,1,0.0,1.0,0.0,1.0
SF-L21,SF-G19,9,10,1,0,8,10,0.1111111111111111,0.8888888888888888,0.0,1.0
SF-L21,SF-G17,4,6,1,0,3,6,0.25,0.75,0.0,1.0
SF-L21,SF-G18,10,6,0,1,10,5,0.0,1.0,0.16666666666666666,0.8333333333333334
SF-L21,SF-G20,53,26,2,2,51,24,0.03773584905660377,0.9622641509433962,0.07692307692307693,0.9230769230769231
SF-L21,SF-F19,18,6,3,0,15,6,0.16666666666666666,0.8333333333333334,0.0,1.0
SF-L21,SF-E18,5,13,0,0,5,13,0.0,1.0,0.0,1.0
SF-L21,SF-E20,14,21,2,0,12,21,0.14285714285714285,0.8571428571428571,0.0,1.0
SF-L21,SF-H30,1,1,0,1,1,0,0.0,1.0,1.0,0.0
SF-L21,SF-G30-2,27,20,3,5,24,15,0.1111111111111111,0.8888888888888888,0.25,0.75
SF-L21,SF-F30-1,15,21,0,2,15,19,0.0,1.0,0.09523809523809523,0.9047619047619048
SF-L21,SF-E29-2,84,66,16,20,68,46,0.19047619047619047,0.8095238095238095,0.30303030303030304,0.696969696969697
SF-L21,SF-E29-1,25,17,4,9,21,8,0.16,0.84,0.5294117647058824,0.47058823529411764
SF-L21,SF-D29,12,2,2,0,10,2,0.16666666666666666,0.8333333333333334,0.0,1.0
SF-L21,SF-D28,28,21,2,2,26,19,0.07142857142857142,0.9285714285714286,0.09523809523809523,0.9047619047619048
SF-L21,SF-A27,33,14,3,1,30,13,0.09090909090909091,0.9090909090909091,0.07142857142857142,0.9285714285714286
SF-L21,SF-G29-2,37,31,4,9,33,22,0.10810810810810811,0.8918918918918919,0.2903225806451613,0.7096774193548387
SF-L21,SF-G29-1,24,27,7,6,17,21,0.2916666666666667,0.7083333333333334,0.2222222222222222,0.7777777777777778
SF-L21,SF-G30-1,13,16,3,5,10,11,0.23076923076923078,0.7692307692307693,0.3125,0.6875
SF-L21,SF-G29-3,27,17,5,3,22,14,0.18518518518518517,0.8148148148148148,0.17647058823529413,0.8235294117647058
SF-L21,SF-F30-2,8,7,3,2,5,5,0.375,0.625,0.2857142857142857,0.7142857142857143
SF-L21,SF-F29,7,12,1,3,6,9,0.14285714285714285,0.8571428571428571,0.25,0.75
SF-L21,SF-E29-3,63,73,7,36,56,37,0.1111111111111111,0.8888888888888888,0.4931506849315068,0.5068493150684932
SF-L21,SF-F28-1,40,17,14,10,26,7,0.35,0.65,0.5882352941176471,0.4117647058823529
SF-L21,SF-E28-2,20,3,0,1,20,2,0.0,1.0,0.3333333333333333,0.6666666666666666
SF-L21,SF-E28,6,2,1,1,5,1,0.16666666666666666,0.8333333333333334,0.5,0.5
SF-L21,SF-J10,11,18,3,8,8,10,0.2727272727272727,0.7272727272727273,0.4444444444444444,0.5555555555555556
SF-L21,SF-J12,26,21,12,3,14,18,0.46153846153846156,0.5384615384615384,0.14285714285714285,0.8571428571428571
SF-L21,SF-J13,9,17,0,1,9,16,0.0,1.0,0.058823529411764705,0.9411764705882353
SF-L21,SF-J15,3,4,2,3,1,1,0.6666666666666666,0.3333333333333333,0.75,0.25
SF-L21,SF-J14,3,3,1,0,2,3,0.3333333333333333,0.6666666666666666,0.0,1.0
SF-L21,SF-H13,21,45,1,0,20,45,0.047619047619047616,0.9523809523809523,0.0,1.0
SF-L21,SF-I16,10,2,1,0,9,2,0.1,0.9,0.0,1.0
SF-L21,SF-H12,39,7,0,0,39,7,0.0,1.0,0.0,1.0
SF-L21,SF-H15,1,2,0,0,1,2,0.0,1.0,0.0,1.0
SF-L21,SF-G9,2,5,1,0,1,5,0.5,0.5,0.0,1.0
SF-L21,SF-H14,1,1,0,0,1,1,0.0,1.0,0.0,1.0
SF-L21,SF-G13,22,29,10,1,12,28,0.45454545454545453,0.5454545454545454,0.034482758620689655,0.9655172413793104
SF-L21,SF-G11,3,5,0,0,3,5,0.0,1.0,0.0,1.0
SF-L21,SF-G12,10,19,3,1,7,18,0.3,0.7,0.05263157894736842,0.9473684210526315
SF-L21,SF-G10-1,3,4,0,0,3,4,0.0,1.0,0.0,1.0
SF-L21,SF-F15,4,1,2,0,2,1,0.5,0.5,0.0,1.0
SF-L21,SF-F16,2,4,0,0,2,4,0.0,1.0,0.0,1.0
SF-L21,SF-C21,1,3,1,1,0,2,1.0,0.0,0.3333333333333333,0.6666666666666666
SF-L21,SF-C20,3,3,0,0,3,3,0.0,1.0,0.0,1.0
SF-L21,SF-B21,4,4,0,1,4,3,0.0,1.0,0.25,0.75
SF-L21,SF-B19,16,4,0,0,16,4,0.0,1.0,0.0,1.0
SF-L21,SF-A20,9,8,1,0,8,8,0.1111111111111111,0.8888888888888888,0.0,1.0
SF-L21,SF-C26,9,16,1,7,8,9,0.1111111111111111,0.8888888888888888,0.4375,0.5625
SF-L21,SF-C25,22,21,3,2,19,19,0.13636363636363635,0.8636363636363636,0.09523809523809523,0.9047619047619048
SF-L21,SF-B25,12,15,2,5,10,10,0.16666666666666666,0.8333333333333334,0.3333333333333333,0.6666666666666666
SF-L21,SF-E27,11,6,2,2,9,4,0.18181818181818182,0.8181818181818182,0.3333333333333333,0.6666666666666666
SF-L21,SF-B28-2,18,44,0,36,18,8,0.0,1.0,0.8181818181818182,0.18181818181818182
SF-L21,SF-D27,13,9,6,6,7,3,0.46153846153846156,0.5384615384615384,0.6666666666666666,0.3333333333333333
SF-L21,SF-C28-2,3,1,0,0,3,1,0.0,1.0,0.0,1.0
SF-L21,SF-C28-1,3,2,0,2,3,0,0.0,1.0,1.0,0.0
SF-L21,SF-B28,7,1,1,0,6,1,0.14285714285714285,0.8571428571428571,0.0,1.0
SF-L21,SF-J1,6,27,0,7,6,20,0.0,1.0,0.25925925925925924,0.7407407407407407
SF-L21,SF-H0,9,5,4,1,5,4,0.4444444444444444,0.5555555555555556,0.2,0.8
SF-L21,SF-J3,2,7,2,0,0,7,1.0,0.0,0.0,1.0
SF-L21,SF-J5,3,4,1,3,2,1,0.3333333333333333,0.6666666666666666,0.75,0.25
SF-L21,SF-G6,1,3,0,0,1,3,0.0,1.0,0.0,1.0
SF-L21,SF-G8,4,4,0,0,4,4,0.0,1.0,0.0,1.0
SF-L21,SF-G5,4,1,0,0,4,1,0.0,1.0,0.0,1.0
SF-L21,SF-G7,2,2,1,0,1,2,0.5,0.5,0.0,1.0
SF-L21,SF-F9,3,4,1,1,2,3,0.3333333333333333,0.6666666666666666,0.25,0.75
SF-L21,SF-H25,18,79,3,19,15,60,0.16666666666666666,0.8333333333333334,0.24050632911392406,0.759493670886076
SF-L21,SF-G26,34,126,4,34,30,92,0.11764705882352941,0.8823529411764706,0.2698412698412698,0.7301587301587301
SF-L21,SF-K21,46,46,31,6,15,40,0.6739130434782609,0.32608695652173914,0.13043478260869565,0.8695652173913043
SF-L21,SF-K22-1,148,47,79,30,69,17,0.5337837837837838,0.46621621621621623,0.6382978723404256,0.3617021276595745
SF-L21,SF-J23-1,410,439,153,239,257,200,0.37317073170731707,0.6268292682926829,0.5444191343963554,0.45558086560364464
SF-L21,SF-J22-1,73,40,25,8,48,32,0.3424657534246575,0.6575342465753424,0.2,0.8
SF-L21,SF-J22-2,82,55,26,10,56,45,0.3170731707317073,0.6829268292682927,0.18181818181818182,0.8181818181818182
SF-L21,SF-J21,105,80,44,24,61,56,0.41904761904761906,0.580952380952381,0.3,0.7
SF-L21,SF-I21,10,16,4,5,6,11,0.4,0.6,0.3125,0.6875
SF-L21,SF-I22,36,20,6,3,30,17,0.16666666666666666,0.8333333333333334,0.15,0.85
SF-L21,SF-I23-2,46,37,19,21,27,16,0.41304347826086957,0.5869565217391305,0.5675675675675675,0.43243243243243246
SF-L21,SF-I24,46,47,20,33,26,14,0.43478260869565216,0.5652173913043478,0.7021276595744681,0.2978723404255319
SF-L21,SF-I23-1,88,61,18,10,70,51,0.20454545454545456,0.7954545454545454,0.16393442622950818,0.8360655737704918
SF-L21,SF-F26,84,42,39,14,45,28,0.4642857142857143,0.5357142857142857,0.3333333333333333,0.6666666666666666
SF-L21,SF-M13,38,32,8,6,30,26,0.21052631578947367,0.7894736842105263,0.1875,0.8125
SF-L21,SF-M15,38,24,14,1,24,23,0.3684210526315789,0.631578947368421,0.041666666666666664,0.9583333333333334
SF-L21,SF-L19,66,43,40,17,26,26,0.6060606060606061,0.3939393939393939,0.3953488372093023,0.6046511627906976
SF-L21,SF-L20,47,76,27,51,20,25,0.574468085106383,0.425531914893617,0.6710526315789473,0.32894736842105265
SF-L21,SF-N20-1,67,79,30,15,37,64,0.44776119402985076,0.5522388059701493,0.189873417721519,0.810126582278481
SF-L21,SF-M20,69,103,34,39,35,64,0.4927536231884058,0.5072463768115942,0.3786407766990291,0.6213592233009708
SF-L21,SF-K17-2,35,30,17,3,18,27,0.4857142857142857,0.5142857142857142,0.1,0.9
SF-L21,SF-K20,74,92,43,39,31,53,0.581081081081081,0.4189189189189189,0.42391304347826086,0.5760869565217391
SF-L21,SF-K15-,106,139,39,30,67,109,0.36792452830188677,0.6320754716981132,0.2158273381294964,0.7841726618705036
SF-L21,SF-K19,75,102,44,45,31,57,0.5866666666666667,0.41333333333333333,0.4411764705882353,0.5588235294117647
SF-L21,SF-K18,121,122,77,13,44,109,0.6363636363636364,0.36363636363636365,0.10655737704918032,0.8934426229508197
SF-L21,SF-K17,49,56,10,11,39,45,0.20408163265306123,0.7959183673469388,0.19642857142857142,0.8035714285714286
SF-L21,SF-J16,15,19,7,2,8,17,0.4666666666666667,0.5333333333333333,0.10526315789473684,0.8947368421052632
SF-L21,SF-J18,36,62,9,12,27,50,0.25,0.75,0.1935483870967742,0.8064516129032258
SF-L21,SF-J20,13,11,8,3,5,8,0.6153846153846154,0.38461538461538464,0.2727272727272727,0.7272727272727273
SF-L21,SF-J19,7,22,2,0,5,22,0.2857142857142857,0.7142857142857143,0.0,1.0
SF-L21,SF-M12,15,30,2,6,13,24,0.13333333333333333,0.8666666666666667,0.2,0.8
SF-L21,SF-M10,10,8,3,1,7,7,0.3,0.7,0.125,0.875
SF-L21,SF-M11,23,21,8,1,15,20,0.34782608695652173,0.6521739130434783,0.047619047619047616,0.9523809523809523
SF-L21,SF-R19,8,16,2,4,6,12,0.25,0.75,0.25,0.75
SF-L21,SF-R20,6,7,1,0,5,7,0.16666666666666666,0.8333333333333334,0.0,1.0
SF-L21,SF-Q21-2,13,11,2,0,11,11,0.15384615384615385,0.8461538461538461,0.0,1.0
SF-L21,SF-Q21-1,4,21,0,6,4,15,0.0,1.0,0.2857142857142857,0.7142857142857143
SF-L21,SF-P21,50,57,13,4,37,53,0.26,0.74,0.07017543859649122,0.9298245614035088
SF-L21,SF-O18,53,89,15,15,38,74,0.2830188679245283,0.7169811320754716,0.16853932584269662,0.8314606741573034
SF-L21,SF-O19,37,98,10,31,27,67,0.2702702702702703,0.7297297297297297,0.3163265306122449,0.6836734693877551
SF-L21,SF-O21,89,124,19,58,70,66,0.21348314606741572,0.7865168539325843,0.46774193548387094,0.532258064516129
SF-L21,SF-O22,55,69,12,36,43,33,0.21818181818181817,0.7818181818181819,0.5217391304347826,0.4782608695652174
SF-L21,SF-N21,32,53,14,40,18,13,0.4375,0.5625,0.7547169811320755,0.24528301886792453
SF-L21,SF-N20-2,23,26,13,6,10,20,0.5652173913043478,0.43478260869565216,0.23076923076923078,0.7692307692307693
SF-L21,SF-M21,51,59,22,33,29,26,0.43137254901960786,0.5686274509803921,0.559322033898305,0.4406779661016949
SF-L21,SF-Q30,2,6,0,1,2,5,0.0,1.0,0.16666666666666666,0.8333333333333334
SF-L21,SF-P30,3,2,0,1,3,1,0.0,1.0,0.5,0.5
SF-L21,SF-O30-2,2,3,0,0,2,3,0.0,1.0,0.0,1.0
SF-L21,SF-O30,10,7,2,1,8,6,0.2,0.8,0.14285714285714285,0.8571428571428571
SF-L21,SF-N27,16,18,4,6,12,12,0.25,0.75,0.3333333333333333,0.6666666666666666
SF-L21,SF-N29,4,5,0,1,4,4,0.0,1.0,0.2,0.8
SF-L21,SF-N28,9,6,3,2,6,4,0.3333333333333333,0.6666666666666666,0.3333333333333333,0.6666666666666666
SF-L21,SF-L30-1,37,9,19,1,18,8,0.5135135135135135,0.4864864864864865,0.1111111111111111,0.8888888888888888
SF-L21,SF-L31-1,12,16,1,0,11,16,0.08333333333333333,0.9166666666666666,0.0,1.0
SF-L21,SF-K30-2,10,1,1,0,9,1,0.1,0.9,0.0,1.0
SF-L21,SF-L29,35,43,3,2,32,41,0.08571428571428572,0.9142857142857143,0.046511627906976744,0.9534883720930233
SF-L21,SF-J29-1,20,5,2,2,18,3,0.1,0.9,0.4,0.6
SF-L21,SF-I30,4,6,1,1,3,5,0.25,0.75,0.16666666666666666,0.8333333333333334
SF-L21,SF-I29-2,4,3,1,1,3,2,0.25,0.75,0.3333333333333333,0.6666666666666666
SF-L21,SF-I27,15,29,4,12,11,17,0.26666666666666666,0.7333333333333333,0.41379310344827586,0.5862068965517241
SF-L21,SF-I28,7,37,3,4,4,33,0.42857142857142855,0.5714285714285714,0.10810810810810811,0.8918918918918919
SF-L21,SF-I30-2,6,7,4,0,2,7,0.6666666666666666,0.3333333333333333,0.0,1.0
SF-L21,SF I29-1,2,5,0,0,2,5,0.0,1.0,0.0,1.0
SF-L21,SF-H28,8,9,7,4,1,5,0.875,0.125,0.4444444444444444,0.5555555555555556
SF-L21,SF-H29,4,1,0,0,4,1,0.0,1.0,0.0,1.0
SF-L21,SF-S24,6,4,2,0,4,4,0.3333333333333333,0.6666666666666666,0.0,1.0
SF-L21,SF-R24,22,14,5,1,17,13,0.22727272727272727,0.7727272727272727,0.07142857142857142,0.9285714285714286
SF-L21,SF-R26,4,5,0,0,4,5,0.0,1.0,0.0,1.0
SF-L21,SF-Q26,6,11,3,6,3,5,0.5,0.5,0.5454545454545454,0.45454545454545453
SF-L21,SF-P26,6,12,1,0,5,12,0.16666666666666666,0.8333333333333334,0.0,1.0
SF-L21,SF-O25-2,3,6,1,3,2,3,0.3333333333333333,0.6666666666666666,0.5,0.5
SF-L21,SF-N22-1B,34,147,3,123,31,24,0.08823529411764706,0.9117647058823529,0.8367346938775511,0.16326530612244897
SF-L21,SF-N26,4,5,2,0,2,5,0.5,0.5,0.0,1.0
SF-L21,SF-N25,9,9,1,2,8,7,0.1111111111111111,0.8888888888888888,0.2222222222222222,0.7777777777777778
SF-L21,SF-T21,3,6,3,1,0,5,1.0,0.0,0.16666666666666666,0.8333333333333334
SF-L21,SF-T22,16,19,2,3,14,16,0.125,0.875,0.15789473684210525,0.8421052631578947
SF-L21,SF-S22-2,5,6,0,0,5,6,0.0,1.0,0.0,1.0
SF-L21,SF-S22-1,16,15,7,5,9,10,0.4375,0.5625,0.3333333333333333,0.6666666666666666
SF-L21,SF-Q23-3,15,9,3,3,12,6,0.2,0.8,0.3333333333333333,0.6666666666666666
SF-L21,SF-Q22-1,31,52,13,26,18,26,0.41935483870967744,0.5806451612903226,0.5,0.5
SF-L21,SF-Q22-2,39,27,12,9,27,18,0.3076923076923077,0.6923076923076923,0.3333333333333333,0.6666666666666666
SF-L21,SF-P22,52,76,30,49,22,27,0.5769230769230769,0.4230769230769231,0.6447368421052632,0.35526315789473684
SF-L21,SF-W19,2,4,0,2,2,2,0.0,1.0,0.5,0.5
SF-L21,SF-W19-2,1,2,0,0,1,2,0.0,1.0,0.0,1.0
SF-L21,SF-U21,4,2,0,0,4,2,0.0,1.0,0.0,1.0
SF-L21,SF-T20,38,30,26,1,12,29,0.6842105263157895,0.3157894736842105,0.03333333333333333,0.9666666666666667
SF-L21,SF-S21,5,4,2,1,3,3,0.4,0.6,0.25,0.75
SF-L21,SF-AA28,1,1,0,0,1,1,0.0,1.0,0.0,1.0
SF-L21,SF-Y30,5,2,0,0,5,2,0.0,1.0,0.0,1.0
SF-L21,SF-Y27,1,2,0,0,1,2,0.0,1.0,0.0,1.0
SF-L21,SF-V29,1,1,1,0,0,1,1.0,0.0,0.0,1.0
SF-L21,SF-U30,16,4,0,0,16,4,0.0,1.0,0.0,1.0
SF-S29,SF-J27,1,1,1,1,0,0,1.0,0.0,1.0,0.0
SF-S29,SF-M30,8,12,6,12,2,0,0.75,0.25,1.0,0.0
SF-S29,SF-J29-3,3,4,0,1,3,3,0.0,1.0,0.25,0.75
SF-S29,SF-M28,4,2,1,0,3,2,0.25,0.75,0.0,1.0
SF-S29,SF-K27-2,3,13,0,12,3,1,0.0,1.0,0.9230769230769231,0.07692307692307693
SF-S29,SF-L28,4,5,4,1,0,4,1.0,0.0,0.2,0.8
SF-S29,SF-K29-1,4,2,2,1,2,1,0.5,0.5,0.5,0.5
SF-S29,SF-K25,1,1,0,0,1,1,0.0,1.0,0.0,1.0
SF-S29,SF-J25,1,1,0,1,1,0,0.0,1.0,1.0,0.0
SF-S29,SF-P24,3,1,0,1,3,0,0.0,1.0,1.0,0.0
SF-S29,SF-J24,5,1,4,1,1,0,0.8,0.2,1.0,0.0
SF-S29,SF-I25,1,2,1,1,0,1,1.0,0.0,0.5,0.5
SF-S29,SF-H27-1,1,1,0,0,1,1,0.0,1.0,0.0,1.0
SF-S29,SF-G27,1,4,0,4,1,0,0.0,1.0,1.0,0.0
SF-S29,SF-L22,1,5,0,1,1,4,0.0,1.0,0.2,0.8
SF-S29,SF-N22-2,2,2,1,0,1,2,0.5,0.5,0.0,1.0
SF-S29,SF-O25-1,1,1,0,1,1,0,0.0,1.0,1.0,0.0
SF-S29,SF-G25,3,3,0,0,3,3,0.0,1.0,0.0,1.0
SF-S29,SF-E23,1,1,0,1,1,0,0.0,1.0,1.0,0.0
SF-S29,SF-H20,1,1,0,0,1,1,0.0,1.0,0.0,1.0
SF-S29,SF-H30,6,1,3,0,3,1,0.5,0.5,0.0,1.0
SF-S29,SF-G30-2,2,1,1,0,1,1,0.5,0.5,0.0,1.0
SF-S29,SF-E29-2,13,27,5,16,8,11,0.38461538461538464,0.6153846153846154,0.5925925925925926,0.4074074074074074
SF-S29,SF-E29-1,7,10,2,3,5,7,0.2857142857142857,0.7142857142857143,0.3,0.7
SF-S29,SF-D29,2,1,2,1,0,0,1.0,0.0,1.0,0.0
SF-S29,SF-J15,1,1,0,1,1,0,0.0,1.0,1.0,0.0
SF-S29,SF-D27,1,2,1,2,0,0,1.0,0.0,1.0,0.0
SF-S29,SF-H25,1,1,0,1,1,0,0.0,1.0,1.0,0.0
SF-S29,SF-K22-1,2,1,2,1,0,0,1.0,0.0,1.0,0.0
SF-S29,SF-J23-1,5,6,2,1,3,5,0.4,0.6,0.16666666666666666,0.8333333333333334
SF-S29,SF-J22-2,1,2,0,0,1,2,0.0,1.0,0.0,1.0
SF-S29,SF-I23-2,1,1,1,1,0,0,1.0,0.0,1.0,0.0
SF-S29,SF-I23-1,2,2,2,2,0,0,1.0,0.0,1.0,0.0
SF-S29,SF-F26,2,1,0,0,2,1,0.0,1.0,0.0,1.0
SF-S29,SF-M15,1,2,1,2,0,0,1.0,0.0,1.0,0.0
SF-S29,SF-K19,1,1,1,0,0,1,1.0,0.0,0.0,1.0
SF-S29,SF-K18,1,5,1,0,0,5,1.0,0.0,0.0,1.0
SF-S29,SF-R19,2,3,0,0,2,3,0.0,1.0,0.0,1.0
SF-S29,SF-S30,1,3,1,1,0,2,1.0,0.0,0.3333333333333333,0.6666666666666666
SF-S29,SF-Q30,1,13,1,7,0,6,1.0,0.0,0.5384615384615384,0.46153846153846156
SF-S29,SF-P30,27,15,21,12,6,3,0.7777777777777778,0.2222222222222222,0.8,0.2
SF-S29,SF-O30-2,4,7,3,2,1,5,0.75,0.25,0.2857142857142857,0.7142857142857143
SF-S29,SF-O30,21,14,14,11,7,3,0.6666666666666666,0.3333333333333333,0.7857142857142857,0.21428571428571427
SF-S29,SF-N27,10,4,1,2,9,2,0.1,0.9,0.5,0.5
SF-S29,SF-N28,1,3,1,1,0,2,1.0,0.0,0.3333333333333333,0.6666666666666666
SF-S29,SF-L30-1,8,17,3,5,5,12,0.375,0.625,0.29411764705882354,0.7058823529411765
SF-S29,SF-K30-2,4,1,2,0,2,1,0.5,0.5,0.0,1.0
SF-S29,SF-L29,2,5,1,3,1,2,0.5,0.5,0.6,0.4
SF-S29,SF-J29-1,2,4,2,2,0,2,1.0,0.0,0.5,0.5
SF-S29,SF-H28,4,3,4,2,0,1,1.0,0.0,0.6666666666666666,0.3333333333333333
SF-S29,SF-S24,4,7,2,2,2,5,0.5,0.5,0.2857142857142857,0.7142857142857143
SF-S29,SF-R24,6,12,5,5,1,7,0.8333333333333334,0.16666666666666666,0.4166666666666667,0.5833333333333334
SF-S29,SF-R26,3,6,1,3,2,3,0.3333333333333333,0.6666666666666666,0.5,0.5
SF-S29,SF-Q26,3,2,0,2,3,0,0.0,1.0,1.0,0.0
SF-S29,SF-N26,1,3,0,0,1,3,0.0,1.0,0.0,1.0
SF-S29,SF-T22,3,3,3,1,0,2,1.0,0.0,0.3333333333333333,0.6666666666666666
SF-S29,SF-S22-1,21,21,8,7,13,14,0.38095238095238093,0.6190476190476191,0.3333333333333333,0.6666666666666666
SF-S29,SF-Q23-3,4,4,2,2,2,2,0.5,0.5,0.5,0.5
SF-S29,SF-Q22-2,2,2,2,0,0,2,1.0,0.0,0.0,1.0
SF-S29,SF-T20,1,1,0,0,1,1,0.0,1.0,0.0,1.0
SF-S29,SF-S21,2,1,2,1,0,0,1.0,0.0,1.0,0.0
SF-S29,SF-W29,1,2,1,2,0,0,1.0,0.0,1.0,0.0
SF-S29,SF-V29,1,4,0,2,1,2,0.0,1.0,0.5,0.5
SF-S29,SF-V32,5,1,3,1,2,0,0.6,0.4,1.0,0.0
SF-S29,SF-X19,1,1,0,1,1,0,0.0,1.0,1.0,0.0
SF-S30,SF-M30,29,20,28,18,1,2,0.9655172413793104,0.034482758620689655,0.9,0.1
SF-S30,SF-J29-3,1,3,1,2,0,1,1.0,0.0,0.6666666666666666,0.3333333333333333
SF-S30,SF-M28,3,3,0,0,3,3,0.0,1.0,0.0,1.0
SF-S30,SF-L25,1,1,0,1,1,0,0.0,1.0,1.0,0.0
SF-S30,SF-K27-2,2,3,2,3,0,0,1.0,0.0,1.0,0.0
SF-S30,SF-K29-1,4,6,3,5,1,1,0.75,0.25,0.8333333333333334,0.16666666666666666
SF-S30,SF-K25,13,3,9,2,4,1,0.6923076923076923,0.3076923076923077,0.6666666666666666,0.3333333333333333
SF-S30,SF-J25,24,10,20,4,4,6,0.8333333333333334,0.16666666666666666,0.4,0.6
SF-S30,SF-O24,1,3,0,1,1,2,0.0,1.0,0.3333333333333333,0.6666666666666666
SF-S30,SF-M22-2,2,3,2,1,0,2,1.0,0.0,0.3333333333333333,0.6666666666666666
SF-S30,SF-G28-2,1,2,0,0,1,2,0.0,1.0,0.0,1.0
SF-S30,SF-H30,12,6,11,5,1,1,0.9166666666666666,0.08333333333333333,0.8333333333333334,0.16666666666666666
SF-S30,SF-G30-2,3,18,3,0,0,18,1.0,0.0,0.0,1.0
SF-S30,SF-E29-2,4,7,2,4,2,3,0.5,0.5,0.5714285714285714,0.42857142857142855
SF-S30,SF-E29-1,3,12,1,3,2,9,0.3333333333333333,0.6666666666666666,0.25,0.75
SF-S30,SF-D29,1,5,1,2,0,3,1.0,0.0,0.4,0.6
SF-S30,SF-G29-2,21,21,1,0,20,21,0.047619047619047616,0.9523809523809523,0.0,1.0
SF-S30,SF-G30-1,17,10,3,2,14,8,0.17647058823529413,0.8235294117647058,0.2,0.8
SF-S30,SF-G29-3,6,1,0,0,6,1,0.0,1.0,0.0,1.0
SF-S30,SF-F29,1,1,1,1,0,0,1.0,0.0,1.0,0.0
SF-S30,SF-B25,3,1,0,0,3,1,0.0,1.0,0.0,1.0
SF-S30,SF-B28,1,1,0,1,1,0,0.0,1.0,1.0,0.0
SF-S30,SF-J1,1,1,0,0,1,1,0.0,1.0,0.0,1.0
SF-S30,SF-H25,1,1,0,0,1,1,0.0,1.0,0.0,1.0
SF-S30,SF-K21,1,1,0,0,1,1,0.0,1.0,0.0,1.0
SF-S30,SF-J23-1,6,6,1,1,5,5,0.16666666666666666,0.8333333333333334,0.16666666666666666,0.8333333333333334
SF-S30,SF-I24,2,3,1,3,1,0,0.5,0.5,1.0,0.0
SF-S30,SF-L19,5,1,1,0,4,1,0.2,0.8,0.0,1.0
SF-S30,SF-L20,1,2,1,0,0,2,1.0,0.0,0.0,1.0
SF-S30,SF-K18,2,2,1,1,1,1,0.5,0.5,0.5,0.5
SF-S30,SF-J18,3,2,0,0,3,2,0.0,1.0,0.0,1.0
SF-S30,SF-R19,2,1,1,0,1,1,0.5,0.5,0.0,1.0
SF-S30,SF-O21,3,2,1,2,2,0,0.3333333333333333,0.6666666666666666,1.0,0.0
SF-S30,SF-O22,4,5,0,1,4,4,0.0,1.0,0.2,0.8
SF-S30,SF-N20-2,1,2,1,0,0,2,1.0,0.0,0.0,1.0
SF-S30,SF-S29,3,1,1,1,2,0,0.3333333333333333,0.6666666666666666,1.0,0.0
SF-S30,SF-Q30,5,12,3,8,2,4,0.6,0.4,0.6666666666666666,0.3333333333333333
SF-S30,SF-P30,3,3,2,2,1,1,0.6666666666666666,0.3333333333333333,0.6666666666666666,0.3333333333333333
SF-S30,SF-O30-2,9,19,5,13,4,6,0.5555555555555556,0.4444444444444444,0.6842105263157895,0.3157894736842105
SF-S30,SF-O30,33,30,21,22,12,8,0.6363636363636364,0.36363636363636365,0.7333333333333333,0.26666666666666666
SF-S30,SF-N28,4,7,2,3,2,4,0.5,0.5,0.42857142857142855,0.5714285714285714
SF-S30,SF-L30-1,7,8,6,3,1,5,0.8571428571428571,0.14285714285714285,0.375,0.625
SF-S30,SF-L31-1,13,26,6,22,7,4,0.46153846153846156,0.5384615384615384,0.8461538461538461,0.15384615384615385
SF-S30,SF-K30-2,3,3,1,0,2,3,0.3333333333333333,0.6666666666666666,0.0,1.0
SF-S30,SF-L29,10,35,5,9,5,26,0.5,0.5,0.2571428571428571,0.7428571428571429
SF-S30,SF-I30,6,6,6,6,0,0,1.0,0.0,1.0,0.0
SF-S30,SF-I29-2,3,11,3,9,0,2,1.0,0.0,0.8181818181818182,0.18181818181818182
SF-S30,SF-I27,1,1,0,0,1,1,0.0,1.0,0.0,1.0
SF-S30,SF-H28,3,1,1,0,2,1,0.3333333333333333,0.6666666666666666,0.0,1.0
SF-S30,SF-H29,1,2,0,0,1,2,0.0,1.0,0.0,1.0
SF-S30,SF-S24,4,3,2,1,2,2,0.5,0.5,0.3333333333333333,0.6666666666666666
SF-S30,SF-R24,6,5,2,0,4,5,0.3333333333333333,0.6666666666666666,0.0,1.0
SF-S30,SF-R26,1,1,0,1,1,0,0.0,1.0,1.0,0.0
SF-S30,SF-P26,1,1,1,0,0,1,1.0,0.0,0.0,1.0
SF-S30,SF-T22,1,2,1,0,0,2,1.0,0.0,0.0,1.0
SF-S30,SF-S22-1,1,1,0,0,1,1,0.0,1.0,0.0,1.0
SF-S30,SF-Q23-3,2,3,1,1,1,2,0.5,0.5,0.3333333333333333,0.6666666666666666
SF-S30,SF-Q22-2,2,4,0,2,2,2,0.0,1.0,0.5,0.5
SF-S30,SF-P22,2,1,1,0,1,1,0.5,0.5,0.0,1.0
SF-S30,SF-X30,2,1,2,0,0,1,1.0,0.0,0.0,1.0
SF-S30,SF-X29,2,1,1,1,1,0,0.5,0.5,1.0,0.0
SF-S30,SF-V28,4,3,0,1,4,2,0.0,1.0,0.3333333333333333,0.6666666666666666
SF-S30,SF-V29,4,1,2,1,2,0,0.5,0.5,1.0,0.0
SF-S30,SF-V30,7,1,7,1,0,0,1.0,0.0,1.0,0.0
SF-S30,SF-V31,10,8,1,8,9,0,0.1,0.9,1.0,0.0
SF-S30,SF-V32,10,18,10,16,0,2,1.0,0.0,0.8888888888888888,0.1111111111111111
SF-S30,SF-U30,7,1,3,1,4,0,0.42857142857142855,0.5714285714285714,1.0,0.0
SF-S30,SF-Y25,1,13,0,0,1,13,0.0,1.0,0.0,1.0
SF-Q30,SF-M26,1,2,1,1,0,1,1.0,0.0,0.5,0.5
SF-Q30,SF-M25,5,3,2,3,3,0,0.4,0.6,1.0,0.0
SF-Q30,SF-M26-2,9,8,3,3,6,5,0.3333333333333333,0.6666666666666666,0.375,0.625
SF-Q30,SF-L27,4,2,1,0,3,2,0.25,0.75,0.0,1.0
SF-Q30,SF-K26,23,25,11,9,12,16,0.4782608695652174,0.5217391304347826,0.36,0.64
SF-Q30,SF-J27,2,5,1,2,1,3,0.5,0.5,0.4,0.6
SF-Q30,SF-M30,52,34,24,17,28,17,0.46153846153846156,0.5384615384615384,0.5,0.5
SF-Q30,SF-L27-2,5,8,2,4,3,4,0.4,0.6,0.5,0.5
SF-Q30,SF-J29-3,3,2,1,0,2,2,0.3333333333333333,0.6666666666666666,0.0,1.0
SF-Q30,SF-J29,10,13,2,6,8,7,0.2,0.8,0.46153846153846156,0.5384615384615384
SF-Q30,SF-L26,24,28,22,19,2,9,0.9166666666666666,0.08333333333333333,0.6785714285714286,0.32142857142857145
SF-Q30,SF-M28,18,15,10,1,8,14,0.5555555555555556,0.4444444444444444,0.06666666666666667,0.9333333333333333
SF-Q30,SF-M27,3,1,3,0,0,1,1.0,0.0,0.0,1.0
SF-Q30,SF-L25,1,2,0,0,1,2,0.0,1.0,0.0,1.0
SF-Q30,SF-M24,3,2,1,2,2,0,0.3333333333333333,0.6666666666666666,1.0,0.0
SF-Q30,SF-L24,5,5,2,4,3,1,0.4,0.6,0.8,0.2
SF-Q30,SF-N23,10,12,4,5,6,7,0.4,0.6,0.4166666666666667,0.5833333333333334
SF-Q30,SF-N24-2,5,1,2,1,3,0,0.4,0.6,1.0,0.0
SF-Q30,SF-K27-2,10,10,5,5,5,5,0.5,0.5,0.5,0.5
SF-Q30,SF-J26-2,47,50,10,0,37,50,0.2127659574468085,0.7872340425531915,0.0,1.0
SF-Q30,SF-K28-3,6,7,3,3,3,4,0.5,0.5,0.42857142857142855,0.5714285714285714
SF-Q30,SF-L28,43,62,4,3,39,59,0.09302325581395349,0.9069767441860465,0.04838709677419355,0.9516129032258065
SF-Q30,SF-K28,19,9,18,8,1,1,0.9473684210526315,0.05263157894736842,0.8888888888888888,0.1111111111111111
SF-Q30,SF-K29-1,124,215,51,29,73,186,0.4112903225806452,0.5887096774193549,0.13488372093023257,0.8651162790697674
SF-Q30,SF-J28-2,13,9,5,3,8,6,0.38461538461538464,0.6153846153846154,0.3333333333333333,0.6666666666666666
SF-Q30,SF-K27,1,10,1,2,0,8,1.0,0.0,0.2,0.8
SF-Q30,SF-K25,6,1,1,0,5,1,0.16666666666666666,0.8333333333333334,0.0,1.0
SF-Q30,SF-J25,12,13,7,6,5,7,0.5833333333333334,0.4166666666666667,0.46153846153846156,0.5384615384615384
SF-Q30,SF-P24,3,2,0,0,3,2,0.0,1.0,0.0,1.0
SF-Q30,SF-J24,11,11,0,1,11,10,0.0,1.0,0.09090909090909091,0.9090909090909091
SF-Q30,SF-O24,2,6,0,1,2,5,0.0,1.0,0.16666666666666666,0.8333333333333334
SF-Q30,SF-J26,3,2,2,1,1,1,0.6666666666666666,0.3333333333333333,0.5,0.5
SF-Q30,SF-I25,13,11,2,1,11,10,0.15384615384615385,0.8461538461538461,0.09090909090909091,0.9090909090909091
SF-Q30,SF-H26,56,8,46,1,10,7,0.8214285714285714,0.17857142857142858,0.125,0.875
SF-Q30,SF-O23,8,4,1,1,7,3,0.125,0.875,0.25,0.75
SF-Q30,SF-H27-1,11,16,6,5,5,11,0.5454545454545454,0.45454545454545453,0.3125,0.6875
SF-Q30,SF-F28-2,9,5,2,1,7,4,0.2222222222222222,0.7777777777777778,0.2,0.8
SF-Q30,SF-G27,17,7,2,1,15,6,0.11764705882352941,0.8823529411764706,0.14285714285714285,0.8571428571428571
SF-Q30,SF-M22-2,5,7,2,1,3,6,0.4,0.6,0.14285714285714285,0.8571428571428571
SF-Q30,SF-L22,5,3,0,1,5,2,0.0,1.0,0.3333333333333333,0.6666666666666666
SF-Q30,SF-F27,11,12,2,5,9,7,0.18181818181818182,0.8181818181818182,0.4166666666666667,0.5833333333333334
SF-Q30,SF-N22-2,13,24,6,8,7,16,0.46153846153846156,0.5384615384615384,0.3333333333333333,0.6666666666666666
SF-Q30,SF-G28-1,6,2,2,0,4,2,0.3333333333333333,0.6666666666666666,0.0,1.0
SF-Q30,SF-M22-1,2,6,1,0,1,6,0.5,0.5,0.0,1.0
SF-Q30,SF-O25-1,6,6,4,0,2,6,0.6666666666666666,0.3333333333333333,0.0,1.0
SF-Q30,SF-K22-2,24,1,2,0,22,1,0.08333333333333333,0.9166666666666666,0.0,1.0
SF-Q30,SF-J23-2,1,2,0,0,1,2,0.0,1.0,0.0,1.0
SF-Q30,SF-G23,6,2,1,0,5,2,0.16666666666666666,0.8333333333333334,0.0,1.0
SF-Q30,SF-G24,36,15,0,0,36,15,0.0,1.0,0.0,1.0
SF-Q30,SF-G25,6,4,1,1,5,3,0.16666666666666666,0.8333333333333334,0.25,0.75
SF-Q30,SF-F23,14,9,0,0,14,9,0.0,1.0,0.0,1.0
SF-Q30,SF-E23,4,32,0,0,4,32,0.0,1.0,0.0,1.0
SF-Q30,SF-C22,1,2,0,0,1,2,0.0,1.0,0.0,1.0
SF-Q30,SF-B22,3,8,1,4,2,4,0.3333333333333333,0.6666666666666666,0.5,0.5
SF-Q30,SF-J17,8,2,0,0,8,2,0.0,1.0,0.0,1.0
SF-Q30,SF-H20,3,4,1,0,2,4,0.3333333333333333,0.6666666666666666,0.0,1.0
SF-Q30,SF-G19,4,1,0,0,4,1,0.0,1.0,0.0,1.0
SF-Q30,SF-G20,1,3,0,0,1,3,0.0,1.0,0.0,1.0
SF-Q30,SF-E18,1,1,0,0,1,1,0.0,1.0,0.0,1.0
SF-Q30,SF-H30,16,86,4,12,12,74,0.25,0.75,0.13953488372093023,0.8604651162790697
SF-Q30,SF-G30-2,23,25,10,7,13,18,0.43478260869565216,0.5652173913043478,0.28,0.72
SF-Q30,SF-F30-1,111,108,54,49,57,59,0.4864864864864865,0.5135135135135135,0.4537037037037037,0.5462962962962963
SF-Q30,SF-E29-2,95,60,7,5,88,55,0.07368421052631578,0.9263157894736842,0.08333333333333333,0.9166666666666666
SF-Q30,SF-E29-1,58,27,14,11,44,16,0.2413793103448276,0.7586206896551724,0.4074074074074074,0.5925925925925926
SF-Q30,SF-D29,41,37,16,22,25,15,0.3902439024390244,0.6097560975609756,0.5945945945945946,0.40540540540540543
SF-Q30,SF-D28,41,44,28,40,13,4,0.6829268292682927,0.3170731707317073,0.9090909090909091,0.09090909090909091
SF-Q30,SF-A27,2,6,2,2,0,4,1.0,0.0,0.3333333333333333,0.6666666666666666
SF-Q30,SF-G29-2,4,6,1,5,3,1,0.25,0.75,0.8333333333333334,0.16666666666666666
SF-Q30,SF-G29-1,16,19,0,0,16,19,0.0,1.0,0.0,1.0
SF-Q30,SF-G30-1,13,3,2,0,11,3,0.15384615384615385,0.8461538461538461,0.0,1.0
SF-Q30,SF-G29-3,2,1,1,1,1,0,0.5,0.5,1.0,0.0
SF-Q30,SF-F30-2,12,6,4,3,8,3,0.3333333333333333,0.6666666666666666,0.5,0.5
SF-Q30,SF-F29,3,6,1,0,2,6,0.3333333333333333,0.6666666666666666,0.0,1.0
SF-Q30,SF-E29-3,7,9,2,9,5,0,0.2857142857142857,0.7142857142857143,1.0,0.0
SF-Q30,SF-F28-1,6,6,1,1,5,5,0.16666666666666666,0.8333333333333334,0.16666666666666666,0.8333333333333334
SF-Q30,SF-E28-2,14,2,2,1,12,1,0.14285714285714285,0.8571428571428571,0.5,0.5
SF-Q30,SF-E28,10,1,0,0,10,1,0.0,1.0,0.0,1.0
SF-Q30,SF-B19,1,3,0,1,1,2,0.0,1.0,0.3333333333333333,0.6666666666666666
SF-Q30,SF-A20,2,3,0,3,2,0,0.0,1.0,1.0,0.0
SF-Q30,SF-A19,1,1,0,0,1,1,0.0,1.0,0.0,1.0
SF-Q30,SF-C26,7,18,3,0,4,18,0.42857142857142855,0.5714285714285714,0.0,1.0
SF-Q30,SF-C25,8,5,1,0,7,5,0.125,0.875,0.0,1.0
SF-Q30,SF-B25,6,4,0,2,6,2,0.0,1.0,0.5,0.5
SF-Q30,SF-D27,47,27,23,25,24,2,0.48936170212765956,0.5106382978723404,0.9259259259259259,0.07407407407407407
SF-Q30,SF-C28-2,1,3,0,2,1,1,0.0,1.0,0.6666666666666666,0.3333333333333333
SF-Q30,SF-B28,15,28,15,24,0,4,1.0,0.0,0.8571428571428571,0.14285714285714285
SF-Q30,SF-H25,4,1,2,0,2,1,0.5,0.5,0.0,1.0
SF-Q30,SF-G26,10,8,1,6,9,2,0.1,0.9,0.75,0.25
SF-Q30,SF-K21,11,3,0,0,11,3,0.0,1.0,0.0,1.0
SF-Q30,SF-K22-1,2,3,1,0,1,3,0.5,0.5,0.0,1.0
SF-Q30,SF-J23-1,17,67,6,3,11,64,0.35294117647058826,0.6470588235294118,0.04477611940298507,0.9552238805970149
SF-Q30,SF-J22-1,9,18,5,1,4,17,0.5555555555555556,0.4444444444444444,0.05555555555555555,0.9444444444444444
SF-Q30,SF-J22-2,2,2,1,0,1,2,0.5,0.5,0.0,1.0
SF-Q30,SF-J21,9,3,0,0,9,3,0.0,1.0,0.0,1.0
SF-Q30,SF-I24,6,3,1,0,5,3,0.16666666666666666,0.8333333333333334,0.0,1.0
SF-Q30,SF-F26,17,12,3,1,14,11,0.17647058823529413,0.8235294117647058,0.08333333333333333,0.9166666666666666
SF-Q30,SF-M15,1,1,0,1,1,0,0.0,1.0,1.0,0.0
SF-Q30,SF-L20,6,5,1,0,5,5,0.16666666666666666,0.8333333333333334,0.0,1.0
SF-Q30,SF-N20-1,1,3,1,0,0,3,1.0,0.0,0.0,1.0
SF-Q30,SF-M20,3,5,2,0,1,5,0.6666666666666666,0.3333333333333333,0.0,1.0
SF-Q30,SF-K17-2,4,5,0,0,4,5,0.0,1.0,0.0,1.0
SF-Q30,SF-K20,1,3,0,0,1,3,0.0,1.0,0.0,1.0
SF-Q30,SF-K15-,2,3,2,2,0,1,1.0,0.0,0.6666666666666666,0.3333333333333333
SF-Q30,SF-K19,2,3,0,0,2,3,0.0,1.0,0.0,1.0
SF-Q30,SF-K18,3,1,0,0,3,1,0.0,1.0,0.0,1.0
SF-Q30,SF-K17,6,7,0,2,6,5,0.0,1.0,0.2857142857142857,0.7142857142857143
SF-Q30,SF-J18,1,3,0,0,1,3,0.0,1.0,0.0,1.0
SF-Q30,SF-J20,19,28,1,0,18,28,0.05263157894736842,0.9473684210526315,0.0,1.0
SF-Q30,SF-M10,1,1,1,0,0,1,1.0,0.0,0.0,1.0
SF-Q30,SF-P21,13,10,0,0,13,10,0.0,1.0,0.0,1.0
SF-Q30,SF-O18,1,3,0,0,1,3,0.0,1.0,0.0,1.0
SF-Q30,SF-O19,23,46,1,0,22,46,0.043478260869565216,0.9565217391304348,0.0,1.0
SF-Q30,SF-O21,8,10,1,2,7,8,0.125,0.875,0.2,0.8
SF-Q30,SF-O22,6,7,0,0,6,7,0.0,1.0,0.0,1.0
SF-Q30,SF-N21,1,6,1,2,0,4,1.0,0.0,0.3333333333333333,0.6666666666666666
SF-Q30,SF-N20-2,12,12,9,10,3,2,0.75,0.25,0.8333333333333334,0.16666666666666666
SF-Q30,SF-M21,3,4,1,0,2,4,0.3333333333333333,0.6666666666666666,0.0,1.0
SF-Q30,SF-L21,6,2,1,0,5,2,0.16666666666666666,0.8333333333333334,0.0,1.0
SF-Q30,SF-S29,13,1,7,1,6,0,0.5384615384615384,0.46153846153846156,1.0,0.0
SF-Q30,SF-S30,12,5,8,3,4,2,0.6666666666666666,0.3333333333333333,0.6,0.4
SF-Q30,SF-P30,104,81,84,45,20,36,0.8076923076923077,0.19230769230769232,0.5555555555555556,0.4444444444444444
SF-Q30,SF-O30-2,43,79,35,61,8,18,0.813953488372093,0.18604651162790697,0.7721518987341772,0.22784810126582278
SF-Q30,SF-O30,75,60,49,41,26,19,0.6533333333333333,0.3466666666666667,0.6833333333333333,0.31666666666666665
SF-Q30,SF-N27,82,52,16,9,66,43,0.1951219512195122,0.8048780487804879,0.17307692307692307,0.8269230769230769
SF-Q30,SF-N29,7,8,5,5,2,3,0.7142857142857143,0.2857142857142857,0.625,0.375
SF-Q30,SF-N28,21,18,4,6,17,12,0.19047619047619047,0.8095238095238095,0.3333333333333333,0.6666666666666666
SF-Q30,SF-L30-1,77,80,39,10,38,70,0.5064935064935064,0.4935064935064935,0.125,0.875
SF-Q30,SF-L31-1,30,48,15,37,15,11,0.5,0.5,0.7708333333333334,0.22916666666666666
SF-Q30,SF-K30-2,36,15,22,5,14,10,0.6111111111111112,0.3888888888888889,0.3333333333333333,0.6666666666666666
SF-Q30,SF-L29,88,27,22,13,66,14,0.25,0.75,0.48148148148148145,0.5185185185185185
SF-Q30,SF-J29-1,32,31,12,4,20,27,0.375,0.625,0.12903225806451613,0.8709677419354839
SF-Q30,SF-I30,14,4,9,2,5,2,0.6428571428571429,0.35714285714285715,0.5,0.5
SF-Q30,SF-I29-2,1,1,0,0,1,1,0.0,1.0,0.0,1.0
SF-Q30,SF-I27,11,7,3,3,8,4,0.2727272727272727,0.7272727272727273,0.42857142857142855,0.5714285714285714
SF-Q30,SF-I28,16,6,7,5,9,1,0.4375,0.5625,0.8333333333333334,0.16666666666666666
SF-Q30,SF-I30-2,14,3,1,0,13,3,0.07142857142857142,0.9285714285714286,0.0,1.0
SF-Q30,SF I29-1,3,4,0,1,3,3,0.0,1.0,0.25,0.75
SF-Q30,SF-H28,3,3,1,3,2,0,0.3333333333333333,0.6666666666666666,1.0,0.0
SF-Q30,SF-H29,3,2,2,1,1,1,0.6666666666666666,0.3333333333333333,0.5,0.5
SF-Q30,SF-S24,6,12,0,2,6,10,0.0,1.0,0.16666666666666666,0.8333333333333334
SF-Q30,SF-R24,15,22,6,4,9,18,0.4,0.6,0.18181818181818182,0.8181818181818182
SF-Q30,SF-Q26,5,8,0,1,5,7,0.0,1.0,0.125,0.875
SF-Q30,SF-O25-2,3,11,1,0,2,11,0.3333333333333333,0.6666666666666666,0.0,1.0
SF-Q30,SF-N22-1B,2,1,0,1,2,0,0.0,1.0,1.0,0.0
SF-Q30,SF-N26,6,11,0,0,6,11,0.0,1.0,0.0,1.0
SF-Q30,SF-N25,9,1,0,1,9,0,0.0,1.0,1.0,0.0
SF-Q30,SF-T22,4,2,0,0,4,2,0.0,1.0,0.0,1.0
SF-Q30,SF-S22-2,5,3,2,0,3,3,0.4,0.6,0.0,1.0
SF-Q30,SF-S22-1,1,4,0,1,1,3,0.0,1.0,0.25,0.75
SF-Q30,SF-Q23-3,11,17,10,8,1,9,0.9090909090909091,0.09090909090909091,0.47058823529411764,0.5294117647058824
SF-Q30,SF-Q22-1,6,7,0,2,6,5,0.0,1.0,0.2857142857142857,0.7142857142857143
SF-Q30,SF-Q22-2,9,13,1,0,8,13,0.1111111111111111,0.8888888888888888,0.0,1.0
SF-Q30,SF-P22,7,2,2,0,5,2,0.2857142857142857,0.7142857142857143,0.0,1.0
SF-Q30,SF-W19,2,1,2,0,0,1,1.0,0.0,0.0,1.0
SF-Q30,SF-U21,1,2,0,0,1,2,0.0,1.0,0.0,1.0
SF-Q30,SF-AA28,2,2,2,2,0,0,1.0,0.0,1.0,0.0
SF-Q30,SF-X29,1,1,0,0,1,1,0.0,1.0,0.0,1.0
SF-Q30,SF-W29,42,35,1,1,41,34,0.023809523809523808,0.9761904761904762,0.02857142857142857,0.9714285714285714
SF-Q30,SF-V28,4,5,0,0,4,5,0.0,1.0,0.0,1.0
SF-Q30,SF-V29,17,24,6,6,11,18,0.35294117647058826,0.6470588235294118,0.25,0.75
SF-Q30,SF-V30,10,16,8,9,2,7,0.8,0.2,0.5625,0.4375
SF-Q30,SF-V31,8,5,1,1,7,4,0.125,0.875,0.2,0.8
SF-Q30,SF-V32,54,47,46,47,8,0,0.8518518518518519,0.14814814814814814,1.0,0.0
SF-Q30,SF-U30,17,10,7,6,10,4,0.4117647058823529,0.5882352941176471,0.6,0.4
SF-Q30,SF-W14,3,1,0,0,3,1,0.0,1.0,0.0,1.0
SF-Q30,SF-Y25,1,8,0,2,1,6,0.0,1.0,0.25,0.75
SF-P30,SF-M26,1,3,0,3,1,0,0.0,1.0,1.0,0.0
SF-P30,SF-M25,6,7,5,2,1,5,0.8333333333333334,0.16666666666666666,0.2857142857142857,0.7142857142857143
SF-P30,SF-M26-2,7,9,3,0,4,9,0.42857142857142855,0.5714285714285714,0.0,1.0
SF-P30,SF-L27,4,1,0,0,4,1,0.0,1.0,0.0,1.0
SF-P30,SF-K26,12,12,6,6,6,6,0.5,0.5,0.5,0.5
SF-P30,SF-J27,6,11,4,7,2,4,0.6666666666666666,0.3333333333333333,0.6363636363636364,0.36363636363636365
SF-P30,SF-M30,124,103,47,35,77,68,0.3790322580645161,0.6209677419354839,0.33980582524271846,0.6601941747572816
SF-P30,SF-L27-2,3,3,1,2,2,1,0.3333333333333333,0.6666666666666666,0.6666666666666666,0.3333333333333333
SF-P30,SF-J29-3,17,16,5,8,12,8,0.29411764705882354,0.7058823529411765,0.5,0.5
SF-P30,SF-J29,13,38,5,33,8,5,0.38461538461538464,0.6153846153846154,0.868421052631579,0.13157894736842105
SF-P30,SF-L26,11,3,3,1,8,2,0.2727272727272727,0.7272727272727273,0.3333333333333333,0.6666666666666666
SF-P30,SF-M28,13,20,8,8,5,12,0.6153846153846154,0.38461538461538464,0.4,0.6
SF-P30,SF-L25,5,4,3,3,2,1,0.6,0.4,0.75,0.25
SF-P30,SF-M24,3,4,3,0,0,4,1.0,0.0,0.0,1.0
SF-P30,SF-L24,6,13,3,5,3,8,0.5,0.5,0.38461538461538464,0.6153846153846154
SF-P30,SF-N23,5,5,4,2,1,3,0.8,0.2,0.4,0.6
SF-P30,SF-N24-2,2,14,1,4,1,10,0.5,0.5,0.2857142857142857,0.7142857142857143
SF-P30,SF-K27-2,13,12,8,7,5,5,0.6153846153846154,0.38461538461538464,0.5833333333333334,0.4166666666666667
SF-P30,SF-J26-2,8,7,2,5,6,2,0.25,0.75,0.7142857142857143,0.2857142857142857
SF-P30,SF-L28,9,11,4,6,5,5,0.4444444444444444,0.5555555555555556,0.5454545454545454,0.45454545454545453
SF-P30,SF-K28,3,5,1,2,2,3,0.3333333333333333,0.6666666666666666,0.4,0.6
SF-P30,SF-K29-1,158,119,134,98,24,21,0.8481012658227848,0.1518987341772152,0.8235294117647058,0.17647058823529413
SF-P30,SF-J28-2,32,13,20,2,12,11,0.625,0.375,0.15384615384615385,0.8461538461538461
SF-P30,SF-K27,6,5,2,2,4,3,0.3333333333333333,0.6666666666666666,0.4,0.6
SF-P30,SF-K25,4,3,1,1,3,2,0.25,0.75,0.3333333333333333,0.6666666666666666
SF-P30,SF-J25,12,8,1,4,11,4,0.08333333333333333,0.9166666666666666,0.5,0.5
SF-P30,SF-P24,4,10,0,1,4,9,0.0,1.0,0.1,0.9
SF-P30,SF-J24,11,8,4,5,7,3,0.36363636363636365,0.6363636363636364,0.625,0.375
SF-P30,SF-O24,2,7,0,2,2,5,0.0,1.0,0.2857142857142857,0.7142857142857143
SF-P30,SF-J26,5,4,1,2,4,2,0.2,0.8,0.5,0.5
SF-P30,SF-I25,3,17,1,3,2,14,0.3333333333333333,0.6666666666666666,0.17647058823529413,0.8235294117647058
SF-P30,SF-H26,11,20,5,5,6,15,0.45454545454545453,0.5454545454545454,0.25,0.75
SF-P30,SF-O23,8,12,5,2,3,10,0.625,0.375,0.16666666666666666,0.8333333333333334
SF-P30,SF-H27-1,8,11,4,3,4,8,0.5,0.5,0.2727272727272727,0.7272727272727273
SF-P30,SF-F28-2,7,14,3,2,4,12,0.42857142857142855,0.5714285714285714,0.14285714285714285,0.8571428571428571
SF-P30,SF-G27,17,4,1,0,16,4,0.058823529411764705,0.9411764705882353,0.0,1.0
SF-P30,SF-M22-2,7,7,2,3,5,4,0.2857142857142857,0.7142857142857143,0.42857142857142855,0.5714285714285714
SF-P30,SF-L22,8,16,0,1,8,15,0.0,1.0,0.0625,0.9375
SF-P30,SF-F27,4,8,3,3,1,5,0.75,0.25,0.375,0.625
SF-P30,SF-N22-2,20,27,8,5,12,22,0.4,0.6,0.18518518518518517,0.8148148148148148
SF-P30,SF-G28-2,2,1,1,1,1,0,0.5,0.5,1.0,0.0
SF-P30,SF-O25-1,6,10,1,3,5,7,0.16666666666666666,0.8333333333333334,0.3,0.7
SF-P30,SF-K22-2,3,2,0,0,3,2,0.0,1.0,0.0,1.0
SF-P30,SF-K24,3,3,1,2,2,1,0.3333333333333333,0.6666666666666666,0.6666666666666666,0.3333333333333333
SF-P30,SF-J23-2,4,2,0,1,4,1,0.0,1.0,0.5,0.5
SF-P30,SF-G23,1,1,0,0,1,1,0.0,1.0,0.0,1.0
SF-P30,SF-G24,7,1,1,0,6,1,0.14285714285714285,0.8571428571428571,0.0,1.0
SF-P30,SF-G25,4,11,2,0,2,11,0.5,0.5,0.0,1.0
SF-P30,SF-F23,16,9,0,0,16,9,0.0,1.0,0.0,1.0
SF-P30,SF-E23,3,29,2,0,1,29,0.6666666666666666,0.3333333333333333,0.0,1.0
SF-P30,SF-D24,15,7,0,0,15,7,0.0,1.0,0.0,1.0
SF-P30,SF-B22,3,9,2,6,1,3,0.6666666666666666,0.3333333333333333,0.6666666666666666,0.3333333333333333
SF-P30,SF-F19,2,3,1,0,1,3,0.5,0.5,0.0,1.0
SF-P30,SF-E20,3,11,1,0,2,11,0.3333333333333333,0.6666666666666666,0.0,1.0
SF-P30,SF-H30,23,31,19,13,4,18,0.8260869565217391,0.17391304347826086,0.41935483870967744,0.5806451612903226
SF-P30,SF-G30-2,23,14,11,4,12,10,0.4782608695652174,0.5217391304347826,0.2857142857142857,0.7142857142857143
SF-P30,SF-F30-1,21,4,10,2,11,2,0.47619047619047616,0.5238095238095238,0.5,0.5
SF-P30,SF-E29-2,12,21,5,6,7,15,0.4166666666666667,0.5833333333333334,0.2857142857142857,0.7142857142857143
SF-P30,SF-E29-1,27,53,20,36,7,17,0.7407407407407407,0.25925925925925924,0.6792452830188679,0.32075471698113206
SF-P30,SF-D29,25,37,17,29,8,8,0.68,0.32,0.7837837837837838,0.21621621621621623
SF-P30,SF-D28,8,3,4,3,4,0,0.5,0.5,1.0,0.0
SF-P30,SF-A27,7,14,6,8,1,6,0.8571428571428571,0.14285714285714285,0.5714285714285714,0.42857142857142855
SF-P30,SF-G29-2,6,4,5,3,1,1,0.8333333333333334,0.16666666666666666,0.75,0.25
SF-P30,SF-G29-1,10,3,8,1,2,2,0.8,0.2,0.3333333333333333,0.6666666666666666
SF-P30,SF-G30-1,8,4,4,3,4,1,0.5,0.5,0.75,0.25
SF-P30,SF-G29-3,1,3,1,2,0,1,1.0,0.0,0.6666666666666666,0.3333333333333333
SF-P30,SF-F30-2,1,2,1,1,0,1,1.0,0.0,0.5,0.5
SF-P30,SF-F29,3,6,3,5,0,1,1.0,0.0,0.8333333333333334,0.16666666666666666
SF-P30,SF-E29-3,3,1,2,0,1,1,0.6666666666666666,0.3333333333333333,0.0,1.0
SF-P30,SF-F28-1,6,9,1,1,5,8,0.16666666666666666,0.8333333333333334,0.1111111111111111,0.8888888888888888
SF-P30,SF-E28-2,4,4,2,0,2,4,0.5,0.5,0.0,1.0
SF-P30,SF-E28,3,6,0,2,3,4,0.0,1.0,0.3333333333333333,0.6666666666666666
SF-P30,SF-J10,2,2,2,1,0,1,1.0,0.0,0.5,0.5
SF-P30,SF-G13,1,1,0,0,1,1,0.0,1.0,0.0,1.0
SF-P30,SF-G12,2,1,0,0,2,1,0.0,1.0,0.0,1.0
SF-P30,SF-F15,1,1,0,1,1,0,0.0,1.0,1.0,0.0
SF-P30,SF-C21,5,2,0,0,5,2,0.0,1.0,0.0,1.0
SF-P30,SF-B19,5,6,2,3,3,3,0.4,0.6,0.5,0.5
SF-P30,SF-A20,4,6,3,4,1,2,0.75,0.25,0.6666666666666666,0.3333333333333333
SF-P30,SF-A19,1,3,1,0,0,3,1.0,0.0,0.0,1.0
SF-P30,SF-C26,51,17,28,2,23,15,0.5490196078431373,0.45098039215686275,0.11764705882352941,0.8823529411764706
SF-P30,SF-C25,8,11,2,2,6,9,0.25,0.75,0.18181818181818182,0.8181818181818182
SF-P30,SF-B25,10,6,1,2,9,4,0.1,0.9,0.3333333333333333,0.6666666666666666
SF-P30,SF-B28-2,7,2,4,0,3,2,0.5714285714285714,0.42857142857142855,0.0,1.0
SF-P30,SF-D27,2,4,1,2,1,2,0.5,0.5,0.5,0.5
SF-P30,SF-C28-2,10,32,6,25,4,7,0.6,0.4,0.78125,0.21875
SF-P30,SF-C28-1,3,4,2,3,1,1,0.6666666666666666,0.3333333333333333,0.75,0.25
SF-P30,SF-B28,47,39,44,35,3,4,0.9361702127659575,0.06382978723404255,0.8974358974358975,0.10256410256410256
SF-P30,SF-H25,6,2,0,0,6,2,0.0,1.0,0.0,1.0
SF-P30,SF-G26,4,5,1,0,3,5,0.25,0.75,0.0,1.0
SF-P30,SF-K21,1,1,0,0,1,1,0.0,1.0,0.0,1.0
SF-P30,SF-K22-1,7,5,3,2,4,3,0.42857142857142855,0.5714285714285714,0.4,0.6
SF-P30,SF-J23-1,42,15,7,2,35,13,0.16666666666666666,0.8333333333333334,0.13333333333333333,0.8666666666666667
SF-P30,SF-J22-1,1,1,1,0,0,1,1.0,0.0,0.0,1.0
SF-P30,SF-J22-2,2,4,1,2,1,2,0.5,0.5,0.5,0.5
SF-P30,SF-J21,2,2,0,1,2,1,0.0,1.0,0.5,0.5
SF-P30,SF-I23-2,2,4,1,4,1,0,0.5,0.5,1.0,0.0
SF-P30,SF-I24,1,8,1,0,0,8,1.0,0.0,0.0,1.0
SF-P30,SF-I23-1,1,4,0,0,1,4,0.0,1.0,0.0,1.0
SF-P30,SF-F26,14,11,6,1,8,10,0.42857142857142855,0.5714285714285714,0.09090909090909091,0.9090909090909091
SF-P30,SF-M15,14,21,0,0,14,21,0.0,1.0,0.0,1.0
SF-P30,SF-L19,6,3,3,0,3,3,0.5,0.5,0.0,1.0
SF-P30,SF-L20,4,6,0,3,4,3,0.0,1.0,0.5,0.5
SF-P30,SF-N20-1,1,4,1,3,0,1,1.0,0.0,0.75,0.25
SF-P30,SF-M20,8,7,1,0,7,7,0.125,0.875,0.0,1.0
SF-P30,SF-K17-2,9,1,2,0,7,1,0.2222222222222222,0.7777777777777778,0.0,1.0
SF-P30,SF-K20,9,8,6,3,3,5,0.6666666666666666,0.3333333333333333,0.375,0.625
SF-P30,SF-K15-,2,5,1,0,1,5,0.5,0.5,0.0,1.0
SF-P30,SF-K19,6,6,2,1,4,5,0.3333333333333333,0.6666666666666666,0.16666666666666666,0.8333333333333334
SF-P30,SF-K18,5,3,1,0,4,3,0.2,0.8,0.0,1.0
SF-P30,SF-K17,2,1,0,0,2,1,0.0,1.0,0.0,1.0
SF-P30,SF-J18,3,2,1,0,2,2,0.3333333333333333,0.6666666666666666,0.0,1.0
SF-P30,SF-J20,1,12,0,9,1,3,0.0,1.0,0.75,0.25
SF-P30,SF-J19,10,6,7,4,3,2,0.7,0.3,0.6666666666666666,0.3333333333333333
SF-P30,SF-R19,10,5,1,1,9,4,0.1,0.9,0.2,0.8
SF-P30,SF-R20,5,3,0,1,5,2,0.0,1.0,0.3333333333333333,0.6666666666666666
SF-P30,SF-Q21-2,3,3,0,0,3,3,0.0,1.0,0.0,1.0
SF-P30,SF-Q21-1,2,4,0,2,2,2,0.0,1.0,0.5,0.5
SF-P30,SF-P21,5,2,0,1,5,1,0.0,1.0,0.5,0.5
SF-P30,SF-O18,9,6,5,0,4,6,0.5555555555555556,0.4444444444444444,0.0,1.0
SF-P30,SF-O19,11,27,3,0,8,27,0.2727272727272727,0.7272727272727273,0.0,1.0
SF-P30,SF-O21,22,10,2,4,20,6,0.09090909090909091,0.9090909090909091,0.4,0.6
SF-P30,SF-O22,6,8,0,1,6,7,0.0,1.0,0.125,0.875
SF-P30,SF-N21,31,32,14,1,17,31,0.45161290322580644,0.5483870967741935,0.03125,0.96875
SF-P30,SF-N20-2,24,44,24,44,0,0,1.0,0.0,1.0,0.0
SF-P30,SF-M21,6,6,4,0,2,6,0.6666666666666666,0.3333333333333333,0.0,1.0
SF-P30,SF-L21,2,3,1,0,1,3,0.5,0.5,0.0,1.0
SF-P30,SF-S29,15,27,12,21,3,6,0.8,0.2,0.7777777777777778,0.2222222222222222
SF-P30,SF-S30,3,3,2,2,1,1,0.6666666666666666,0.3333333333333333,0.6666666666666666,0.3333333333333333
SF-P30,SF-Q30,81,104,45,84,36,20,0.5555555555555556,0.4444444444444444,0.8076923076923077,0.19230769230769232
SF-P30,SF-O30-2,21,32,15,28,6,4,0.7142857142857143,0.2857142857142857,0.875,0.125
SF-P30,SF-O30,166,110,109,68,57,42,0.6566265060240963,0.3433734939759036,0.6181818181818182,0.38181818181818183
SF-P30,SF-N27,53,25,15,8,38,17,0.2830188679245283,0.7169811320754716,0.32,0.68
SF-P30,SF-N29,17,5,10,4,7,1,0.5882352941176471,0.4117647058823529,0.8,0.2
SF-P30,SF-N28,25,22,13,11,12,11,0.52,0.48,0.5,0.5
SF-P30,SF-L30-1,151,100,64,58,87,42,0.423841059602649,0.5761589403973509,0.58,0.42
SF-P30,SF-L31-1,23,12,15,5,8,7,0.6521739130434783,0.34782608695652173,0.4166666666666667,0.5833333333333334
SF-P30,SF-K30-2,21,27,11,11,10,16,0.5238095238095238,0.47619047619047616,0.4074074074074074,0.5925925925925926
SF-P30,SF-L29,58,56,25,26,33,30,0.43103448275862066,0.5689655172413793,0.4642857142857143,0.5357142857142857
SF-P30,SF-J29-1,6,25,4,15,2,10,0.6666666666666666,0.3333333333333333,0.6,0.4
SF-P30,SF-I30,10,21,10,17,0,4,1.0,0.0,0.8095238095238095,0.19047619047619047
SF-P30,SF-I29-2,1,3,0,2,1,1,0.0,1.0,0.6666666666666666,0.3333333333333333
SF-P30,SF-I27,4,4,2,1,2,3,0.5,0.5,0.25,0.75
SF-P30,SF-I28,3,2,1,1,2,1,0.3333333333333333,0.6666666666666666,0.5,0.5
SF-P30,SF-I30-2,3,3,0,0,3,3,0.0,1.0,0.0,1.0
SF-P30,SF-H28,6,3,2,1,4,2,0.3333333333333333,0.6666666666666666,0.3333333333333333,0.6666666666666666
SF-P30,SF-H29,4,3,1,0,3,3,0.25,0.75,0.0,1.0
SF-P30,SF-S24,22,22,6,11,16,11,0.2727272727272727,0.7272727272727273,0.5,0.5
SF-P30,SF-R24,16,18,2,5,14,13,0.125,0.875,0.2777777777777778,0.7222222222222222
SF-P30,SF-R26,7,9,2,3,5,6,0.2857142857142857,0.7142857142857143,0.3333333333333333,0.6666666666666666
SF-P30,SF-Q26,4,2,2,1,2,1,0.5,0.5,0.5,0.5
SF-P30,SF-O25-2,7,5,2,0,5,5,0.2857142857142857,0.7142857142857143,0.0,1.0
SF-P30,SF-N22-1B,2,6,0,0,2,6,0.0,1.0,0.0,1.0
SF-P30,SF-N26,4,5,2,4,2,1,0.5,0.5,0.8,0.2
SF-P30,SF-N25,10,5,3,1,7,4,0.3,0.7,0.2,0.8
SF-P30,SF-T21,2,2,0,1,2,1,0.0,1.0,0.5,0.5
SF-P30,SF-T22,4,2,1,0,3,2,0.25,0.75,0.0,1.0
SF-P30,SF-S22-2,1,1,0,0,1,1,0.0,1.0,0.0,1.0
SF-P30,SF-S22-1,5,8,2,3,3,5,0.4,0.6,0.375,0.625
SF-P30,SF-Q23-3,10,11,2,3,8,8,0.2,0.8,0.2727272727272727,0.7272727272727273
SF-P30,SF-Q22-1,5,4,2,0,3,4,0.4,0.6,0.0,1.0
SF-P30,SF-Q22-2,7,4,3,2,4,2,0.42857142857142855,0.5714285714285714,0.5,0.5
SF-P30,SF-P22,5,4,2,1,3,3,0.4,0.6,0.25,0.75
SF-P30,SF-S21,2,4,0,2,2,2,0.0,1.0,0.5,0.5
SF-P30,SF-Z28,4,1,1,0,3,1,0.25,0.75,0.0,1.0
SF-P30,SF-V28,1,1,0,1,1,0,0.0,1.0,1.0,0.0
SF-P30,SF-V29,8,14,8,10,0,4,1.0,0.0,0.7142857142857143,0.2857142857142857
SF-P30,SF-V30,4,4,2,2,2,2,0.5,0.5,0.5,0.5
SF-P30,SF-V31,2,6,2,5,0,1,1.0,0.0,0.8333333333333334,0.16666666666666666
SF-P30,SF-V32,11,8,8,7,3,1,0.7272727272727273,0.2727272727272727,0.875,0.125
SF-P30,SF-W14,1,1,0,0,1,1,0.0,1.0,0.0,1.0
SF-O30-2,SF-M25,1,2,0,1,1,1,0.0,1.0,0.5,0.5
SF-O30-2,SF-M26-2,5,2,3,0,2,2,0.6,0.4,0.0,1.0
SF-O30-2,SF-K26,6,6,3,3,3,3,0.5,0.5,0.5,0.5
SF-O30-2,SF-J27,12,16,8,7,4,9,0.6666666666666666,0.3333333333333333,0.4375,0.5625
SF-O30-2,SF-M30,52,72,43,67,9,5,0.8269230769230769,0.17307692307692307,0.9305555555555556,0.06944444444444445
SF-O30-2,SF-L27-2,4,2,3,1,1,1,0.75,0.25,0.5,0.5
SF-O30-2,SF-J29-3,22,14,16,5,6,9,0.7272727272727273,0.2727272727272727,0.35714285714285715,0.6428571428571429
SF-O30-2,SF-J29,18,14,6,4,12,10,0.3333333333333333,0.6666666666666666,0.2857142857142857,0.7142857142857143
SF-O30-2,SF-L26,3,4,1,1,2,3,0.3333333333333333,0.6666666666666666,0.25,0.75
SF-O30-2,SF-M28,8,9,4,2,4,7,0.5,0.5,0.2222222222222222,0.7777777777777778
SF-O30-2,SF-M27,2,2,0,2,2,0,0.0,1.0,1.0,0.0
SF-O30-2,SF-L25,4,4,2,1,2,3,0.5,0.5,0.25,0.75
SF-O30-2,SF-M24,4,2,3,0,1,2,0.75,0.25,0.0,1.0
SF-O30-2,SF-L24,2,2,0,0,2,2,0.0,1.0,0.0,1.0
SF-O30-2,SF-N23,13,10,1,6,12,4,0.07692307692307693,0.9230769230769231,0.6,0.4
SF-O30-2,SF-N24-2,1,5,1,0,0,5,1.0,0.0,0.0,1.0
SF-O30-2,SF-K27-2,8,12,5,7,3,5,0.625,0.375,0.5833333333333334,0.4166666666666667
SF-O30-2,SF-J26-2,8,16,2,3,6,13,0.25,0.75,0.1875,0.8125
SF-O30-2,SF-K28-3,5,3,3,1,2,2,0.6,0.4,0.3333333333333333,0.6666666666666666
SF-O30-2,SF-L28,13,13,7,6,6,7,0.5384615384615384,0.46153846153846156,0.46153846153846156,0.5384615384615384
SF-O30-2,SF-K28,1,2,1,1,0,1,1.0,0.0,0.5,0.5
SF-O30-2,SF-K29-1,29,40,21,25,8,15,0.7241379310344828,0.27586206896551724,0.625,0.375
SF-O30-2,SF-J28-2,3,5,2,4,1,1,0.6666666666666666,0.3333333333333333,0.8,0.2
SF-O30-2,SF-K27,1,2,0,0,1,2,0.0,1.0,0.0,1.0
SF-O30-2,SF-K25,6,2,5,2,1,0,0.8333333333333334,0.16666666666666666,1.0,0.0
SF-O30-2,SF-J25,10,14,5,3,5,11,0.5,0.5,0.21428571428571427,0.7857142857142857
SF-O30-2,SF-H26-2,1,1,1,1,0,0,1.0,0.0,1.0,0.0
SF-O30-2,SF-J24,9,4,5,3,4,1,0.5555555555555556,0.4444444444444444,0.75,0.25
SF-O30-2,SF-O24,3,1,1,0,2,1,0.3333333333333333,0.6666666666666666,0.0,1.0
SF-O30-2,SF-J26,1,6,1,1,0,5,1.0,0.0,0.16666666666666666,0.8333333333333334
SF-O30-2,SF-I26-,1,1,1,1,0,0,1.0,0.0,1.0,0.0
SF-O30-2,SF-H26,8,10,4,8,4,2,0.5,0.5,0.8,0.2
SF-O30-2,SF-O23,13,12,1,2,12,10,0.07692307692307693,0.9230769230769231,0.16666666666666666,0.8333333333333334
SF-O30-2,SF-H27-1,5,8,3,3,2,5,0.6,0.4,0.375,0.625
SF-O30-2,SF-F28-2,20,12,16,5,4,7,0.8,0.2,0.4166666666666667,0.5833333333333334
SF-O30-2,SF-G27,31,55,18,23,13,32,0.5806451612903226,0.41935483870967744,0.41818181818181815,0.5818181818181818
SF-O30-2,SF-M22-2,8,8,2,2,6,6,0.25,0.75,0.25,0.75
SF-O30-2,SF-L22,3,5,1,3,2,2,0.3333333333333333,0.6666666666666666,0.6,0.4
SF-O30-2,SF-F27,10,5,6,3,4,2,0.6,0.4,0.6,0.4
SF-O30-2,SF-N22-2,14,34,3,1,11,33,0.21428571428571427,0.7857142857142857,0.029411764705882353,0.9705882352941176
SF-O30-2,SF-G28-1,3,3,3,3,0,0,1.0,0.0,1.0,0.0
SF-O30-2,SF-M22-1,5,1,2,1,3,0,0.4,0.6,1.0,0.0
SF-O30-2,SF-O25-1,1,6,0,1,1,5,0.0,1.0,0.16666666666666666,0.8333333333333334
SF-O30-2,SF-K22-2,1,2,1,2,0,0,1.0,0.0,1.0,0.0
SF-O30-2,SF-K24,3,2,2,0,1,2,0.6666666666666666,0.3333333333333333,0.0,1.0
SF-O30-2,SF-J23-2,1,3,1,1,0,2,1.0,0.0,0.3333333333333333,0.6666666666666666
SF-O30-2,SF-G24,6,4,5,2,1,2,0.8333333333333334,0.16666666666666666,0.5,0.5
SF-O30-2,SF-G25,9,8,2,1,7,7,0.2222222222222222,0.7777777777777778,0.125,0.875
SF-O30-2,SF-F23,5,5,1,0,4,5,0.2,0.8,0.0,1.0
SF-O30-2,SF-E23,39,3,2,0,37,3,0.05128205128205128,0.9487179487179487,0.0,1.0
SF-O30-2,SF-D24,4,1,0,1,4,0,0.0,1.0,1.0,0.0
SF-O30-2,SF-C22,2,1,2,1,0,0,1.0,0.0,1.0,0.0
SF-O30-2,SF-B22,3,8,0,4,3,4,0.0,1.0,0.5,0.5
SF-O30-2,SF-H20,2,2,1,0,1,2,0.5,0.5,0.0,1.0
SF-O30-2,SF-G20,2,1,2,0,0,1,1.0,0.0,0.0,1.0
SF-O30-2,SF-H30,65,89,51,41,14,48,0.7846153846153846,0.2153846153846154,0.4606741573033708,0.5393258426966292
SF-O30-2,SF-G30-2,48,24,36,16,12,8,0.75,0.25,0.6666666666666666,0.3333333333333333
SF-O30-2,SF-F30-1,12,3,8,2,4,1,0.6666666666666666,0.3333333333333333,0.6666666666666666,0.3333333333333333
SF-O30-2,SF-E29-2,120,86,80,56,40,30,0.6666666666666666,0.3333333333333333,0.6511627906976745,0.3488372093023256
SF-O30-2,SF-E29-1,53,79,39,55,14,24,0.7358490566037735,0.2641509433962264,0.6962025316455697,0.3037974683544304
SF-O30-2,SF-D29,67,48,46,37,21,11,0.6865671641791045,0.31343283582089554,0.7708333333333334,0.22916666666666666
SF-O30-2,SF-D28,7,10,2,7,5,3,0.2857142857142857,0.7142857142857143,0.7,0.3
SF-O30-2,SF-A27,15,3,9,0,6,3,0.6,0.4,0.0,1.0
SF-O30-2,SF-G29-2,9,11,5,3,4,8,0.5555555555555556,0.4444444444444444,0.2727272727272727,0.7272727272727273
SF-O30-2,SF-G29-1,4,1,1,0,3,1,0.25,0.75,0.0,1.0
SF-O30-2,SF-G30-1,16,10,7,3,9,7,0.4375,0.5625,0.3,0.7
SF-O30-2,SF-G29-3,12,6,9,2,3,4,0.75,0.25,0.3333333333333333,0.6666666666666666
SF-O30-2,SF-F30-2,6,4,1,4,5,0,0.16666666666666666,0.8333333333333334,1.0,0.0
SF-O30-2,SF-F29,2,1,2,1,0,0,1.0,0.0,1.0,0.0
SF-O30-2,SF-F28-1,2,2,1,2,1,0,0.5,0.5,1.0,0.0
SF-O30-2,SF-E28-2,3,2,1,0,2,2,0.3333333333333333,0.6666666666666666,0.0,1.0
SF-O30-2,SF-B19,1,1,0,0,1,1,0.0,1.0,0.0,1.0
SF-O30-2,SF-A20,33,13,10,9,23,4,0.30303030303030304,0.696969696969697,0.6923076923076923,0.3076923076923077
SF-O30-2,SF-A19,1,3,0,1,1,2,0.0,1.0,0.3333333333333333,0.6666666666666666
SF-O30-2,SF-C26,7,8,2,2,5,6,0.2857142857142857,0.7142857142857143,0.25,0.75
SF-O30-2,SF-C25,16,6,4,4,12,2,0.25,0.75,0.6666666666666666,0.3333333333333333
SF-O30-2,SF-B25,6,25,3,1,3,24,0.5,0.5,0.04,0.96
SF-O30-2,SF-E27,6,6,4,3,2,3,0.6666666666666666,0.3333333333333333,0.5,0.5
SF-O30-2,SF-B28-2,5,1,3,0,2,1,0.6,0.4,0.0,1.0
SF-O30-2,SF-D27,3,2,1,2,2,0,0.3333333333333333,0.6666666666666666,1.0,0.0
SF-O30-2,SF-C28-2,3,2,3,1,0,1,1.0,0.0,0.5,0.5
SF-O30-2,SF-C28-1,8,1,5,1,3,0,0.625,0.375,1.0,0.0
SF-O30-2,SF-B28,14,40,14,39,0,1,1.0,0.0,0.975,0.025
SF-O30-2,SF-G26,4,3,2,3,2,0,0.5,0.5,1.0,0.0
SF-O30-2,SF-K21,4,2,1,0,3,2,0.25,0.75,0.0,1.0
SF-O30-2,SF-K22-1,2,3,2,2,0,1,1.0,0.0,0.6666666666666666,0.3333333333333333
SF-O30-2,SF-J23-1,6,16,4,7,2,9,0.6666666666666666,0.3333333333333333,0.4375,0.5625
SF-O30-2,SF-J22-1,1,2,0,0,1,2,0.0,1.0,0.0,1.0
SF-O30-2,SF-J22-2,7,1,3,0,4,1,0.42857142857142855,0.5714285714285714,0.0,1.0
SF-O30-2,SF-J21,3,3,1,0,2,3,0.3333333333333333,0.6666666666666666,0.0,1.0
SF-O30-2,SF-I23-2,4,5,0,1,4,4,0.0,1.0,0.2,0.8
SF-O30-2,SF-F26,8,6,2,0,6,6,0.25,0.75,0.0,1.0
SF-O30-2,SF-M13,2,1,0,0,2,1,0.0,1.0,0.0,1.0
SF-O30-2,SF-L19,5,1,1,0,4,1,0.2,0.8,0.0,1.0
SF-O30-2,SF-L20,4,3,0,0,4,3,0.0,1.0,0.0,1.0
SF-O30-2,SF-M20,5,2,1,1,4,1,0.2,0.8,0.5,0.5
SF-O30-2,SF-K17-2,4,1,0,0,4,1,0.0,1.0,0.0,1.0
SF-O30-2,SF-K15-,2,3,0,0,2,3,0.0,1.0,0.0,1.0
SF-O30-2,SF-K19,8,1,3,0,5,1,0.375,0.625,0.0,1.0
SF-O30-2,SF-K18,1,5,0,0,1,5,0.0,1.0,0.0,1.0
SF-O30-2,SF-K17,1,1,1,0,0,1,1.0,0.0,0.0,1.0
SF-O30-2,SF-J18,25,14,4,1,21,13,0.16,0.84,0.07142857142857142,0.9285714285714286
SF-O30-2,SF-J19,5,3,1,1,4,2,0.2,0.8,0.3333333333333333,0.6666666666666666
SF-O30-2,SF-R19,5,1,3,0,2,1,0.6,0.4,0.0,1.0
SF-O30-2,SF-Q21-1,3,3,0,1,3,2,0.0,1.0,0.3333333333333333,0.6666666666666666
SF-O30-2,SF-P21,1,2,0,0,1,2,0.0,1.0,0.0,1.0
SF-O30-2,SF-O18,1,1,0,0,1,1,0.0,1.0,0.0,1.0
SF-O30-2,SF-O19,8,4,2,1,6,3,0.25,0.75,0.25,0.75
SF-O30-2,SF-O21,12,14,2,1,10,13,0.16666666666666666,0.8333333333333334,0.07142857142857142,0.9285714285714286
SF-O30-2,SF-O22,8,2,0,0,8,2,0.0,1.0,0.0,1.0
SF-O30-2,SF-N21,2,7,2,2,0,5,1.0,0.0,0.2857142857142857,0.7142857142857143
SF-O30-2,SF-N20-2,3,3,2,2,1,1,0.6666666666666666,0.3333333333333333,0.6666666666666666,0.3333333333333333
SF-O30-2,SF-M21,5,4,2,0,3,4,0.4,0.6,0.0,1.0
SF-O30-2,SF-L21,3,2,0,0,3,2,0.0,1.0,0.0,1.0
SF-O30-2,SF-S29,7,4,2,3,5,1,0.2857142857142857,0.7142857142857143,0.75,0.25
SF-O30-2,SF-S30,19,9,13,5,6,4,0.6842105263157895,0.3157894736842105,0.5555555555555556,0.4444444444444444
SF-O30-2,SF-Q30,79,43,61,35,18,8,0.7721518987341772,0.22784810126582278,0.813953488372093,0.18604651162790697
SF-O30-2,SF-P30,32,21,28,15,4,6,0.875,0.125,0.7142857142857143,0.2857142857142857
SF-O30-2,SF-O30,32,37,29,27,3,10,0.90625,0.09375,0.7297297297297297,0.2702702702702703
SF-O30-2,SF-N27,27,21,9,8,18,13,0.3333333333333333,0.6666666666666666,0.38095238095238093,0.6190476190476191
SF-O30-2,SF-N29,8,6,5,3,3,3,0.625,0.375,0.5,0.5
SF-O30-2,SF-N28,14,14,9,7,5,7,0.6428571428571429,0.35714285714285715,0.5,0.5
SF-O30-2,SF-L30-1,39,27,27,13,12,14,0.6923076923076923,0.3076923076923077,0.48148148148148145,0.5185185185185185
SF-O30-2,SF-L31-1,41,48,31,41,10,7,0.7560975609756098,0.24390243902439024,0.8541666666666666,0.14583333333333334
SF-O30-2,SF-K30-2,25,18,22,15,3,3,0.88,0.12,0.8333333333333334,0.16666666666666666
SF-O30-2,SF-L29,21,26,13,16,8,10,0.6190476190476191,0.38095238095238093,0.6153846153846154,0.38461538461538464
SF-O30-2,SF-J29-1,33,47,11,20,22,27,0.3333333333333333,0.6666666666666666,0.425531914893617,0.574468085106383
SF-O30-2,SF-I30,24,13,22,7,2,6,0.9166666666666666,0.08333333333333333,0.5384615384615384,0.46153846153846156
SF-O30-2,SF-I29-2,14,9,8,4,6,5,0.5714285714285714,0.42857142857142855,0.4444444444444444,0.5555555555555556
SF-O30-2,SF-I27,3,5,0,1,3,4,0.0,1.0,0.2,0.8
SF-O30-2,SF-I28,6,10,2,6,4,4,0.3333333333333333,0.6666666666666666,0.6,0.4
SF-O30-2,SF-I30-2,15,5,9,2,6,3,0.6,0.4,0.4,0.6
SF-O30-2,SF I29-1,4,3,2,2,2,1,0.5,0.5,0.6666666666666666,0.3333333333333333
SF-O30-2,SF-H28,9,14,5,5,4,9,0.5555555555555556,0.4444444444444444,0.35714285714285715,0.6428571428571429
SF-O30-2,SF-H29,4,2,4,1,0,1,1.0,0.0,0.5,0.5
SF-O30-2,SF-S24,3,16,1,8,2,8,0.3333333333333333,0.6666666666666666,0.5,0.5
SF-O30-2,SF-R24,3,2,0,1,3,1,0.0,1.0,0.5,0.5
SF-O30-2,SF-Q26,3,5,1,2,2,3,0.3333333333333333,0.6666666666666666,0.4,0.6
SF-O30-2,SF-P26,4,2,1,0,3,2,0.25,0.75,0.0,1.0
SF-O30-2,SF-O25-2,2,3,0,1,2,2,0.0,1.0,0.3333333333333333,0.6666666666666666
SF-O30-2,SF-N22-1B,5,1,3,1,2,0,0.6,0.4,1.0,0.0
SF-O30-2,SF-N26,4,4,1,3,3,1,0.25,0.75,0.75,0.25
SF-O30-2,SF-N25,5,5,1,1,4,4,0.2,0.8,0.2,0.8
SF-O30-2,SF-T22,3,1,1,0,2,1,0.3333333333333333,0.6666666666666666,0.0,1.0
SF-O30-2,SF-S22-1,5,6,1,3,4,3,0.2,0.8,0.5,0.5
SF-O30-2,SF-Q23-3,2,2,2,0,0,2,1.0,0.0,0.0,1.0
SF-O30-2,SF-Q22-1,6,16,1,0,5,16,0.16666666666666666,0.8333333333333334,0.0,1.0
SF-O30-2,SF-Q22-2,4,5,1,2,3,3,0.25,0.75,0.4,0.6
SF-O30-2,SF-P22,10,5,2,0,8,5,0.2,0.8,0.0,1.0
SF-O30-2,SF-W19,2,3,0,0,2,3,0.0,1.0,0.0,1.0
SF-O30-2,SF-AA28,1,1,1,1,0,0,1.0,0.0,1.0,0.0
SF-O30-2,SF-V28,1,2,0,0,1,2,0.0,1.0,0.0,1.0
SF-O30-2,SF-V29,6,6,2,4,4,2,0.3333333333333333,0.6666666666666666,0.6666666666666666,0.3333333333333333
SF-O30-2,SF-V30,3,4,2,0,1,4,0.6666666666666666,0.3333333333333333,0.0,1.0
SF-O30-2,SF-V31,4,9,1,7,3,2,0.25,0.75,0.7777777777777778,0.2222222222222222
SF-O30-2,SF-V32,30,24,20,22,10,2,0.6666666666666666,0.3333333333333333,0.9166666666666666,0.08333333333333333
SF-O30-2,SF-U30,5,4,0,2,5,2,0.0,1.0,0.5,0.5
SF-O30-2,SF-Y25,5,7,1,0,4,7,0.2,0.8,0.0,1.0
SF-O30,SF-M26,17,21,2,6,15,15,0.11764705882352941,0.8823529411764706,0.2857142857142857,0.7142857142857143
SF-O30,SF-M25,20,17,9,5,11,12,0.45,0.55,0.29411764705882354,0.7058823529411765
SF-O30,SF-M26-2,33,29,14,7,19,22,0.42424242424242425,0.5757575757575758,0.2413793103448276,0.7586206896551724
SF-O30,SF-L27,10,11,6,9,4,2,0.6,0.4,0.8181818181818182,0.18181818181818182
SF-O30,SF-K26,56,48,24,22,32,26,0.42857142857142855,0.5714285714285714,0.4583333333333333,0.5416666666666666
SF-O30,SF-J27,11,9,7,6,4,3,0.6363636363636364,0.36363636363636365,0.6666666666666666,0.3333333333333333
SF-O30,SF-M30,362,350,291,296,71,54,0.8038674033149171,0.19613259668508287,0.8457142857142858,0.15428571428571428
SF-O30,SF-L27-2,12,13,10,10,2,3,0.8333333333333334,0.16666666666666666,0.7692307692307693,0.23076923076923078
SF-O30,SF-J29-3,82,62,54,34,28,28,0.6585365853658537,0.34146341463414637,0.5483870967741935,0.45161290322580644
SF-O30,SF-J29,60,27,27,13,33,14,0.45,0.55,0.48148148148148145,0.5185185185185185
SF-O30,SF-L26,86,81,18,18,68,63,0.20930232558139536,0.7906976744186046,0.2222222222222222,0.7777777777777778
SF-O30,SF-M28,19,21,10,7,9,14,0.5263157894736842,0.47368421052631576,0.3333333333333333,0.6666666666666666
SF-O30,SF-M27,3,1,2,1,1,0,0.6666666666666666,0.3333333333333333,1.0,0.0
SF-O30,SF-L25,9,10,7,4,2,6,0.7777777777777778,0.2222222222222222,0.4,0.6
SF-O30,SF-M24,25,18,20,8,5,10,0.8,0.2,0.4444444444444444,0.5555555555555556
SF-O30,SF-L24,14,10,2,1,12,9,0.14285714285714285,0.8571428571428571,0.1,0.9
SF-O30,SF-N23,22,11,10,3,12,8,0.45454545454545453,0.5454545454545454,0.2727272727272727,0.7272727272727273
SF-O30,SF-N24-2,6,6,1,0,5,6,0.16666666666666666,0.8333333333333334,0.0,1.0
SF-O30,SF-K27-2,31,19,22,9,9,10,0.7096774193548387,0.2903225806451613,0.47368421052631576,0.5263157894736842
SF-O30,SF-J26-2,14,25,3,8,11,17,0.21428571428571427,0.7857142857142857,0.32,0.68
SF-O30,SF-K28-3,4,1,4,1,0,0,1.0,0.0,1.0,0.0
SF-O30,SF-L28,18,15,15,13,3,2,0.8333333333333334,0.16666666666666666,0.8666666666666667,0.13333333333333333
SF-O30,SF-K28,3,2,1,0,2,2,0.3333333333333333,0.6666666666666666,0.0,1.0
SF-O30,SF-K29-1,173,164,113,109,60,55,0.653179190751445,0.3468208092485549,0.6646341463414634,0.3353658536585366
SF-O30,SF-J28-2,19,12,10,7,9,5,0.5263157894736842,0.47368421052631576,0.5833333333333334,0.4166666666666667
SF-O30,SF-K27,13,7,12,5,1,2,0.9230769230769231,0.07692307692307693,0.7142857142857143,0.2857142857142857
SF-O30,SF-K25,7,6,3,1,4,5,0.42857142857142855,0.5714285714285714,0.16666666666666666,0.8333333333333334
SF-O30,SF-J25,19,14,9,11,10,3,0.47368421052631576,0.5263157894736842,0.7857142857142857,0.21428571428571427
SF-O30,SF-H26-2,4,6,1,6,3,0,0.25,0.75,1.0,0.0
SF-O30,SF-P24,18,12,3,1,15,11,0.16666666666666666,0.8333333333333334,0.08333333333333333,0.9166666666666666
SF-O30,SF-N22-1A,6,2,3,0,3,2,0.5,0.5,0.0,1.0
SF-O30,SF-J24,14,13,8,10,6,3,0.5714285714285714,0.42857142857142855,0.7692307692307693,0.23076923076923078
SF-O30,SF-O24,6,6,0,0,6,6,0.0,1.0,0.0,1.0
SF-O30,SF-J26,6,3,2,1,4,2,0.3333333333333333,0.6666666666666666,0.3333333333333333,0.6666666666666666
SF-O30,SF-I26-,1,2,1,1,0,1,1.0,0.0,0.5,0.5
SF-O30,SF-I25,7,21,3,11,4,10,0.42857142857142855,0.5714285714285714,0.5238095238095238,0.47619047619047616
SF-O30,SF-K23,2,3,1,2,1,1,0.5,0.5,0.6666666666666666,0.3333333333333333
SF-O30,SF-H26,22,27,13,18,9,9,0.5909090909090909,0.4090909090909091,0.6666666666666666,0.3333333333333333
SF-O30,SF-O23,85,128,72,108,13,20,0.8470588235294118,0.15294117647058825,0.84375,0.15625
SF-O30,SF-H27-1,15,16,8,7,7,9,0.5333333333333333,0.4666666666666667,0.4375,0.5625
SF-O30,SF-F28-2,13,23,7,10,6,13,0.5384615384615384,0.46153846153846156,0.43478260869565216,0.5652173913043478
SF-O30,SF-G27,33,27,11,12,22,15,0.3333333333333333,0.6666666666666666,0.4444444444444444,0.5555555555555556
SF-O30,SF-M22-2,9,8,3,1,6,7,0.3333333333333333,0.6666666666666666,0.125,0.875
SF-O30,SF-L22,5,11,3,4,2,7,0.6,0.4,0.36363636363636365,0.6363636363636364
SF-O30,SF-F27,10,13,4,6,6,7,0.4,0.6,0.46153846153846156,0.5384615384615384
SF-O30,SF-N22-2,30,46,11,14,19,32,0.36666666666666664,0.6333333333333333,0.30434782608695654,0.6956521739130435
SF-O30,SF-M22-1,5,6,3,0,2,6,0.6,0.4,0.0,1.0
SF-O30,SF-O25-1,11,6,4,2,7,4,0.36363636363636365,0.6363636363636364,0.3333333333333333,0.6666666666666666
SF-O30,SF-K22-2,1,1,0,0,1,1,0.0,1.0,0.0,1.0
SF-O30,SF-K24,6,10,4,8,2,2,0.6666666666666666,0.3333333333333333,0.8,0.2
SF-O30,SF-G23,14,13,13,5,1,8,0.9285714285714286,0.07142857142857142,0.38461538461538464,0.6153846153846154
SF-O30,SF-G24,25,13,4,4,21,9,0.16,0.84,0.3076923076923077,0.6923076923076923
SF-O30,SF-G25,8,13,2,0,6,13,0.25,0.75,0.0,1.0
SF-O30,SF-F23,16,12,5,2,11,10,0.3125,0.6875,0.16666666666666666,0.8333333333333334
SF-O30,SF-E23,20,14,4,2,16,12,0.2,0.8,0.14285714285714285,0.8571428571428571
SF-O30,SF-B22,11,15,3,5,8,10,0.2727272727272727,0.7272727272727273,0.3333333333333333,0.6666666666666666
SF-O30,SF-J17,5,3,3,0,2,3,0.6,0.4,0.0,1.0
SF-O30,SF-I20,2,5,0,3,2,2,0.0,1.0,0.6,0.4
SF-O30,SF-H20,2,6,0,1,2,5,0.0,1.0,0.16666666666666666,0.8333333333333334
SF-O30,SF-H18,1,2,0,0,1,2,0.0,1.0,0.0,1.0
SF-O30,SF-G19,1,5,1,1,0,4,1.0,0.0,0.2,0.8
SF-O30,SF-G18,8,12,0,0,8,12,0.0,1.0,0.0,1.0
SF-O30,SF-G20,2,3,1,2,1,1,0.5,0.5,0.6666666666666666,0.3333333333333333
SF-O30,SF-E18,2,1,0,0,2,1,0.0,1.0,0.0,1.0
SF-O30,SF-E20,1,2,1,1,0,1,1.0,0.0,0.5,0.5
SF-O30,SF-H30,94,64,50,34,44,30,0.5319148936170213,0.46808510638297873,0.53125,0.46875
SF-O30,SF-G30-2,49,27,18,13,31,14,0.3673469387755102,0.6326530612244898,0.48148148148148145,0.5185185185185185
SF-O30,SF-F30-1,31,17,17,12,14,5,0.5483870967741935,0.45161290322580644,0.7058823529411765,0.29411764705882354
SF-O30,SF-E29-2,30,37,9,14,21,23,0.3,0.7,0.3783783783783784,0.6216216216216216
SF-O30,SF-E29-1,87,100,31,56,56,44,0.3563218390804598,0.6436781609195402,0.56,0.44
SF-O30,SF-D29,63,93,29,48,34,45,0.4603174603174603,0.5396825396825397,0.5161290322580645,0.4838709677419355
SF-O30,SF-D28,35,21,8,4,27,17,0.22857142857142856,0.7714285714285715,0.19047619047619047,0.8095238095238095
SF-O30,SF-A27,26,26,14,13,12,13,0.5384615384615384,0.46153846153846156,0.5,0.5
SF-O30,SF-G29-2,15,8,5,2,10,6,0.3333333333333333,0.6666666666666666,0.25,0.75
SF-O30,SF-G29-1,5,9,0,3,5,6,0.0,1.0,0.3333333333333333,0.6666666666666666
SF-O30,SF-G30-1,9,7,5,5,4,2,0.5555555555555556,0.4444444444444444,0.7142857142857143,0.2857142857142857
SF-O30,SF-G29-3,4,14,2,7,2,7,0.5,0.5,0.5,0.5
SF-O30,SF-F30-2,7,3,2,2,5,1,0.2857142857142857,0.7142857142857143,0.6666666666666666,0.3333333333333333
SF-O30,SF-F29,23,34,11,24,12,10,0.4782608695652174,0.5217391304347826,0.7058823529411765,0.29411764705882354
SF-O30,SF-E29-3,10,3,5,1,5,2,0.5,0.5,0.3333333333333333,0.6666666666666666
SF-O30,SF-F28-1,12,16,4,5,8,11,0.3333333333333333,0.6666666666666666,0.3125,0.6875
SF-O30,SF-E28-2,2,22,0,2,2,20,0.0,1.0,0.09090909090909091,0.9090909090909091
SF-O30,SF-E28,11,6,4,2,7,4,0.36363636363636365,0.6363636363636364,0.3333333333333333,0.6666666666666666
SF-O30,SF-J10,1,3,1,1,0,2,1.0,0.0,0.3333333333333333,0.6666666666666666
SF-O30,SF-I16,1,1,0,0,1,1,0.0,1.0,0.0,1.0
SF-O30,SF-H15,1,1,0,0,1,1,0.0,1.0,0.0,1.0
SF-O30,SF-G13,1,2,0,0,1,2,0.0,1.0,0.0,1.0
SF-O30,SF-F16,8,6,1,2,7,4,0.125,0.875,0.3333333333333333,0.6666666666666666
SF-O30,SF-C21,2,1,1,0,1,1,0.5,0.5,0.0,1.0
SF-O30,SF-C20,3,3,0,0,3,3,0.0,1.0,0.0,1.0
SF-O30,SF-B19,4,4,2,0,2,4,0.5,0.5,0.0,1.0
SF-O30,SF-A20,8,6,0,2,8,4,0.0,1.0,0.3333333333333333,0.6666666666666666
SF-O30,SF-A19,3,7,0,3,3,4,0.0,1.0,0.42857142857142855,0.5714285714285714
SF-O30,SF-C26,11,10,5,7,6,3,0.45454545454545453,0.5454545454545454,0.7,0.3
SF-O30,SF-C25,13,21,0,4,13,17,0.0,1.0,0.19047619047619047,0.8095238095238095
SF-O30,SF-B25,18,17,5,9,13,8,0.2777777777777778,0.7222222222222222,0.5294117647058824,0.47058823529411764
SF-O30,SF-E27,1,5,1,2,0,3,1.0,0.0,0.4,0.6
SF-O30,SF-B28-2,3,4,0,1,3,3,0.0,1.0,0.25,0.75
SF-O30,SF-D27,19,21,12,16,7,5,0.631578947368421,0.3684210526315789,0.7619047619047619,0.23809523809523808
SF-O30,SF-C28-2,4,4,2,2,2,2,0.5,0.5,0.5,0.5
SF-O30,SF-C28-1,6,9,0,9,6,0,0.0,1.0,1.0,0.0
SF-O30,SF-B28,21,52,16,46,5,6,0.7619047619047619,0.23809523809523808,0.8846153846153846,0.11538461538461539
SF-O30,SF-J1,1,5,0,1,1,4,0.0,1.0,0.2,0.8
SF-O30,SF-J3,1,1,0,0,1,1,0.0,1.0,0.0,1.0
SF-O30,SF-H25,2,5,1,1,1,4,0.5,0.5,0.2,0.8
SF-O30,SF-G26,9,27,2,6,7,21,0.2222222222222222,0.7777777777777778,0.2222222222222222,0.7777777777777778
SF-O30,SF-K21,11,10,7,1,4,9,0.6363636363636364,0.36363636363636365,0.1,0.9
SF-O30,SF-K22-1,9,11,2,5,7,6,0.2222222222222222,0.7777777777777778,0.45454545454545453,0.5454545454545454
SF-O30,SF-J23-1,18,23,7,5,11,18,0.3888888888888889,0.6111111111111112,0.21739130434782608,0.782608695652174
SF-O30,SF-J22-1,7,11,1,3,6,8,0.14285714285714285,0.8571428571428571,0.2727272727272727,0.7272727272727273
SF-O30,SF-J22-2,9,23,4,3,5,20,0.4444444444444444,0.5555555555555556,0.13043478260869565,0.8695652173913043
SF-O30,SF-J21,15,14,5,3,10,11,0.3333333333333333,0.6666666666666666,0.21428571428571427,0.7857142857142857
SF-O30,SF-I21,2,3,1,1,1,2,0.5,0.5,0.3333333333333333,0.6666666666666666
SF-O30,SF-I22,2,2,1,0,1,2,0.5,0.5,0.0,1.0
SF-O30,SF-I23-2,13,10,4,2,9,8,0.3076923076923077,0.6923076923076923,0.2,0.8
SF-O30,SF-I24,7,2,4,0,3,2,0.5714285714285714,0.42857142857142855,0.0,1.0
SF-O30,SF-I23-1,1,3,0,1,1,2,0.0,1.0,0.3333333333333333,0.6666666666666666
SF-O30,SF-F26,25,28,3,6,22,22,0.12,0.88,0.21428571428571427,0.7857142857142857
SF-O30,SF-M13,28,16,3,0,25,16,0.10714285714285714,0.8928571428571429,0.0,1.0
SF-O30,SF-M15,19,16,3,2,16,14,0.15789473684210525,0.8421052631578947,0.125,0.875
SF-O30,SF-L19,7,6,1,0,6,6,0.14285714285714285,0.8571428571428571,0.0,1.0
SF-O30,SF-L20,4,6,1,2,3,4,0.25,0.75,0.3333333333333333,0.6666666666666666
SF-O30,SF-N20-1,4,7,1,1,3,6,0.25,0.75,0.14285714285714285,0.8571428571428571
SF-O30,SF-M20,16,22,3,5,13,17,0.1875,0.8125,0.22727272727272727,0.7727272727272727
SF-O30,SF-K20,1,12,0,0,1,12,0.0,1.0,0.0,1.0
SF-O30,SF-K15-,43,26,33,0,10,26,0.7674418604651163,0.23255813953488372,0.0,1.0
SF-O30,SF-K19,6,3,3,0,3,3,0.5,0.5,0.0,1.0
SF-O30,SF-K18,8,7,4,1,4,6,0.5,0.5,0.14285714285714285,0.8571428571428571
SF-O30,SF-K17,7,5,3,2,4,3,0.42857142857142855,0.5714285714285714,0.4,0.6
SF-O30,SF-J16,5,2,1,1,4,1,0.2,0.8,0.5,0.5
SF-O30,SF-J18,41,23,23,3,18,20,0.5609756097560976,0.43902439024390244,0.13043478260869565,0.8695652173913043
SF-O30,SF-J20,3,2,2,0,1,2,0.6666666666666666,0.3333333333333333,0.0,1.0
SF-O30,SF-J19,3,2,0,0,3,2,0.0,1.0,0.0,1.0
SF-O30,SF-M12,4,2,2,0,2,2,0.5,0.5,0.0,1.0
SF-O30,SF-M10,9,3,5,0,4,3,0.5555555555555556,0.4444444444444444,0.0,1.0
SF-O30,SF-M11,3,3,0,1,3,2,0.0,1.0,0.3333333333333333,0.6666666666666666
SF-O30,SF-R19,2,5,0,2,2,3,0.0,1.0,0.4,0.6
SF-O30,SF-R20,1,2,0,2,1,0,0.0,1.0,1.0,0.0
SF-O30,SF-Q21-2,2,3,0,2,2,1,0.0,1.0,0.6666666666666666,0.3333333333333333
SF-O30,SF-Q21-1,16,22,3,2,13,20,0.1875,0.8125,0.09090909090909091,0.9090909090909091
SF-O30,SF-P21,17,4,8,0,9,4,0.47058823529411764,0.5294117647058824,0.0,1.0
SF-O30,SF-O18,20,21,5,1,15,20,0.25,0.75,0.047619047619047616,0.9523809523809523
SF-O30,SF-O19,12,20,0,0,12,20,0.0,1.0,0.0,1.0
SF-O30,SF-O21,25,30,13,9,12,21,0.52,0.48,0.3,0.7
SF-O30,SF-O22,21,17,2,5,19,12,0.09523809523809523,0.9047619047619048,0.29411764705882354,0.7058823529411765
SF-O30,SF-N21,6,22,3,4,3,18,0.5,0.5,0.18181818181818182,0.8181818181818182
SF-O30,SF-N20-2,1,10,0,4,1,6,0.0,1.0,0.4,0.6
SF-O30,SF-M21,10,8,8,5,2,3,0.8,0.2,0.625,0.375
SF-O30,SF-L21,7,10,1,2,6,8,0.14285714285714285,0.8571428571428571,0.2,0.8
SF-O30,SF-S29,14,21,11,14,3,7,0.7857142857142857,0.21428571428571427,0.6666666666666666,0.3333333333333333
SF-O30,SF-S30,30,33,22,21,8,12,0.7333333333333333,0.26666666666666666,0.6363636363636364,0.36363636363636365
SF-O30,SF-Q30,60,75,41,49,19,26,0.6833333333333333,0.31666666666666665,0.6533333333333333,0.3466666666666667
SF-O30,SF-P30,110,166,68,109,42,57,0.6181818181818182,0.38181818181818183,0.6566265060240963,0.3433734939759036
SF-O30,SF-O30-2,37,32,27,29,10,3,0.7297297297297297,0.2702702702702703,0.90625,0.09375
SF-O30,SF-N27,116,98,46,45,70,53,0.39655172413793105,0.603448275862069,0.45918367346938777,0.5408163265306123
SF-O30,SF-N29,22,39,11,22,11,17,0.5,0.5,0.5641025641025641,0.4358974358974359
SF-O30,SF-N28,35,42,15,22,20,20,0.42857142857142855,0.5714285714285714,0.5238095238095238,0.47619047619047616
SF-O30,SF-L30-1,392,432,245,316,147,116,0.625,0.375,0.7314814814814815,0.26851851851851855
SF-O30,SF-L31-1,46,60,21,42,25,18,0.45652173913043476,0.5434782608695652,0.7,0.3
SF-O30,SF-K30-2,60,64,40,47,20,17,0.6666666666666666,0.3333333333333333,0.734375,0.265625
SF-O30,SF-L29,92,74,50,45,42,29,0.5434782608695652,0.45652173913043476,0.6081081081081081,0.3918918918918919
SF-O30,SF-J29-1,42,84,28,69,14,15,0.6666666666666666,0.3333333333333333,0.8214285714285714,0.17857142857142858
SF-O30,SF-I30,20,15,15,12,5,3,0.75,0.25,0.8,0.2
SF-O30,SF-I29-2,9,2,2,0,7,2,0.2222222222222222,0.7777777777777778,0.0,1.0
SF-O30,SF-I27,24,13,18,7,6,6,0.75,0.25,0.5384615384615384,0.46153846153846156
SF-O30,SF-I28,16,11,7,6,9,5,0.4375,0.5625,0.5454545454545454,0.45454545454545453
SF-O30,SF-I30-2,15,12,5,2,10,10,0.3333333333333333,0.6666666666666666,0.16666666666666666,0.8333333333333334
SF-O30,SF I29-1,6,9,4,5,2,4,0.6666666666666666,0.3333333333333333,0.5555555555555556,0.4444444444444444
SF-O30,SF-H28,20,15,15,11,5,4,0.75,0.25,0.7333333333333333,0.26666666666666666
SF-O30,SF-H29,2,2,1,1,1,1,0.5,0.5,0.5,0.5
SF-O30,SF-S24,15,6,2,2,13,4,0.13333333333333333,0.8666666666666667,0.3333333333333333,0.6666666666666666
SF-O30,SF-R24,23,13,14,8,9,5,0.6086956521739131,0.391304347826087,0.6153846153846154,0.38461538461538464
SF-O30,SF-R26,6,8,0,5,6,3,0.0,1.0,0.625,0.375
SF-O30,SF-Q26,29,33,6,7,23,26,0.20689655172413793,0.7931034482758621,0.21212121212121213,0.7878787878787878
SF-O30,SF-P26,91,98,12,12,79,86,0.13186813186813187,0.8681318681318682,0.12244897959183673,0.8775510204081632
SF-O30,SF-O25-2,9,16,3,3,6,13,0.3333333333333333,0.6666666666666666,0.1875,0.8125
SF-O30,SF-N22-1B,23,16,7,6,16,10,0.30434782608695654,0.6956521739130435,0.375,0.625
SF-O30,SF-N26,16,9,8,4,8,5,0.5,0.5,0.4444444444444444,0.5555555555555556
SF-O30,SF-N25,20,25,9,10,11,15,0.45,0.55,0.4,0.6
SF-O30,SF-T22,6,7,0,0,6,7,0.0,1.0,0.0,1.0
SF-O30,SF-S22-2,5,2,2,0,3,2,0.4,0.6,0.0,1.0
SF-O30,SF-S22-1,2,2,0,0,2,2,0.0,1.0,0.0,1.0
SF-O30,SF-Q23-3,5,7,1,3,4,4,0.2,0.8,0.42857142857142855,0.5714285714285714
SF-O30,SF-Q22-1,7,9,1,2,6,7,0.14285714285714285,0.8571428571428571,0.2222222222222222,0.7777777777777778
SF-O30,SF-Q22-2,12,10,1,2,11,8,0.08333333333333333,0.9166666666666666,0.2,0.8
SF-O30,SF-P22,7,16,1,6,6,10,0.14285714285714285,0.8571428571428571,0.375,0.625
SF-O30,SF-T20,5,6,1,1,4,5,0.2,0.8,0.16666666666666666,0.8333333333333334
SF-O30,SF-S21,5,3,0,0,5,3,0.0,1.0,0.0,1.0
SF-O30,SF-Z28,2,4,1,0,1,4,0.5,0.5,0.0,1.0
SF-O30,SF-Y27,1,1,1,0,0,1,1.0,0.0,0.0,1.0
SF-O30,SF-W29,1,3,1,0,0,3,1.0,0.0,0.0,1.0
SF-O30,SF-V29,1,10,0,6,1,4,0.0,1.0,0.6,0.4
SF-O30,SF-V30,1,3,1,0,0,3,1.0,0.0,0.0,1.0
SF-O30,SF-V31,2,2,0,0,2,2,0.0,1.0,0.0,1.0
SF-O30,SF-V32,16,12,10,8,6,4,0.625,0.375,0.6666666666666666,0.3333333333333333
SF-O30,SF-U30,8,4,4,2,4,2,0.5,0.5,0.5,0.5
SF-O30,SF-Y25,3,39,0,0,3,39,0.0,1.0,0.0,1.0
SF-N27,SF-M26,4,5,1,5,3,0,0.25,0.75,1.0,0.0
SF-N27,SF-M25,14,5,4,1,10,4,0.2857142857142857,0.7142857142857143,0.2,0.8
SF-N27,SF-M26-2,121,218,60,67,61,151,0.49586776859504134,0.5041322314049587,0.3073394495412844,0.6926605504587156
SF-N27,SF-L27,23,25,19,20,4,5,0.8260869565217391,0.17391304347826086,0.8,0.2
SF-N27,SF-K26,47,44,28,28,19,16,0.5957446808510638,0.40425531914893614,0.6363636363636364,0.36363636363636365
SF-N27,SF-J27,3,3,3,0,0,3,1.0,0.0,0.0,1.0
SF-N27,SF-M30,75,49,52,33,23,16,0.6933333333333334,0.30666666666666664,0.673469387755102,0.32653061224489793
SF-N27,SF-J29-3,12,8,6,4,6,4,0.5,0.5,0.5,0.5
SF-N27,SF-J29,31,20,11,11,20,9,0.3548387096774194,0.6451612903225806,0.55,0.45
SF-N27,SF-L26,47,27,23,22,24,5,0.48936170212765956,0.5106382978723404,0.8148148148148148,0.18518518518518517
SF-N27,SF-M28,115,116,62,50,53,66,0.5391304347826087,0.4608695652173913,0.43103448275862066,0.5689655172413793
SF-N27,SF-M27,6,5,6,4,0,1,1.0,0.0,0.8,0.2
SF-N27,SF-L25,9,9,4,8,5,1,0.4444444444444444,0.5555555555555556,0.8888888888888888,0.1111111111111111
SF-N27,SF-M24,12,13,8,10,4,3,0.6666666666666666,0.3333333333333333,0.7692307692307693,0.23076923076923078
SF-N27,SF-L24,7,12,2,8,5,4,0.2857142857142857,0.7142857142857143,0.6666666666666666,0.3333333333333333
SF-N27,SF-N23,22,17,8,12,14,5,0.36363636363636365,0.6363636363636364,0.7058823529411765,0.29411764705882354
SF-N27,SF-N24-2,13,13,8,8,5,5,0.6153846153846154,0.38461538461538464,0.6153846153846154,0.38461538461538464
SF-N27,SF-K27-2,23,24,15,14,8,10,0.6521739130434783,0.34782608695652173,0.5833333333333334,0.4166666666666667
SF-N27,SF-J26-2,4,19,1,7,3,12,0.25,0.75,0.3684210526315789,0.631578947368421
SF-N27,SF-K28-3,4,1,3,1,1,0,0.75,0.25,1.0,0.0
SF-N27,SF-L28,44,55,29,37,15,18,0.6590909090909091,0.3409090909090909,0.6727272727272727,0.32727272727272727
SF-N27,SF-K28,7,3,6,2,1,1,0.8571428571428571,0.14285714285714285,0.6666666666666666,0.3333333333333333
SF-N27,SF-K29-1,61,55,33,31,28,24,0.5409836065573771,0.45901639344262296,0.5636363636363636,0.43636363636363634
SF-N27,SF-J28-2,14,17,3,6,11,11,0.21428571428571427,0.7857142857142857,0.35294117647058826,0.6470588235294118
SF-N27,SF-K27,5,5,0,5,5,0,0.0,1.0,1.0,0.0
SF-N27,SF-K25,14,11,9,6,5,5,0.6428571428571429,0.35714285714285715,0.5454545454545454,0.45454545454545453
SF-N27,SF-J25,46,20,31,7,15,13,0.6739130434782609,0.32608695652173914,0.35,0.65
SF-N27,SF-H26-2,24,14,9,6,15,8,0.375,0.625,0.42857142857142855,0.5714285714285714
SF-N27,SF-P24,38,33,7,5,31,28,0.18421052631578946,0.8157894736842105,0.15151515151515152,0.8484848484848485
SF-N27,SF-N22-1A,4,8,0,1,4,7,0.0,1.0,0.125,0.875
SF-N27,SF-J24,34,47,15,6,19,41,0.4411764705882353,0.5588235294117647,0.1276595744680851,0.8723404255319149
SF-N27,SF-O24,10,7,3,4,7,3,0.3,0.7,0.5714285714285714,0.42857142857142855
SF-N27,SF-J26,20,12,12,9,8,3,0.6,0.4,0.75,0.25
SF-N27,SF-I26-,5,6,3,4,2,2,0.6,0.4,0.6666666666666666,0.3333333333333333
SF-N27,SF-I25,8,20,5,10,3,10,0.625,0.375,0.5,0.5
SF-N27,SF-H26,50,38,34,23,16,15,0.68,0.32,0.6052631578947368,0.39473684210526316
SF-N27,SF-O23,19,18,10,5,9,13,0.5263157894736842,0.47368421052631576,0.2777777777777778,0.7222222222222222
SF-N27,SF-H27-1,8,9,5,8,3,1,0.625,0.375,0.8888888888888888,0.1111111111111111
SF-N27,SF-F28-2,18,18,3,9,15,9,0.16666666666666666,0.8333333333333334,0.5,0.5
SF-N27,SF-G27,31,41,11,5,20,36,0.3548387096774194,0.6451612903225806,0.12195121951219512,0.8780487804878049
SF-N27,SF-M22-2,18,21,6,5,12,16,0.3333333333333333,0.6666666666666666,0.23809523809523808,0.7619047619047619
SF-N27,SF-L22,10,8,4,3,6,5,0.4,0.6,0.375,0.625
SF-N27,SF-F27,48,46,32,36,16,10,0.6666666666666666,0.3333333333333333,0.782608695652174,0.21739130434782608
SF-N27,SF-N22-2,37,51,12,15,25,36,0.32432432432432434,0.6756756756756757,0.29411764705882354,0.7058823529411765
SF-N27,SF-G28-2,2,2,1,0,1,2,0.5,0.5,0.0,1.0
SF-N27,SF-G28-1,2,2,2,2,0,0,1.0,0.0,1.0,0.0
SF-N27,SF-M22-1,8,6,4,2,4,4,0.5,0.5,0.3333333333333333,0.6666666666666666
SF-N27,SF-O25-1,10,8,4,2,6,6,0.4,0.6,0.25,0.75
SF-N27,SF-K22-2,4,8,1,4,3,4,0.25,0.75,0.5,0.5
SF-N27,SF-K24,14,11,8,7,6,4,0.5714285714285714,0.42857142857142855,0.6363636363636364,0.36363636363636365
SF-N27,SF-J23-2,13,12,5,3,8,9,0.38461538461538464,0.6153846153846154,0.25,0.75
SF-N27,SF-G23,6,16,5,2,1,14,0.8333333333333334,0.16666666666666666,0.125,0.875
SF-N27,SF-G24,14,11,5,2,9,9,0.35714285714285715,0.6428571428571429,0.18181818181818182,0.8181818181818182
SF-N27,SF-G25,57,5,15,3,42,2,0.2631578947368421,0.7368421052631579,0.6,0.4
SF-N27,SF-F23,23,26,12,15,11,11,0.5217391304347826,0.4782608695652174,0.5769230769230769,0.4230769230769231
SF-N27,SF-E23,4,13,3,1,1,12,0.75,0.25,0.07692307692307693,0.9230769230769231
SF-N27,SF-C22,3,1,1,0,2,1,0.3333333333333333,0.6666666666666666,0.0,1.0
SF-N27,SF-B22,2,1,0,0,2,1,0.0,1.0,0.0,1.0
SF-N27,SF-H16,1,2,0,0,1,2,0.0,1.0,0.0,1.0
SF-N27,SF-H20,5,3,3,2,2,1,0.6,0.4,0.6666666666666666,0.3333333333333333
SF-N27,SF-G19,4,1,3,0,1,1,0.75,0.25,0.0,1.0
SF-N27,SF-G18,2,4,0,3,2,1,0.0,1.0,0.75,0.25
SF-N27,SF-G20,3,2,1,0,2,2,0.3333333333333333,0.6666666666666666,0.0,1.0
SF-N27,SF-F19,2,2,0,2,2,0,0.0,1.0,1.0,0.0
SF-N27,SF-E18,5,10,0,0,5,10,0.0,1.0,0.0,1.0
SF-N27,SF-E20,2,1,0,0,2,1,0.0,1.0,0.0,1.0
SF-N27,SF-H30,30,24,10,7,20,17,0.3333333333333333,0.6666666666666666,0.2916666666666667,0.7083333333333334
SF-N27,SF-G30-2,23,8,5,3,18,5,0.21739130434782608,0.782608695652174,0.375,0.625
SF-N27,SF-F30-1,29,27,6,8,23,19,0.20689655172413793,0.7931034482758621,0.2962962962962963,0.7037037037037037
SF-N27,SF-E29-2,20,10,6,2,14,8,0.3,0.7,0.2,0.8
SF-N27,SF-E29-1,27,26,7,14,20,12,0.25925925925925924,0.7407407407407407,0.5384615384615384,0.46153846153846156
SF-N27,SF-D29,32,113,10,48,22,65,0.3125,0.6875,0.4247787610619469,0.5752212389380531
SF-N27,SF-D28,2,3,2,2,0,1,1.0,0.0,0.6666666666666666,0.3333333333333333
SF-N27,SF-A27,2,8,1,7,1,1,0.5,0.5,0.875,0.125
SF-N27,SF-G29-2,21,13,4,6,17,7,0.19047619047619047,0.8095238095238095,0.46153846153846156,0.5384615384615384
SF-N27,SF-G29-1,18,9,8,6,10,3,0.4444444444444444,0.5555555555555556,0.6666666666666666,0.3333333333333333
SF-N27,SF-G30-1,15,16,4,2,11,14,0.26666666666666666,0.7333333333333333,0.125,0.875
SF-N27,SF-G29-3,22,2,3,1,19,1,0.13636363636363635,0.8636363636363636,0.5,0.5
SF-N27,SF-F30-2,8,5,0,3,8,2,0.0,1.0,0.6,0.4
SF-N27,SF-F29,17,2,2,2,15,0,0.11764705882352941,0.8823529411764706,1.0,0.0
SF-N27,SF-E29-3,6,6,1,1,5,5,0.16666666666666666,0.8333333333333334,0.16666666666666666,0.8333333333333334
SF-N27,SF-F28-1,7,3,5,1,2,2,0.7142857142857143,0.2857142857142857,0.3333333333333333,0.6666666666666666
SF-N27,SF-E28-2,5,2,0,0,5,2,0.0,1.0,0.0,1.0
SF-N27,SF-E28,4,2,2,0,2,2,0.5,0.5,0.0,1.0
SF-N27,SF-J12,8,8,3,2,5,6,0.375,0.625,0.25,0.75
SF-N27,SF-G9,4,1,4,0,0,1,1.0,0.0,0.0,1.0
SF-N27,SF-C21,2,3,0,0,2,3,0.0,1.0,0.0,1.0
SF-N27,SF-C20,6,2,3,0,3,2,0.5,0.5,0.0,1.0
SF-N27,SF-B19,2,4,1,1,1,3,0.5,0.5,0.25,0.75
SF-N27,SF-A20,6,5,0,0,6,5,0.0,1.0,0.0,1.0
SF-N27,SF-A19,2,4,0,2,2,2,0.0,1.0,0.5,0.5
SF-N27,SF-C26,39,32,0,4,39,28,0.0,1.0,0.125,0.875
SF-N27,SF-C25,7,3,0,1,7,2,0.0,1.0,0.3333333333333333,0.6666666666666666
SF-N27,SF-B25,6,2,0,1,6,1,0.0,1.0,0.5,0.5
SF-N27,SF-D27,4,5,4,0,0,5,1.0,0.0,0.0,1.0
SF-N27,SF-C28-2,1,5,0,2,1,3,0.0,1.0,0.4,0.6
SF-N27,SF-B28,8,12,1,8,7,4,0.125,0.875,0.6666666666666666,0.3333333333333333
SF-N27,SF-G5,1,3,0,0,1,3,0.0,1.0,0.0,1.0
SF-N27,SF-H25,4,4,2,0,2,4,0.5,0.5,0.0,1.0
SF-N27,SF-G26,6,35,4,8,2,27,0.6666666666666666,0.3333333333333333,0.22857142857142856,0.7714285714285715
SF-N27,SF-K21,9,5,2,1,7,4,0.2222222222222222,0.7777777777777778,0.2,0.8
SF-N27,SF-K22-1,7,8,6,7,1,1,0.8571428571428571,0.14285714285714285,0.875,0.125
SF-N27,SF-J23-1,29,19,17,4,12,15,0.5862068965517241,0.41379310344827586,0.21052631578947367,0.7894736842105263
SF-N27,SF-J22-1,3,6,0,1,3,5,0.0,1.0,0.16666666666666666,0.8333333333333334
SF-N27,SF-J22-2,3,4,0,2,3,2,0.0,1.0,0.5,0.5
SF-N27,SF-J21,11,6,4,3,7,3,0.36363636363636365,0.6363636363636364,0.5,0.5
SF-N27,SF-I22,1,7,0,1,1,6,0.0,1.0,0.14285714285714285,0.8571428571428571
SF-N27,SF-I23-2,23,4,19,1,4,3,0.8260869565217391,0.17391304347826086,0.25,0.75
SF-N27,SF-I24,7,6,6,0,1,6,0.8571428571428571,0.14285714285714285,0.0,1.0
SF-N27,SF-I23-1,12,8,11,2,1,6,0.9166666666666666,0.08333333333333333,0.25,0.75
SF-N27,SF-F26,24,20,2,1,22,19,0.08333333333333333,0.9166666666666666,0.05,0.95
SF-N27,SF-M13,11,1,3,0,8,1,0.2727272727272727,0.7272727272727273,0.0,1.0
SF-N27,SF-M15,1,2,0,1,1,1,0.0,1.0,0.5,0.5
SF-N27,SF-L19,10,1,2,0,8,1,0.2,0.8,0.0,1.0
SF-N27,SF-L20,7,2,2,0,5,2,0.2857142857142857,0.7142857142857143,0.0,1.0
SF-N27,SF-N20-1,7,9,1,4,6,5,0.14285714285714285,0.8571428571428571,0.4444444444444444,0.5555555555555556
SF-N27,SF-M20,14,12,11,4,3,8,0.7857142857142857,0.21428571428571427,0.3333333333333333,0.6666666666666666
SF-N27,SF-K17-2,4,1,1,0,3,1,0.25,0.75,0.0,1.0
SF-N27,SF-K20,7,3,4,0,3,3,0.5714285714285714,0.42857142857142855,0.0,1.0
SF-N27,SF-K15-,12,15,5,2,7,13,0.4166666666666667,0.5833333333333334,0.13333333333333333,0.8666666666666667
SF-N27,SF-K19,14,12,3,6,11,6,0.21428571428571427,0.7857142857142857,0.5,0.5
SF-N27,SF-K18,6,4,2,2,4,2,0.3333333333333333,0.6666666666666666,0.5,0.5
SF-N27,SF-K17,17,11,4,0,13,11,0.23529411764705882,0.7647058823529411,0.0,1.0
SF-N27,SF-J18,8,5,2,0,6,5,0.25,0.75,0.0,1.0
SF-N27,SF-J20,3,2,0,0,3,2,0.0,1.0,0.0,1.0
SF-N27,SF-J19,2,4,0,0,2,4,0.0,1.0,0.0,1.0
SF-N27,SF-M12,1,1,0,0,1,1,0.0,1.0,0.0,1.0
SF-N27,SF-M10,3,1,1,0,2,1,0.3333333333333333,0.6666666666666666,0.0,1.0
SF-N27,SF-M11,3,5,0,0,3,5,0.0,1.0,0.0,1.0
SF-N27,SF-R19,8,4,0,0,8,4,0.0,1.0,0.0,1.0
SF-N27,SF-R20,2,1,0,0,2,1,0.0,1.0,0.0,1.0
SF-N27,SF-Q21-2,8,4,1,0,7,4,0.125,0.875,0.0,1.0
SF-N27,SF-Q21-1,47,8,42,3,5,5,0.8936170212765957,0.10638297872340426,0.375,0.625
SF-N27,SF-P21,11,9,6,1,5,8,0.5454545454545454,0.45454545454545453,0.1111111111111111,0.8888888888888888
SF-N27,SF-O18,7,7,1,1,6,6,0.14285714285714285,0.8571428571428571,0.14285714285714285,0.8571428571428571
SF-N27,SF-O19,12,10,3,3,9,7,0.25,0.75,0.3,0.7
SF-N27,SF-O21,24,26,5,10,19,16,0.20833333333333334,0.7916666666666666,0.38461538461538464,0.6153846153846154
SF-N27,SF-O22,11,17,3,8,8,9,0.2727272727272727,0.7272727272727273,0.47058823529411764,0.5294117647058824
SF-N27,SF-N21,4,26,3,8,1,18,0.75,0.25,0.3076923076923077,0.6923076923076923
SF-N27,SF-N20-2,5,15,2,4,3,11,0.4,0.6,0.26666666666666666,0.7333333333333333
SF-N27,SF-M21,13,8,3,1,10,7,0.23076923076923078,0.7692307692307693,0.125,0.875
SF-N27,SF-L21,18,16,6,4,12,12,0.3333333333333333,0.6666666666666666,0.25,0.75
SF-N27,SF-S29,4,10,2,1,2,9,0.5,0.5,0.1,0.9
SF-N27,SF-Q30,52,82,9,16,43,66,0.17307692307692307,0.8269230769230769,0.1951219512195122,0.8048780487804879
SF-N27,SF-P30,25,53,8,15,17,38,0.32,0.68,0.2830188679245283,0.7169811320754716
SF-N27,SF-O30-2,21,27,8,9,13,18,0.38095238095238093,0.6190476190476191,0.3333333333333333,0.6666666666666666
SF-N27,SF-O30,98,116,45,46,53,70,0.45918367346938777,0.5408163265306123,0.39655172413793105,0.603448275862069
SF-N27,SF-N29,62,97,53,86,9,11,0.8548387096774194,0.14516129032258066,0.8865979381443299,0.1134020618556701
SF-N27,SF-N28,60,43,47,33,13,10,0.7833333333333333,0.21666666666666667,0.7674418604651163,0.23255813953488372
SF-N27,SF-L30-1,64,51,38,22,26,29,0.59375,0.40625,0.43137254901960786,0.5686274509803921
SF-N27,SF-L31-1,14,14,6,9,8,5,0.42857142857142855,0.5714285714285714,0.6428571428571429,0.35714285714285715
SF-N27,SF-K30-2,21,11,11,4,10,7,0.5238095238095238,0.47619047619047616,0.36363636363636365,0.6363636363636364
SF-N27,SF-L29,25,33,17,26,8,7,0.68,0.32,0.7878787878787878,0.21212121212121213
SF-N27,SF-J29-1,11,10,6,5,5,5,0.5454545454545454,0.45454545454545453,0.5,0.5
SF-N27,SF-I30,15,19,11,12,4,7,0.7333333333333333,0.26666666666666666,0.631578947368421,0.3684210526315789
SF-N27,SF-I29-2,4,6,2,3,2,3,0.5,0.5,0.5,0.5
SF-N27,SF-I27,7,7,5,4,2,3,0.7142857142857143,0.2857142857142857,0.5714285714285714,0.42857142857142855
SF-N27,SF-I28,12,11,7,7,5,4,0.5833333333333334,0.4166666666666667,0.6363636363636364,0.36363636363636365
SF-N27,SF-I30-2,7,5,2,5,5,0,0.2857142857142857,0.7142857142857143,1.0,0.0
SF-N27,SF I29-1,11,9,2,0,9,9,0.18181818181818182,0.8181818181818182,0.0,1.0
SF-N27,SF-H28,6,6,6,4,0,2,1.0,0.0,0.6666666666666666,0.3333333333333333
SF-N27,SF-H29,7,2,3,0,4,2,0.42857142857142855,0.5714285714285714,0.0,1.0
SF-N27,SF-S24,11,12,2,7,9,5,0.18181818181818182,0.8181818181818182,0.5833333333333334,0.4166666666666667
SF-N27,SF-R24,22,38,10,15,12,23,0.45454545454545453,0.5454545454545454,0.39473684210526316,0.6052631578947368
SF-N27,SF-R26,7,4,5,2,2,2,0.7142857142857143,0.2857142857142857,0.5,0.5
SF-N27,SF-Q26,11,14,4,2,7,12,0.36363636363636365,0.6363636363636364,0.14285714285714285,0.8571428571428571
SF-N27,SF-P26,40,13,23,3,17,10,0.575,0.425,0.23076923076923078,0.7692307692307693
SF-N27,SF-O25-2,10,11,5,2,5,9,0.5,0.5,0.18181818181818182,0.8181818181818182
SF-N27,SF-N22-1B,13,13,6,5,7,8,0.46153846153846156,0.5384615384615384,0.38461538461538464,0.6153846153846154
SF-N27,SF-N26,46,47,12,9,34,38,0.2608695652173913,0.7391304347826086,0.19148936170212766,0.8085106382978723
SF-N27,SF-N25,19,25,12,18,7,7,0.631578947368421,0.3684210526315789,0.72,0.28
SF-N27,SF-T22,3,3,1,1,2,2,0.3333333333333333,0.6666666666666666,0.3333333333333333,0.6666666666666666
SF-N27,SF-S22-2,2,2,0,0,2,2,0.0,1.0,0.0,1.0
SF-N27,SF-S22-1,2,2,1,1,1,1,0.5,0.5,0.5,0.5
SF-N27,SF-Q23-3,4,4,1,2,3,2,0.25,0.75,0.5,0.5
SF-N27,SF-Q22-1,6,14,3,4,3,10,0.5,0.5,0.2857142857142857,0.7142857142857143
SF-N27,SF-Q22-2,10,8,4,4,6,4,0.4,0.6,0.5,0.5
SF-N27,SF-P22,16,22,11,6,5,16,0.6875,0.3125,0.2727272727272727,0.7272727272727273
SF-N27,SF-W19,9,5,0,0,9,5,0.0,1.0,0.0,1.0
SF-N27,SF-W19-2,1,2,0,0,1,2,0.0,1.0,0.0,1.0
SF-N27,SF-V30,5,4,1,1,4,3,0.2,0.8,0.25,0.75
SF-N27,SF-V31,1,4,0,1,1,3,0.0,1.0,0.25,0.75
SF-N27,SF-V32,2,4,2,4,0,0,1.0,0.0,1.0,0.0
SF-N27,SF-U30,17,15,0,0,17,15,0.0,1.0,0.0,1.0
SF-N27,SF-W14,1,8,0,1,1,7,0.0,1.0,0.125,0.875
SF-N27,SF-AA15,2,3,0,0,2,3,0.0,1.0,0.0,1.0
SF-N27,SF-Y25,2,1,0,0,2,1,0.0,1.0,0.0,1.0
SF-N29,SF-M26,3,4,1,2,2,2,0.3333333333333333,0.6666666666666666,0.5,0.5
SF-N29,SF-M25,1,4,0,2,1,2,0.0,1.0,0.5,0.5
SF-N29,SF-M26-2,10,24,4,13,6,11,0.4,0.6,0.5416666666666666,0.4583333333333333
SF-N29,SF-L27,4,2,3,0,1,2,0.75,0.25,0.0,1.0
SF-N29,SF-K26,8,7,6,3,2,4,0.75,0.25,0.42857142857142855,0.5714285714285714
SF-N29,SF-J27,10,6,7,5,3,1,0.7,0.3,0.8333333333333334,0.16666666666666666
SF-N29,SF-M30,37,40,30,38,7,2,0.8108108108108109,0.1891891891891892,0.95,0.05
SF-N29,SF-L27-2,6,17,6,14,0,3,1.0,0.0,0.8235294117647058,0.17647058823529413
SF-N29,SF-J29-3,6,2,2,1,4,1,0.3333333333333333,0.6666666666666666,0.5,0.5
SF-N29,SF-J29,18,13,6,8,12,5,0.3333333333333333,0.6666666666666666,0.6153846153846154,0.38461538461538464
SF-N29,SF-L26,6,3,3,1,3,2,0.5,0.5,0.3333333333333333,0.6666666666666666
SF-N29,SF-M28,5,17,4,8,1,9,0.8,0.2,0.47058823529411764,0.5294117647058824
SF-N29,SF-L25,3,4,3,4,0,0,1.0,0.0,1.0,0.0
SF-N29,SF-M24,3,8,2,5,1,3,0.6666666666666666,0.3333333333333333,0.625,0.375
SF-N29,SF-L24,4,8,4,7,0,1,1.0,0.0,0.875,0.125
SF-N29,SF-N23,10,17,3,8,7,9,0.3,0.7,0.47058823529411764,0.5294117647058824
SF-N29,SF-N24-2,10,7,5,0,5,7,0.5,0.5,0.0,1.0
SF-N29,SF-K27-2,14,10,11,8,3,2,0.7857142857142857,0.21428571428571427,0.8,0.2
SF-N29,SF-J26-2,3,8,1,3,2,5,0.3333333333333333,0.6666666666666666,0.375,0.625
SF-N29,SF-K28-3,3,1,3,1,0,0,1.0,0.0,1.0,0.0
SF-N29,SF-L28,13,5,12,4,1,1,0.9230769230769231,0.07692307692307693,0.8,0.2
SF-N29,SF-K28,10,47,8,37,2,10,0.8,0.2,0.7872340425531915,0.2127659574468085
SF-N29,SF-K29-1,52,55,7,5,45,50,0.1346153846153846,0.8653846153846154,0.09090909090909091,0.9090909090909091
SF-N29,SF-J28-2,6,6,5,5,1,1,0.8333333333333334,0.16666666666666666,0.8333333333333334,0.16666666666666666
SF-N29,SF-K27,2,8,2,7,0,1,1.0,0.0,0.875,0.125
SF-N29,SF-K25,5,4,4,2,1,2,0.8,0.2,0.5,0.5
SF-N29,SF-J25,33,37,29,35,4,2,0.8787878787878788,0.12121212121212122,0.9459459459459459,0.05405405405405406
SF-N29,SF-P24,10,6,3,5,7,1,0.3,0.7,0.8333333333333334,0.16666666666666666
SF-N29,SF-N22-1A,1,2,0,1,1,1,0.0,1.0,0.5,0.5
SF-N29,SF-J24,3,3,3,3,0,0,1.0,0.0,1.0,0.0
SF-N29,SF-J26,5,1,3,1,2,0,0.6,0.4,1.0,0.0
SF-N29,SF-I25,5,7,3,3,2,4,0.6,0.4,0.42857142857142855,0.5714285714285714
SF-N29,SF-H26,6,7,2,4,4,3,0.3333333333333333,0.6666666666666666,0.5714285714285714,0.42857142857142855
SF-N29,SF-O23,5,9,3,4,2,5,0.6,0.4,0.4444444444444444,0.5555555555555556
SF-N29,SF-H27-1,25,6,6,1,19,5,0.24,0.76,0.16666666666666666,0.8333333333333334
SF-N29,SF-F28-2,7,2,3,1,4,1,0.42857142857142855,0.5714285714285714,0.5,0.5
SF-N29,SF-G27,5,8,1,6,4,2,0.2,0.8,0.75,0.25
SF-N29,SF-M22-2,3,7,1,2,2,5,0.3333333333333333,0.6666666666666666,0.2857142857142857,0.7142857142857143
SF-N29,SF-L22,5,3,2,2,3,1,0.4,0.6,0.6666666666666666,0.3333333333333333
SF-N29,SF-F27,18,17,15,15,3,2,0.8333333333333334,0.16666666666666666,0.8823529411764706,0.11764705882352941
SF-N29,SF-N22-2,19,28,11,6,8,22,0.5789473684210527,0.42105263157894735,0.21428571428571427,0.7857142857142857
SF-N29,SF-M22-1,9,5,2,1,7,4,0.2222222222222222,0.7777777777777778,0.2,0.8
SF-N29,SF-O25-1,1,4,0,2,1,2,0.0,1.0,0.5,0.5
SF-N29,SF-K22-2,5,5,1,3,4,2,0.2,0.8,0.6,0.4
SF-N29,SF-K24,5,8,1,4,4,4,0.2,0.8,0.5,0.5
SF-N29,SF-G23,3,7,0,1,3,6,0.0,1.0,0.14285714285714285,0.8571428571428571
SF-N29,SF-G24,5,3,0,1,5,2,0.0,1.0,0.3333333333333333,0.6666666666666666
SF-N29,SF-G25,2,2,0,0,2,2,0.0,1.0,0.0,1.0
SF-N29,SF-F23,5,9,0,0,5,9,0.0,1.0,0.0,1.0
SF-N29,SF-E23,27,24,1,2,26,22,0.037037037037037035,0.9629629629629629,0.08333333333333333,0.9166666666666666
SF-N29,SF-D24,1,1,0,0,1,1,0.0,1.0,0.0,1.0
SF-N29,SF-B22,3,5,1,2,2,3,0.3333333333333333,0.6666666666666666,0.4,0.6
SF-N29,SF-J17,1,5,0,0,1,5,0.0,1.0,0.0,1.0
SF-N29,SF-H20,1,2,1,1,0,1,1.0,0.0,0.5,0.5
SF-N29,SF-G18,4,6,2,1,2,5,0.5,0.5,0.16666666666666666,0.8333333333333334
SF-N29,SF-G20,3,3,3,2,0,1,1.0,0.0,0.6666666666666666,0.3333333333333333
SF-N29,SF-H30,16,2,9,2,7,0,0.5625,0.4375,1.0,0.0
SF-N29,SF-G30-2,13,3,10,0,3,3,0.7692307692307693,0.23076923076923078,0.0,1.0
SF-N29,SF-F30-1,6,3,4,1,2,2,0.6666666666666666,0.3333333333333333,0.3333333333333333,0.6666666666666666
SF-N29,SF-E29-2,3,9,0,3,3,6,0.0,1.0,0.3333333333333333,0.6666666666666666
SF-N29,SF-E29-1,11,21,5,12,6,9,0.45454545454545453,0.5454545454545454,0.5714285714285714,0.42857142857142855
SF-N29,SF-D29,14,32,5,24,9,8,0.35714285714285715,0.6428571428571429,0.75,0.25
SF-N29,SF-D28,1,8,0,3,1,5,0.0,1.0,0.375,0.625
SF-N29,SF-A27,8,4,4,1,4,3,0.5,0.5,0.25,0.75
SF-N29,SF-G29-2,2,6,2,0,0,6,1.0,0.0,0.0,1.0
SF-N29,SF-G30-1,7,1,2,0,5,1,0.2857142857142857,0.7142857142857143,0.0,1.0
SF-N29,SF-G29-3,2,6,1,4,1,2,0.5,0.5,0.6666666666666666,0.3333333333333333
SF-N29,SF-F30-2,1,3,1,1,0,2,1.0,0.0,0.3333333333333333,0.6666666666666666
SF-N29,SF-F29,2,1,0,1,2,0,0.0,1.0,1.0,0.0
SF-N29,SF-E29-3,3,2,2,1,1,1,0.6666666666666666,0.3333333333333333,0.5,0.5
SF-N29,SF-F28-1,2,3,2,3,0,0,1.0,0.0,1.0,0.0
SF-N29,SF-E28-2,3,2,1,0,2,2,0.3333333333333333,0.6666666666666666,0.0,1.0
SF-N29,SF-J10,2,1,0,1,2,0,0.0,1.0,1.0,0.0
SF-N29,SF-G13,1,2,0,0,1,2,0.0,1.0,0.0,1.0
SF-N29,SF-B19,1,2,0,2,1,0,0.0,1.0,1.0,0.0
SF-N29,SF-A20,3,2,1,0,2,2,0.3333333333333333,0.6666666666666666,0.0,1.0
SF-N29,SF-C26,7,2,2,0,5,2,0.2857142857142857,0.7142857142857143,0.0,1.0
SF-N29,SF-C25,6,5,3,3,3,2,0.5,0.5,0.6,0.4
SF-N29,SF-B25,11,15,1,2,10,13,0.09090909090909091,0.9090909090909091,0.13333333333333333,0.8666666666666667
SF-N29,SF-E27,6,7,1,3,5,4,0.16666666666666666,0.8333333333333334,0.42857142857142855,0.5714285714285714
SF-N29,SF-B28-2,22,21,3,5,19,16,0.13636363636363635,0.8636363636363636,0.23809523809523808,0.7619047619047619
SF-N29,SF-D27,5,5,3,4,2,1,0.6,0.4,0.8,0.2
SF-N29,SF-C28-2,1,1,1,1,0,0,1.0,0.0,1.0,0.0
SF-N29,SF-C28-1,1,2,1,0,0,2,1.0,0.0,0.0,1.0
SF-N29,SF-B28,7,9,4,8,3,1,0.5714285714285714,0.42857142857142855,0.8888888888888888,0.1111111111111111
SF-N29,SF-G5,4,3,0,0,4,3,0.0,1.0,0.0,1.0
SF-N29,SF-G26,3,8,0,3,3,5,0.0,1.0,0.375,0.625
SF-N29,SF-K21,6,5,2,0,4,5,0.3333333333333333,0.6666666666666666,0.0,1.0
SF-N29,SF-K22-1,6,8,6,7,0,1,1.0,0.0,0.875,0.125
SF-N29,SF-J23-1,15,6,7,1,8,5,0.4666666666666667,0.5333333333333333,0.16666666666666666,0.8333333333333334
SF-N29,SF-J22-1,2,3,2,1,0,2,1.0,0.0,0.3333333333333333,0.6666666666666666
SF-N29,SF-J22-2,8,3,2,0,6,3,0.25,0.75,0.0,1.0
SF-N29,SF-J21,3,6,2,3,1,3,0.6666666666666666,0.3333333333333333,0.5,0.5
SF-N29,SF-I21,3,1,0,0,3,1,0.0,1.0,0.0,1.0
SF-N29,SF-I22,2,1,1,0,1,1,0.5,0.5,0.0,1.0
SF-N29,SF-I23-2,4,3,2,2,2,1,0.5,0.5,0.6666666666666666,0.3333333333333333
SF-N29,SF-I23-1,1,6,1,1,0,5,1.0,0.0,0.16666666666666666,0.8333333333333334
SF-N29,SF-F26,8,11,1,2,7,9,0.125,0.875,0.18181818181818182,0.8181818181818182
SF-N29,SF-M13,23,8,12,0,11,8,0.5217391304347826,0.4782608695652174,0.0,1.0
SF-N29,SF-M15,11,17,0,0,11,17,0.0,1.0,0.0,1.0
SF-N29,SF-L19,16,18,3,0,13,18,0.1875,0.8125,0.0,1.0
SF-N29,SF-L20,2,6,0,2,2,4,0.0,1.0,0.3333333333333333,0.6666666666666666
SF-N29,SF-N20-1,3,1,2,0,1,1,0.6666666666666666,0.3333333333333333,0.0,1.0
SF-N29,SF-M20,3,14,1,1,2,13,0.3333333333333333,0.6666666666666666,0.07142857142857142,0.9285714285714286
SF-N29,SF-K17-2,1,2,1,0,0,2,1.0,0.0,0.0,1.0
SF-N29,SF-K20,2,7,1,1,1,6,0.5,0.5,0.14285714285714285,0.8571428571428571
SF-N29,SF-K15-,5,5,0,3,5,2,0.0,1.0,0.6,0.4
SF-N29,SF-K19,4,5,3,0,1,5,0.75,0.25,0.0,1.0
SF-N29,SF-K18,3,7,0,0,3,7,0.0,1.0,0.0,1.0
SF-N29,SF-K17,3,3,0,2,3,1,0.0,1.0,0.6666666666666666,0.3333333333333333
SF-N29,SF-J18,6,20,0,0,6,20,0.0,1.0,0.0,1.0
SF-N29,SF-J20,4,5,0,1,4,4,0.0,1.0,0.2,0.8
SF-N29,SF-J19,4,7,3,4,1,3,0.75,0.25,0.5714285714285714,0.42857142857142855
SF-N29,SF-M12,1,2,1,0,0,2,1.0,0.0,0.0,1.0
SF-N29,SF-M11,1,1,0,0,1,1,0.0,1.0,0.0,1.0
SF-N29,SF-R19,24,1,2,0,22,1,0.08333333333333333,0.9166666666666666,0.0,1.0
SF-N29,SF-Q21-2,86,37,2,3,84,34,0.023255813953488372,0.9767441860465116,0.08108108108108109,0.918918918918919
SF-N29,SF-Q21-1,81,87,49,1,32,86,0.6049382716049383,0.3950617283950617,0.011494252873563218,0.9885057471264368
SF-N29,SF-P21,5,3,0,1,5,2,0.0,1.0,0.3333333333333333,0.6666666666666666
SF-N29,SF-O18,12,4,3,0,9,4,0.25,0.75,0.0,1.0
SF-N29,SF-O19,10,11,4,6,6,5,0.4,0.6,0.5454545454545454,0.45454545454545453
SF-N29,SF-O21,13,18,4,3,9,15,0.3076923076923077,0.6923076923076923,0.16666666666666666,0.8333333333333334
SF-N29,SF-O22,3,15,0,5,3,10,0.0,1.0,0.3333333333333333,0.6666666666666666
SF-N29,SF-N21,49,26,31,7,18,19,0.6326530612244898,0.3673469387755102,0.2692307692307692,0.7307692307692307
SF-N29,SF-N20-2,5,13,2,5,3,8,0.4,0.6,0.38461538461538464,0.6153846153846154
SF-N29,SF-M21,3,6,2,0,1,6,0.6666666666666666,0.3333333333333333,0.0,1.0
SF-N29,SF-L21,5,4,1,0,4,4,0.2,0.8,0.0,1.0
SF-N29,SF-Q30,8,7,5,5,3,2,0.625,0.375,0.7142857142857143,0.2857142857142857
SF-N29,SF-P30,5,17,4,10,1,7,0.8,0.2,0.5882352941176471,0.4117647058823529
SF-N29,SF-O30-2,6,8,3,5,3,3,0.5,0.5,0.625,0.375
SF-N29,SF-O30,39,22,22,11,17,11,0.5641025641025641,0.4358974358974359,0.5,0.5
SF-N29,SF-N27,97,62,86,53,11,9,0.8865979381443299,0.1134020618556701,0.8548387096774194,0.14516129032258066
SF-N29,SF-N28,15,36,11,29,4,7,0.7333333333333333,0.26666666666666666,0.8055555555555556,0.19444444444444445
SF-N29,SF-L30-1,39,44,26,36,13,8,0.6666666666666666,0.3333333333333333,0.8181818181818182,0.18181818181818182
SF-N29,SF-L31-1,9,3,7,2,2,1,0.7777777777777778,0.2222222222222222,0.6666666666666666,0.3333333333333333
SF-N29,SF-K30-2,13,10,8,7,5,3,0.6153846153846154,0.38461538461538464,0.7,0.3
SF-N29,SF-L29,33,6,17,3,16,3,0.5151515151515151,0.48484848484848486,0.5,0.5
SF-N29,SF-J29-1,6,11,1,8,5,3,0.16666666666666666,0.8333333333333334,0.7272727272727273,0.2727272727272727
SF-N29,SF-I30,13,7,11,6,2,1,0.8461538461538461,0.15384615384615385,0.8571428571428571,0.14285714285714285
SF-N29,SF-I29-2,4,2,4,2,0,0,1.0,0.0,1.0,0.0
SF-N29,SF-I27,20,2,2,1,18,1,0.1,0.9,0.5,0.5
SF-N29,SF-I28,2,3,1,2,1,1,0.5,0.5,0.6666666666666666,0.3333333333333333
SF-N29,SF-I30-2,5,6,3,5,2,1,0.6,0.4,0.8333333333333334,0.16666666666666666
SF-N29,SF I29-1,3,2,2,1,1,1,0.6666666666666666,0.3333333333333333,0.5,0.5
SF-N29,SF-H28,10,34,4,4,6,30,0.4,0.6,0.11764705882352941,0.8823529411764706
SF-N29,SF-H29,3,2,3,2,0,0,1.0,0.0,1.0,0.0
SF-N29,SF-S24,7,17,3,8,4,9,0.42857142857142855,0.5714285714285714,0.47058823529411764,0.5294117647058824
SF-N29,SF-R24,15,11,0,2,15,9,0.0,1.0,0.18181818181818182,0.8181818181818182
SF-N29,SF-R26,3,5,2,1,1,4,0.6666666666666666,0.3333333333333333,0.2,0.8
SF-N29,SF-Q26,22,20,2,1,20,19,0.09090909090909091,0.9090909090909091,0.05,0.95
SF-N29,SF-P26,7,10,1,0,6,10,0.14285714285714285,0.8571428571428571,0.0,1.0
SF-N29,SF-O25-2,11,9,5,1,6,8,0.45454545454545453,0.5454545454545454,0.1111111111111111,0.8888888888888888
SF-N29,SF-N22-1B,4,5,0,3,4,2,0.0,1.0,0.6,0.4
SF-N29,SF-N26,11,5,10,2,1,3,0.9090909090909091,0.09090909090909091,0.4,0.6
SF-N29,SF-N25,36,12,32,10,4,2,0.8888888888888888,0.1111111111111111,0.8333333333333334,0.16666666666666666
SF-N29,SF-T21,2,1,2,1,0,0,1.0,0.0,1.0,0.0
SF-N29,SF-T22,1,8,0,2,1,6,0.0,1.0,0.25,0.75
SF-N29,SF-S22-1,2,1,0,0,2,1,0.0,1.0,0.0,1.0
SF-N29,SF-Q22-1,4,14,4,4,0,10,1.0,0.0,0.2857142857142857,0.7142857142857143
SF-N29,SF-Q22-2,9,6,5,3,4,3,0.5555555555555556,0.4444444444444444,0.5,0.5
SF-N29,SF-P22,11,12,5,7,6,5,0.45454545454545453,0.5454545454545454,0.5833333333333334,0.4166666666666667
SF-N29,SF-T20,1,1,0,0,1,1,0.0,1.0,0.0,1.0
SF-N29,SF-Y29,3,2,0,0,3,2,0.0,1.0,0.0,1.0
SF-N29,SF-Y27,8,2,0,0,8,2,0.0,1.0,0.0,1.0
SF-N29,SF-W29,7,4,0,0,7,4,0.0,1.0,0.0,1.0
SF-N29,SF-V30,2,2,0,0,2,2,0.0,1.0,0.0,1.0
SF-N28,SF-M26,4,9,4,4,0,5,1.0,0.0,0.4444444444444444,0.5555555555555556
SF-N28,SF-M25,35,20,21,15,14,5,0.6,0.4,0.75,0.25
SF-N28,SF-M26-2,34,26,17,15,17,11,0.5,0.5,0.5769230769230769,0.4230769230769231
SF-N28,SF-K26,29,17,18,11,11,6,0.6206896551724138,0.3793103448275862,0.6470588235294118,0.35294117647058826
SF-N28,SF-J27,3,3,1,1,2,2,0.3333333333333333,0.6666666666666666,0.3333333333333333,0.6666666666666666
SF-N28,SF-M30,87,46,68,41,19,5,0.7816091954022989,0.21839080459770116,0.8913043478260869,0.10869565217391304
SF-N28,SF-L27-2,4,4,2,3,2,1,0.5,0.5,0.75,0.25
SF-N28,SF-J29-3,10,9,6,4,4,5,0.6,0.4,0.4444444444444444,0.5555555555555556
SF-N28,SF-J29,25,45,16,39,9,6,0.64,0.36,0.8666666666666667,0.13333333333333333
SF-N28,SF-L26,38,46,13,25,25,21,0.34210526315789475,0.6578947368421053,0.5434782608695652,0.45652173913043476
SF-N28,SF-M28,37,45,27,20,10,25,0.7297297297297297,0.2702702702702703,0.4444444444444444,0.5555555555555556
SF-N28,SF-M27,5,9,5,0,0,9,1.0,0.0,0.0,1.0
SF-N28,SF-L25,11,14,8,9,3,5,0.7272727272727273,0.2727272727272727,0.6428571428571429,0.35714285714285715
SF-N28,SF-M24,18,9,13,6,5,3,0.7222222222222222,0.2777777777777778,0.6666666666666666,0.3333333333333333
SF-N28,SF-L24,6,9,2,6,4,3,0.3333333333333333,0.6666666666666666,0.6666666666666666,0.3333333333333333
SF-N28,SF-N23,19,21,6,8,13,13,0.3157894736842105,0.6842105263157895,0.38095238095238093,0.6190476190476191
SF-N28,SF-N24-2,10,11,1,6,9,5,0.1,0.9,0.5454545454545454,0.45454545454545453
SF-N28,SF-K27-2,20,30,8,12,12,18,0.4,0.6,0.4,0.6
SF-N28,SF-J26-2,7,8,2,5,5,3,0.2857142857142857,0.7142857142857143,0.625,0.375
SF-N28,SF-K28-3,2,2,2,1,0,1,1.0,0.0,0.5,0.5
SF-N28,SF-L28,58,43,34,15,24,28,0.5862068965517241,0.41379310344827586,0.3488372093023256,0.6511627906976745
SF-N28,SF-K28,14,7,9,2,5,5,0.6428571428571429,0.35714285714285715,0.2857142857142857,0.7142857142857143
SF-N28,SF-K29-1,36,31,27,22,9,9,0.75,0.25,0.7096774193548387,0.2903225806451613
SF-N28,SF-J28-2,26,23,10,7,16,16,0.38461538461538464,0.6153846153846154,0.30434782608695654,0.6956521739130435
SF-N28,SF-K27,4,6,2,3,2,3,0.5,0.5,0.5,0.5
SF-N28,SF-K25,11,10,9,5,2,5,0.8181818181818182,0.18181818181818182,0.5,0.5
SF-N28,SF-J25,26,14,17,8,9,6,0.6538461538461539,0.34615384615384615,0.5714285714285714,0.42857142857142855
SF-N28,SF-H26-2,7,6,6,5,1,1,0.8571428571428571,0.14285714285714285,0.8333333333333334,0.16666666666666666
SF-N28,SF-P24,14,7,9,4,5,3,0.6428571428571429,0.35714285714285715,0.5714285714285714,0.42857142857142855
SF-N28,SF-N22-1A,3,4,2,2,1,2,0.6666666666666666,0.3333333333333333,0.5,0.5
SF-N28,SF-J24,19,7,14,2,5,5,0.7368421052631579,0.2631578947368421,0.2857142857142857,0.7142857142857143
SF-N28,SF-O24,8,10,3,8,5,2,0.375,0.625,0.8,0.2
SF-N28,SF-J26,6,6,2,2,4,4,0.3333333333333333,0.6666666666666666,0.3333333333333333,0.6666666666666666
SF-N28,SF-I26-,20,15,16,13,4,2,0.8,0.2,0.8666666666666667,0.13333333333333333
SF-N28,SF-I25,34,45,8,23,26,22,0.23529411764705882,0.7647058823529411,0.5111111111111111,0.4888888888888889
SF-N28,SF-K23,2,4,1,1,1,3,0.5,0.5,0.25,0.75
SF-N28,SF-H26,32,8,19,5,13,3,0.59375,0.40625,0.625,0.375
SF-N28,SF-O23,22,32,8,11,14,21,0.36363636363636365,0.6363636363636364,0.34375,0.65625
SF-N28,SF-H27-1,13,19,12,18,1,1,0.9230769230769231,0.07692307692307693,0.9473684210526315,0.05263157894736842
SF-N28,SF-F28-2,5,6,2,3,3,3,0.4,0.6,0.5,0.5
SF-N28,SF-G27,19,26,5,8,14,18,0.2631578947368421,0.7368421052631579,0.3076923076923077,0.6923076923076923
SF-N28,SF-M22-2,22,23,9,12,13,11,0.4090909090909091,0.5909090909090909,0.5217391304347826,0.4782608695652174
SF-N28,SF-L22,16,9,5,1,11,8,0.3125,0.6875,0.1111111111111111,0.8888888888888888
SF-N28,SF-F27,23,14,8,7,15,7,0.34782608695652173,0.6521739130434783,0.5,0.5
SF-N28,SF-N22-2,28,55,6,23,22,32,0.21428571428571427,0.7857142857142857,0.41818181818181815,0.5818181818181818
SF-N28,SF-G28-2,9,2,5,0,4,2,0.5555555555555556,0.4444444444444444,0.0,1.0
SF-N28,SF-G28-1,1,3,0,0,1,3,0.0,1.0,0.0,1.0
SF-N28,SF-M22-1,7,4,1,1,6,3,0.14285714285714285,0.8571428571428571,0.25,0.75
SF-N28,SF-O25-1,5,13,2,3,3,10,0.4,0.6,0.23076923076923078,0.7692307692307693
SF-N28,SF-K22-2,3,5,2,0,1,5,0.6666666666666666,0.3333333333333333,0.0,1.0
SF-N28,SF-K24,3,9,1,3,2,6,0.3333333333333333,0.6666666666666666,0.3333333333333333,0.6666666666666666
SF-N28,SF-J23-2,3,4,0,2,3,2,0.0,1.0,0.5,0.5
SF-N28,SF-G23,6,2,0,0,6,2,0.0,1.0,0.0,1.0
SF-N28,SF-G24,25,7,4,0,21,7,0.16,0.84,0.0,1.0
SF-N28,SF-G25,2,5,0,0,2,5,0.0,1.0,0.0,1.0
SF-N28,SF-F23,6,6,3,3,3,3,0.5,0.5,0.5,0.5
SF-N28,SF-E23,37,23,5,3,32,20,0.13513513513513514,0.8648648648648649,0.13043478260869565,0.8695652173913043
SF-N28,SF-C22,2,4,0,0,2,4,0.0,1.0,0.0,1.0
SF-N28,SF-B22,4,8,0,8,4,0,0.0,1.0,1.0,0.0
SF-N28,SF-J17,2,3,0,0,2,3,0.0,1.0,0.0,1.0
SF-N28,SF-I19,3,3,3,1,0,2,1.0,0.0,0.3333333333333333,0.6666666666666666
SF-N28,SF-H20,3,3,3,1,0,2,1.0,0.0,0.3333333333333333,0.6666666666666666
SF-N28,SF-G19,8,7,6,0,2,7,0.75,0.25,0.0,1.0
SF-N28,SF-G20,5,3,4,0,1,3,0.8,0.2,0.0,1.0
SF-N28,SF-F19,3,5,0,0,3,5,0.0,1.0,0.0,1.0
SF-N28,SF-H30,32,21,21,13,11,8,0.65625,0.34375,0.6190476190476191,0.38095238095238093
SF-N28,SF-G30-2,36,43,13,12,23,31,0.3611111111111111,0.6388888888888888,0.27906976744186046,0.7209302325581395
SF-N28,SF-F30-1,16,11,11,4,5,7,0.6875,0.3125,0.36363636363636365,0.6363636363636364
SF-N28,SF-E29-2,31,12,17,6,14,6,0.5483870967741935,0.45161290322580644,0.5,0.5
SF-N28,SF-E29-1,32,38,13,24,19,14,0.40625,0.59375,0.631578947368421,0.3684210526315789
SF-N28,SF-D29,37,38,4,15,33,23,0.10810810810810811,0.8918918918918919,0.39473684210526316,0.6052631578947368
SF-N28,SF-D28,15,52,9,37,6,15,0.6,0.4,0.7115384615384616,0.28846153846153844
SF-N28,SF-A27,3,1,1,0,2,1,0.3333333333333333,0.6666666666666666,0.0,1.0
SF-N28,SF-G29-2,14,3,6,2,8,1,0.42857142857142855,0.5714285714285714,0.6666666666666666,0.3333333333333333
SF-N28,SF-G29-1,8,5,2,0,6,5,0.25,0.75,0.0,1.0
SF-N28,SF-G30-1,8,7,0,0,8,7,0.0,1.0,0.0,1.0
SF-N28,SF-G29-3,5,7,5,2,0,5,1.0,0.0,0.2857142857142857,0.7142857142857143
SF-N28,SF-F30-2,4,1,1,0,3,1,0.25,0.75,0.0,1.0
SF-N28,SF-F29,2,2,0,0,2,2,0.0,1.0,0.0,1.0
SF-N28,SF-E29-3,1,1,0,0,1,1,0.0,1.0,0.0,1.0
SF-N28,SF-F28-1,1,4,0,0,1,4,0.0,1.0,0.0,1.0
SF-N28,SF-J10,3,1,0,0,3,1,0.0,1.0,0.0,1.0
SF-N28,SF-J12,2,1,0,0,2,1,0.0,1.0,0.0,1.0
SF-N28,SF-G10-2,4,2,2,0,2,2,0.5,0.5,0.0,1.0
SF-N28,SF-C20,1,2,0,1,1,1,0.0,1.0,0.5,0.5
SF-N28,SF-B21,1,2,1,2,0,0,1.0,0.0,1.0,0.0
SF-N28,SF-B19,3,4,2,1,1,3,0.6666666666666666,0.3333333333333333,0.25,0.75
SF-N28,SF-A19,3,2,3,1,0,1,1.0,0.0,0.5,0.5
SF-N28,SF-C26,10,10,1,2,9,8,0.1,0.9,0.2,0.8
SF-N28,SF-C25,10,5,3,0,7,5,0.3,0.7,0.0,1.0
SF-N28,SF-B25,4,3,2,0,2,3,0.5,0.5,0.0,1.0
SF-N28,SF-E27,5,12,0,5,5,7,0.0,1.0,0.4166666666666667,0.5833333333333334
SF-N28,SF-B28-2,5,8,1,2,4,6,0.2,0.8,0.25,0.75
SF-N28,SF-D27,6,3,1,1,5,2,0.16666666666666666,0.8333333333333334,0.3333333333333333,0.6666666666666666
SF-N28,SF-C28-2,3,4,2,2,1,2,0.6666666666666666,0.3333333333333333,0.5,0.5
SF-N28,SF-C28-1,4,5,4,4,0,1,1.0,0.0,0.8,0.2
SF-N28,SF-B28,4,9,2,7,2,2,0.5,0.5,0.7777777777777778,0.2222222222222222
SF-N28,SF-G7,4,3,0,0,4,3,0.0,1.0,0.0,1.0
SF-N28,SF-G26,5,8,2,4,3,4,0.4,0.6,0.5,0.5
SF-N28,SF-K21,10,7,0,0,10,7,0.0,1.0,0.0,1.0
SF-N28,SF-K22-1,4,3,1,0,3,3,0.25,0.75,0.0,1.0
SF-N28,SF-J23-1,11,10,7,6,4,4,0.6363636363636364,0.36363636363636365,0.6,0.4
SF-N28,SF-J22-1,4,2,1,0,3,2,0.25,0.75,0.0,1.0
SF-N28,SF-J22-2,5,8,2,2,3,6,0.4,0.6,0.25,0.75
SF-N28,SF-J21,10,7,6,4,4,3,0.6,0.4,0.5714285714285714,0.42857142857142855
SF-N28,SF-I21,1,3,0,2,1,1,0.0,1.0,0.6666666666666666,0.3333333333333333
SF-N28,SF-I22,6,6,3,3,3,3,0.5,0.5,0.5,0.5
SF-N28,SF-I23-2,4,4,1,0,3,4,0.25,0.75,0.0,1.0
SF-N28,SF-I24,14,5,12,3,2,2,0.8571428571428571,0.14285714285714285,0.6,0.4
SF-N28,SF-I23-1,6,5,1,5,5,0,0.16666666666666666,0.8333333333333334,1.0,0.0
SF-N28,SF-F26,41,62,5,3,36,59,0.12195121951219512,0.8780487804878049,0.04838709677419355,0.9516129032258065
SF-N28,SF-M13,1,6,0,0,1,6,0.0,1.0,0.0,1.0
SF-N28,SF-M15,13,15,0,0,13,15,0.0,1.0,0.0,1.0
SF-N28,SF-L19,6,8,1,0,5,8,0.16666666666666666,0.8333333333333334,0.0,1.0
SF-N28,SF-L20,9,9,5,3,4,6,0.5555555555555556,0.4444444444444444,0.3333333333333333,0.6666666666666666
SF-N28,SF-N20-1,5,7,1,3,4,4,0.2,0.8,0.42857142857142855,0.5714285714285714
SF-N28,SF-M20,7,20,2,1,5,19,0.2857142857142857,0.7142857142857143,0.05,0.95
SF-N28,SF-K17-2,8,13,1,2,7,11,0.125,0.875,0.15384615384615385,0.8461538461538461
SF-N28,SF-K20,7,7,0,3,7,4,0.0,1.0,0.42857142857142855,0.5714285714285714
SF-N28,SF-K15-,8,22,3,12,5,10,0.375,0.625,0.5454545454545454,0.45454545454545453
SF-N28,SF-K19,11,11,4,3,7,8,0.36363636363636365,0.6363636363636364,0.2727272727272727,0.7272727272727273
SF-N28,SF-K18,17,4,8,2,9,2,0.47058823529411764,0.5294117647058824,0.5,0.5
SF-N28,SF-K17,9,5,2,2,7,3,0.2222222222222222,0.7777777777777778,0.4,0.6
SF-N28,SF-J18,7,5,0,1,7,4,0.0,1.0,0.2,0.8
SF-N28,SF-J20,1,4,0,0,1,4,0.0,1.0,0.0,1.0
SF-N28,SF-J19,7,5,3,1,4,4,0.42857142857142855,0.5714285714285714,0.2,0.8
SF-N28,SF-M11,1,2,0,0,1,2,0.0,1.0,0.0,1.0
SF-N28,SF-R19,4,9,3,0,1,9,0.75,0.25,0.0,1.0
SF-N28,SF-R20,2,1,1,1,1,0,0.5,0.5,1.0,0.0
SF-N28,SF-Q21-1,6,17,5,3,1,14,0.8333333333333334,0.16666666666666666,0.17647058823529413,0.8235294117647058
SF-N28,SF-P21,9,6,0,1,9,5,0.0,1.0,0.16666666666666666,0.8333333333333334
SF-N28,SF-O18,7,11,2,2,5,9,0.2857142857142857,0.7142857142857143,0.18181818181818182,0.8181818181818182
SF-N28,SF-O19,14,15,5,6,9,9,0.35714285714285715,0.6428571428571429,0.4,0.6
SF-N28,SF-O21,31,27,11,8,20,19,0.3548387096774194,0.6451612903225806,0.2962962962962963,0.7037037037037037
SF-N28,SF-O22,28,27,2,11,26,16,0.07142857142857142,0.9285714285714286,0.4074074074074074,0.5925925925925926
SF-N28,SF-N21,14,20,6,4,8,16,0.42857142857142855,0.5714285714285714,0.2,0.8
SF-N28,SF-N20-2,6,14,3,2,3,12,0.5,0.5,0.14285714285714285,0.8571428571428571
SF-N28,SF-M21,21,13,6,4,15,9,0.2857142857142857,0.7142857142857143,0.3076923076923077,0.6923076923076923
SF-N28,SF-L21,6,9,2,3,4,6,0.3333333333333333,0.6666666666666666,0.3333333333333333,0.6666666666666666
SF-N28,SF-S29,3,1,1,1,2,0,0.3333333333333333,0.6666666666666666,1.0,0.0
SF-N28,SF-S30,7,4,3,2,4,2,0.42857142857142855,0.5714285714285714,0.5,0.5
SF-N28,SF-Q30,18,21,6,4,12,17,0.3333333333333333,0.6666666666666666,0.19047619047619047,0.8095238095238095
SF-N28,SF-P30,22,25,11,13,11,12,0.5,0.5,0.52,0.48
SF-N28,SF-O30-2,14,14,7,9,7,5,0.5,0.5,0.6428571428571429,0.35714285714285715
SF-N28,SF-O30,42,35,22,15,20,20,0.5238095238095238,0.47619047619047616,0.42857142857142855,0.5714285714285714
SF-N28,SF-N27,43,60,33,47,10,13,0.7674418604651163,0.23255813953488372,0.7833333333333333,0.21666666666666667
SF-N28,SF-N29,36,15,29,11,7,4,0.8055555555555556,0.19444444444444445,0.7333333333333333,0.26666666666666666
SF-N28,SF-L30-1,77,56,65,34,12,22,0.8441558441558441,0.15584415584415584,0.6071428571428571,0.39285714285714285
SF-N28,SF-L31-1,18,10,15,8,3,2,0.8333333333333334,0.16666666666666666,0.8,0.2
SF-N28,SF-K30-2,13,6,6,4,7,2,0.46153846153846156,0.5384615384615384,0.6666666666666666,0.3333333333333333
SF-N28,SF-L29,24,20,15,19,9,1,0.625,0.375,0.95,0.05
SF-N28,SF-J29-1,18,15,5,10,13,5,0.2777777777777778,0.7222222222222222,0.6666666666666666,0.3333333333333333
SF-N28,SF-I30,12,16,9,12,3,4,0.75,0.25,0.75,0.25
SF-N28,SF-I29-2,4,4,4,2,0,2,1.0,0.0,0.5,0.5
SF-N28,SF-I27,15,15,6,8,9,7,0.4,0.6,0.5333333333333333,0.4666666666666667
SF-N28,SF-I28,9,4,6,4,3,0,0.6666666666666666,0.3333333333333333,1.0,0.0
SF-N28,SF-I30-2,2,1,2,1,0,0,1.0,0.0,1.0,0.0
SF-N28,SF I29-1,6,2,5,2,1,0,0.8333333333333334,0.16666666666666666,1.0,0.0
SF-N28,SF-H28,23,36,15,8,8,28,0.6521739130434783,0.34782608695652173,0.2222222222222222,0.7777777777777778
SF-N28,SF-H29,2,3,1,1,1,2,0.5,0.5,0.3333333333333333,0.6666666666666666
SF-N28,SF-S24,8,7,3,1,5,6,0.375,0.625,0.14285714285714285,0.8571428571428571
SF-N28,SF-R24,14,18,3,6,11,12,0.21428571428571427,0.7857142857142857,0.3333333333333333,0.6666666666666666
SF-N28,SF-R26,4,8,2,2,2,6,0.5,0.5,0.25,0.75
SF-N28,SF-Q26,11,11,3,4,8,7,0.2727272727272727,0.7272727272727273,0.36363636363636365,0.6363636363636364
SF-N28,SF-P26,16,5,4,1,12,4,0.25,0.75,0.2,0.8
SF-N28,SF-O25-2,7,6,3,3,4,3,0.42857142857142855,0.5714285714285714,0.5,0.5
SF-N28,SF-N22-1B,7,11,5,6,2,5,0.7142857142857143,0.2857142857142857,0.5454545454545454,0.45454545454545453
SF-N28,SF-N26,13,12,6,7,7,5,0.46153846153846156,0.5384615384615384,0.5833333333333334,0.4166666666666667
SF-N28,SF-N25,21,19,11,9,10,10,0.5238095238095238,0.47619047619047616,0.47368421052631576,0.5263157894736842
SF-N28,SF-T21,2,1,1,0,1,1,0.5,0.5,0.0,1.0
SF-N28,SF-T22,8,5,4,2,4,3,0.5,0.5,0.4,0.6
SF-N28,SF-S22-2,5,4,1,0,4,4,0.2,0.8,0.0,1.0
SF-N28,SF-S22-1,5,10,2,4,3,6,0.4,0.6,0.4,0.6
SF-N28,SF-Q23-3,14,7,9,3,5,4,0.6428571428571429,0.35714285714285715,0.42857142857142855,0.5714285714285714
SF-N28,SF-Q22-1,11,18,3,4,8,14,0.2727272727272727,0.7272727272727273,0.2222222222222222,0.7777777777777778
SF-N28,SF-Q22-2,16,12,8,5,8,7,0.5,0.5,0.4166666666666667,0.5833333333333334
SF-N28,SF-P22,19,17,7,3,12,14,0.3684210526315789,0.631578947368421,0.17647058823529413,0.8235294117647058
SF-N28,SF-W19,15,5,0,0,15,5,0.0,1.0,0.0,1.0
SF-N28,SF-W19-2,3,2,0,0,3,2,0.0,1.0,0.0,1.0
SF-N28,SF-T20,3,2,1,0,2,2,0.3333333333333333,0.6666666666666666,0.0,1.0
SF-N28,SF-S21,5,8,0,1,5,7,0.0,1.0,0.125,0.875
SF-N28,SF-Y29,3,3,3,3,0,0,1.0,0.0,1.0,0.0
SF-N28,SF-V29,1,2,0,2,1,0,0.0,1.0,1.0,0.0
SF-N28,SF-V30,1,4,1,3,0,1,1.0,0.0,0.75,0.25
SF-N28,SF-V32,3,1,2,0,1,1,0.6666666666666666,0.3333333333333333,0.0,1.0
SF-N28,SF-U30,1,1,0,0,1,1,0.0,1.0,0.0,1.0
SF-N28,SF-W14,5,11,1,0,4,11,0.2,0.8,0.0,1.0
SF-N28,SF-Y25,2,1,0,0,2,1,0.0,1.0,0.0,1.0
SF-L30-1,SF-M26,5,13,4,10,1,3,0.8,0.2,0.7692307692307693,0.23076923076923078
SF-L30-1,SF-M25,18,23,8,15,10,8,0.4444444444444444,0.5555555555555556,0.6521739130434783,0.34782608695652173
SF-L30-1,SF-M26-2,33,28,23,20,10,8,0.696969696969697,0.30303030303030304,0.7142857142857143,0.2857142857142857
SF-L30-1,SF-L27,13,22,6,13,7,9,0.46153846153846156,0.5384615384615384,0.5909090909090909,0.4090909090909091
SF-L30-1,SF-K26,113,88,87,74,26,14,0.7699115044247787,0.23008849557522124,0.8409090909090909,0.1590909090909091
SF-L30-1,SF-J27,41,30,7,4,34,26,0.17073170731707318,0.8292682926829268,0.13333333333333333,0.8666666666666667
SF-L30-1,SF-M30,203,174,136,114,67,60,0.6699507389162561,0.33004926108374383,0.6551724137931034,0.3448275862068966
SF-L30-1,SF-L27-2,40,57,36,48,4,9,0.9,0.1,0.8421052631578947,0.15789473684210525
SF-L30-1,SF-J29-3,105,89,88,77,17,12,0.8380952380952381,0.1619047619047619,0.8651685393258427,0.1348314606741573
SF-L30-1,SF-J29,33,24,21,15,12,9,0.6363636363636364,0.36363636363636365,0.625,0.375
SF-L30-1,SF-L26,77,63,22,21,55,42,0.2857142857142857,0.7142857142857143,0.3333333333333333,0.6666666666666666
SF-L30-1,SF-M28,26,32,13,14,13,18,0.5,0.5,0.4375,0.5625
SF-L30-1,SF-L25,117,69,96,56,21,13,0.8205128205128205,0.1794871794871795,0.8115942028985508,0.18840579710144928
SF-L30-1,SF-M24,25,36,16,19,9,17,0.64,0.36,0.5277777777777778,0.4722222222222222
SF-L30-1,SF-L24,25,31,16,17,9,14,0.64,0.36,0.5483870967741935,0.45161290322580644
SF-L30-1,SF-N23,24,21,8,12,16,9,0.3333333333333333,0.6666666666666666,0.5714285714285714,0.42857142857142855
SF-L30-1,SF-N24-2,5,7,1,2,4,5,0.2,0.8,0.2857142857142857,0.7142857142857143
SF-L30-1,SF-K27-2,83,27,37,19,46,8,0.4457831325301205,0.5542168674698795,0.7037037037037037,0.2962962962962963
SF-L30-1,SF-J26-2,49,103,15,71,34,32,0.30612244897959184,0.6938775510204082,0.6893203883495146,0.3106796116504854
SF-L30-1,SF-K28-3,1,2,1,1,0,1,1.0,0.0,0.5,0.5
SF-L30-1,SF-L28,33,24,30,20,3,4,0.9090909090909091,0.09090909090909091,0.8333333333333334,0.16666666666666666
SF-L30-1,SF-K28,7,3,3,0,4,3,0.42857142857142855,0.5714285714285714,0.0,1.0
SF-L30-1,SF-K29-1,227,255,150,185,77,70,0.6607929515418502,0.3392070484581498,0.7254901960784313,0.27450980392156865
SF-L30-1,SF-J28-2,44,31,18,17,26,14,0.4090909090909091,0.5909090909090909,0.5483870967741935,0.45161290322580644
SF-L30-1,SF-K27,36,13,18,8,18,5,0.5,0.5,0.6153846153846154,0.38461538461538464
SF-L30-1,SF-K25,18,14,13,11,5,3,0.7222222222222222,0.2777777777777778,0.7857142857142857,0.21428571428571427
SF-L30-1,SF-J25,53,69,23,38,30,31,0.4339622641509434,0.5660377358490566,0.5507246376811594,0.4492753623188406
SF-L30-1,SF-H26-2,12,8,6,1,6,7,0.5,0.5,0.125,0.875
SF-L30-1,SF-P24,10,10,4,2,6,8,0.4,0.6,0.2,0.8
SF-L30-1,SF-J24,30,31,17,15,13,16,0.5666666666666667,0.43333333333333335,0.4838709677419355,0.5161290322580645
SF-L30-1,SF-O24,6,3,2,0,4,3,0.3333333333333333,0.6666666666666666,0.0,1.0
SF-L30-1,SF-J26,31,72,13,39,18,33,0.41935483870967744,0.5806451612903226,0.5416666666666666,0.4583333333333333
SF-L30-1,SF-I26-,8,4,6,1,2,3,0.75,0.25,0.25,0.75
SF-L30-1,SF-I25,21,43,12,7,9,36,0.5714285714285714,0.42857142857142855,0.16279069767441862,0.8372093023255814
SF-L30-1,SF-K23,3,5,1,3,2,2,0.3333333333333333,0.6666666666666666,0.6,0.4
SF-L30-1,SF-H26,31,32,23,18,8,14,0.7419354838709677,0.25806451612903225,0.5625,0.4375
SF-L30-1,SF-O23,56,52,48,47,8,5,0.8571428571428571,0.14285714285714285,0.9038461538461539,0.09615384615384616
SF-L30-1,SF-H27-1,32,37,22,25,10,12,0.6875,0.3125,0.6756756756756757,0.32432432432432434
SF-L30-1,SF-F28-2,41,28,4,6,37,22,0.0975609756097561,0.9024390243902439,0.21428571428571427,0.7857142857142857
SF-L30-1,SF-G27,70,81,51,34,19,47,0.7285714285714285,0.2714285714285714,0.41975308641975306,0.5802469135802469
SF-L30-1,SF-M22-2,20,14,7,9,13,5,0.35,0.65,0.6428571428571429,0.35714285714285715
SF-L30-1,SF-L22,50,14,32,8,18,6,0.64,0.36,0.5714285714285714,0.42857142857142855
SF-L30-1,SF-F27,14,34,10,13,4,21,0.7142857142857143,0.2857142857142857,0.38235294117647056,0.6176470588235294
SF-L30-1,SF-N22-2,21,57,2,27,19,30,0.09523809523809523,0.9047619047619048,0.47368421052631576,0.5263157894736842
SF-L30-1,SF-G28-2,2,2,2,2,0,0,1.0,0.0,1.0,0.0
SF-L30-1,SF-G28-1,11,5,7,3,4,2,0.6363636363636364,0.36363636363636365,0.6,0.4
SF-L30-1,SF-M22-1,27,9,14,2,13,7,0.5185185185185185,0.48148148148148145,0.2222222222222222,0.7777777777777778
SF-L30-1,SF-O25-1,4,9,2,3,2,6,0.5,0.5,0.3333333333333333,0.6666666666666666
SF-L30-1,SF-K22-2,62,58,29,2,33,56,0.46774193548387094,0.532258064516129,0.034482758620689655,0.9655172413793104
SF-L30-1,SF-K24,16,14,5,5,11,9,0.3125,0.6875,0.35714285714285715,0.6428571428571429
SF-L30-1,SF-J23-2,14,2,5,0,9,2,0.35714285714285715,0.6428571428571429,0.0,1.0
SF-L30-1,SF-G23,6,7,5,3,1,4,0.8333333333333334,0.16666666666666666,0.42857142857142855,0.5714285714285714
SF-L30-1,SF-G24,18,3,5,0,13,3,0.2777777777777778,0.7222222222222222,0.0,1.0
SF-L30-1,SF-G25,8,16,4,3,4,13,0.5,0.5,0.1875,0.8125
SF-L30-1,SF-E23,24,17,9,7,15,10,0.375,0.625,0.4117647058823529,0.5882352941176471
SF-L30-1,SF-D24,37,2,27,0,10,2,0.7297297297297297,0.2702702702702703,0.0,1.0
SF-L30-1,SF-C22,6,4,1,0,5,4,0.16666666666666666,0.8333333333333334,0.0,1.0
SF-L30-1,SF-B22,3,16,0,7,3,9,0.0,1.0,0.4375,0.5625
SF-L30-1,SF-J17,135,106,39,21,96,85,0.28888888888888886,0.7111111111111111,0.19811320754716982,0.8018867924528302
SF-L30-1,SF-I19,5,7,2,5,3,2,0.4,0.6,0.7142857142857143,0.2857142857142857
SF-L30-1,SF-I20,21,18,5,7,16,11,0.23809523809523808,0.7619047619047619,0.3888888888888889,0.6111111111111112
SF-L30-1,SF-H16,2,2,0,0,2,2,0.0,1.0,0.0,1.0
SF-L30-1,SF-H20,13,22,13,13,0,9,1.0,0.0,0.5909090909090909,0.4090909090909091
SF-L30-1,SF-H18,10,2,9,1,1,1,0.9,0.1,0.5,0.5
SF-L30-1,SF-G19,5,6,0,2,5,4,0.0,1.0,0.3333333333333333,0.6666666666666666
SF-L30-1,SF-G18,15,8,3,4,12,4,0.2,0.8,0.5,0.5
SF-L30-1,SF-G20,10,4,7,0,3,4,0.7,0.3,0.0,1.0
SF-L30-1,SF-F19,2,1,1,0,1,1,0.5,0.5,0.0,1.0
SF-L30-1,SF-E18,8,1,3,1,5,0,0.375,0.625,1.0,0.0
SF-L30-1,SF-H30,83,70,65,57,18,13,0.7831325301204819,0.21686746987951808,0.8142857142857143,0.18571428571428572
SF-L30-1,SF-G30-2,65,38,50,33,15,5,0.7692307692307693,0.23076923076923078,0.868421052631579,0.13157894736842105
SF-L30-1,SF-F30-1,25,65,13,9,12,56,0.52,0.48,0.13846153846153847,0.8615384615384616
SF-L30-1,SF-E29-2,273,342,174,211,99,131,0.6373626373626373,0.3626373626373626,0.6169590643274854,0.3830409356725146
SF-L30-1,SF-E29-1,104,127,63,96,41,31,0.6057692307692307,0.3942307692307692,0.7559055118110236,0.2440944881889764
SF-L30-1,SF-D29,36,42,20,24,16,18,0.5555555555555556,0.4444444444444444,0.5714285714285714,0.42857142857142855
SF-L30-1,SF-D28,30,24,15,12,15,12,0.5,0.5,0.5,0.5
SF-L30-1,SF-A27,17,24,5,11,12,13,0.29411764705882354,0.7058823529411765,0.4583333333333333,0.5416666666666666
SF-L30-1,SF-G29-2,29,31,16,18,13,13,0.5517241379310345,0.4482758620689655,0.5806451612903226,0.41935483870967744
SF-L30-1,SF-G29-1,13,16,6,12,7,4,0.46153846153846156,0.5384615384615384,0.75,0.25
SF-L30-1,SF-G30-1,41,26,30,21,11,5,0.7317073170731707,0.2682926829268293,0.8076923076923077,0.19230769230769232
SF-L30-1,SF-G29-3,18,6,13,1,5,5,0.7222222222222222,0.2777777777777778,0.16666666666666666,0.8333333333333334
SF-L30-1,SF-F30-2,12,16,7,9,5,7,0.5833333333333334,0.4166666666666667,0.5625,0.4375
SF-L30-1,SF-F29,39,12,32,6,7,6,0.8205128205128205,0.1794871794871795,0.5,0.5
SF-L30-1,SF-E29-3,123,71,103,39,20,32,0.8373983739837398,0.16260162601626016,0.5492957746478874,0.4507042253521127
SF-L30-1,SF-F28-1,37,16,28,5,9,11,0.7567567567567568,0.24324324324324326,0.3125,0.6875
SF-L30-1,SF-E28-2,6,2,2,0,4,2,0.3333333333333333,0.6666666666666666,0.0,1.0
SF-L30-1,SF-E28,6,4,2,0,4,4,0.3333333333333333,0.6666666666666666,0.0,1.0
SF-L30-1,SF-J10,4,2,2,2,2,0,0.5,0.5,1.0,0.0
SF-L30-1,SF-J12,81,32,62,0,19,32,0.7654320987654321,0.2345679012345679,0.0,1.0
SF-L30-1,SF-J13,1,1,1,1,0,0,1.0,0.0,1.0,0.0
SF-L30-1,SF-J15,1,1,0,1,1,0,0.0,1.0,1.0,0.0
SF-L30-1,SF-H12,4,3,0,2,4,1,0.0,1.0,0.6666666666666666,0.3333333333333333
SF-L30-1,SF-H15,1,3,1,1,0,2,1.0,0.0,0.3333333333333333,0.6666666666666666
SF-L30-1,SF-G13,4,7,2,2,2,5,0.5,0.5,0.2857142857142857,0.7142857142857143
SF-L30-1,SF-F15,2,1,1,0,1,1,0.5,0.5,0.0,1.0
SF-L30-1,SF-C20,11,26,3,2,8,24,0.2727272727272727,0.7272727272727273,0.07692307692307693,0.9230769230769231
SF-L30-1,SF-B19,5,15,0,2,5,13,0.0,1.0,0.13333333333333333,0.8666666666666667
SF-L30-1,SF-A20,9,20,3,11,6,9,0.3333333333333333,0.6666666666666666,0.55,0.45
SF-L30-1,SF-A19,6,7,2,4,4,3,0.3333333333333333,0.6666666666666666,0.5714285714285714,0.42857142857142855
SF-L30-1,SF-C26,14,35,4,6,10,29,0.2857142857142857,0.7142857142857143,0.17142857142857143,0.8285714285714286
SF-L30-1,SF-C25,85,48,11,3,74,45,0.12941176470588237,0.8705882352941177,0.0625,0.9375
SF-L30-1,SF-B25,16,28,11,11,5,17,0.6875,0.3125,0.39285714285714285,0.6071428571428571
SF-L30-1,SF-E27,10,8,2,4,8,4,0.2,0.8,0.5,0.5
SF-L30-1,SF-B28-2,7,16,5,13,2,3,0.7142857142857143,0.2857142857142857,0.8125,0.1875
SF-L30-1,SF-D27,96,94,88,88,8,6,0.9166666666666666,0.08333333333333333,0.9361702127659575,0.06382978723404255
SF-L30-1,SF-C28-2,1,5,0,2,1,3,0.0,1.0,0.4,0.6
SF-L30-1,SF-C28-1,7,2,4,2,3,0,0.5714285714285714,0.42857142857142855,1.0,0.0
SF-L30-1,SF-B28,57,68,53,58,4,10,0.9298245614035088,0.07017543859649122,0.8529411764705882,0.14705882352941177
SF-L30-1,SF-J1,1,1,0,0,1,1,0.0,1.0,0.0,1.0
SF-L30-1,SF-G5,1,1,0,0,1,1,0.0,1.0,0.0,1.0
SF-L30-1,SF-F9,12,3,0,0,12,3,0.0,1.0,0.0,1.0
SF-L30-1,SF-H25,3,2,1,0,2,2,0.3333333333333333,0.6666666666666666,0.0,1.0
SF-L30-1,SF-G26,85,68,55,35,30,33,0.6470588235294118,0.35294117647058826,0.5147058823529411,0.4852941176470588
SF-L30-1,SF-K21,14,12,4,2,10,10,0.2857142857142857,0.7142857142857143,0.16666666666666666,0.8333333333333334
SF-L30-1,SF-K22-1,157,118,98,71,59,47,0.6242038216560509,0.37579617834394907,0.6016949152542372,0.3983050847457627
SF-L30-1,SF-J23-1,35,38,16,16,19,22,0.45714285714285713,0.5428571428571428,0.42105263157894735,0.5789473684210527
SF-L30-1,SF-J22-1,128,97,10,15,118,82,0.078125,0.921875,0.15463917525773196,0.845360824742268
SF-L30-1,SF-J22-2,54,55,19,7,35,48,0.35185185185185186,0.6481481481481481,0.12727272727272726,0.8727272727272727
SF-L30-1,SF-J21,31,15,7,4,24,11,0.22580645161290322,0.7741935483870968,0.26666666666666666,0.7333333333333333
SF-L30-1,SF-I21,4,4,3,4,1,0,0.75,0.25,1.0,0.0
SF-L30-1,SF-I22,27,15,23,0,4,15,0.8518518518518519,0.14814814814814814,0.0,1.0
SF-L30-1,SF-I23-2,15,23,3,7,12,16,0.2,0.8,0.30434782608695654,0.6956521739130435
SF-L30-1,SF-I24,13,14,4,7,9,7,0.3076923076923077,0.6923076923076923,0.5,0.5
SF-L30-1,SF-I23-1,26,30,2,5,24,25,0.07692307692307693,0.9230769230769231,0.16666666666666666,0.8333333333333334
SF-L30-1,SF-F26,19,19,10,11,9,8,0.5263157894736842,0.47368421052631576,0.5789473684210527,0.42105263157894735
SF-L30-1,SF-M13,137,20,101,3,36,17,0.7372262773722628,0.26277372262773724,0.15,0.85
SF-L30-1,SF-M15,97,31,51,7,46,24,0.5257731958762887,0.4742268041237113,0.22580645161290322,0.7741935483870968
SF-L30-1,SF-L19,26,18,4,2,22,16,0.15384615384615385,0.8461538461538461,0.1111111111111111,0.8888888888888888
SF-L30-1,SF-L20,9,6,1,2,8,4,0.1111111111111111,0.8888888888888888,0.3333333333333333,0.6666666666666666
SF-L30-1,SF-N20-1,18,10,0,1,18,9,0.0,1.0,0.1,0.9
SF-L30-1,SF-M20,152,18,122,2,30,16,0.8026315789473685,0.19736842105263158,0.1111111111111111,0.8888888888888888
SF-L30-1,SF-K17-2,11,2,5,0,6,2,0.45454545454545453,0.5454545454545454,0.0,1.0
SF-L30-1,SF-K20,7,10,3,1,4,9,0.42857142857142855,0.5714285714285714,0.1,0.9
SF-L30-1,SF-K15-,40,19,31,7,9,12,0.775,0.225,0.3684210526315789,0.631578947368421
SF-L30-1,SF-K19,19,14,8,0,11,14,0.42105263157894735,0.5789473684210527,0.0,1.0
SF-L30-1,SF-K18,13,6,6,3,7,3,0.46153846153846156,0.5384615384615384,0.5,0.5
SF-L30-1,SF-K17,8,9,5,7,3,2,0.625,0.375,0.7777777777777778,0.2222222222222222
SF-L30-1,SF-J16,4,1,2,0,2,1,0.5,0.5,0.0,1.0
SF-L30-1,SF-J18,23,6,6,0,17,6,0.2608695652173913,0.7391304347826086,0.0,1.0
SF-L30-1,SF-J20,8,7,6,4,2,3,0.75,0.25,0.5714285714285714,0.42857142857142855
SF-L30-1,SF-J19,24,26,7,7,17,19,0.2916666666666667,0.7083333333333334,0.2692307692307692,0.7307692307692307
SF-L30-1,SF-M12,39,14,32,6,7,8,0.8205128205128205,0.1794871794871795,0.42857142857142855,0.5714285714285714
SF-L30-1,SF-M10,14,1,10,0,4,1,0.7142857142857143,0.2857142857142857,0.0,1.0
SF-L30-1,SF-M11,10,4,4,0,6,4,0.4,0.6,0.0,1.0
SF-L30-1,SF-R19,3,2,1,0,2,2,0.3333333333333333,0.6666666666666666,0.0,1.0
SF-L30-1,SF-Q21-2,7,6,2,1,5,5,0.2857142857142857,0.7142857142857143,0.16666666666666666,0.8333333333333334
SF-L30-1,SF-Q21-1,11,6,1,0,10,6,0.09090909090909091,0.9090909090909091,0.0,1.0
SF-L30-1,SF-P21,10,4,2,0,8,4,0.2,0.8,0.0,1.0
SF-L30-1,SF-O18,10,12,3,1,7,11,0.3,0.7,0.08333333333333333,0.9166666666666666
SF-L30-1,SF-O19,13,7,2,3,11,4,0.15384615384615385,0.8461538461538461,0.42857142857142855,0.5714285714285714
SF-L30-1,SF-O21,27,39,7,10,20,29,0.25925925925925924,0.7407407407407407,0.2564102564102564,0.7435897435897436
SF-L30-1,SF-O22,26,40,3,11,23,29,0.11538461538461539,0.8846153846153846,0.275,0.725
SF-L30-1,SF-N21,21,38,5,8,16,30,0.23809523809523808,0.7619047619047619,0.21052631578947367,0.7894736842105263
SF-L30-1,SF-N20-2,30,37,1,1,29,36,0.03333333333333333,0.9666666666666667,0.02702702702702703,0.972972972972973
SF-L30-1,SF-M21,58,16,42,3,16,13,0.7241379310344828,0.27586206896551724,0.1875,0.8125
SF-L30-1,SF-L21,9,37,1,19,8,18,0.1111111111111111,0.8888888888888888,0.5135135135135135,0.4864864864864865
SF-L30-1,SF-S29,17,8,5,3,12,5,0.29411764705882354,0.7058823529411765,0.375,0.625
SF-L30-1,SF-S30,8,7,3,6,5,1,0.375,0.625,0.8571428571428571,0.14285714285714285
SF-L30-1,SF-Q30,80,77,10,39,70,38,0.125,0.875,0.5064935064935064,0.4935064935064935
SF-L30-1,SF-P30,100,151,58,64,42,87,0.58,0.42,0.423841059602649,0.5761589403973509
SF-L30-1,SF-O30-2,27,39,13,27,14,12,0.48148148148148145,0.5185185185185185,0.6923076923076923,0.3076923076923077
SF-L30-1,SF-O30,432,392,316,245,116,147,0.7314814814814815,0.26851851851851855,0.625,0.375
SF-L30-1,SF-N27,51,64,22,38,29,26,0.43137254901960786,0.5686274509803921,0.59375,0.40625
SF-L30-1,SF-N29,44,39,36,26,8,13,0.8181818181818182,0.18181818181818182,0.6666666666666666,0.3333333333333333
SF-L30-1,SF-N28,56,77,34,65,22,12,0.6071428571428571,0.39285714285714285,0.8441558441558441,0.15584415584415584
SF-L30-1,SF-L31-1,21,35,15,29,6,6,0.7142857142857143,0.2857142857142857,0.8285714285714286,0.17142857142857143
SF-L30-1,SF-K30-2,28,25,22,18,6,7,0.7857142857142857,0.21428571428571427,0.72,0.28
SF-L30-1,SF-L29,63,58,49,44,14,14,0.7777777777777778,0.2222222222222222,0.7586206896551724,0.2413793103448276
SF-L30-1,SF-J29-1,28,30,12,21,16,9,0.42857142857142855,0.5714285714285714,0.7,0.3
SF-L30-1,SF-I30,38,38,21,22,17,16,0.5526315789473685,0.4473684210526316,0.5789473684210527,0.42105263157894735
SF-L30-1,SF-I29-2,9,16,5,7,4,9,0.5555555555555556,0.4444444444444444,0.4375,0.5625
SF-L30-1,SF-I27,35,25,19,10,16,15,0.5428571428571428,0.45714285714285713,0.4,0.6
SF-L30-1,SF-I28,25,11,17,7,8,4,0.68,0.32,0.6363636363636364,0.36363636363636365
SF-L30-1,SF-I30-2,43,19,23,7,20,12,0.5348837209302325,0.46511627906976744,0.3684210526315789,0.631578947368421
SF-L30-1,SF I29-1,21,15,12,4,9,11,0.5714285714285714,0.42857142857142855,0.26666666666666666,0.7333333333333333
SF-L30-1,SF-H28,52,46,44,38,8,8,0.8461538461538461,0.15384615384615385,0.8260869565217391,0.17391304347826086
SF-L30-1,SF-H29,9,10,7,7,2,3,0.7777777777777778,0.2222222222222222,0.7,0.3
SF-L30-1,SF-S24,19,21,6,4,13,17,0.3157894736842105,0.6842105263157895,0.19047619047619047,0.8095238095238095
SF-L30-1,SF-R24,25,30,3,12,22,18,0.12,0.88,0.4,0.6
SF-L30-1,SF-R26,30,42,9,4,21,38,0.3,0.7,0.09523809523809523,0.9047619047619048
SF-L30-1,SF-Q26,10,12,6,8,4,4,0.6,0.4,0.6666666666666666,0.3333333333333333
SF-L30-1,SF-P26,28,32,12,9,16,23,0.42857142857142855,0.5714285714285714,0.28125,0.71875
SF-L30-1,SF-O25-2,13,11,7,3,6,8,0.5384615384615384,0.46153846153846156,0.2727272727272727,0.7272727272727273
SF-L30-1,SF-N22-1B,14,16,9,11,5,5,0.6428571428571429,0.35714285714285715,0.6875,0.3125
SF-L30-1,SF-N26,18,5,7,0,11,5,0.3888888888888889,0.6111111111111112,0.0,1.0
SF-L30-1,SF-N25,12,5,4,3,8,2,0.3333333333333333,0.6666666666666666,0.6,0.4
SF-L30-1,SF-T21,3,2,1,1,2,1,0.3333333333333333,0.6666666666666666,0.5,0.5
SF-L30-1,SF-T22,16,10,7,3,9,7,0.4375,0.5625,0.3,0.7
SF-L30-1,SF-S22-2,1,2,0,0,1,2,0.0,1.0,0.0,1.0
SF-L30-1,SF-S22-1,8,8,4,2,4,6,0.5,0.5,0.25,0.75
SF-L30-1,SF-Q23-3,5,14,2,5,3,9,0.4,0.6,0.35714285714285715,0.6428571428571429
SF-L30-1,SF-Q22-1,11,10,3,2,8,8,0.2727272727272727,0.7272727272727273,0.2,0.8
SF-L30-1,SF-Q22-2,15,6,9,4,6,2,0.6,0.4,0.6666666666666666,0.3333333333333333
SF-L30-1,SF-P22,8,4,4,1,4,3,0.5,0.5,0.25,0.75
SF-L30-1,SF-T20,10,6,2,0,8,6,0.2,0.8,0.0,1.0
SF-L30-1,SF-Y27,4,1,4,0,0,1,1.0,0.0,0.0,1.0
SF-L30-1,SF-X29,1,1,0,0,1,1,0.0,1.0,0.0,1.0
SF-L30-1,SF-W29,1,1,0,1,1,0,0.0,1.0,1.0,0.0
SF-L30-1,SF-V28,1,4,0,1,1,3,0.0,1.0,0.25,0.75
SF-L30-1,SF-V29,3,6,2,4,1,2,0.6666666666666666,0.3333333333333333,0.6666666666666666,0.3333333333333333
SF-L30-1,SF-V30,1,1,0,0,1,1,0.0,1.0,0.0,1.0
SF-L30-1,SF-V32,32,7,16,5,16,2,0.5,0.5,0.7142857142857143,0.2857142857142857
SF-L30-1,SF-U30,1,1,1,1,0,0,1.0,0.0,1.0,0.0
SF-L30-1,SF-Y25,36,38,35,37,1,1,0.9722222222222222,0.027777777777777776,0.9736842105263158,0.02631578947368421
SF-L31-1,SF-M25,3,2,1,1,2,1,0.3333333333333333,0.6666666666666666,0.5,0.5
SF-L31-1,SF-M26-2,1,5,1,3,0,2,1.0,0.0,0.6,0.4
SF-L31-1,SF-L27,3,2,3,2,0,0,1.0,0.0,1.0,0.0
SF-L31-1,SF-K26,58,56,26,19,32,37,0.4482758620689655,0.5517241379310345,0.3392857142857143,0.6607142857142857
SF-L31-1,SF-M30,12,15,10,13,2,2,0.8333333333333334,0.16666666666666666,0.8666666666666667,0.13333333333333333
SF-L31-1,SF-L27-2,5,5,5,4,0,1,1.0,0.0,0.8,0.2
SF-L31-1,SF-J29-3,2,5,2,2,0,3,1.0,0.0,0.4,0.6
SF-L31-1,SF-J29,5,5,4,4,1,1,0.8,0.2,0.8,0.2
SF-L31-1,SF-L26,9,5,1,2,8,3,0.1111111111111111,0.8888888888888888,0.4,0.6
SF-L31-1,SF-M28,2,10,1,6,1,4,0.5,0.5,0.6,0.4
SF-L31-1,SF-L25,2,1,0,1,2,0,0.0,1.0,1.0,0.0
SF-L31-1,SF-M24,5,9,4,1,1,8,0.8,0.2,0.1111111111111111,0.8888888888888888
SF-L31-1,SF-N23,4,13,2,8,2,5,0.5,0.5,0.6153846153846154,0.38461538461538464
SF-L31-1,SF-N24-2,1,1,1,1,0,0,1.0,0.0,1.0,0.0
SF-L31-1,SF-K27-2,9,3,3,0,6,3,0.3333333333333333,0.6666666666666666,0.0,1.0
SF-L31-1,SF-J26-2,2,4,0,0,2,4,0.0,1.0,0.0,1.0
SF-L31-1,SF-L28,6,10,5,9,1,1,0.8333333333333334,0.16666666666666666,0.9,0.1
SF-L31-1,SF-K28,1,1,1,1,0,0,1.0,0.0,1.0,0.0
SF-L31-1,SF-K29-1,24,13,18,11,6,2,0.75,0.25,0.8461538461538461,0.15384615384615385
SF-L31-1,SF-J28-2,3,2,2,1,1,1,0.6666666666666666,0.3333333333333333,0.5,0.5
SF-L31-1,SF-K27,2,3,1,2,1,1,0.5,0.5,0.6666666666666666,0.3333333333333333
SF-L31-1,SF-K25,4,3,4,2,0,1,1.0,0.0,0.6666666666666666,0.3333333333333333
SF-L31-1,SF-J25,5,32,3,19,2,13,0.6,0.4,0.59375,0.40625
SF-L31-1,SF-P24,3,3,2,2,1,1,0.6666666666666666,0.3333333333333333,0.6666666666666666,0.3333333333333333
SF-L31-1,SF-J24,6,2,2,1,4,1,0.3333333333333333,0.6666666666666666,0.5,0.5
SF-L31-1,SF-O24,2,1,0,0,2,1,0.0,1.0,0.0,1.0
SF-L31-1,SF-J26,14,3,1,3,13,0,0.07142857142857142,0.9285714285714286,1.0,0.0
SF-L31-1,SF-I25,5,4,5,2,0,2,1.0,0.0,0.5,0.5
SF-L31-1,SF-H26,6,6,4,4,2,2,0.6666666666666666,0.3333333333333333,0.6666666666666666,0.3333333333333333
SF-L31-1,SF-O23,2,4,0,1,2,3,0.0,1.0,0.25,0.75
SF-L31-1,SF-H27-1,6,7,5,4,1,3,0.8333333333333334,0.16666666666666666,0.5714285714285714,0.42857142857142855
SF-L31-1,SF-F28-2,6,17,5,14,1,3,0.8333333333333334,0.16666666666666666,0.8235294117647058,0.17647058823529413
SF-L31-1,SF-G27,10,8,9,5,1,3,0.9,0.1,0.625,0.375
SF-L31-1,SF-M22-2,5,3,1,0,4,3,0.2,0.8,0.0,1.0
SF-L31-1,SF-F27,11,36,7,6,4,30,0.6363636363636364,0.36363636363636365,0.16666666666666666,0.8333333333333334
SF-L31-1,SF-N22-2,17,18,13,8,4,10,0.7647058823529411,0.23529411764705882,0.4444444444444444,0.5555555555555556
SF-L31-1,SF-G28-2,5,5,0,3,5,2,0.0,1.0,0.6,0.4
SF-L31-1,SF-G28-1,3,3,3,3,0,0,1.0,0.0,1.0,0.0
SF-L31-1,SF-M22-1,4,3,3,0,1,3,0.75,0.25,0.0,1.0
SF-L31-1,SF-K24,1,4,0,1,1,3,0.0,1.0,0.25,0.75
SF-L31-1,SF-G24,3,4,3,1,0,3,1.0,0.0,0.25,0.75
SF-L31-1,SF-G25,4,1,2,0,2,1,0.5,0.5,0.0,1.0
SF-L31-1,SF-F23,3,2,3,1,0,1,1.0,0.0,0.5,0.5
SF-L31-1,SF-E23,9,1,5,0,4,1,0.5555555555555556,0.4444444444444444,0.0,1.0
SF-L31-1,SF-C22,3,4,0,0,3,4,0.0,1.0,0.0,1.0
SF-L31-1,SF-B22,4,9,0,6,4,3,0.0,1.0,0.6666666666666666,0.3333333333333333
SF-L31-1,SF-H30,61,54,49,45,12,9,0.8032786885245902,0.19672131147540983,0.8333333333333334,0.16666666666666666
SF-L31-1,SF-G30-2,36,26,21,14,15,12,0.5833333333333334,0.4166666666666667,0.5384615384615384,0.46153846153846156
SF-L31-1,SF-F30-1,22,22,15,11,7,11,0.6818181818181818,0.3181818181818182,0.5,0.5
SF-L31-1,SF-E29-2,77,112,38,106,39,6,0.4935064935064935,0.5064935064935064,0.9464285714285714,0.05357142857142857
SF-L31-1,SF-E29-1,52,83,40,66,12,17,0.7692307692307693,0.23076923076923078,0.7951807228915663,0.20481927710843373
SF-L31-1,SF-D29,54,73,43,56,11,17,0.7962962962962963,0.2037037037037037,0.7671232876712328,0.2328767123287671
SF-L31-1,SF-D28,22,40,13,29,9,11,0.5909090909090909,0.4090909090909091,0.725,0.275
SF-L31-1,SF-A27,13,12,12,10,1,2,0.9230769230769231,0.07692307692307693,0.8333333333333334,0.16666666666666666
SF-L31-1,SF-G29-2,34,22,16,14,18,8,0.47058823529411764,0.5294117647058824,0.6363636363636364,0.36363636363636365
SF-L31-1,SF-G29-1,3,3,2,2,1,1,0.6666666666666666,0.3333333333333333,0.6666666666666666,0.3333333333333333
SF-L31-1,SF-G30-1,37,27,27,24,10,3,0.7297297297297297,0.2702702702702703,0.8888888888888888,0.1111111111111111
SF-L31-1,SF-G29-3,4,6,2,2,2,4,0.5,0.5,0.3333333333333333,0.6666666666666666
SF-L31-1,SF-F30-2,6,13,3,7,3,6,0.5,0.5,0.5384615384615384,0.46153846153846156
SF-L31-1,SF-F29,19,16,15,9,4,7,0.7894736842105263,0.21052631578947367,0.5625,0.4375
SF-L31-1,SF-F28-1,3,8,1,7,2,1,0.3333333333333333,0.6666666666666666,0.875,0.125
SF-L31-1,SF-E28-2,2,2,1,2,1,0,0.5,0.5,1.0,0.0
SF-L31-1,SF-E28,2,2,1,1,1,1,0.5,0.5,0.5,0.5
SF-L31-1,SF-F15,8,4,0,0,8,4,0.0,1.0,0.0,1.0
SF-L31-1,SF-C21,2,1,0,0,2,1,0.0,1.0,0.0,1.0
SF-L31-1,SF-C20,1,1,0,0,1,1,0.0,1.0,0.0,1.0
SF-L31-1,SF-B21,2,1,0,0,2,1,0.0,1.0,0.0,1.0
SF-L31-1,SF-B19,5,1,4,0,1,1,0.8,0.2,0.0,1.0
SF-L31-1,SF-A20,3,7,2,3,1,4,0.6666666666666666,0.3333333333333333,0.42857142857142855,0.5714285714285714
SF-L31-1,SF-A19,2,4,0,2,2,2,0.0,1.0,0.5,0.5
SF-L31-1,SF-C26,6,11,4,2,2,9,0.6666666666666666,0.3333333333333333,0.18181818181818182,0.8181818181818182
SF-L31-1,SF-C25,7,12,6,6,1,6,0.8571428571428571,0.14285714285714285,0.5,0.5
SF-L31-1,SF-B25,10,21,3,8,7,13,0.3,0.7,0.38095238095238093,0.6190476190476191
SF-L31-1,SF-E27,14,6,4,4,10,2,0.2857142857142857,0.7142857142857143,0.6666666666666666,0.3333333333333333
SF-L31-1,SF-B28-2,1,4,1,1,0,3,1.0,0.0,0.25,0.75
SF-L31-1,SF-D27,11,7,6,6,5,1,0.5454545454545454,0.45454545454545453,0.8571428571428571,0.14285714285714285
SF-L31-1,SF-C28-2,7,3,3,3,4,0,0.42857142857142855,0.5714285714285714,1.0,0.0
SF-L31-1,SF-B28,35,37,28,29,7,8,0.8,0.2,0.7837837837837838,0.21621621621621623
SF-L31-1,SF-G26,3,6,2,0,1,6,0.6666666666666666,0.3333333333333333,0.0,1.0
SF-L31-1,SF-J23-1,5,7,4,4,1,3,0.8,0.2,0.5714285714285714,0.42857142857142855
SF-L31-1,SF-J22-1,8,7,3,0,5,7,0.375,0.625,0.0,1.0
SF-L31-1,SF-J22-2,2,1,1,0,1,1,0.5,0.5,0.0,1.0
SF-L31-1,SF-J21,4,10,0,0,4,10,0.0,1.0,0.0,1.0
SF-L31-1,SF-I22,1,1,1,1,0,0,1.0,0.0,1.0,0.0
SF-L31-1,SF-I23-1,2,4,1,2,1,2,0.5,0.5,0.5,0.5
SF-L31-1,SF-F26,10,10,4,6,6,4,0.4,0.6,0.6,0.4
SF-L31-1,SF-M15,1,1,0,0,1,1,0.0,1.0,0.0,1.0
SF-L31-1,SF-L19,1,2,1,0,0,2,1.0,0.0,0.0,1.0
SF-L31-1,SF-K19,4,2,2,0,2,2,0.5,0.5,0.0,1.0
SF-L31-1,SF-K17,1,1,0,0,1,1,0.0,1.0,0.0,1.0
SF-L31-1,SF-J18,1,3,1,1,0,2,1.0,0.0,0.3333333333333333,0.6666666666666666
SF-L31-1,SF-P21,1,2,1,0,0,2,1.0,0.0,0.0,1.0
SF-L31-1,SF-O18,4,2,0,0,4,2,0.0,1.0,0.0,1.0
SF-L31-1,SF-O19,5,3,2,2,3,1,0.4,0.6,0.6666666666666666,0.3333333333333333
SF-L31-1,SF-O21,5,3,0,1,5,2,0.0,1.0,0.3333333333333333,0.6666666666666666
SF-L31-1,SF-O22,3,2,0,2,3,0,0.0,1.0,1.0,0.0
SF-L31-1,SF-N21,7,4,3,2,4,2,0.42857142857142855,0.5714285714285714,0.5,0.5
SF-L31-1,SF-N20-2,13,8,1,0,12,8,0.07692307692307693,0.9230769230769231,0.0,1.0
SF-L31-1,SF-L21,16,12,0,1,16,11,0.0,1.0,0.08333333333333333,0.9166666666666666
SF-L31-1,SF-S30,26,13,22,6,4,7,0.8461538461538461,0.15384615384615385,0.46153846153846156,0.5384615384615384
SF-L31-1,SF-Q30,48,30,37,15,11,15,0.7708333333333334,0.22916666666666666,0.5,0.5
SF-L31-1,SF-P30,12,23,5,15,7,8,0.4166666666666667,0.5833333333333334,0.6521739130434783,0.34782608695652173
SF-L31-1,SF-O30-2,48,41,41,31,7,10,0.8541666666666666,0.14583333333333334,0.7560975609756098,0.24390243902439024
SF-L31-1,SF-O30,60,46,42,21,18,25,0.7,0.3,0.45652173913043476,0.5434782608695652
SF-L31-1,SF-N27,14,14,9,6,5,8,0.6428571428571429,0.35714285714285715,0.42857142857142855,0.5714285714285714
SF-L31-1,SF-N29,3,9,2,7,1,2,0.6666666666666666,0.3333333333333333,0.7777777777777778,0.2222222222222222
SF-L31-1,SF-N28,10,18,8,15,2,3,0.8,0.2,0.8333333333333334,0.16666666666666666
SF-L31-1,SF-L30-1,35,21,29,15,6,6,0.8285714285714286,0.17142857142857143,0.7142857142857143,0.2857142857142857
SF-L31-1,SF-K30-2,24,21,24,18,0,3,1.0,0.0,0.8571428571428571,0.14285714285714285
SF-L31-1,SF-L29,14,12,8,11,6,1,0.5714285714285714,0.42857142857142855,0.9166666666666666,0.08333333333333333
SF-L31-1,SF-J29-1,16,15,13,14,3,1,0.8125,0.1875,0.9333333333333333,0.06666666666666667
SF-L31-1,SF-I30,21,19,13,16,8,3,0.6190476190476191,0.38095238095238093,0.8421052631578947,0.15789473684210525
SF-L31-1,SF-I29-2,4,3,0,2,4,1,0.0,1.0,0.6666666666666666,0.3333333333333333
SF-L31-1,SF-I27,2,5,1,3,1,2,0.5,0.5,0.6,0.4
SF-L31-1,SF-I28,1,9,0,1,1,8,0.0,1.0,0.1111111111111111,0.8888888888888888
SF-L31-1,SF-I30-2,5,3,4,2,1,1,0.8,0.2,0.6666666666666666,0.3333333333333333
SF-L31-1,SF I29-1,3,2,2,1,1,1,0.6666666666666666,0.3333333333333333,0.5,0.5
SF-L31-1,SF-H28,13,12,8,6,5,6,0.6153846153846154,0.38461538461538464,0.5,0.5
SF-L31-1,SF-H29,4,3,4,1,0,2,1.0,0.0,0.3333333333333333,0.6666666666666666
SF-L31-1,SF-S24,2,3,1,2,1,1,0.5,0.5,0.6666666666666666,0.3333333333333333
SF-L31-1,SF-R24,5,3,5,2,0,1,1.0,0.0,0.6666666666666666,0.3333333333333333
SF-L31-1,SF-R26,3,1,0,1,3,0,0.0,1.0,1.0,0.0
SF-L31-1,SF-Q26,10,3,5,1,5,2,0.5,0.5,0.3333333333333333,0.6666666666666666
SF-L31-1,SF-P26,3,2,0,0,3,2,0.0,1.0,0.0,1.0
SF-L31-1,SF-O25-2,2,2,2,1,0,1,1.0,0.0,0.5,0.5
SF-L31-1,SF-N26,5,1,1,0,4,1,0.2,0.8,0.0,1.0
SF-L31-1,SF-T22,3,1,0,0,3,1,0.0,1.0,0.0,1.0
SF-L31-1,SF-S22-1,3,2,0,1,3,1,0.0,1.0,0.5,0.5
SF-L31-1,SF-Q23-3,2,10,2,3,0,7,1.0,0.0,0.3,0.7
SF-L31-1,SF-Q22-1,2,2,0,1,2,1,0.0,1.0,0.5,0.5
SF-L31-1,SF-Q22-2,2,6,0,1,2,5,0.0,1.0,0.16666666666666666,0.8333333333333334
SF-L31-1,SF-P22,4,2,2,1,2,1,0.5,0.5,0.5,0.5
SF-L31-1,SF-T20,6,6,0,0,6,6,0.0,1.0,0.0,1.0
SF-L31-1,SF-V29,1,3,0,1,1,2,0.0,1.0,0.3333333333333333,0.6666666666666666
SF-L31-1,SF-V30,7,9,5,4,2,5,0.7142857142857143,0.2857142857142857,0.4444444444444444,0.5555555555555556
SF-L31-1,SF-V31,2,1,0,0,2,1,0.0,1.0,0.0,1.0
SF-L31-1,SF-V32,14,13,11,13,3,0,0.7857142857142857,0.21428571428571427,1.0,0.0
SF-L31-1,SF-AA15,13,1,3,0,10,1,0.23076923076923078,0.7692307692307693,0.0,1.0
SF-L31-1,SF-Y25,3,1,3,0,0,1,1.0,0.0,0.0,1.0
SF-K30-2,SF-M25,4,6,1,4,3,2,0.25,0.75,0.6666666666666666,0.3333333333333333
SF-K30-2,SF-M26-2,2,3,1,1,1,2,0.5,0.5,0.3333333333333333,0.6666666666666666
SF-K30-2,SF-L27,2,16,2,12,0,4,1.0,0.0,0.75,0.25
SF-K30-2,SF-K26,10,9,3,5,7,4,0.3,0.7,0.5555555555555556,0.4444444444444444
SF-K30-2,SF-J27,31,34,11,15,20,19,0.3548387096774194,0.6451612903225806,0.4411764705882353,0.5588235294117647
SF-K30-2,SF-M30,45,41,30,27,15,14,0.6666666666666666,0.3333333333333333,0.6585365853658537,0.34146341463414637
SF-K30-2,SF-L27-2,6,30,4,27,2,3,0.6666666666666666,0.3333333333333333,0.9,0.1
SF-K30-2,SF-J29-3,35,28,31,26,4,2,0.8857142857142857,0.11428571428571428,0.9285714285714286,0.07142857142857142
SF-K30-2,SF-J29,13,10,9,8,4,2,0.6923076923076923,0.3076923076923077,0.8,0.2
SF-K30-2,SF-L26,5,17,1,1,4,16,0.2,0.8,0.058823529411764705,0.9411764705882353
SF-K30-2,SF-M28,28,24,2,3,26,21,0.07142857142857142,0.9285714285714286,0.125,0.875
SF-K30-2,SF-L25,9,11,5,5,4,6,0.5555555555555556,0.4444444444444444,0.45454545454545453,0.5454545454545454
SF-K30-2,SF-M24,5,12,3,10,2,2,0.6,0.4,0.8333333333333334,0.16666666666666666
SF-K30-2,SF-L24,3,4,1,2,2,2,0.3333333333333333,0.6666666666666666,0.5,0.5
SF-K30-2,SF-N23,5,1,4,0,1,1,0.8,0.2,0.0,1.0
SF-K30-2,SF-N24-2,3,1,0,0,3,1,0.0,1.0,0.0,1.0
SF-K30-2,SF-K27-2,8,5,7,4,1,1,0.875,0.125,0.8,0.2
SF-K30-2,SF-J26-2,7,9,3,5,4,4,0.42857142857142855,0.5714285714285714,0.5555555555555556,0.4444444444444444
SF-K30-2,SF-L28,7,3,5,3,2,0,0.7142857142857143,0.2857142857142857,1.0,0.0
SF-K30-2,SF-K28,1,1,1,0,0,1,1.0,0.0,0.0,1.0
SF-K30-2,SF-K29-1,41,41,28,30,13,11,0.6829268292682927,0.3170731707317073,0.7317073170731707,0.2682926829268293
SF-K30-2,SF-J28-2,3,6,2,6,1,0,0.6666666666666666,0.3333333333333333,1.0,0.0
SF-K30-2,SF-K27,3,9,2,5,1,4,0.6666666666666666,0.3333333333333333,0.5555555555555556,0.4444444444444444
SF-K30-2,SF-K25,10,3,3,1,7,2,0.3,0.7,0.3333333333333333,0.6666666666666666
SF-K30-2,SF-J25,24,11,4,4,20,7,0.16666666666666666,0.8333333333333334,0.36363636363636365,0.6363636363636364
SF-K30-2,SF-P24,1,2,0,0,1,2,0.0,1.0,0.0,1.0
SF-K30-2,SF-J24,7,2,5,1,2,1,0.7142857142857143,0.2857142857142857,0.5,0.5
SF-K30-2,SF-J26,42,33,33,24,9,9,0.7857142857142857,0.21428571428571427,0.7272727272727273,0.2727272727272727
SF-K30-2,SF-I25,5,7,2,3,3,4,0.4,0.6,0.42857142857142855,0.5714285714285714
SF-K30-2,SF-H26,6,7,4,0,2,7,0.6666666666666666,0.3333333333333333,0.0,1.0
SF-K30-2,SF-O23,15,9,3,3,12,6,0.2,0.8,0.3333333333333333,0.6666666666666666
SF-K30-2,SF-H27-1,6,9,1,7,5,2,0.16666666666666666,0.8333333333333334,0.7777777777777778,0.2222222222222222
SF-K30-2,SF-F28-2,22,11,10,4,12,7,0.45454545454545453,0.5454545454545454,0.36363636363636365,0.6363636363636364
SF-K30-2,SF-G27,29,12,12,4,17,8,0.41379310344827586,0.5862068965517241,0.3333333333333333,0.6666666666666666
SF-K30-2,SF-M22-2,2,3,1,2,1,1,0.5,0.5,0.6666666666666666,0.3333333333333333
SF-K30-2,SF-F27,57,74,9,15,48,59,0.15789473684210525,0.8421052631578947,0.20270270270270271,0.7972972972972973
SF-K30-2,SF-N22-2,6,5,1,2,5,3,0.16666666666666666,0.8333333333333334,0.4,0.6
SF-K30-2,SF-G28-2,2,4,2,1,0,3,1.0,0.0,0.25,0.75
SF-K30-2,SF-G28-1,4,3,2,1,2,2,0.5,0.5,0.3333333333333333,0.6666666666666666
SF-K30-2,SF-M22-1,5,2,4,1,1,1,0.8,0.2,0.5,0.5
SF-K30-2,SF-O25-1,1,1,0,0,1,1,0.0,1.0,0.0,1.0
SF-K30-2,SF-K22-2,2,4,2,2,0,2,1.0,0.0,0.5,0.5
SF-K30-2,SF-K24,2,4,1,0,1,4,0.5,0.5,0.0,1.0
SF-K30-2,SF-J23-2,1,1,1,1,0,0,1.0,0.0,1.0,0.0
SF-K30-2,SF-G24,8,2,3,0,5,2,0.375,0.625,0.0,1.0
SF-K30-2,SF-G25,5,2,4,1,1,1,0.8,0.2,0.5,0.5
SF-K30-2,SF-F23,1,1,0,0,1,1,0.0,1.0,0.0,1.0
SF-K30-2,SF-E23,1,6,0,2,1,4,0.0,1.0,0.3333333333333333,0.6666666666666666
SF-K30-2,SF-C22,1,2,1,1,0,1,1.0,0.0,0.5,0.5
SF-K30-2,SF-B22,4,10,0,5,4,5,0.0,1.0,0.5,0.5
SF-K30-2,SF-J17,5,2,5,0,0,2,1.0,0.0,0.0,1.0
SF-K30-2,SF-I20,2,5,1,2,1,3,0.5,0.5,0.4,0.6
SF-K30-2,SF-H30,22,31,16,27,6,4,0.7272727272727273,0.2727272727272727,0.8709677419354839,0.12903225806451613
SF-K30-2,SF-G30-2,23,9,13,6,10,3,0.5652173913043478,0.43478260869565216,0.6666666666666666,0.3333333333333333
SF-K30-2,SF-F30-1,30,12,22,7,8,5,0.7333333333333333,0.26666666666666666,0.5833333333333334,0.4166666666666667
SF-K30-2,SF-E29-2,54,111,22,64,32,47,0.4074074074074074,0.5925925925925926,0.5765765765765766,0.42342342342342343
SF-K30-2,SF-E29-1,39,41,24,24,15,17,0.6153846153846154,0.38461538461538464,0.5853658536585366,0.4146341463414634
SF-K30-2,SF-D29,24,32,15,29,9,3,0.625,0.375,0.90625,0.09375
SF-K30-2,SF-D28,15,9,9,3,6,6,0.6,0.4,0.3333333333333333,0.6666666666666666
SF-K30-2,SF-A27,22,11,18,9,4,2,0.8181818181818182,0.18181818181818182,0.8181818181818182,0.18181818181818182
SF-K30-2,SF-G29-2,12,13,8,9,4,4,0.6666666666666666,0.3333333333333333,0.6923076923076923,0.3076923076923077
SF-K30-2,SF-G29-1,4,4,2,4,2,0,0.5,0.5,1.0,0.0
SF-K30-2,SF-G30-1,22,12,13,7,9,5,0.5909090909090909,0.4090909090909091,0.5833333333333334,0.4166666666666667
SF-K30-2,SF-G29-3,4,1,3,1,1,0,0.75,0.25,1.0,0.0
SF-K30-2,SF-F30-2,50,42,46,41,4,1,0.92,0.08,0.9761904761904762,0.023809523809523808
SF-K30-2,SF-E29-3,79,30,77,29,2,1,0.9746835443037974,0.02531645569620253,0.9666666666666667,0.03333333333333333
SF-K30-2,SF-F28-1,2,5,1,2,1,3,0.5,0.5,0.4,0.6
SF-K30-2,SF-E28-2,1,1,0,1,1,0,0.0,1.0,1.0,0.0
SF-K30-2,SF-E28,4,5,1,4,3,1,0.25,0.75,0.8,0.2
SF-K30-2,SF-J15,1,1,0,0,1,1,0.0,1.0,0.0,1.0
SF-K30-2,SF-F15,1,3,0,0,1,3,0.0,1.0,0.0,1.0
SF-K30-2,SF-C20,3,2,0,2,3,0,0.0,1.0,1.0,0.0
SF-K30-2,SF-B19,5,4,0,0,5,4,0.0,1.0,0.0,1.0
SF-K30-2,SF-A20,2,2,2,0,0,2,1.0,0.0,0.0,1.0
SF-K30-2,SF-A19,1,3,0,2,1,1,0.0,1.0,0.6666666666666666,0.3333333333333333
SF-K30-2,SF-C26,11,16,4,4,7,12,0.36363636363636365,0.6363636363636364,0.25,0.75
SF-K30-2,SF-C25,6,4,0,0,6,4,0.0,1.0,0.0,1.0
SF-K30-2,SF-B25,6,5,0,0,6,5,0.0,1.0,0.0,1.0
SF-K30-2,SF-E27,3,5,3,3,0,2,1.0,0.0,0.6,0.4
SF-K30-2,SF-D27,8,3,7,3,1,0,0.875,0.125,1.0,0.0
SF-K30-2,SF-C28-2,4,3,2,2,2,1,0.5,0.5,0.6666666666666666,0.3333333333333333
SF-K30-2,SF-C28-1,3,1,3,0,0,1,1.0,0.0,0.0,1.0
SF-K30-2,SF-B28,19,45,16,45,3,0,0.8421052631578947,0.15789473684210525,1.0,0.0
SF-K30-2,SF-F9,1,2,0,2,1,0,0.0,1.0,1.0,0.0
SF-K30-2,SF-G26,4,2,1,1,3,1,0.25,0.75,0.5,0.5
SF-K30-2,SF-K22-1,8,21,4,11,4,10,0.5,0.5,0.5238095238095238,0.47619047619047616
SF-K30-2,SF-J23-1,9,8,1,6,8,2,0.1111111111111111,0.8888888888888888,0.75,0.25
SF-K30-2,SF-J22-1,1,9,0,0,1,9,0.0,1.0,0.0,1.0
SF-K30-2,SF-J22-2,4,9,2,3,2,6,0.5,0.5,0.3333333333333333,0.6666666666666666
SF-K30-2,SF-J21,3,5,1,2,2,3,0.3333333333333333,0.6666666666666666,0.4,0.6
SF-K30-2,SF-I23-2,1,1,1,1,0,0,1.0,0.0,1.0,0.0
SF-K30-2,SF-I24,2,3,0,1,2,2,0.0,1.0,0.3333333333333333,0.6666666666666666
SF-K30-2,SF-F26,13,11,5,4,8,7,0.38461538461538464,0.6153846153846154,0.36363636363636365,0.6363636363636364
SF-K30-2,SF-M13,72,3,56,1,16,2,0.7777777777777778,0.2222222222222222,0.3333333333333333,0.6666666666666666
SF-K30-2,SF-M15,6,1,3,0,3,1,0.5,0.5,0.0,1.0
SF-K30-2,SF-L19,2,4,1,1,1,3,0.5,0.5,0.25,0.75
SF-K30-2,SF-L20,6,2,6,2,0,0,1.0,0.0,1.0,0.0
SF-K30-2,SF-N20-1,2,4,2,0,0,4,1.0,0.0,0.0,1.0
SF-K30-2,SF-M20,19,2,16,1,3,1,0.8421052631578947,0.15789473684210525,0.5,0.5
SF-K30-2,SF-K20,4,94,4,93,0,1,1.0,0.0,0.9893617021276596,0.010638297872340425
SF-K30-2,SF-K15-,2,2,2,2,0,0,1.0,0.0,1.0,0.0
SF-K30-2,SF-K19,21,3,20,2,1,1,0.9523809523809523,0.047619047619047616,0.6666666666666666,0.3333333333333333
SF-K30-2,SF-K18,4,5,0,1,4,4,0.0,1.0,0.2,0.8
SF-K30-2,SF-K17,1,1,1,0,0,1,1.0,0.0,0.0,1.0
SF-K30-2,SF-J16,1,1,0,0,1,1,0.0,1.0,0.0,1.0
SF-K30-2,SF-J20,1,2,1,0,0,2,1.0,0.0,0.0,1.0
SF-K30-2,SF-J19,1,2,0,0,1,2,0.0,1.0,0.0,1.0
SF-K30-2,SF-O18,1,2,0,0,1,2,0.0,1.0,0.0,1.0
SF-K30-2,SF-O21,5,2,2,0,3,2,0.4,0.6,0.0,1.0
SF-K30-2,SF-O22,1,7,0,3,1,4,0.0,1.0,0.42857142857142855,0.5714285714285714
SF-K30-2,SF-N21,2,2,1,0,1,2,0.5,0.5,0.0,1.0
SF-K30-2,SF-N20-2,1,2,0,0,1,2,0.0,1.0,0.0,1.0
SF-K30-2,SF-M21,4,3,2,0,2,3,0.5,0.5,0.0,1.0
SF-K30-2,SF-L21,1,10,0,1,1,9,0.0,1.0,0.1,0.9
SF-K30-2,SF-S29,1,4,0,2,1,2,0.0,1.0,0.5,0.5
SF-K30-2,SF-S30,3,3,0,1,3,2,0.0,1.0,0.3333333333333333,0.6666666666666666
SF-K30-2,SF-Q30,15,36,5,22,10,14,0.3333333333333333,0.6666666666666666,0.6111111111111112,0.3888888888888889
SF-K30-2,SF-P30,27,21,11,11,16,10,0.4074074074074074,0.5925925925925926,0.5238095238095238,0.47619047619047616
SF-K30-2,SF-O30-2,18,25,15,22,3,3,0.8333333333333334,0.16666666666666666,0.88,0.12
SF-K30-2,SF-O30,64,60,47,40,17,20,0.734375,0.265625,0.6666666666666666,0.3333333333333333
SF-K30-2,SF-N27,11,21,4,11,7,10,0.36363636363636365,0.6363636363636364,0.5238095238095238,0.47619047619047616
SF-K30-2,SF-N29,10,13,7,8,3,5,0.7,0.3,0.6153846153846154,0.38461538461538464
SF-K30-2,SF-N28,6,13,4,6,2,7,0.6666666666666666,0.3333333333333333,0.46153846153846156,0.5384615384615384
SF-K30-2,SF-L30-1,25,28,18,22,7,6,0.72,0.28,0.7857142857142857,0.21428571428571427
SF-K30-2,SF-L31-1,21,24,18,24,3,0,0.8571428571428571,0.14285714285714285,1.0,0.0
SF-K30-2,SF-L29,23,26,21,22,2,4,0.9130434782608695,0.08695652173913043,0.8461538461538461,0.15384615384615385
SF-K30-2,SF-J29-1,30,18,15,15,15,3,0.5,0.5,0.8333333333333334,0.16666666666666666
SF-K30-2,SF-I30,84,15,61,11,23,4,0.7261904761904762,0.27380952380952384,0.7333333333333333,0.26666666666666666
SF-K30-2,SF-I29-2,5,11,1,9,4,2,0.2,0.8,0.8181818181818182,0.18181818181818182
SF-K30-2,SF-I27,5,10,3,5,2,5,0.6,0.4,0.5,0.5
SF-K30-2,SF-I28,9,5,6,3,3,2,0.6666666666666666,0.3333333333333333,0.6,0.4
SF-K30-2,SF-I30-2,7,5,4,1,3,4,0.5714285714285714,0.42857142857142855,0.2,0.8
SF-K30-2,SF I29-1,8,5,1,2,7,3,0.125,0.875,0.4,0.6
SF-K30-2,SF-H28,10,9,4,5,6,4,0.4,0.6,0.5555555555555556,0.4444444444444444
SF-K30-2,SF-H29,6,11,5,4,1,7,0.8333333333333334,0.16666666666666666,0.36363636363636365,0.6363636363636364
SF-K30-2,SF-R24,4,3,3,1,1,2,0.75,0.25,0.3333333333333333,0.6666666666666666
SF-K30-2,SF-R26,2,3,1,2,1,1,0.5,0.5,0.6666666666666666,0.3333333333333333
SF-K30-2,SF-Q26,3,8,1,4,2,4,0.3333333333333333,0.6666666666666666,0.5,0.5
SF-K30-2,SF-P26,2,3,1,0,1,3,0.5,0.5,0.0,1.0
SF-K30-2,SF-N22-1B,20,34,19,34,1,0,0.95,0.05,1.0,0.0
SF-K30-2,SF-N26,1,2,1,1,0,1,1.0,0.0,0.5,0.5
SF-K30-2,SF-N25,4,2,2,0,2,2,0.5,0.5,0.0,1.0
SF-K30-2,SF-T22,1,1,1,0,0,1,1.0,0.0,0.0,1.0
SF-K30-2,SF-Q23-3,4,1,1,0,3,1,0.25,0.75,0.0,1.0
SF-K30-2,SF-Q22-1,2,6,0,5,2,1,0.0,1.0,0.8333333333333334,0.16666666666666666
SF-K30-2,SF-Q22-2,3,2,3,0,0,2,1.0,0.0,0.0,1.0
SF-K30-2,SF-P22,2,1,1,0,1,1,0.5,0.5,0.0,1.0
SF-K30-2,SF-Y27,1,1,0,0,1,1,0.0,1.0,0.0,1.0
SF-K30-2,SF-V28,12,8,0,0,12,8,0.0,1.0,0.0,1.0
SF-K30-2,SF-V29,2,1,1,1,1,0,0.5,0.5,1.0,0.0
SF-K30-2,SF-U30,5,1,3,1,2,0,0.6,0.4,1.0,0.0
SF-L29,SF-M26,14,8,7,5,7,3,0.5,0.5,0.625,0.375
SF-L29,SF-M25,10,6,5,4,5,2,0.5,0.5,0.6666666666666666,0.3333333333333333
SF-L29,SF-M26-2,76,72,34,32,42,40,0.4473684210526316,0.5526315789473685,0.4444444444444444,0.5555555555555556
SF-L29,SF-L27,12,5,9,4,3,1,0.75,0.25,0.8,0.2
SF-L29,SF-K26,51,22,39,16,12,6,0.7647058823529411,0.23529411764705882,0.7272727272727273,0.2727272727272727
SF-L29,SF-J27,8,21,3,8,5,13,0.375,0.625,0.38095238095238093,0.6190476190476191
SF-L29,SF-M30,89,89,37,37,52,52,0.4157303370786517,0.5842696629213483,0.4157303370786517,0.5842696629213483
SF-L29,SF-L27-2,8,33,6,19,2,14,0.75,0.25,0.5757575757575758,0.42424242424242425
SF-L29,SF-J29-3,71,27,57,17,14,10,0.8028169014084507,0.19718309859154928,0.6296296296296297,0.37037037037037035
SF-L29,SF-J29,27,38,15,32,12,6,0.5555555555555556,0.4444444444444444,0.8421052631578947,0.15789473684210525
SF-L29,SF-L26,73,72,23,28,50,44,0.3150684931506849,0.684931506849315,0.3888888888888889,0.6111111111111112
SF-L29,SF-M28,24,33,14,26,10,7,0.5833333333333334,0.4166666666666667,0.7878787878787878,0.21212121212121213
SF-L29,SF-M27,2,8,2,7,0,1,1.0,0.0,0.875,0.125
SF-L29,SF-L25,18,29,10,19,8,10,0.5555555555555556,0.4444444444444444,0.6551724137931034,0.3448275862068966
SF-L29,SF-M24,13,17,7,10,6,7,0.5384615384615384,0.46153846153846156,0.5882352941176471,0.4117647058823529
SF-L29,SF-L24,15,11,7,10,8,1,0.4666666666666667,0.5333333333333333,0.9090909090909091,0.09090909090909091
SF-L29,SF-N23,3,11,2,7,1,4,0.6666666666666666,0.3333333333333333,0.6363636363636364,0.36363636363636365
SF-L29,SF-N24-2,6,15,0,7,6,8,0.0,1.0,0.4666666666666667,0.5333333333333333
SF-L29,SF-K27-2,34,41,25,29,9,12,0.7352941176470589,0.2647058823529412,0.7073170731707317,0.2926829268292683
SF-L29,SF-J26-2,26,43,13,30,13,13,0.5,0.5,0.6976744186046512,0.3023255813953488
SF-L29,SF-L28,69,54,50,35,19,19,0.7246376811594203,0.2753623188405797,0.6481481481481481,0.35185185185185186
SF-L29,SF-K28,13,35,13,35,0,0,1.0,0.0,1.0,0.0
SF-L29,SF-K29-1,94,207,83,192,11,15,0.8829787234042553,0.11702127659574468,0.927536231884058,0.07246376811594203
SF-L29,SF-J28-2,24,13,18,10,6,3,0.75,0.25,0.7692307692307693,0.23076923076923078
SF-L29,SF-K27,6,9,3,4,3,5,0.5,0.5,0.4444444444444444,0.5555555555555556
SF-L29,SF-K25,7,9,2,6,5,3,0.2857142857142857,0.7142857142857143,0.6666666666666666,0.3333333333333333
SF-L29,SF-J25,35,27,24,15,11,12,0.6857142857142857,0.3142857142857143,0.5555555555555556,0.4444444444444444
SF-L29,SF-H26-2,20,14,10,5,10,9,0.5,0.5,0.35714285714285715,0.6428571428571429
SF-L29,SF-P24,3,3,2,3,1,0,0.6666666666666666,0.3333333333333333,1.0,0.0
SF-L29,SF-N22-1A,1,3,0,2,1,1,0.0,1.0,0.6666666666666666,0.3333333333333333
SF-L29,SF-J24,33,17,14,7,19,10,0.42424242424242425,0.5757575757575758,0.4117647058823529,0.5882352941176471
SF-L29,SF-J26,19,21,8,5,11,16,0.42105263157894735,0.5789473684210527,0.23809523809523808,0.7619047619047619
SF-L29,SF-I26-,1,4,0,3,1,1,0.0,1.0,0.75,0.25
SF-L29,SF-I25,13,36,6,15,7,21,0.46153846153846156,0.5384615384615384,0.4166666666666667,0.5833333333333334
SF-L29,SF-K23,1,4,0,3,1,1,0.0,1.0,0.75,0.25
SF-L29,SF-H26,37,38,18,20,19,18,0.4864864864864865,0.5135135135135135,0.5263157894736842,0.47368421052631576
SF-L29,SF-H27-1,34,29,18,18,16,11,0.5294117647058824,0.47058823529411764,0.6206896551724138,0.3793103448275862
SF-L29,SF-F28-2,87,67,17,5,70,62,0.19540229885057472,0.8045977011494253,0.07462686567164178,0.9253731343283582
SF-L29,SF-G27,73,48,25,22,48,26,0.3424657534246575,0.6575342465753424,0.4583333333333333,0.5416666666666666
SF-L29,SF-M22-2,10,8,2,5,8,3,0.2,0.8,0.625,0.375
SF-L29,SF-L22,5,11,3,4,2,7,0.6,0.4,0.36363636363636365,0.6363636363636364
SF-L29,SF-F27,20,27,10,12,10,15,0.5,0.5,0.4444444444444444,0.5555555555555556
SF-L29,SF-N22-2,24,36,11,22,13,14,0.4583333333333333,0.5416666666666666,0.6111111111111112,0.3888888888888889
SF-L29,SF-G28-2,13,13,4,2,9,11,0.3076923076923077,0.6923076923076923,0.15384615384615385,0.8461538461538461
SF-L29,SF-G28-1,6,12,3,5,3,7,0.5,0.5,0.4166666666666667,0.5833333333333334
SF-L29,SF-M22-1,16,5,11,3,5,2,0.6875,0.3125,0.6,0.4
SF-L29,SF-O25-1,1,20,0,10,1,10,0.0,1.0,0.5,0.5
SF-L29,SF-K22-2,6,2,4,0,2,2,0.6666666666666666,0.3333333333333333,0.0,1.0
SF-L29,SF-K24,4,16,3,9,1,7,0.75,0.25,0.5625,0.4375
SF-L29,SF-J23-2,5,3,3,2,2,1,0.6,0.4,0.6666666666666666,0.3333333333333333
SF-L29,SF-G23,7,5,1,0,6,5,0.14285714285714285,0.8571428571428571,0.0,1.0
SF-L29,SF-G24,38,3,1,0,37,3,0.02631578947368421,0.9736842105263158,0.0,1.0
SF-L29,SF-G25,9,33,3,2,6,31,0.3333333333333333,0.6666666666666666,0.06060606060606061,0.9393939393939394
SF-L29,SF-F23,4,1,2,0,2,1,0.5,0.5,0.0,1.0
SF-L29,SF-E23,4,7,1,2,3,5,0.25,0.75,0.2857142857142857,0.7142857142857143
SF-L29,SF-C22,3,2,0,0,3,2,0.0,1.0,0.0,1.0
SF-L29,SF-B22,6,12,2,7,4,5,0.3333333333333333,0.6666666666666666,0.5833333333333334,0.4166666666666667
SF-L29,SF-J17,3,6,1,3,2,3,0.3333333333333333,0.6666666666666666,0.5,0.5
SF-L29,SF-I20,7,13,5,4,2,9,0.7142857142857143,0.2857142857142857,0.3076923076923077,0.6923076923076923
SF-L29,SF-H20,3,5,1,5,2,0,0.3333333333333333,0.6666666666666666,1.0,0.0
SF-L29,SF-H17,1,2,0,1,1,1,0.0,1.0,0.5,0.5
SF-L29,SF-G19,7,3,4,1,3,2,0.5714285714285714,0.42857142857142855,0.3333333333333333,0.6666666666666666
SF-L29,SF-G18,4,3,2,0,2,3,0.5,0.5,0.0,1.0
SF-L29,SF-G20,7,4,2,0,5,4,0.2857142857142857,0.7142857142857143,0.0,1.0
SF-L29,SF-E20,4,2,2,0,2,2,0.5,0.5,0.0,1.0
SF-L29,SF-H30,76,53,53,29,23,24,0.6973684210526315,0.3026315789473684,0.5471698113207547,0.4528301886792453
SF-L29,SF-G30-2,43,16,24,7,19,9,0.5581395348837209,0.4418604651162791,0.4375,0.5625
SF-L29,SF-F30-1,36,39,27,28,9,11,0.75,0.25,0.717948717948718,0.28205128205128205
SF-L29,SF-E29-2,62,55,33,28,29,27,0.532258064516129,0.46774193548387094,0.509090909090909,0.4909090909090909
SF-L29,SF-E29-1,57,87,29,49,28,38,0.5087719298245614,0.49122807017543857,0.5632183908045977,0.4367816091954023
SF-L29,SF-D29,47,59,28,41,19,18,0.5957446808510638,0.40425531914893614,0.6949152542372882,0.3050847457627119
SF-L29,SF-D28,4,5,1,2,3,3,0.25,0.75,0.4,0.6
SF-L29,SF-A27,26,17,11,9,15,8,0.4230769230769231,0.5769230769230769,0.5294117647058824,0.47058823529411764
SF-L29,SF-G29-2,35,21,21,13,14,8,0.6,0.4,0.6190476190476191,0.38095238095238093
SF-L29,SF-G29-1,16,4,1,1,15,3,0.0625,0.9375,0.25,0.75
SF-L29,SF-G30-1,34,36,26,23,8,13,0.7647058823529411,0.23529411764705882,0.6388888888888888,0.3611111111111111
SF-L29,SF-G29-3,26,16,19,13,7,3,0.7307692307692307,0.2692307692307692,0.8125,0.1875
SF-L29,SF-F30-2,47,50,38,37,9,13,0.8085106382978723,0.19148936170212766,0.74,0.26
SF-L29,SF-F29,23,24,11,5,12,19,0.4782608695652174,0.5217391304347826,0.20833333333333334,0.7916666666666666
SF-L29,SF-E29-3,5,2,1,1,4,1,0.2,0.8,0.5,0.5
SF-L29,SF-F28-1,6,6,3,0,3,6,0.5,0.5,0.0,1.0
SF-L29,SF-E28-2,7,6,1,2,6,4,0.14285714285714285,0.8571428571428571,0.3333333333333333,0.6666666666666666
SF-L29,SF-E28,8,9,6,4,2,5,0.75,0.25,0.4444444444444444,0.5555555555555556
SF-L29,SF-G12,2,1,0,0,2,1,0.0,1.0,0.0,1.0
SF-L29,SF-F15,4,3,4,0,0,3,1.0,0.0,0.0,1.0
SF-L29,SF-F16,2,1,0,1,2,0,0.0,1.0,1.0,0.0
SF-L29,SF-C20,25,25,0,3,25,22,0.0,1.0,0.12,0.88
SF-L29,SF-B19,7,3,2,0,5,3,0.2857142857142857,0.7142857142857143,0.0,1.0
SF-L29,SF-A20,8,17,2,7,6,10,0.25,0.75,0.4117647058823529,0.5882352941176471
SF-L29,SF-A19,2,2,1,1,1,1,0.5,0.5,0.5,0.5
SF-L29,SF-C26,7,19,1,0,6,19,0.14285714285714285,0.8571428571428571,0.0,1.0
SF-L29,SF-C25,4,14,0,3,4,11,0.0,1.0,0.21428571428571427,0.7857142857142857
SF-L29,SF-B25,8,10,3,6,5,4,0.375,0.625,0.6,0.4
SF-L29,SF-E27,11,26,0,0,11,26,0.0,1.0,0.0,1.0
SF-L29,SF-B28-2,7,4,2,0,5,4,0.2857142857142857,0.7142857142857143,0.0,1.0
SF-L29,SF-D27,18,27,9,9,9,18,0.5,0.5,0.3333333333333333,0.6666666666666666
SF-L29,SF-C28-2,7,5,3,2,4,3,0.42857142857142855,0.5714285714285714,0.4,0.6
SF-L29,SF-C28-1,8,9,6,9,2,0,0.75,0.25,1.0,0.0
SF-L29,SF-B28,23,31,18,17,5,14,0.782608695652174,0.21739130434782608,0.5483870967741935,0.45161290322580644
SF-L29,SF-J1,3,3,0,0,3,3,0.0,1.0,0.0,1.0
SF-L29,SF-G5,4,2,0,0,4,2,0.0,1.0,0.0,1.0
SF-L29,SF-G26,41,40,25,20,16,20,0.6097560975609756,0.3902439024390244,0.5,0.5
SF-L29,SF-K21,11,6,3,3,8,3,0.2727272727272727,0.7272727272727273,0.5,0.5
SF-L29,SF-K22-1,6,13,2,3,4,10,0.3333333333333333,0.6666666666666666,0.23076923076923078,0.7692307692307693
SF-L29,SF-J23-1,29,16,11,6,18,10,0.3793103448275862,0.6206896551724138,0.375,0.625
SF-L29,SF-J22-1,7,9,0,2,7,7,0.0,1.0,0.2222222222222222,0.7777777777777778
SF-L29,SF-J22-2,8,13,2,3,6,10,0.25,0.75,0.23076923076923078,0.7692307692307693
SF-L29,SF-J21,16,17,3,2,13,15,0.1875,0.8125,0.11764705882352941,0.8823529411764706
SF-L29,SF-I21,6,3,3,2,3,1,0.5,0.5,0.6666666666666666,0.3333333333333333
SF-L29,SF-I22,8,8,4,1,4,7,0.5,0.5,0.125,0.875
SF-L29,SF-I23-2,4,2,1,2,3,0,0.25,0.75,1.0,0.0
SF-L29,SF-I24,8,8,7,5,1,3,0.875,0.125,0.625,0.375
SF-L29,SF-I23-1,4,13,1,5,3,8,0.25,0.75,0.38461538461538464,0.6153846153846154
SF-L29,SF-F26,23,24,11,9,12,15,0.4782608695652174,0.5217391304347826,0.375,0.625
SF-L29,SF-M13,14,9,5,2,9,7,0.35714285714285715,0.6428571428571429,0.2222222222222222,0.7777777777777778
SF-L29,SF-M15,12,21,11,2,1,19,0.9166666666666666,0.08333333333333333,0.09523809523809523,0.9047619047619048
SF-L29,SF-L19,9,1,3,0,6,1,0.3333333333333333,0.6666666666666666,0.0,1.0
SF-L29,SF-L20,3,4,1,1,2,3,0.3333333333333333,0.6666666666666666,0.25,0.75
SF-L29,SF-N20-1,6,20,1,2,5,18,0.16666666666666666,0.8333333333333334,0.1,0.9
SF-L29,SF-M20,14,11,1,1,13,10,0.07142857142857142,0.9285714285714286,0.09090909090909091,0.9090909090909091
SF-L29,SF-K15-,15,20,3,3,12,17,0.2,0.8,0.15,0.85
SF-L29,SF-K19,8,3,1,0,7,3,0.125,0.875,0.0,1.0
SF-L29,SF-K18,4,4,0,1,4,3,0.0,1.0,0.25,0.75
SF-L29,SF-K17,4,1,2,0,2,1,0.5,0.5,0.0,1.0
SF-L29,SF-J16,2,3,1,1,1,2,0.5,0.5,0.3333333333333333,0.6666666666666666
SF-L29,SF-J18,8,9,0,1,8,8,0.0,1.0,0.1111111111111111,0.8888888888888888
SF-L29,SF-J20,2,5,1,5,1,0,0.5,0.5,1.0,0.0
SF-L29,SF-J19,7,11,4,6,3,5,0.5714285714285714,0.42857142857142855,0.5454545454545454,0.45454545454545453
SF-L29,SF-M12,3,3,1,0,2,3,0.3333333333333333,0.6666666666666666,0.0,1.0
SF-L29,SF-M11,11,2,4,0,7,2,0.36363636363636365,0.6363636363636364,0.0,1.0
SF-L29,SF-Q21-2,3,1,0,0,3,1,0.0,1.0,0.0,1.0
SF-L29,SF-P21,2,9,1,4,1,5,0.5,0.5,0.4444444444444444,0.5555555555555556
SF-L29,SF-O18,2,4,2,1,0,3,1.0,0.0,0.25,0.75
SF-L29,SF-O19,4,8,1,0,3,8,0.25,0.75,0.0,1.0
SF-L29,SF-O21,26,25,5,6,21,19,0.19230769230769232,0.8076923076923077,0.24,0.76
SF-L29,SF-O22,5,5,0,2,5,3,0.0,1.0,0.4,0.6
SF-L29,SF-N21,9,12,2,6,7,6,0.2222222222222222,0.7777777777777778,0.5,0.5
SF-L29,SF-N20-2,4,4,0,0,4,4,0.0,1.0,0.0,1.0
SF-L29,SF-M21,5,6,2,3,3,3,0.4,0.6,0.5,0.5
SF-L29,SF-L21,43,35,2,3,41,32,0.046511627906976744,0.9534883720930233,0.08571428571428572,0.9142857142857143
SF-L29,SF-S29,5,2,3,1,2,1,0.6,0.4,0.5,0.5
SF-L29,SF-S30,35,10,9,5,26,5,0.2571428571428571,0.7428571428571429,0.5,0.5
SF-L29,SF-Q30,27,88,13,22,14,66,0.48148148148148145,0.5185185185185185,0.25,0.75
SF-L29,SF-P30,56,58,26,25,30,33,0.4642857142857143,0.5357142857142857,0.43103448275862066,0.5689655172413793
SF-L29,SF-O30-2,26,21,16,13,10,8,0.6153846153846154,0.38461538461538464,0.6190476190476191,0.38095238095238093
SF-L29,SF-O30,74,92,45,50,29,42,0.6081081081081081,0.3918918918918919,0.5434782608695652,0.45652173913043476
SF-L29,SF-N27,33,25,26,17,7,8,0.7878787878787878,0.21212121212121213,0.68,0.32
SF-L29,SF-N29,6,33,3,17,3,16,0.5,0.5,0.5151515151515151,0.48484848484848486
SF-L29,SF-N28,20,24,19,15,1,9,0.95,0.05,0.625,0.375
SF-L29,SF-L30-1,58,63,44,49,14,14,0.7586206896551724,0.2413793103448276,0.7777777777777778,0.2222222222222222
SF-L29,SF-L31-1,12,14,11,8,1,6,0.9166666666666666,0.08333333333333333,0.5714285714285714,0.42857142857142855
SF-L29,SF-K30-2,26,23,22,21,4,2,0.8461538461538461,0.15384615384615385,0.9130434782608695,0.08695652173913043
SF-L29,SF-J29-1,7,20,5,16,2,4,0.7142857142857143,0.2857142857142857,0.8,0.2
SF-L29,SF-I30,22,21,15,15,7,6,0.6818181818181818,0.3181818181818182,0.7142857142857143,0.2857142857142857
SF-L29,SF-I29-2,11,16,4,15,7,1,0.36363636363636365,0.6363636363636364,0.9375,0.0625
SF-L29,SF-I27,8,15,8,6,0,9,1.0,0.0,0.4,0.6
SF-L29,SF-I28,39,24,25,18,14,6,0.6410256410256411,0.358974358974359,0.75,0.25
SF-L29,SF-I30-2,6,3,2,1,4,2,0.3333333333333333,0.6666666666666666,0.3333333333333333,0.6666666666666666
SF-L29,SF I29-1,6,4,2,1,4,3,0.3333333333333333,0.6666666666666666,0.25,0.75
SF-L29,SF-H28,17,10,7,6,10,4,0.4117647058823529,0.5882352941176471,0.6,0.4
SF-L29,SF-H29,7,8,4,5,3,3,0.5714285714285714,0.42857142857142855,0.625,0.375
SF-L29,SF-S24,8,7,0,0,8,7,0.0,1.0,0.0,1.0
SF-L29,SF-R24,4,4,2,2,2,2,0.5,0.5,0.5,0.5
SF-L29,SF-R26,2,1,1,0,1,1,0.5,0.5,0.0,1.0
SF-L29,SF-Q26,2,2,2,1,0,1,1.0,0.0,0.5,0.5
SF-L29,SF-P26,36,29,4,5,32,24,0.1111111111111111,0.8888888888888888,0.1724137931034483,0.8275862068965517
SF-L29,SF-O25-2,3,9,0,2,3,7,0.0,1.0,0.2222222222222222,0.7777777777777778
SF-L29,SF-N22-1B,3,5,2,1,1,4,0.6666666666666666,0.3333333333333333,0.2,0.8
SF-L29,SF-N26,19,14,10,3,9,11,0.5263157894736842,0.47368421052631576,0.21428571428571427,0.7857142857142857
SF-L29,SF-N25,10,18,7,13,3,5,0.7,0.3,0.7222222222222222,0.2777777777777778
SF-L29,SF-T22,3,3,1,1,2,2,0.3333333333333333,0.6666666666666666,0.3333333333333333,0.6666666666666666
SF-L29,SF-S22-1,2,6,0,2,2,4,0.0,1.0,0.3333333333333333,0.6666666666666666
SF-L29,SF-Q23-3,3,3,0,1,3,2,0.0,1.0,0.3333333333333333,0.6666666666666666
SF-L29,SF-Q22-1,3,6,1,3,2,3,0.3333333333333333,0.6666666666666666,0.5,0.5
SF-L29,SF-P22,5,4,0,0,5,4,0.0,1.0,0.0,1.0
SF-L29,SF-Z28,10,12,10,12,0,0,1.0,0.0,1.0,0.0
SF-L29,SF-V29,2,3,1,3,1,0,0.5,0.5,1.0,0.0
SF-L29,SF-V30,5,7,3,5,2,2,0.6,0.4,0.7142857142857143,0.2857142857142857
SF-L29,SF-V32,1,1,0,1,1,0,0.0,1.0,1.0,0.0
SF-L29,SF-Y25,11,33,2,25,9,8,0.18181818181818182,0.8181818181818182,0.7575757575757576,0.24242424242424243
SF-J29-1,SF-M26,2,2,1,0,1,2,0.5,0.5,0.0,1.0
SF-J29-1,SF-M25,1,5,0,3,1,2,0.0,1.0,0.6,0.4
SF-J29-1,SF-M26-2,12,16,7,12,5,4,0.5833333333333334,0.4166666666666667,0.75,0.25
SF-J29-1,SF-L27,20,18,13,14,7,4,0.65,0.35,0.7777777777777778,0.2222222222222222
SF-J29-1,SF-K26,4,18,0,14,4,4,0.0,1.0,0.7777777777777778,0.2222222222222222
SF-J29-1,SF-J27,9,15,3,8,6,7,0.3333333333333333,0.6666666666666666,0.5333333333333333,0.4666666666666667
SF-J29-1,SF-M30,19,23,9,13,10,10,0.47368421052631576,0.5263157894736842,0.5652173913043478,0.43478260869565216
SF-J29-1,SF-L27-2,5,3,5,2,0,1,1.0,0.0,0.6666666666666666,0.3333333333333333
SF-J29-1,SF-J29-3,20,6,17,3,3,3,0.85,0.15,0.5,0.5
SF-J29-1,SF-J29,28,15,14,11,14,4,0.5,0.5,0.7333333333333333,0.26666666666666666
SF-J29-1,SF-L26,34,42,17,25,17,17,0.5,0.5,0.5952380952380952,0.40476190476190477
SF-J29-1,SF-M28,10,8,3,3,7,5,0.3,0.7,0.375,0.625
SF-J29-1,SF-L25,6,10,2,4,4,6,0.3333333333333333,0.6666666666666666,0.4,0.6
SF-J29-1,SF-M24,5,8,3,5,2,3,0.6,0.4,0.625,0.375
SF-J29-1,SF-L24,1,3,1,1,0,2,1.0,0.0,0.3333333333333333,0.6666666666666666
SF-J29-1,SF-N23,7,8,6,5,1,3,0.8571428571428571,0.14285714285714285,0.625,0.375
SF-J29-1,SF-K27-2,12,27,9,17,3,10,0.75,0.25,0.6296296296296297,0.37037037037037035
SF-J29-1,SF-J26-2,14,39,8,15,6,24,0.5714285714285714,0.42857142857142855,0.38461538461538464,0.6153846153846154
SF-J29-1,SF-K28-3,1,5,1,2,0,3,1.0,0.0,0.4,0.6
SF-J29-1,SF-L28,10,10,9,6,1,4,0.9,0.1,0.6,0.4
SF-J29-1,SF-K28,7,16,3,13,4,3,0.42857142857142855,0.5714285714285714,0.8125,0.1875
SF-J29-1,SF-K29-1,40,16,32,12,8,4,0.8,0.2,0.75,0.25
SF-J29-1,SF-J28-2,8,4,6,4,2,0,0.75,0.25,1.0,0.0
SF-J29-1,SF-K27,3,2,2,1,1,1,0.6666666666666666,0.3333333333333333,0.5,0.5
SF-J29-1,SF-K25,7,12,5,7,2,5,0.7142857142857143,0.2857142857142857,0.5833333333333334,0.4166666666666667
SF-J29-1,SF-J25,25,10,12,6,13,4,0.48,0.52,0.6,0.4
SF-J29-1,SF-H26-2,15,14,8,7,7,7,0.5333333333333333,0.4666666666666667,0.5,0.5
SF-J29-1,SF-P24,3,3,0,0,3,3,0.0,1.0,0.0,1.0
SF-J29-1,SF-J24,24,23,20,14,4,9,0.8333333333333334,0.16666666666666666,0.6086956521739131,0.391304347826087
SF-J29-1,SF-O24,5,2,0,0,5,2,0.0,1.0,0.0,1.0
SF-J29-1,SF-J26,3,6,2,4,1,2,0.6666666666666666,0.3333333333333333,0.6666666666666666,0.3333333333333333
SF-J29-1,SF-I26-,3,6,2,4,1,2,0.6666666666666666,0.3333333333333333,0.6666666666666666,0.3333333333333333
SF-J29-1,SF-I25,10,5,5,2,5,3,0.5,0.5,0.4,0.6
SF-J29-1,SF-H26,17,14,10,7,7,7,0.5882352941176471,0.4117647058823529,0.5,0.5
SF-J29-1,SF-H27-1,21,33,15,18,6,15,0.7142857142857143,0.2857142857142857,0.5454545454545454,0.45454545454545453
SF-J29-1,SF-F28-2,32,29,19,16,13,13,0.59375,0.40625,0.5517241379310345,0.4482758620689655
SF-J29-1,SF-G27,46,37,28,22,18,15,0.6086956521739131,0.391304347826087,0.5945945945945946,0.40540540540540543
SF-J29-1,SF-M22-2,3,4,1,0,2,4,0.3333333333333333,0.6666666666666666,0.0,1.0
SF-J29-1,SF-L22,5,7,0,0,5,7,0.0,1.0,0.0,1.0
SF-J29-1,SF-F27,8,49,5,19,3,30,0.625,0.375,0.3877551020408163,0.6122448979591837
SF-J29-1,SF-N22-2,7,17,4,8,3,9,0.5714285714285714,0.42857142857142855,0.47058823529411764,0.5294117647058824
SF-J29-1,SF-G28-2,19,17,6,11,13,6,0.3157894736842105,0.6842105263157895,0.6470588235294118,0.35294117647058826
SF-J29-1,SF-G28-1,12,16,6,7,6,9,0.5,0.5,0.4375,0.5625
SF-J29-1,SF-M22-1,12,10,11,7,1,3,0.9166666666666666,0.08333333333333333,0.7,0.3
SF-J29-1,SF-K22-2,20,3,3,1,17,2,0.15,0.85,0.3333333333333333,0.6666666666666666
SF-J29-1,SF-K24,2,4,0,2,2,2,0.0,1.0,0.5,0.5
SF-J29-1,SF-G23,2,1,0,0,2,1,0.0,1.0,0.0,1.0
SF-J29-1,SF-G24,49,15,10,1,39,14,0.20408163265306123,0.7959183673469388,0.06666666666666667,0.9333333333333333
SF-J29-1,SF-G25,42,19,10,2,32,17,0.23809523809523808,0.7619047619047619,0.10526315789473684,0.8947368421052632
SF-J29-1,SF-F23,3,3,0,0,3,3,0.0,1.0,0.0,1.0
SF-J29-1,SF-C22,2,2,2,0,0,2,1.0,0.0,0.0,1.0
SF-J29-1,SF-B22,1,6,0,5,1,1,0.0,1.0,0.8333333333333334,0.16666666666666666
SF-J29-1,SF-J17,2,1,1,0,1,1,0.5,0.5,0.0,1.0
SF-J29-1,SF-I19,1,3,0,0,1,3,0.0,1.0,0.0,1.0
SF-J29-1,SF-I20,3,1,0,0,3,1,0.0,1.0,0.0,1.0
SF-J29-1,SF-H20,1,2,0,0,1,2,0.0,1.0,0.0,1.0
SF-J29-1,SF-G18,1,1,1,0,0,1,1.0,0.0,0.0,1.0
SF-J29-1,SF-G20,2,7,1,0,1,7,0.5,0.5,0.0,1.0
SF-J29-1,SF-F19,1,1,0,0,1,1,0.0,1.0,0.0,1.0
SF-J29-1,SF-H30,52,26,32,17,20,9,0.6153846153846154,0.38461538461538464,0.6538461538461539,0.34615384615384615
SF-J29-1,SF-G30-2,72,34,50,22,22,12,0.6944444444444444,0.3055555555555556,0.6470588235294118,0.35294117647058826
SF-J29-1,SF-F30-1,32,15,16,8,16,7,0.5,0.5,0.5333333333333333,0.4666666666666667
SF-J29-1,SF-E29-2,121,102,115,94,6,8,0.9504132231404959,0.049586776859504134,0.9215686274509803,0.0784313725490196
SF-J29-1,SF-E29-1,101,53,59,43,42,10,0.5841584158415841,0.4158415841584158,0.8113207547169812,0.18867924528301888
SF-J29-1,SF-D29,22,36,17,24,5,12,0.7727272727272727,0.22727272727272727,0.6666666666666666,0.3333333333333333
SF-J29-1,SF-D28,13,7,6,1,7,6,0.46153846153846156,0.5384615384615384,0.14285714285714285,0.8571428571428571
SF-J29-1,SF-A27,55,46,23,35,32,11,0.41818181818181815,0.5818181818181818,0.7608695652173914,0.2391304347826087
SF-J29-1,SF-G29-2,29,22,15,13,14,9,0.5172413793103449,0.4827586206896552,0.5909090909090909,0.4090909090909091
SF-J29-1,SF-G29-1,32,30,15,12,17,18,0.46875,0.53125,0.4,0.6
SF-J29-1,SF-G30-1,40,41,33,35,7,6,0.825,0.175,0.8536585365853658,0.14634146341463414
SF-J29-1,SF-G29-3,22,33,10,14,12,19,0.45454545454545453,0.5454545454545454,0.42424242424242425,0.5757575757575758
SF-J29-1,SF-F30-2,5,24,2,21,3,3,0.4,0.6,0.875,0.125
SF-J29-1,SF-F29,9,5,6,5,3,0,0.6666666666666666,0.3333333333333333,1.0,0.0
SF-J29-1,SF-E29-3,5,3,3,1,2,2,0.6,0.4,0.3333333333333333,0.6666666666666666
SF-J29-1,SF-F28-1,1,3,1,2,0,1,1.0,0.0,0.6666666666666666,0.3333333333333333
SF-J29-1,SF-E28-2,6,13,1,8,5,5,0.16666666666666666,0.8333333333333334,0.6153846153846154,0.38461538461538464
SF-J29-1,SF-E28,3,4,1,1,2,3,0.3333333333333333,0.6666666666666666,0.25,0.75
SF-J29-1,SF-J13,3,2,0,0,3,2,0.0,1.0,0.0,1.0
SF-J29-1,SF-B21,1,1,0,0,1,1,0.0,1.0,0.0,1.0
SF-J29-1,SF-A20,11,19,2,11,9,8,0.18181818181818182,0.8181818181818182,0.5789473684210527,0.42105263157894735
SF-J29-1,SF-A19,2,8,0,6,2,2,0.0,1.0,0.75,0.25
SF-J29-1,SF-C26,20,18,4,5,16,13,0.2,0.8,0.2777777777777778,0.7222222222222222
SF-J29-1,SF-C25,11,10,0,3,11,7,0.0,1.0,0.3,0.7
SF-J29-1,SF-B25,6,15,4,6,2,9,0.6666666666666666,0.3333333333333333,0.4,0.6
SF-J29-1,SF-E27,8,5,1,2,7,3,0.125,0.875,0.4,0.6
SF-J29-1,SF-D27,12,12,11,7,1,5,0.9166666666666666,0.08333333333333333,0.5833333333333334,0.4166666666666667
SF-J29-1,SF-C28-2,4,6,2,2,2,4,0.5,0.5,0.3333333333333333,0.6666666666666666
SF-J29-1,SF-C28-1,14,3,4,2,10,1,0.2857142857142857,0.7142857142857143,0.6666666666666666,0.3333333333333333
SF-J29-1,SF-B28,28,39,22,29,6,10,0.7857142857142857,0.21428571428571427,0.7435897435897436,0.2564102564102564
SF-J29-1,SF-H25,6,3,2,1,4,2,0.3333333333333333,0.6666666666666666,0.3333333333333333,0.6666666666666666
SF-J29-1,SF-G26,11,17,3,5,8,12,0.2727272727272727,0.7272727272727273,0.29411764705882354,0.7058823529411765
SF-J29-1,SF-K21,2,4,0,1,2,3,0.0,1.0,0.25,0.75
SF-J29-1,SF-K22-1,7,6,3,3,4,3,0.42857142857142855,0.5714285714285714,0.5,0.5
SF-J29-1,SF-J23-1,9,9,0,4,9,5,0.0,1.0,0.4444444444444444,0.5555555555555556
SF-J29-1,SF-J22-1,5,6,2,2,3,4,0.4,0.6,0.3333333333333333,0.6666666666666666
SF-J29-1,SF-J22-2,2,13,1,4,1,9,0.5,0.5,0.3076923076923077,0.6923076923076923
SF-J29-1,SF-J21,7,5,1,0,6,5,0.14285714285714285,0.8571428571428571,0.0,1.0
SF-J29-1,SF-I21,2,3,2,2,0,1,1.0,0.0,0.6666666666666666,0.3333333333333333
SF-J29-1,SF-I23-2,2,3,2,0,0,3,1.0,0.0,0.0,1.0
SF-J29-1,SF-I24,2,3,0,1,2,2,0.0,1.0,0.3333333333333333,0.6666666666666666
SF-J29-1,SF-I23-1,4,3,4,1,0,2,1.0,0.0,0.3333333333333333,0.6666666666666666
SF-J29-1,SF-F26,19,50,11,17,8,33,0.5789473684210527,0.42105263157894735,0.34,0.66
SF-J29-1,SF-L19,1,1,0,0,1,1,0.0,1.0,0.0,1.0
SF-J29-1,SF-N20-1,2,4,1,0,1,4,0.5,0.5,0.0,1.0
SF-J29-1,SF-M20,8,2,2,0,6,2,0.25,0.75,0.0,1.0
SF-J29-1,SF-K20,3,3,1,2,2,1,0.3333333333333333,0.6666666666666666,0.6666666666666666,0.3333333333333333
SF-J29-1,SF-K15-,5,3,0,0,5,3,0.0,1.0,0.0,1.0
SF-J29-1,SF-K19,4,4,0,0,4,4,0.0,1.0,0.0,1.0
SF-J29-1,SF-K18,2,2,0,0,2,2,0.0,1.0,0.0,1.0
SF-J29-1,SF-K17,4,2,1,1,3,1,0.25,0.75,0.5,0.5
SF-J29-1,SF-J18,5,6,0,0,5,6,0.0,1.0,0.0,1.0
SF-J29-1,SF-J20,3,2,0,2,3,0,0.0,1.0,1.0,0.0
SF-J29-1,SF-J19,3,6,0,0,3,6,0.0,1.0,0.0,1.0
SF-J29-1,SF-Q21-2,2,1,0,0,2,1,0.0,1.0,0.0,1.0
SF-J29-1,SF-Q21-1,3,1,2,0,1,1,0.6666666666666666,0.3333333333333333,0.0,1.0
SF-J29-1,SF-O18,1,1,0,0,1,1,0.0,1.0,0.0,1.0
SF-J29-1,SF-O19,2,1,0,0,2,1,0.0,1.0,0.0,1.0
SF-J29-1,SF-O21,13,12,2,5,11,7,0.15384615384615385,0.8461538461538461,0.4166666666666667,0.5833333333333334
SF-J29-1,SF-O22,10,10,1,0,9,10,0.1,0.9,0.0,1.0
SF-J29-1,SF-N21,2,4,0,2,2,2,0.0,1.0,0.5,0.5
SF-J29-1,SF-M21,2,5,2,2,0,3,1.0,0.0,0.4,0.6
SF-J29-1,SF-L21,5,20,2,2,3,18,0.4,0.6,0.1,0.9
SF-J29-1,SF-S29,4,2,2,2,2,0,0.5,0.5,1.0,0.0
SF-J29-1,SF-Q30,31,32,4,12,27,20,0.12903225806451613,0.8709677419354839,0.375,0.625
SF-J29-1,SF-P30,25,6,15,4,10,2,0.6,0.4,0.6666666666666666,0.3333333333333333
SF-J29-1,SF-O30-2,47,33,20,11,27,22,0.425531914893617,0.574468085106383,0.3333333333333333,0.6666666666666666
SF-J29-1,SF-O30,84,42,69,28,15,14,0.8214285714285714,0.17857142857142858,0.6666666666666666,0.3333333333333333
SF-J29-1,SF-N27,10,11,5,6,5,5,0.5,0.5,0.5454545454545454,0.45454545454545453
SF-J29-1,SF-N29,11,6,8,1,3,5,0.7272727272727273,0.2727272727272727,0.16666666666666666,0.8333333333333334
SF-J29-1,SF-N28,15,18,10,5,5,13,0.6666666666666666,0.3333333333333333,0.2777777777777778,0.7222222222222222
SF-J29-1,SF-L30-1,30,28,21,12,9,16,0.7,0.3,0.42857142857142855,0.5714285714285714
SF-J29-1,SF-L31-1,15,16,14,13,1,3,0.9333333333333333,0.06666666666666667,0.8125,0.1875
SF-J29-1,SF-K30-2,18,30,15,15,3,15,0.8333333333333334,0.16666666666666666,0.5,0.5
SF-J29-1,SF-L29,20,7,16,5,4,2,0.8,0.2,0.7142857142857143,0.2857142857142857
SF-J29-1,SF-I30,32,41,27,37,5,4,0.84375,0.15625,0.9024390243902439,0.0975609756097561
SF-J29-1,SF-I29-2,33,38,23,30,10,8,0.696969696969697,0.30303030303030304,0.7894736842105263,0.21052631578947367
SF-J29-1,SF-I27,19,15,8,4,11,11,0.42105263157894735,0.5789473684210527,0.26666666666666666,0.7333333333333333
SF-J29-1,SF-I28,10,10,7,6,3,4,0.7,0.3,0.6,0.4
SF-J29-1,SF-I30-2,12,18,10,4,2,14,0.8333333333333334,0.16666666666666666,0.2222222222222222,0.7777777777777778
SF-J29-1,SF I29-1,9,7,4,3,5,4,0.4444444444444444,0.5555555555555556,0.42857142857142855,0.5714285714285714
SF-J29-1,SF-H28,34,50,24,34,10,16,0.7058823529411765,0.29411764705882354,0.68,0.32
SF-J29-1,SF-H29,20,6,12,2,8,4,0.6,0.4,0.3333333333333333,0.6666666666666666
SF-J29-1,SF-S24,2,4,1,1,1,3,0.5,0.5,0.25,0.75
SF-J29-1,SF-R24,8,7,4,1,4,6,0.5,0.5,0.14285714285714285,0.8571428571428571
SF-J29-1,SF-R26,3,4,2,2,1,2,0.6666666666666666,0.3333333333333333,0.5,0.5
SF-J29-1,SF-P26,21,1,1,1,20,0,0.047619047619047616,0.9523809523809523,1.0,0.0
SF-J29-1,SF-O25-2,7,11,3,1,4,10,0.42857142857142855,0.5714285714285714,0.09090909090909091,0.9090909090909091
SF-J29-1,SF-N26,1,1,1,1,0,0,1.0,0.0,1.0,0.0
SF-J29-1,SF-T22,1,1,0,1,1,0,0.0,1.0,1.0,0.0
SF-J29-1,SF-Q22-1,7,7,1,0,6,7,0.14285714285714285,0.8571428571428571,0.0,1.0
SF-J29-1,SF-Q22-2,2,1,1,0,1,1,0.5,0.5,0.0,1.0
SF-J29-1,SF-P22,3,3,1,0,2,3,0.3333333333333333,0.6666666666666666,0.0,1.0
SF-J29-1,SF-W19,2,3,0,0,2,3,0.0,1.0,0.0,1.0
SF-J29-1,SF-Z28,1,3,0,0,1,3,0.0,1.0,0.0,1.0
SF-J29-1,SF-V32,4,1,4,1,0,0,1.0,0.0,1.0,0.0
SF-I30,SF-M26,4,10,2,6,2,4,0.5,0.5,0.6,0.4
SF-I30,SF-M25,13,14,9,8,4,6,0.6923076923076923,0.3076923076923077,0.5714285714285714,0.42857142857142855
SF-I30,SF-M26-2,11,18,10,14,1,4,0.9090909090909091,0.09090909090909091,0.7777777777777778,0.2222222222222222
SF-I30,SF-L27,12,16,7,6,5,10,0.5833333333333334,0.4166666666666667,0.375,0.625
SF-I30,SF-K26,22,14,15,9,7,5,0.6818181818181818,0.3181818181818182,0.6428571428571429,0.35714285714285715
SF-I30,SF-J27,2,2,1,2,1,0,0.5,0.5,1.0,0.0
SF-I30,SF-M30,18,26,13,18,5,8,0.7222222222222222,0.2777777777777778,0.6923076923076923,0.3076923076923077
SF-I30,SF-L27-2,6,7,4,6,2,1,0.6666666666666666,0.3333333333333333,0.8571428571428571,0.14285714285714285
SF-I30,SF-J29-3,22,20,15,17,7,3,0.6818181818181818,0.3181818181818182,0.85,0.15
SF-I30,SF-J29,36,65,24,55,12,10,0.6666666666666666,0.3333333333333333,0.8461538461538461,0.15384615384615385
SF-I30,SF-L26,46,49,28,33,18,16,0.6086956521739131,0.391304347826087,0.673469387755102,0.32653061224489793
SF-I30,SF-M28,3,8,0,4,3,4,0.0,1.0,0.5,0.5
SF-I30,SF-L25,11,9,4,5,7,4,0.36363636363636365,0.6363636363636364,0.5555555555555556,0.4444444444444444
SF-I30,SF-M24,37,38,32,31,5,7,0.8648648648648649,0.13513513513513514,0.8157894736842105,0.18421052631578946
SF-I30,SF-L24,11,5,10,4,1,1,0.9090909090909091,0.09090909090909091,0.8,0.2
SF-I30,SF-N23,7,4,2,3,5,1,0.2857142857142857,0.7142857142857143,0.75,0.25
SF-I30,SF-K27-2,13,11,10,9,3,2,0.7692307692307693,0.23076923076923078,0.8181818181818182,0.18181818181818182
SF-I30,SF-J26-2,3,38,2,20,1,18,0.6666666666666666,0.3333333333333333,0.5263157894736842,0.47368421052631576
SF-I30,SF-L28,6,7,4,6,2,1,0.6666666666666666,0.3333333333333333,0.8571428571428571,0.14285714285714285
SF-I30,SF-K28,4,11,3,9,1,2,0.75,0.25,0.8181818181818182,0.18181818181818182
SF-I30,SF-K29-1,52,77,45,68,7,9,0.8653846153846154,0.1346153846153846,0.8831168831168831,0.11688311688311688
SF-I30,SF-J28-2,10,13,9,12,1,1,0.9,0.1,0.9230769230769231,0.07692307692307693
SF-I30,SF-K25,4,3,3,1,1,2,0.75,0.25,0.3333333333333333,0.6666666666666666
SF-I30,SF-J25,46,12,17,5,29,7,0.3695652173913043,0.6304347826086957,0.4166666666666667,0.5833333333333334
SF-I30,SF-H26-2,6,4,5,3,1,1,0.8333333333333334,0.16666666666666666,0.75,0.25
SF-I30,SF-P24,3,2,2,0,1,2,0.6666666666666666,0.3333333333333333,0.0,1.0
SF-I30,SF-J24,8,17,7,15,1,2,0.875,0.125,0.8823529411764706,0.11764705882352941
SF-I30,SF-O24,1,5,1,1,0,4,1.0,0.0,0.2,0.8
SF-I30,SF-J26,4,6,3,2,1,4,0.75,0.25,0.3333333333333333,0.6666666666666666
SF-I30,SF-I26-,1,2,1,2,0,0,1.0,0.0,1.0,0.0
SF-I30,SF-I25,6,4,4,4,2,0,0.6666666666666666,0.3333333333333333,1.0,0.0
SF-I30,SF-H26,11,14,9,11,2,3,0.8181818181818182,0.18181818181818182,0.7857142857142857,0.21428571428571427
SF-I30,SF-O23,12,8,9,6,3,2,0.75,0.25,0.75,0.25
SF-I30,SF-H27-1,38,35,13,10,25,25,0.34210526315789475,0.6578947368421053,0.2857142857142857,0.7142857142857143
SF-I30,SF-F28-2,170,175,151,150,19,25,0.888235294117647,0.11176470588235295,0.8571428571428571,0.14285714285714285
SF-I30,SF-G27,23,26,12,15,11,11,0.5217391304347826,0.4782608695652174,0.5769230769230769,0.4230769230769231
SF-I30,SF-M22-2,2,6,0,0,2,6,0.0,1.0,0.0,1.0
SF-I30,SF-L22,1,2,1,1,0,1,1.0,0.0,0.5,0.5
SF-I30,SF-F27,144,51,110,29,34,22,0.7638888888888888,0.2361111111111111,0.5686274509803921,0.43137254901960786
SF-I30,SF-N22-2,8,14,4,3,4,11,0.5,0.5,0.21428571428571427,0.7857142857142857
SF-I30,SF-G28-2,1,4,0,1,1,3,0.0,1.0,0.25,0.75
SF-I30,SF-G28-1,8,8,4,5,4,3,0.5,0.5,0.625,0.375
SF-I30,SF-M22-1,2,3,1,0,1,3,0.5,0.5,0.0,1.0
SF-I30,SF-O25-1,2,1,2,0,0,1,1.0,0.0,0.0,1.0
SF-I30,SF-K22-2,5,2,5,1,0,1,1.0,0.0,0.5,0.5
SF-I30,SF-K24,5,3,4,1,1,2,0.8,0.2,0.3333333333333333,0.6666666666666666
SF-I30,SF-G23,5,1,2,0,3,1,0.4,0.6,0.0,1.0
SF-I30,SF-G24,96,85,21,1,75,84,0.21875,0.78125,0.011764705882352941,0.9882352941176471
SF-I30,SF-G25,102,108,58,61,44,47,0.5686274509803921,0.43137254901960786,0.5648148148148148,0.4351851851851852
SF-I30,SF-F23,6,6,2,0,4,6,0.3333333333333333,0.6666666666666666,0.0,1.0
SF-I30,SF-E23,14,13,2,1,12,12,0.14285714285714285,0.8571428571428571,0.07692307692307693,0.9230769230769231
SF-I30,SF-D24,19,2,4,0,15,2,0.21052631578947367,0.7894736842105263,0.0,1.0
SF-I30,SF-C22,3,1,1,1,2,0,0.3333333333333333,0.6666666666666666,1.0,0.0
SF-I30,SF-B22,3,21,1,10,2,11,0.3333333333333333,0.6666666666666666,0.47619047619047616,0.5238095238095238
SF-I30,SF-G20,6,5,2,0,4,5,0.3333333333333333,0.6666666666666666,0.0,1.0
SF-I30,SF-E20,2,1,1,0,1,1,0.5,0.5,0.0,1.0
SF-I30,SF-H30,28,44,22,37,6,7,0.7857142857142857,0.21428571428571427,0.8409090909090909,0.1590909090909091
SF-I30,SF-G30-2,36,25,24,13,12,12,0.6666666666666666,0.3333333333333333,0.52,0.48
SF-I30,SF-F30-1,41,25,30,16,11,9,0.7317073170731707,0.2682926829268293,0.64,0.36
SF-I30,SF-E29-2,21,48,14,43,7,5,0.6666666666666666,0.3333333333333333,0.8958333333333334,0.10416666666666667
SF-I30,SF-E29-1,28,45,20,37,8,8,0.7142857142857143,0.2857142857142857,0.8222222222222222,0.17777777777777778
SF-I30,SF-D29,22,27,10,13,12,14,0.45454545454545453,0.5454545454545454,0.48148148148148145,0.5185185185185185
SF-I30,SF-D28,31,9,14,5,17,4,0.45161290322580644,0.5483870967741935,0.5555555555555556,0.4444444444444444
SF-I30,SF-A27,30,49,11,23,19,26,0.36666666666666664,0.6333333333333333,0.46938775510204084,0.5306122448979592
SF-I30,SF-G29-2,22,22,14,14,8,8,0.6363636363636364,0.36363636363636365,0.6363636363636364,0.36363636363636365
SF-I30,SF-G29-1,20,21,12,15,8,6,0.6,0.4,0.7142857142857143,0.2857142857142857
SF-I30,SF-G30-1,13,14,9,10,4,4,0.6923076923076923,0.3076923076923077,0.7142857142857143,0.2857142857142857
SF-I30,SF-G29-3,17,13,8,8,9,5,0.47058823529411764,0.5294117647058824,0.6153846153846154,0.38461538461538464
SF-I30,SF-F30-2,8,7,7,4,1,3,0.875,0.125,0.5714285714285714,0.42857142857142855
SF-I30,SF-F29,2,7,2,7,0,0,1.0,0.0,1.0,0.0
SF-I30,SF-E29-3,6,1,3,1,3,0,0.5,0.5,1.0,0.0
SF-I30,SF-F28-1,5,8,4,4,1,4,0.8,0.2,0.5,0.5
SF-I30,SF-E28-2,8,4,2,3,6,1,0.25,0.75,0.75,0.25
SF-I30,SF-E28,11,7,7,6,4,1,0.6363636363636364,0.36363636363636365,0.8571428571428571,0.14285714285714285
SF-I30,SF-H12,4,1,0,0,4,1,0.0,1.0,0.0,1.0
SF-I30,SF-G13,1,1,0,0,1,1,0.0,1.0,0.0,1.0
SF-I30,SF-F16,10,6,5,1,5,5,0.5,0.5,0.16666666666666666,0.8333333333333334
SF-I30,SF-C20,3,1,0,1,3,0,0.0,1.0,1.0,0.0
SF-I30,SF-B19,12,9,2,1,10,8,0.16666666666666666,0.8333333333333334,0.1111111111111111,0.8888888888888888
SF-I30,SF-A20,8,21,1,11,7,10,0.125,0.875,0.5238095238095238,0.47619047619047616
SF-I30,SF-A19,1,1,0,0,1,1,0.0,1.0,0.0,1.0
SF-I30,SF-C26,16,20,3,2,13,18,0.1875,0.8125,0.1,0.9
SF-I30,SF-C25,18,25,9,7,9,18,0.5,0.5,0.28,0.72
SF-I30,SF-B25,15,28,7,20,8,8,0.4666666666666667,0.5333333333333333,0.7142857142857143,0.2857142857142857
SF-I30,SF-E27,7,4,6,3,1,1,0.8571428571428571,0.14285714285714285,0.75,0.25
SF-I30,SF-B28-2,3,3,3,2,0,1,1.0,0.0,0.6666666666666666,0.3333333333333333
SF-I30,SF-D27,10,17,6,15,4,2,0.6,0.4,0.8823529411764706,0.11764705882352941
SF-I30,SF-C28-2,8,11,2,5,6,6,0.25,0.75,0.45454545454545453,0.5454545454545454
SF-I30,SF-C28-1,4,4,3,0,1,4,0.75,0.25,0.0,1.0
SF-I30,SF-B28,19,19,12,15,7,4,0.631578947368421,0.3684210526315789,0.7894736842105263,0.21052631578947367
SF-I30,SF-J1,2,3,1,0,1,3,0.5,0.5,0.0,1.0
SF-I30,SF-H25,15,1,13,1,2,0,0.8666666666666667,0.13333333333333333,1.0,0.0
SF-I30,SF-G26,14,11,7,8,7,3,0.5,0.5,0.7272727272727273,0.2727272727272727
SF-I30,SF-K21,5,7,1,1,4,6,0.2,0.8,0.14285714285714285,0.8571428571428571
SF-I30,SF-K22-1,2,2,0,0,2,2,0.0,1.0,0.0,1.0
SF-I30,SF-J23-1,8,7,2,3,6,4,0.25,0.75,0.42857142857142855,0.5714285714285714
SF-I30,SF-J22-1,5,2,1,1,4,1,0.2,0.8,0.5,0.5
SF-I30,SF-J22-2,2,1,2,1,0,0,1.0,0.0,1.0,0.0
SF-I30,SF-J21,9,5,4,4,5,1,0.4444444444444444,0.5555555555555556,0.8,0.2
SF-I30,SF-I22,23,53,2,0,21,53,0.08695652173913043,0.9130434782608695,0.0,1.0
SF-I30,SF-I23-2,2,4,1,3,1,1,0.5,0.5,0.75,0.25
SF-I30,SF-I24,2,3,1,2,1,1,0.5,0.5,0.6666666666666666,0.3333333333333333
SF-I30,SF-I23-1,15,9,10,9,5,0,0.6666666666666666,0.3333333333333333,1.0,0.0
SF-I30,SF-F26,31,43,10,28,21,15,0.3225806451612903,0.6774193548387096,0.6511627906976745,0.3488372093023256
SF-I30,SF-M13,9,1,0,0,9,1,0.0,1.0,0.0,1.0
SF-I30,SF-L19,3,1,0,0,3,1,0.0,1.0,0.0,1.0
SF-I30,SF-L20,2,6,1,0,1,6,0.5,0.5,0.0,1.0
SF-I30,SF-M20,1,2,0,1,1,1,0.0,1.0,0.5,0.5
SF-I30,SF-K20,11,4,2,0,9,4,0.18181818181818182,0.8181818181818182,0.0,1.0
SF-I30,SF-K15-,3,5,3,5,0,0,1.0,0.0,1.0,0.0
SF-I30,SF-K19,8,12,2,2,6,10,0.25,0.75,0.16666666666666666,0.8333333333333334
SF-I30,SF-K18,15,6,4,0,11,6,0.26666666666666666,0.7333333333333333,0.0,1.0
SF-I30,SF-K17,6,2,5,0,1,2,0.8333333333333334,0.16666666666666666,0.0,1.0
SF-I30,SF-J18,1,3,0,0,1,3,0.0,1.0,0.0,1.0
SF-I30,SF-J20,2,4,2,2,0,2,1.0,0.0,0.5,0.5
SF-I30,SF-J19,1,4,1,2,0,2,1.0,0.0,0.5,0.5
SF-I30,SF-Q21-2,5,1,0,0,5,1,0.0,1.0,0.0,1.0
SF-I30,SF-Q21-1,5,5,2,1,3,4,0.4,0.6,0.2,0.8
SF-I30,SF-O18,1,3,0,1,1,2,0.0,1.0,0.3333333333333333,0.6666666666666666
SF-I30,SF-O21,11,9,3,6,8,3,0.2727272727272727,0.7272727272727273,0.6666666666666666,0.3333333333333333
SF-I30,SF-O22,4,10,2,6,2,4,0.5,0.5,0.6,0.4
SF-I30,SF-N21,10,5,5,3,5,2,0.5,0.5,0.6,0.4
SF-I30,SF-N20-2,7,10,5,5,2,5,0.7142857142857143,0.2857142857142857,0.5,0.5
SF-I30,SF-M21,2,11,1,8,1,3,0.5,0.5,0.7272727272727273,0.2727272727272727
SF-I30,SF-L21,6,4,1,1,5,3,0.16666666666666666,0.8333333333333334,0.25,0.75
SF-I30,SF-S30,6,6,6,6,0,0,1.0,0.0,1.0,0.0
SF-I30,SF-Q30,4,14,2,9,2,5,0.5,0.5,0.6428571428571429,0.35714285714285715
SF-I30,SF-P30,21,10,17,10,4,0,0.8095238095238095,0.19047619047619047,1.0,0.0
SF-I30,SF-O30-2,13,24,7,22,6,2,0.5384615384615384,0.46153846153846156,0.9166666666666666,0.08333333333333333
SF-I30,SF-O30,15,20,12,15,3,5,0.8,0.2,0.75,0.25
SF-I30,SF-N27,19,15,12,11,7,4,0.631578947368421,0.3684210526315789,0.7333333333333333,0.26666666666666666
SF-I30,SF-N29,7,13,6,11,1,2,0.8571428571428571,0.14285714285714285,0.8461538461538461,0.15384615384615385
SF-I30,SF-N28,16,12,12,9,4,3,0.75,0.25,0.75,0.25
SF-I30,SF-L30-1,38,38,22,21,16,17,0.5789473684210527,0.42105263157894735,0.5526315789473685,0.4473684210526316
SF-I30,SF-L31-1,19,21,16,13,3,8,0.8421052631578947,0.15789473684210525,0.6190476190476191,0.38095238095238093
SF-I30,SF-K30-2,15,84,11,61,4,23,0.7333333333333333,0.26666666666666666,0.7261904761904762,0.27380952380952384
SF-I30,SF-L29,21,22,15,15,6,7,0.7142857142857143,0.2857142857142857,0.6818181818181818,0.3181818181818182
SF-I30,SF-J29-1,41,32,37,27,4,5,0.9024390243902439,0.0975609756097561,0.84375,0.15625
SF-I30,SF-I29-2,6,9,4,6,2,3,0.6666666666666666,0.3333333333333333,0.6666666666666666,0.3333333333333333
SF-I30,SF-I27,13,14,9,10,4,4,0.6923076923076923,0.3076923076923077,0.7142857142857143,0.2857142857142857
SF-I30,SF-I28,13,20,13,19,0,1,1.0,0.0,0.95,0.05
SF-I30,SF-I30-2,17,22,16,14,1,8,0.9411764705882353,0.058823529411764705,0.6363636363636364,0.36363636363636365
SF-I30,SF I29-1,11,11,6,7,5,4,0.5454545454545454,0.45454545454545453,0.6363636363636364,0.36363636363636365
SF-I30,SF-H28,29,12,16,6,13,6,0.5517241379310345,0.4482758620689655,0.5,0.5
SF-I30,SF-H29,33,23,31,23,2,0,0.9393939393939394,0.06060606060606061,1.0,0.0
SF-I30,SF-S24,5,8,0,4,5,4,0.0,1.0,0.5,0.5
SF-I30,SF-R24,6,5,1,0,5,5,0.16666666666666666,0.8333333333333334,0.0,1.0
SF-I30,SF-R26,26,18,25,18,1,0,0.9615384615384616,0.038461538461538464,1.0,0.0
SF-I30,SF-Q26,13,1,12,1,1,0,0.9230769230769231,0.07692307692307693,1.0,0.0
SF-I30,SF-P26,8,2,7,0,1,2,0.875,0.125,0.0,1.0
SF-I30,SF-N26,1,7,0,5,1,2,0.0,1.0,0.7142857142857143,0.2857142857142857
SF-I30,SF-N25,1,2,1,2,0,0,1.0,0.0,1.0,0.0
SF-I30,SF-T22,2,1,0,1,2,0,0.0,1.0,1.0,0.0
SF-I30,SF-S22-1,2,1,0,0,2,1,0.0,1.0,0.0,1.0
SF-I30,SF-Q22-1,3,5,2,1,1,4,0.6666666666666666,0.3333333333333333,0.2,0.8
SF-I30,SF-Q22-2,9,10,3,0,6,10,0.3333333333333333,0.6666666666666666,0.0,1.0
SF-I30,SF-P22,2,3,0,3,2,0,0.0,1.0,1.0,0.0
SF-I30,SF-W19,3,3,2,1,1,2,0.6666666666666666,0.3333333333333333,0.3333333333333333,0.6666666666666666
SF-I30,SF-U21,6,1,4,0,2,1,0.6666666666666666,0.3333333333333333,0.0,1.0
SF-I30,SF-T20,3,8,3,8,0,0,1.0,0.0,1.0,0.0
SF-I30,SF-Z28,7,5,7,4,0,1,1.0,0.0,0.8,0.2
SF-I30,SF-V29,1,2,1,2,0,0,1.0,0.0,1.0,0.0
SF-I30,SF-V32,12,11,12,11,0,0,1.0,0.0,1.0,0.0
SF-I29-2,SF-M25,6,2,4,1,2,1,0.6666666666666666,0.3333333333333333,0.5,0.5
SF-I29-2,SF-M26-2,4,2,4,1,0,1,1.0,0.0,0.5,0.5
SF-I29-2,SF-K26,9,7,5,2,4,5,0.5555555555555556,0.4444444444444444,0.2857142857142857,0.7142857142857143
SF-I29-2,SF-J27,9,7,6,4,3,3,0.6666666666666666,0.3333333333333333,0.5714285714285714,0.42857142857142855
SF-I29-2,SF-M30,15,5,8,3,7,2,0.5333333333333333,0.4666666666666667,0.6,0.4
SF-I29-2,SF-L27-2,5,2,5,2,0,0,1.0,0.0,1.0,0.0
SF-I29-2,SF-J29-3,10,22,5,13,5,9,0.5,0.5,0.5909090909090909,0.4090909090909091
SF-I29-2,SF-J29,12,17,6,9,6,8,0.5,0.5,0.5294117647058824,0.47058823529411764
SF-I29-2,SF-M28,2,2,1,1,1,1,0.5,0.5,0.5,0.5
SF-I29-2,SF-M24,2,5,2,3,0,2,1.0,0.0,0.6,0.4
SF-I29-2,SF-L24,6,2,1,0,5,2,0.16666666666666666,0.8333333333333334,0.0,1.0
SF-I29-2,SF-K27-2,20,9,11,4,9,5,0.55,0.45,0.4444444444444444,0.5555555555555556
SF-I29-2,SF-J26-2,4,2,2,0,2,2,0.5,0.5,0.0,1.0
SF-I29-2,SF-K28-3,1,1,1,1,0,0,1.0,0.0,1.0,0.0
SF-I29-2,SF-L28,2,4,1,1,1,3,0.5,0.5,0.25,0.75
SF-I29-2,SF-K28,1,2,0,0,1,2,0.0,1.0,0.0,1.0
SF-I29-2,SF-K29-1,23,6,17,1,6,5,0.7391304347826086,0.2608695652173913,0.16666666666666666,0.8333333333333334
SF-I29-2,SF-J28-2,11,12,8,7,3,5,0.7272727272727273,0.2727272727272727,0.5833333333333334,0.4166666666666667
SF-I29-2,SF-K27,1,4,1,1,0,3,1.0,0.0,0.25,0.75
SF-I29-2,SF-K25,7,2,1,0,6,2,0.14285714285714285,0.8571428571428571,0.0,1.0
SF-I29-2,SF-J25,7,6,4,2,3,4,0.5714285714285714,0.42857142857142855,0.3333333333333333,0.6666666666666666
SF-I29-2,SF-H26-2,1,9,1,7,0,2,1.0,0.0,0.7777777777777778,0.2222222222222222
SF-I29-2,SF-P24,1,2,0,2,1,0,0.0,1.0,1.0,0.0
SF-I29-2,SF-O24,3,1,0,0,3,1,0.0,1.0,0.0,1.0
SF-I29-2,SF-J26,6,6,3,5,3,1,0.5,0.5,0.8333333333333334,0.16666666666666666
SF-I29-2,SF-I26-,1,5,0,3,1,2,0.0,1.0,0.6,0.4
SF-I29-2,SF-I25,10,2,5,2,5,0,0.5,0.5,1.0,0.0
SF-I29-2,SF-H26,4,9,3,5,1,4,0.75,0.25,0.5555555555555556,0.4444444444444444
SF-I29-2,SF-O23,16,12,0,0,16,12,0.0,1.0,0.0,1.0
SF-I29-2,SF-H27-1,10,9,8,6,2,3,0.8,0.2,0.6666666666666666,0.3333333333333333
SF-I29-2,SF-F28-2,31,7,2,3,29,4,0.06451612903225806,0.9354838709677419,0.42857142857142855,0.5714285714285714
SF-I29-2,SF-G27,35,14,8,2,27,12,0.22857142857142856,0.7714285714285715,0.14285714285714285,0.8571428571428571
SF-I29-2,SF-M22-2,2,6,1,4,1,2,0.5,0.5,0.6666666666666666,0.3333333333333333
SF-I29-2,SF-L22,2,2,0,0,2,2,0.0,1.0,0.0,1.0
SF-I29-2,SF-F27,11,10,6,5,5,5,0.5454545454545454,0.45454545454545453,0.5,0.5
SF-I29-2,SF-G28-2,2,3,1,2,1,1,0.5,0.5,0.6666666666666666,0.3333333333333333
SF-I29-2,SF-M22-1,1,2,1,1,0,1,1.0,0.0,0.5,0.5
SF-I29-2,SF-K22-2,3,4,1,1,2,3,0.3333333333333333,0.6666666666666666,0.25,0.75
SF-I29-2,SF-K24,14,2,4,1,10,1,0.2857142857142857,0.7142857142857143,0.5,0.5
SF-I29-2,SF-J23-2,3,3,0,0,3,3,0.0,1.0,0.0,1.0
SF-I29-2,SF-G24,14,5,3,1,11,4,0.21428571428571427,0.7857142857142857,0.2,0.8
SF-I29-2,SF-G25,7,21,3,0,4,21,0.42857142857142855,0.5714285714285714,0.0,1.0
SF-I29-2,SF-F23,1,3,1,1,0,2,1.0,0.0,0.3333333333333333,0.6666666666666666
SF-I29-2,SF-E23,5,2,4,1,1,1,0.8,0.2,0.5,0.5
SF-I29-2,SF-D24,5,1,4,0,1,1,0.8,0.2,0.0,1.0
SF-I29-2,SF-C22,1,1,1,1,0,0,1.0,0.0,1.0,0.0
SF-I29-2,SF-J17,1,4,0,0,1,4,0.0,1.0,0.0,1.0
SF-I29-2,SF-I19,2,2,0,0,2,2,0.0,1.0,0.0,1.0
SF-I29-2,SF-G18,2,3,0,0,2,3,0.0,1.0,0.0,1.0
SF-I29-2,SF-H30,2,6,1,3,1,3,0.5,0.5,0.5,0.5
SF-I29-2,SF-G30-2,10,3,6,1,4,2,0.6,0.4,0.3333333333333333,0.6666666666666666
SF-I29-2,SF-F30-1,2,4,0,4,2,0,0.0,1.0,1.0,0.0
SF-I29-2,SF-E29-2,3,3,3,1,0,2,1.0,0.0,0.3333333333333333,0.6666666666666666
SF-I29-2,SF-E29-1,5,17,4,7,1,10,0.8,0.2,0.4117647058823529,0.5882352941176471
SF-I29-2,SF-D29,10,13,7,7,3,6,0.7,0.3,0.5384615384615384,0.46153846153846156
SF-I29-2,SF-D28,1,5,0,4,1,1,0.0,1.0,0.8,0.2
SF-I29-2,SF-A27,3,2,3,2,0,0,1.0,0.0,1.0,0.0
SF-I29-2,SF-G29-2,21,27,19,20,2,7,0.9047619047619048,0.09523809523809523,0.7407407407407407,0.25925925925925924
SF-I29-2,SF-G29-1,3,4,3,2,0,2,1.0,0.0,0.5,0.5
SF-I29-2,SF-G30-1,11,7,7,5,4,2,0.6363636363636364,0.36363636363636365,0.7142857142857143,0.2857142857142857
SF-I29-2,SF-G29-3,1,4,0,3,1,1,0.0,1.0,0.75,0.25
SF-I29-2,SF-F30-2,2,6,2,3,0,3,1.0,0.0,0.5,0.5
SF-I29-2,SF-F29,3,1,0,1,3,0,0.0,1.0,1.0,0.0
SF-I29-2,SF-F28-1,1,5,0,3,1,2,0.0,1.0,0.6,0.4
SF-I29-2,SF-E28-2,1,3,1,0,0,3,1.0,0.0,0.0,1.0
SF-I29-2,SF-H12,1,3,1,2,0,1,1.0,0.0,0.6666666666666666,0.3333333333333333
SF-I29-2,SF-A20,1,5,1,3,0,2,1.0,0.0,0.6,0.4
SF-I29-2,SF-C26,4,109,1,102,3,7,0.25,0.75,0.9357798165137615,0.06422018348623854
SF-I29-2,SF-C25,29,84,4,39,25,45,0.13793103448275862,0.8620689655172413,0.4642857142857143,0.5357142857142857
SF-I29-2,SF-B25,29,10,0,7,29,3,0.0,1.0,0.7,0.3
SF-I29-2,SF-E27,3,3,1,1,2,2,0.3333333333333333,0.6666666666666666,0.3333333333333333,0.6666666666666666
SF-I29-2,SF-B28-2,2,1,2,1,0,0,1.0,0.0,1.0,0.0
SF-I29-2,SF-D27,3,6,2,4,1,2,0.6666666666666666,0.3333333333333333,0.6666666666666666,0.3333333333333333
SF-I29-2,SF-C28-1,5,2,3,1,2,1,0.6,0.4,0.5,0.5
SF-I29-2,SF-B28,11,16,11,15,0,1,1.0,0.0,0.9375,0.0625
SF-I29-2,SF-G26,1,1,1,0,0,1,1.0,0.0,0.0,1.0
SF-I29-2,SF-K21,6,2,1,2,5,0,0.16666666666666666,0.8333333333333334,1.0,0.0
SF-I29-2,SF-K22-1,4,3,3,0,1,3,0.75,0.25,0.0,1.0
SF-I29-2,SF-J23-1,23,25,2,0,21,25,0.08695652173913043,0.9130434782608695,0.0,1.0
SF-I29-2,SF-J22-2,2,1,0,1,2,0,0.0,1.0,1.0,0.0
SF-I29-2,SF-I21,1,1,0,0,1,1,0.0,1.0,0.0,1.0
SF-I29-2,SF-I23-2,6,8,0,0,6,8,0.0,1.0,0.0,1.0
SF-I29-2,SF-I24,4,7,3,4,1,3,0.75,0.25,0.5714285714285714,0.42857142857142855
SF-I29-2,SF-I23-1,10,5,2,2,8,3,0.2,0.8,0.4,0.6
SF-I29-2,SF-F26,4,9,2,3,2,6,0.5,0.5,0.3333333333333333,0.6666666666666666
SF-I29-2,SF-L20,1,1,1,0,0,1,1.0,0.0,0.0,1.0
SF-I29-2,SF-M20,1,1,0,0,1,1,0.0,1.0,0.0,1.0
SF-I29-2,SF-K20,3,2,2,2,1,0,0.6666666666666666,0.3333333333333333,1.0,0.0
SF-I29-2,SF-K19,2,1,2,0,0,1,1.0,0.0,0.0,1.0
SF-I29-2,SF-K17,1,3,0,2,1,1,0.0,1.0,0.6666666666666666,0.3333333333333333
SF-I29-2,SF-J18,1,1,0,1,1,0,0.0,1.0,1.0,0.0
SF-I29-2,SF-J20,3,2,3,1,0,1,1.0,0.0,0.5,0.5
SF-I29-2,SF-J19,1,1,1,0,0,1,1.0,0.0,0.0,1.0
SF-I29-2,SF-R19,4,3,1,0,3,3,0.25,0.75,0.0,1.0
SF-I29-2,SF-Q21-2,3,3,0,0,3,3,0.0,1.0,0.0,1.0
SF-I29-2,SF-Q21-1,11,17,0,0,11,17,0.0,1.0,0.0,1.0
SF-I29-2,SF-O21,5,10,2,0,3,10,0.4,0.6,0.0,1.0
SF-I29-2,SF-L21,3,4,1,1,2,3,0.3333333333333333,0.6666666666666666,0.25,0.75
SF-I29-2,SF-S30,11,3,9,3,2,0,0.8181818181818182,0.18181818181818182,1.0,0.0
SF-I29-2,SF-Q30,1,1,0,0,1,1,0.0,1.0,0.0,1.0
SF-I29-2,SF-P30,3,1,2,0,1,1,0.6666666666666666,0.3333333333333333,0.0,1.0
SF-I29-2,SF-O30-2,9,14,4,8,5,6,0.4444444444444444,0.5555555555555556,0.5714285714285714,0.42857142857142855
SF-I29-2,SF-O30,2,9,0,2,2,7,0.0,1.0,0.2222222222222222,0.7777777777777778
SF-I29-2,SF-N27,6,4,3,2,3,2,0.5,0.5,0.5,0.5
SF-I29-2,SF-N29,2,4,2,4,0,0,1.0,0.0,1.0,0.0
SF-I29-2,SF-N28,4,4,2,4,2,0,0.5,0.5,1.0,0.0
SF-I29-2,SF-L30-1,16,9,7,5,9,4,0.4375,0.5625,0.5555555555555556,0.4444444444444444
SF-I29-2,SF-L31-1,3,4,2,0,1,4,0.6666666666666666,0.3333333333333333,0.0,1.0
SF-I29-2,SF-K30-2,11,5,9,1,2,4,0.8181818181818182,0.18181818181818182,0.2,0.8
SF-I29-2,SF-L29,16,11,15,4,1,7,0.9375,0.0625,0.36363636363636365,0.6363636363636364
SF-I29-2,SF-J29-1,38,33,30,23,8,10,0.7894736842105263,0.21052631578947367,0.696969696969697,0.30303030303030304
SF-I29-2,SF-I30,9,6,6,4,3,2,0.6666666666666666,0.3333333333333333,0.6666666666666666,0.3333333333333333
SF-I29-2,SF-I27,10,5,7,5,3,0,0.7,0.3,1.0,0.0
SF-I29-2,SF-I28,20,21,8,11,12,10,0.4,0.6,0.5238095238095238,0.47619047619047616
SF-I29-2,SF-I30-2,16,18,14,8,2,10,0.875,0.125,0.4444444444444444,0.5555555555555556
SF-I29-2,SF I29-1,9,13,5,7,4,6,0.5555555555555556,0.4444444444444444,0.5384615384615384,0.46153846153846156
SF-I29-2,SF-H28,37,24,36,19,1,5,0.972972972972973,0.02702702702702703,0.7916666666666666,0.20833333333333334
SF-I29-2,SF-H29,3,1,1,0,2,1,0.3333333333333333,0.6666666666666666,0.0,1.0
SF-I29-2,SF-S24,3,3,0,0,3,3,0.0,1.0,0.0,1.0
SF-I29-2,SF-R24,3,2,1,1,2,1,0.3333333333333333,0.6666666666666666,0.5,0.5
SF-I29-2,SF-R26,2,2,0,1,2,1,0.0,1.0,0.5,0.5
SF-I29-2,SF-Q26,1,1,1,0,0,1,1.0,0.0,0.0,1.0
SF-I29-2,SF-O25-2,2,1,0,0,2,1,0.0,1.0,0.0,1.0
SF-I29-2,SF-N26,1,1,1,0,0,1,1.0,0.0,0.0,1.0
SF-I29-2,SF-T22,4,1,2,1,2,0,0.5,0.5,1.0,0.0
SF-I29-2,SF-Q22-1,2,4,1,3,1,1,0.5,0.5,0.75,0.25
SF-I29-2,SF-Q22-2,1,2,0,0,1,2,0.0,1.0,0.0,1.0
SF-I29-2,SF-Z28,29,27,0,0,29,27,0.0,1.0,0.0,1.0
SF-I27,SF-M26,2,3,0,1,2,2,0.0,1.0,0.3333333333333333,0.6666666666666666
SF-I27,SF-M25,2,5,1,2,1,3,0.5,0.5,0.4,0.6
SF-I27,SF-M26-2,10,7,4,4,6,3,0.4,0.6,0.5714285714285714,0.42857142857142855
SF-I27,SF-L27,35,8,25,4,10,4,0.7142857142857143,0.2857142857142857,0.5,0.5
SF-I27,SF-K26,8,7,4,3,4,4,0.5,0.5,0.42857142857142855,0.5714285714285714
SF-I27,SF-J27,11,9,7,4,4,5,0.6363636363636364,0.36363636363636365,0.4444444444444444,0.5555555555555556
SF-I27,SF-M30,17,21,9,15,8,6,0.5294117647058824,0.47058823529411764,0.7142857142857143,0.2857142857142857
SF-I27,SF-L27-2,12,9,2,1,10,8,0.16666666666666666,0.8333333333333334,0.1111111111111111,0.8888888888888888
SF-I27,SF-J29-3,16,10,9,5,7,5,0.5625,0.4375,0.5,0.5
SF-I27,SF-J29,86,23,32,13,54,10,0.37209302325581395,0.627906976744186,0.5652173913043478,0.43478260869565216
SF-I27,SF-L26,68,59,59,18,9,41,0.8676470588235294,0.1323529411764706,0.3050847457627119,0.6949152542372882
SF-I27,SF-M28,8,7,4,2,4,5,0.5,0.5,0.2857142857142857,0.7142857142857143
SF-I27,SF-L25,42,49,13,10,29,39,0.30952380952380953,0.6904761904761905,0.20408163265306123,0.7959183673469388
SF-I27,SF-M24,11,5,4,4,7,1,0.36363636363636365,0.6363636363636364,0.8,0.2
SF-I27,SF-L24,15,9,8,7,7,2,0.5333333333333333,0.4666666666666667,0.7777777777777778,0.2222222222222222
SF-I27,SF-N23,9,5,0,3,9,2,0.0,1.0,0.6,0.4
SF-I27,SF-N24-2,3,5,1,3,2,2,0.3333333333333333,0.6666666666666666,0.6,0.4
SF-I27,SF-K27-2,41,10,31,6,10,4,0.7560975609756098,0.24390243902439024,0.6,0.4
SF-I27,SF-J26-2,62,21,44,11,18,10,0.7096774193548387,0.2903225806451613,0.5238095238095238,0.47619047619047616
SF-I27,SF-L28,4,6,0,2,4,4,0.0,1.0,0.3333333333333333,0.6666666666666666
SF-I27,SF-K28,12,10,8,5,4,5,0.6666666666666666,0.3333333333333333,0.5,0.5
SF-I27,SF-K29-1,21,18,15,13,6,5,0.7142857142857143,0.2857142857142857,0.7222222222222222,0.2777777777777778
SF-I27,SF-J28-2,15,13,6,10,9,3,0.4,0.6,0.7692307692307693,0.23076923076923078
SF-I27,SF-K27,4,2,3,0,1,2,0.75,0.25,0.0,1.0
SF-I27,SF-K25,112,25,94,17,18,8,0.8392857142857143,0.16071428571428573,0.68,0.32
SF-I27,SF-J25,77,31,54,19,23,12,0.7012987012987013,0.2987012987012987,0.6129032258064516,0.3870967741935484
SF-I27,SF-H26-2,11,16,4,7,7,9,0.36363636363636365,0.6363636363636364,0.4375,0.5625
SF-I27,SF-P24,3,1,2,0,1,1,0.6666666666666666,0.3333333333333333,0.0,1.0
SF-I27,SF-J24,41,22,29,8,12,14,0.7073170731707317,0.2926829268292683,0.36363636363636365,0.6363636363636364
SF-I27,SF-O24,18,8,11,1,7,7,0.6111111111111112,0.3888888888888889,0.125,0.875
SF-I27,SF-J26,37,7,16,6,21,1,0.43243243243243246,0.5675675675675675,0.8571428571428571,0.14285714285714285
SF-I27,SF-I26-,19,17,17,7,2,10,0.8947368421052632,0.10526315789473684,0.4117647058823529,0.5882352941176471
SF-I27,SF-I25,28,20,15,7,13,13,0.5357142857142857,0.4642857142857143,0.35,0.65
SF-I27,SF-H26,22,31,13,20,9,11,0.5909090909090909,0.4090909090909091,0.6451612903225806,0.3548387096774194
SF-I27,SF-O23,16,7,14,2,2,5,0.875,0.125,0.2857142857142857,0.7142857142857143
SF-I27,SF-H27-1,12,18,6,13,6,5,0.5,0.5,0.7222222222222222,0.2777777777777778
SF-I27,SF-F28-2,27,28,15,16,12,12,0.5555555555555556,0.4444444444444444,0.5714285714285714,0.42857142857142855
SF-I27,SF-G27,51,48,36,32,15,16,0.7058823529411765,0.29411764705882354,0.6666666666666666,0.3333333333333333
SF-I27,SF-M22-2,22,17,6,8,16,9,0.2727272727272727,0.7272727272727273,0.47058823529411764,0.5294117647058824
SF-I27,SF-L22,4,3,2,1,2,2,0.5,0.5,0.3333333333333333,0.6666666666666666
SF-I27,SF-F27,15,30,8,16,7,14,0.5333333333333333,0.4666666666666667,0.5333333333333333,0.4666666666666667
SF-I27,SF-N22-2,14,13,3,7,11,6,0.21428571428571427,0.7857142857142857,0.5384615384615384,0.46153846153846156
SF-I27,SF-G28-2,28,34,21,29,7,5,0.75,0.25,0.8529411764705882,0.14705882352941177
SF-I27,SF-G28-1,7,9,2,7,5,2,0.2857142857142857,0.7142857142857143,0.7777777777777778,0.2222222222222222
SF-I27,SF-M22-1,11,4,7,3,4,1,0.6363636363636364,0.36363636363636365,0.75,0.25
SF-I27,SF-O25-1,4,1,4,1,0,0,1.0,0.0,1.0,0.0
SF-I27,SF-K22-2,4,6,1,1,3,5,0.25,0.75,0.16666666666666666,0.8333333333333334
SF-I27,SF-K24,8,8,6,2,2,6,0.75,0.25,0.25,0.75
SF-I27,SF-G23,1,8,0,2,1,6,0.0,1.0,0.25,0.75
SF-I27,SF-G24,24,13,10,1,14,12,0.4166666666666667,0.5833333333333334,0.07692307692307693,0.9230769230769231
SF-I27,SF-G25,8,7,5,2,3,5,0.625,0.375,0.2857142857142857,0.7142857142857143
SF-I27,SF-F23,33,21,12,1,21,20,0.36363636363636365,0.6363636363636364,0.047619047619047616,0.9523809523809523
SF-I27,SF-E23,26,20,7,2,19,18,0.2692307692307692,0.7307692307692307,0.1,0.9
SF-I27,SF-D24,2,1,2,0,0,1,1.0,0.0,0.0,1.0
SF-I27,SF-C22,2,1,1,1,1,0,0.5,0.5,1.0,0.0
SF-I27,SF-B22,2,6,1,2,1,4,0.5,0.5,0.3333333333333333,0.6666666666666666
SF-I27,SF-J17,4,2,1,0,3,2,0.25,0.75,0.0,1.0
SF-I27,SF-H20,6,15,2,1,4,14,0.3333333333333333,0.6666666666666666,0.06666666666666667,0.9333333333333333
SF-I27,SF-G19,9,5,4,2,5,3,0.4444444444444444,0.5555555555555556,0.4,0.6
SF-I27,SF-G17,2,3,1,1,1,2,0.5,0.5,0.3333333333333333,0.6666666666666666
SF-I27,SF-G18,23,10,13,1,10,9,0.5652173913043478,0.43478260869565216,0.1,0.9
SF-I27,SF-G20,30,9,10,0,20,9,0.3333333333333333,0.6666666666666666,0.0,1.0
SF-I27,SF-F19,1,1,0,1,1,0,0.0,1.0,1.0,0.0
SF-I27,SF-E18,15,3,15,0,0,3,1.0,0.0,0.0,1.0
SF-I27,SF-E20,4,1,2,0,2,1,0.5,0.5,0.0,1.0
SF-I27,SF-H30,5,7,1,7,4,0,0.2,0.8,1.0,0.0
SF-I27,SF-G30-2,36,42,6,7,30,35,0.16666666666666666,0.8333333333333334,0.16666666666666666,0.8333333333333334
SF-I27,SF-F30-1,26,36,4,6,22,30,0.15384615384615385,0.8461538461538461,0.16666666666666666,0.8333333333333334
SF-I27,SF-E29-2,16,7,8,4,8,3,0.5,0.5,0.5714285714285714,0.42857142857142855
SF-I27,SF-E29-1,16,24,7,12,9,12,0.4375,0.5625,0.5,0.5
SF-I27,SF-D29,4,25,1,8,3,17,0.25,0.75,0.32,0.68
SF-I27,SF-D28,5,15,2,5,3,10,0.4,0.6,0.3333333333333333,0.6666666666666666
SF-I27,SF-A27,17,23,8,9,9,14,0.47058823529411764,0.5294117647058824,0.391304347826087,0.6086956521739131
SF-I27,SF-G29-2,29,75,17,38,12,37,0.5862068965517241,0.41379310344827586,0.5066666666666667,0.49333333333333335
SF-I27,SF-G29-1,27,29,11,17,16,12,0.4074074074074074,0.5925925925925926,0.5862068965517241,0.41379310344827586
SF-I27,SF-G30-1,18,22,3,7,15,15,0.16666666666666666,0.8333333333333334,0.3181818181818182,0.6818181818181818
SF-I27,SF-G29-3,17,18,6,10,11,8,0.35294117647058826,0.6470588235294118,0.5555555555555556,0.4444444444444444
SF-I27,SF-F30-2,8,21,5,13,3,8,0.625,0.375,0.6190476190476191,0.38095238095238093
SF-I27,SF-F29,8,14,4,7,4,7,0.5,0.5,0.5,0.5
SF-I27,SF-E29-3,1,2,1,1,0,1,1.0,0.0,0.5,0.5
SF-I27,SF-F28-1,8,10,5,8,3,2,0.625,0.375,0.8,0.2
SF-I27,SF-E28-2,21,18,0,2,21,16,0.0,1.0,0.1111111111111111,0.8888888888888888
SF-I27,SF-E28,16,15,2,3,14,12,0.125,0.875,0.2,0.8
SF-I27,SF-J12,2,1,0,0,2,1,0.0,1.0,0.0,1.0
SF-I27,SF-J13,1,1,0,1,1,0,0.0,1.0,1.0,0.0
SF-I27,SF-H13,1,3,0,1,1,2,0.0,1.0,0.3333333333333333,0.6666666666666666
SF-I27,SF-G11,1,1,0,0,1,1,0.0,1.0,0.0,1.0
SF-I27,SF-F16,1,2,0,1,1,1,0.0,1.0,0.5,0.5
SF-I27,SF-C20,2,3,0,1,2,2,0.0,1.0,0.3333333333333333,0.6666666666666666
SF-I27,SF-B19,4,11,0,7,4,4,0.0,1.0,0.6363636363636364,0.36363636363636365
SF-I27,SF-A20,5,8,2,4,3,4,0.4,0.6,0.5,0.5
SF-I27,SF-C26,13,7,3,4,10,3,0.23076923076923078,0.7692307692307693,0.5714285714285714,0.42857142857142855
SF-I27,SF-C25,6,11,2,6,4,5,0.3333333333333333,0.6666666666666666,0.5454545454545454,0.45454545454545453
SF-I27,SF-B25,5,11,1,4,4,7,0.2,0.8,0.36363636363636365,0.6363636363636364
SF-I27,SF-E27,2,5,1,2,1,3,0.5,0.5,0.4,0.6
SF-I27,SF-B28-2,7,8,5,5,2,3,0.7142857142857143,0.2857142857142857,0.625,0.375
SF-I27,SF-D27,2,14,1,10,1,4,0.5,0.5,0.7142857142857143,0.2857142857142857
SF-I27,SF-B28,7,21,4,13,3,8,0.5714285714285714,0.42857142857142855,0.6190476190476191,0.38095238095238093
SF-I27,SF-H25,3,7,2,4,1,3,0.6666666666666666,0.3333333333333333,0.5714285714285714,0.42857142857142855
SF-I27,SF-G26,29,64,14,30,15,34,0.4827586206896552,0.5172413793103449,0.46875,0.53125
SF-I27,SF-K21,6,3,1,0,5,3,0.16666666666666666,0.8333333333333334,0.0,1.0
SF-I27,SF-K22-1,3,13,1,5,2,8,0.3333333333333333,0.6666666666666666,0.38461538461538464,0.6153846153846154
SF-I27,SF-J23-1,41,43,16,10,25,33,0.3902439024390244,0.6097560975609756,0.23255813953488372,0.7674418604651163
SF-I27,SF-J22-1,6,10,0,1,6,9,0.0,1.0,0.1,0.9
SF-I27,SF-J22-2,6,5,4,2,2,3,0.6666666666666666,0.3333333333333333,0.4,0.6
SF-I27,SF-J21,12,7,6,6,6,1,0.5,0.5,0.8571428571428571,0.14285714285714285
SF-I27,SF-I22,5,4,4,2,1,2,0.8,0.2,0.5,0.5
SF-I27,SF-I23-2,3,6,1,0,2,6,0.3333333333333333,0.6666666666666666,0.0,1.0
SF-I27,SF-I24,6,7,4,5,2,2,0.6666666666666666,0.3333333333333333,0.7142857142857143,0.2857142857142857
SF-I27,SF-I23-1,7,8,4,4,3,4,0.5714285714285714,0.42857142857142855,0.5,0.5
SF-I27,SF-F26,23,22,13,12,10,10,0.5652173913043478,0.43478260869565216,0.5454545454545454,0.45454545454545453
SF-I27,SF-M13,7,3,0,0,7,3,0.0,1.0,0.0,1.0
SF-I27,SF-L19,11,5,5,0,6,5,0.45454545454545453,0.5454545454545454,0.0,1.0
SF-I27,SF-L20,2,12,0,1,2,11,0.0,1.0,0.08333333333333333,0.9166666666666666
SF-I27,SF-N20-1,8,2,2,1,6,1,0.25,0.75,0.5,0.5
SF-I27,SF-M20,12,8,4,3,8,5,0.3333333333333333,0.6666666666666666,0.375,0.625
SF-I27,SF-K17-2,1,1,1,0,0,1,1.0,0.0,0.0,1.0
SF-I27,SF-K20,4,2,0,0,4,2,0.0,1.0,0.0,1.0
SF-I27,SF-K15-,3,11,2,0,1,11,0.6666666666666666,0.3333333333333333,0.0,1.0
SF-I27,SF-K19,7,3,2,0,5,3,0.2857142857142857,0.7142857142857143,0.0,1.0
SF-I27,SF-K18,7,4,5,2,2,2,0.7142857142857143,0.2857142857142857,0.5,0.5
SF-I27,SF-K17,9,8,6,4,3,4,0.6666666666666666,0.3333333333333333,0.5,0.5
SF-I27,SF-J18,4,4,0,0,4,4,0.0,1.0,0.0,1.0
SF-I27,SF-J20,3,4,2,1,1,3,0.6666666666666666,0.3333333333333333,0.25,0.75
SF-I27,SF-J19,11,7,6,3,5,4,0.5454545454545454,0.45454545454545453,0.42857142857142855,0.5714285714285714
SF-I27,SF-R19,4,2,2,0,2,2,0.5,0.5,0.0,1.0
SF-I27,SF-P21,6,3,1,1,5,2,0.16666666666666666,0.8333333333333334,0.3333333333333333,0.6666666666666666
SF-I27,SF-O18,7,4,2,1,5,3,0.2857142857142857,0.7142857142857143,0.25,0.75
SF-I27,SF-O19,6,6,1,1,5,5,0.16666666666666666,0.8333333333333334,0.16666666666666666,0.8333333333333334
SF-I27,SF-O21,36,22,16,13,20,9,0.4444444444444444,0.5555555555555556,0.5909090909090909,0.4090909090909091
SF-I27,SF-O22,16,14,6,7,10,7,0.375,0.625,0.5,0.5
SF-I27,SF-N21,12,10,4,0,8,10,0.3333333333333333,0.6666666666666666,0.0,1.0
SF-I27,SF-M21,8,2,5,0,3,2,0.625,0.375,0.0,1.0
SF-I27,SF-L21,29,15,12,4,17,11,0.41379310344827586,0.5862068965517241,0.26666666666666666,0.7333333333333333
SF-I27,SF-S30,1,1,0,0,1,1,0.0,1.0,0.0,1.0
SF-I27,SF-Q30,7,11,3,3,4,8,0.42857142857142855,0.5714285714285714,0.2727272727272727,0.7272727272727273
SF-I27,SF-P30,4,4,1,2,3,2,0.25,0.75,0.5,0.5
SF-I27,SF-O30-2,5,3,1,0,4,3,0.2,0.8,0.0,1.0
SF-I27,SF-O30,13,24,7,18,6,6,0.5384615384615384,0.46153846153846156,0.75,0.25
SF-I27,SF-N27,7,7,4,5,3,2,0.5714285714285714,0.42857142857142855,0.7142857142857143,0.2857142857142857
SF-I27,SF-N29,2,20,1,2,1,18,0.5,0.5,0.1,0.9
SF-I27,SF-N28,15,15,8,6,7,9,0.5333333333333333,0.4666666666666667,0.4,0.6
SF-I27,SF-L30-1,25,35,10,19,15,16,0.4,0.6,0.5428571428571428,0.45714285714285713
SF-I27,SF-L31-1,5,2,3,1,2,1,0.6,0.4,0.5,0.5
SF-I27,SF-K30-2,10,5,5,3,5,2,0.5,0.5,0.6,0.4
SF-I27,SF-L29,15,8,6,8,9,0,0.4,0.6,1.0,0.0
SF-I27,SF-J29-1,15,19,4,8,11,11,0.26666666666666666,0.7333333333333333,0.42105263157894735,0.5789473684210527
SF-I27,SF-I30,14,13,10,9,4,4,0.7142857142857143,0.2857142857142857,0.6923076923076923,0.3076923076923077
SF-I27,SF-I29-2,5,10,5,7,0,3,1.0,0.0,0.7,0.3
SF-I27,SF-I28,18,28,11,27,7,1,0.6111111111111112,0.3888888888888889,0.9642857142857143,0.03571428571428571
SF-I27,SF-I30-2,8,8,4,5,4,3,0.5,0.5,0.625,0.375
SF-I27,SF I29-1,3,5,1,1,2,4,0.3333333333333333,0.6666666666666666,0.2,0.8
SF-I27,SF-H28,27,59,19,52,8,7,0.7037037037037037,0.2962962962962963,0.8813559322033898,0.11864406779661017
SF-I27,SF-H29,14,18,10,13,4,5,0.7142857142857143,0.2857142857142857,0.7222222222222222,0.2777777777777778
SF-I27,SF-S24,3,7,2,1,1,6,0.6666666666666666,0.3333333333333333,0.14285714285714285,0.8571428571428571
SF-I27,SF-R24,9,8,3,2,6,6,0.3333333333333333,0.6666666666666666,0.25,0.75
SF-I27,SF-R26,4,5,0,3,4,2,0.0,1.0,0.6,0.4
SF-I27,SF-Q26,1,2,0,0,1,2,0.0,1.0,0.0,1.0
SF-I27,SF-O25-2,1,2,0,0,1,2,0.0,1.0,0.0,1.0
SF-I27,SF-N22-1B,2,1,2,0,0,1,1.0,0.0,0.0,1.0
SF-I27,SF-T22,2,5,1,0,1,5,0.5,0.5,0.0,1.0
SF-I27,SF-S22-1,8,3,6,2,2,1,0.75,0.25,0.6666666666666666,0.3333333333333333
SF-I27,SF-Q23-3,5,4,1,1,4,3,0.2,0.8,0.25,0.75
SF-I27,SF-Q22-1,5,3,2,1,3,2,0.4,0.6,0.3333333333333333,0.6666666666666666
SF-I27,SF-Q22-2,2,5,1,1,1,4,0.5,0.5,0.2,0.8
SF-I27,SF-P22,10,6,7,1,3,5,0.7,0.3,0.16666666666666666,0.8333333333333334
SF-I27,SF-T20,15,10,3,0,12,10,0.2,0.8,0.0,1.0
SF-I27,SF-S21,5,1,1,0,4,1,0.2,0.8,0.0,1.0
SF-I27,SF-V28,17,8,0,0,17,8,0.0,1.0,0.0,1.0
SF-I27,SF-V30,3,4,0,0,3,4,0.0,1.0,0.0,1.0
SF-I27,SF-V32,4,1,3,0,1,1,0.75,0.25,0.0,1.0
SF-I28,SF-M26-2,2,1,0,1,2,0,0.0,1.0,1.0,0.0
SF-I28,SF-L27,4,2,4,1,0,1,1.0,0.0,0.5,0.5
SF-I28,SF-K26,9,25,4,23,5,2,0.4444444444444444,0.5555555555555556,0.92,0.08
SF-I28,SF-M30,6,23,4,16,2,7,0.6666666666666666,0.3333333333333333,0.6956521739130435,0.30434782608695654
SF-I28,SF-L27-2,2,13,0,5,2,8,0.0,1.0,0.38461538461538464,0.6153846153846154
SF-I28,SF-J29-3,13,20,12,15,1,5,0.9230769230769231,0.07692307692307693,0.75,0.25
SF-I28,SF-J29,6,25,5,13,1,12,0.8333333333333334,0.16666666666666666,0.52,0.48
SF-I28,SF-L26,3,3,1,2,2,1,0.3333333333333333,0.6666666666666666,0.6666666666666666,0.3333333333333333
SF-I28,SF-M28,12,10,0,4,12,6,0.0,1.0,0.4,0.6
SF-I28,SF-L25,16,31,3,11,13,20,0.1875,0.8125,0.3548387096774194,0.6451612903225806
SF-I28,SF-M24,6,7,5,3,1,4,0.8333333333333334,0.16666666666666666,0.42857142857142855,0.5714285714285714
SF-I28,SF-L24,8,6,5,3,3,3,0.625,0.375,0.5,0.5
SF-I28,SF-N23,1,5,0,1,1,4,0.0,1.0,0.2,0.8
SF-I28,SF-N24-2,1,1,0,0,1,1,0.0,1.0,0.0,1.0
SF-I28,SF-K27-2,11,15,7,11,4,4,0.6363636363636364,0.36363636363636365,0.7333333333333333,0.26666666666666666
SF-I28,SF-J26-2,29,19,20,9,9,10,0.6896551724137931,0.3103448275862069,0.47368421052631576,0.5263157894736842
SF-I28,SF-L28,7,9,4,6,3,3,0.5714285714285714,0.42857142857142855,0.6666666666666666,0.3333333333333333
SF-I28,SF-K28,5,4,4,4,1,0,0.8,0.2,1.0,0.0
SF-I28,SF-K29-1,17,21,12,8,5,13,0.7058823529411765,0.29411764705882354,0.38095238095238093,0.6190476190476191
SF-I28,SF-J28-2,6,8,5,6,1,2,0.8333333333333334,0.16666666666666666,0.75,0.25
SF-I28,SF-K27,3,3,1,2,2,1,0.3333333333333333,0.6666666666666666,0.6666666666666666,0.3333333333333333
SF-I28,SF-K25,67,25,52,18,15,7,0.7761194029850746,0.22388059701492538,0.72,0.28
SF-I28,SF-J25,34,25,22,18,12,7,0.6470588235294118,0.35294117647058826,0.72,0.28
SF-I28,SF-H26-2,5,10,3,4,2,6,0.6,0.4,0.4,0.6
SF-I28,SF-P24,3,4,2,1,1,3,0.6666666666666666,0.3333333333333333,0.25,0.75
SF-I28,SF-J24,17,15,9,6,8,9,0.5294117647058824,0.47058823529411764,0.4,0.6
SF-I28,SF-O24,4,1,2,0,2,1,0.5,0.5,0.0,1.0
SF-I28,SF-J26,37,16,29,13,8,3,0.7837837837837838,0.21621621621621623,0.8125,0.1875
SF-I28,SF-I26-,7,9,5,7,2,2,0.7142857142857143,0.2857142857142857,0.7777777777777778,0.2222222222222222
SF-I28,SF-I25,20,16,15,8,5,8,0.75,0.25,0.5,0.5
SF-I28,SF-H26,23,22,16,14,7,8,0.6956521739130435,0.30434782608695654,0.6363636363636364,0.36363636363636365
SF-I28,SF-O23,2,2,1,0,1,2,0.5,0.5,0.0,1.0
SF-I28,SF-H27-1,10,6,9,5,1,1,0.9,0.1,0.8333333333333334,0.16666666666666666
SF-I28,SF-F28-2,17,12,9,8,8,4,0.5294117647058824,0.47058823529411764,0.6666666666666666,0.3333333333333333
SF-I28,SF-G27,23,26,13,13,10,13,0.5652173913043478,0.43478260869565216,0.5,0.5
SF-I28,SF-M22-2,3,4,2,2,1,2,0.6666666666666666,0.3333333333333333,0.5,0.5
SF-I28,SF-L22,1,3,1,1,0,2,1.0,0.0,0.3333333333333333,0.6666666666666666
SF-I28,SF-F27,16,5,8,1,8,4,0.5,0.5,0.2,0.8
SF-I28,SF-N22-2,3,4,2,1,1,3,0.6666666666666666,0.3333333333333333,0.25,0.75
SF-I28,SF-G28-2,3,3,3,2,0,1,1.0,0.0,0.6666666666666666,0.3333333333333333
SF-I28,SF-M22-1,3,2,2,2,1,0,0.6666666666666666,0.3333333333333333,1.0,0.0
SF-I28,SF-O25-1,1,1,0,0,1,1,0.0,1.0,0.0,1.0
SF-I28,SF-K24,12,4,6,1,6,3,0.5,0.5,0.25,0.75
SF-I28,SF-J23-2,3,3,0,0,3,3,0.0,1.0,0.0,1.0
SF-I28,SF-G23,3,3,0,1,3,2,0.0,1.0,0.3333333333333333,0.6666666666666666
SF-I28,SF-G24,124,62,15,1,109,61,0.12096774193548387,0.8790322580645161,0.016129032258064516,0.9838709677419355
SF-I28,SF-G25,29,3,12,1,17,2,0.41379310344827586,0.5862068965517241,0.3333333333333333,0.6666666666666666
SF-I28,SF-F23,5,6,1,1,4,5,0.2,0.8,0.16666666666666666,0.8333333333333334
SF-I28,SF-E23,6,7,4,1,2,6,0.6666666666666666,0.3333333333333333,0.14285714285714285,0.8571428571428571
SF-I28,SF-B22,1,2,1,1,0,1,1.0,0.0,0.5,0.5
SF-I28,SF-J17,7,5,1,0,6,5,0.14285714285714285,0.8571428571428571,0.0,1.0
SF-I28,SF-I20,2,1,2,0,0,1,1.0,0.0,0.0,1.0
SF-I28,SF-H20,2,10,2,1,0,9,1.0,0.0,0.1,0.9
SF-I28,SF-H18,1,1,1,0,0,1,1.0,0.0,0.0,1.0
SF-I28,SF-G19,1,2,0,0,1,2,0.0,1.0,0.0,1.0
SF-I28,SF-G17,4,1,3,1,1,0,0.75,0.25,1.0,0.0
SF-I28,SF-G18,5,2,2,0,3,2,0.4,0.6,0.0,1.0
SF-I28,SF-G20,2,6,0,0,2,6,0.0,1.0,0.0,1.0
SF-I28,SF-F19,5,6,0,0,5,6,0.0,1.0,0.0,1.0
SF-I28,SF-E18,1,1,1,0,0,1,1.0,0.0,0.0,1.0
SF-I28,SF-H30,5,6,3,2,2,4,0.6,0.4,0.3333333333333333,0.6666666666666666
SF-I28,SF-G30-2,48,36,12,6,36,30,0.25,0.75,0.16666666666666666,0.8333333333333334
SF-I28,SF-F30-1,9,20,6,11,3,9,0.6666666666666666,0.3333333333333333,0.55,0.45
SF-I28,SF-E29-2,5,4,5,2,0,2,1.0,0.0,0.5,0.5
SF-I28,SF-E29-1,9,8,5,5,4,3,0.5555555555555556,0.4444444444444444,0.625,0.375
SF-I28,SF-D29,11,7,6,6,5,1,0.5454545454545454,0.45454545454545453,0.8571428571428571,0.14285714285714285
SF-I28,SF-D28,4,5,4,2,0,3,1.0,0.0,0.4,0.6
SF-I28,SF-A27,4,5,3,3,1,2,0.75,0.25,0.6,0.4
SF-I28,SF-G29-2,33,28,8,9,25,19,0.24242424242424243,0.7575757575757576,0.32142857142857145,0.6785714285714286
SF-I28,SF-G29-1,16,1,10,1,6,0,0.625,0.375,1.0,0.0
SF-I28,SF-G30-1,11,4,7,3,4,1,0.6363636363636364,0.36363636363636365,0.75,0.25
SF-I28,SF-G29-3,13,17,4,1,9,16,0.3076923076923077,0.6923076923076923,0.058823529411764705,0.9411764705882353
SF-I28,SF-F30-2,9,21,5,14,4,7,0.5555555555555556,0.4444444444444444,0.6666666666666666,0.3333333333333333
SF-I28,SF-F29,23,8,17,4,6,4,0.7391304347826086,0.2608695652173913,0.5,0.5
SF-I28,SF-E29-3,4,5,1,3,3,2,0.25,0.75,0.6,0.4
SF-I28,SF-F28-1,4,3,0,1,4,2,0.0,1.0,0.3333333333333333,0.6666666666666666
SF-I28,SF-E28-2,12,6,1,0,11,6,0.08333333333333333,0.9166666666666666,0.0,1.0
SF-I28,SF-G11,3,1,0,0,3,1,0.0,1.0,0.0,1.0
SF-I28,SF-G12,1,1,0,0,1,1,0.0,1.0,0.0,1.0
SF-I28,SF-F16,2,1,1,1,1,0,0.5,0.5,1.0,0.0
SF-I28,SF-A20,3,3,0,0,3,3,0.0,1.0,0.0,1.0
SF-I28,SF-C26,68,24,29,8,39,16,0.4264705882352941,0.5735294117647058,0.3333333333333333,0.6666666666666666
SF-I28,SF-C25,17,5,16,3,1,2,0.9411764705882353,0.058823529411764705,0.6,0.4
SF-I28,SF-B25,5,9,2,3,3,6,0.4,0.6,0.3333333333333333,0.6666666666666666
SF-I28,SF-E27,12,3,4,3,8,0,0.3333333333333333,0.6666666666666666,1.0,0.0
SF-I28,SF-B28-2,1,2,1,0,0,2,1.0,0.0,0.0,1.0
SF-I28,SF-D27,200,197,164,164,36,33,0.82,0.18,0.8324873096446701,0.16751269035532995
SF-I28,SF-C28-1,2,5,2,2,0,3,1.0,0.0,0.4,0.6
SF-I28,SF-B28,4,2,2,2,2,0,0.5,0.5,1.0,0.0
SF-I28,SF-H25,11,3,10,3,1,0,0.9090909090909091,0.09090909090909091,1.0,0.0
SF-I28,SF-G26,11,10,6,5,5,5,0.5454545454545454,0.45454545454545453,0.5,0.5
SF-I28,SF-K21,3,3,0,1,3,2,0.0,1.0,0.3333333333333333,0.6666666666666666
SF-I28,SF-K22-1,7,2,3,0,4,2,0.42857142857142855,0.5714285714285714,0.0,1.0
SF-I28,SF-J23-1,23,35,12,8,11,27,0.5217391304347826,0.4782608695652174,0.22857142857142856,0.7714285714285715
SF-I28,SF-J22-1,2,7,0,0,2,7,0.0,1.0,0.0,1.0
SF-I28,SF-J22-2,4,2,3,0,1,2,0.75,0.25,0.0,1.0
SF-I28,SF-J21,6,6,3,3,3,3,0.5,0.5,0.5,0.5
SF-I28,SF-I21,2,3,1,0,1,3,0.5,0.5,0.0,1.0
SF-I28,SF-I23-2,9,12,5,2,4,10,0.5555555555555556,0.4444444444444444,0.16666666666666666,0.8333333333333334
SF-I28,SF-I24,1,3,1,1,0,2,1.0,0.0,0.3333333333333333,0.6666666666666666
SF-I28,SF-F26,22,10,5,1,17,9,0.22727272727272727,0.7727272727272727,0.1,0.9
SF-I28,SF-M13,1,3,0,0,1,3,0.0,1.0,0.0,1.0
SF-I28,SF-L19,5,1,3,0,2,1,0.6,0.4,0.0,1.0
SF-I28,SF-L20,3,3,1,1,2,2,0.3333333333333333,0.6666666666666666,0.3333333333333333,0.6666666666666666
SF-I28,SF-N20-1,4,2,2,2,2,0,0.5,0.5,1.0,0.0
SF-I28,SF-M20,4,2,3,0,1,2,0.75,0.25,0.0,1.0
SF-I28,SF-K15-,7,9,1,1,6,8,0.14285714285714285,0.8571428571428571,0.1111111111111111,0.8888888888888888
SF-I28,SF-K19,5,5,1,0,4,5,0.2,0.8,0.0,1.0
SF-I28,SF-J18,1,7,1,0,0,7,1.0,0.0,0.0,1.0
SF-I28,SF-J19,3,2,2,0,1,2,0.6666666666666666,0.3333333333333333,0.0,1.0
SF-I28,SF-O18,2,1,1,1,1,0,0.5,0.5,1.0,0.0
SF-I28,SF-O21,8,6,3,2,5,4,0.375,0.625,0.3333333333333333,0.6666666666666666
SF-I28,SF-O22,16,13,3,8,13,5,0.1875,0.8125,0.6153846153846154,0.38461538461538464
SF-I28,SF-N21,2,2,2,2,0,0,1.0,0.0,1.0,0.0
SF-I28,SF-L21,37,7,4,3,33,4,0.10810810810810811,0.8918918918918919,0.42857142857142855,0.5714285714285714
SF-I28,SF-Q30,6,16,5,7,1,9,0.8333333333333334,0.16666666666666666,0.4375,0.5625
SF-I28,SF-P30,2,3,1,1,1,2,0.5,0.5,0.3333333333333333,0.6666666666666666
SF-I28,SF-O30-2,10,6,6,2,4,4,0.6,0.4,0.3333333333333333,0.6666666666666666
SF-I28,SF-O30,11,16,6,7,5,9,0.5454545454545454,0.45454545454545453,0.4375,0.5625
SF-I28,SF-N27,11,12,7,7,4,5,0.6363636363636364,0.36363636363636365,0.5833333333333334,0.4166666666666667
SF-I28,SF-N29,3,2,2,1,1,1,0.6666666666666666,0.3333333333333333,0.5,0.5
SF-I28,SF-N28,4,9,4,6,0,3,1.0,0.0,0.6666666666666666,0.3333333333333333
SF-I28,SF-L30-1,11,25,7,17,4,8,0.6363636363636364,0.36363636363636365,0.68,0.32
SF-I28,SF-L31-1,9,1,1,0,8,1,0.1111111111111111,0.8888888888888888,0.0,1.0
SF-I28,SF-K30-2,5,9,3,6,2,3,0.6,0.4,0.6666666666666666,0.3333333333333333
SF-I28,SF-L29,24,39,18,25,6,14,0.75,0.25,0.6410256410256411,0.358974358974359
SF-I28,SF-J29-1,10,10,6,7,4,3,0.6,0.4,0.7,0.3
SF-I28,SF-I30,20,13,19,13,1,0,0.95,0.05,1.0,0.0
SF-I28,SF-I29-2,21,20,11,8,10,12,0.5238095238095238,0.47619047619047616,0.4,0.6
SF-I28,SF-I27,28,18,27,11,1,7,0.9642857142857143,0.03571428571428571,0.6111111111111112,0.3888888888888889
SF-I28,SF-I30-2,27,24,20,21,7,3,0.7407407407407407,0.25925925925925924,0.875,0.125
SF-I28,SF I29-1,7,5,2,1,5,4,0.2857142857142857,0.7142857142857143,0.2,0.8
SF-I28,SF-H28,23,34,11,20,12,14,0.4782608695652174,0.5217391304347826,0.5882352941176471,0.4117647058823529
SF-I28,SF-H29,1,2,1,1,0,1,1.0,0.0,0.5,0.5
SF-I28,SF-S24,1,3,1,3,0,0,1.0,0.0,1.0,0.0
SF-I28,SF-R24,1,3,0,1,1,2,0.0,1.0,0.3333333333333333,0.6666666666666666
SF-I28,SF-P26,1,2,0,0,1,2,0.0,1.0,0.0,1.0
SF-I28,SF-O25-2,2,1,1,1,1,0,0.5,0.5,1.0,0.0
SF-I28,SF-N22-1B,2,2,0,1,2,1,0.0,1.0,0.5,0.5
SF-I28,SF-T21,7,4,5,4,2,0,0.7142857142857143,0.2857142857142857,1.0,0.0
SF-I28,SF-Q23-3,3,3,2,2,1,1,0.6666666666666666,0.3333333333333333,0.6666666666666666,0.3333333333333333
SF-I28,SF-Q22-1,5,12,0,2,5,10,0.0,1.0,0.16666666666666666,0.8333333333333334
SF-I28,SF-Q22-2,2,2,1,0,1,2,0.5,0.5,0.0,1.0
SF-I28,SF-P22,3,5,1,4,2,1,0.3333333333333333,0.6666666666666666,0.8,0.2
SF-I28,SF-V28,1,4,0,0,1,4,0.0,1.0,0.0,1.0
SF-I30-2,SF-M26,2,2,1,1,1,1,0.5,0.5,0.5,0.5
SF-I30-2,SF-M25,1,14,1,6,0,8,1.0,0.0,0.42857142857142855,0.5714285714285714
SF-I30-2,SF-M26-2,3,4,2,2,1,2,0.6666666666666666,0.3333333333333333,0.5,0.5
SF-I30-2,SF-L27,4,20,1,4,3,16,0.25,0.75,0.2,0.8
SF-I30-2,SF-K26,25,15,18,6,7,9,0.72,0.28,0.4,0.6
SF-I30-2,SF-J27,3,9,0,7,3,2,0.0,1.0,0.7777777777777778,0.2222222222222222
SF-I30-2,SF-M30,8,9,2,5,6,4,0.25,0.75,0.5555555555555556,0.4444444444444444
SF-I30-2,SF-L27-2,1,2,1,1,0,1,1.0,0.0,0.5,0.5
SF-I30-2,SF-J29-3,2,7,1,6,1,1,0.5,0.5,0.8571428571428571,0.14285714285714285
SF-I30-2,SF-J29,7,18,4,7,3,11,0.5714285714285714,0.42857142857142855,0.3888888888888889,0.6111111111111112
SF-I30-2,SF-L26,15,16,13,12,2,4,0.8666666666666667,0.13333333333333333,0.75,0.25
SF-I30-2,SF-M28,7,6,2,1,5,5,0.2857142857142857,0.7142857142857143,0.16666666666666666,0.8333333333333334
SF-I30-2,SF-L25,14,17,6,7,8,10,0.42857142857142855,0.5714285714285714,0.4117647058823529,0.5882352941176471
SF-I30-2,SF-M24,5,12,4,10,1,2,0.8,0.2,0.8333333333333334,0.16666666666666666
SF-I30-2,SF-L24,44,61,42,55,2,6,0.9545454545454546,0.045454545454545456,0.9016393442622951,0.09836065573770492
SF-I30-2,SF-N24-2,6,2,4,2,2,0,0.6666666666666666,0.3333333333333333,1.0,0.0
SF-I30-2,SF-K27-2,25,22,11,9,14,13,0.44,0.56,0.4090909090909091,0.5909090909090909
SF-I30-2,SF-J26-2,8,7,1,3,7,4,0.125,0.875,0.42857142857142855,0.5714285714285714
SF-I30-2,SF-L28,9,8,5,5,4,3,0.5555555555555556,0.4444444444444444,0.625,0.375
SF-I30-2,SF-K28,5,6,4,2,1,4,0.8,0.2,0.3333333333333333,0.6666666666666666
SF-I30-2,SF-K29-1,31,18,11,13,20,5,0.3548387096774194,0.6451612903225806,0.7222222222222222,0.2777777777777778
SF-I30-2,SF-J28-2,20,32,18,26,2,6,0.9,0.1,0.8125,0.1875
SF-I30-2,SF-K27,3,15,0,11,3,4,0.0,1.0,0.7333333333333333,0.26666666666666666
SF-I30-2,SF-K25,20,20,18,14,2,6,0.9,0.1,0.7,0.3
SF-I30-2,SF-J25,5,8,3,4,2,4,0.6,0.4,0.5,0.5
SF-I30-2,SF-H26-2,1,7,0,2,1,5,0.0,1.0,0.2857142857142857,0.7142857142857143
SF-I30-2,SF-P24,1,3,0,0,1,3,0.0,1.0,0.0,1.0
SF-I30-2,SF-J24,10,13,4,3,6,10,0.4,0.6,0.23076923076923078,0.7692307692307693
SF-I30-2,SF-J26,3,1,0,1,3,0,0.0,1.0,1.0,0.0
SF-I30-2,SF-I25,7,6,6,4,1,2,0.8571428571428571,0.14285714285714285,0.6666666666666666,0.3333333333333333
SF-I30-2,SF-H26,3,9,3,6,0,3,1.0,0.0,0.6666666666666666,0.3333333333333333
SF-I30-2,SF-O23,4,1,1,0,3,1,0.25,0.75,0.0,1.0
SF-I30-2,SF-H27-1,52,75,46,58,6,17,0.8846153846153846,0.11538461538461539,0.7733333333333333,0.22666666666666666
SF-I30-2,SF-F28-2,51,85,38,56,13,29,0.7450980392156863,0.2549019607843137,0.6588235294117647,0.3411764705882353
SF-I30-2,SF-G27,40,27,24,14,16,13,0.6,0.4,0.5185185185185185,0.48148148148148145
SF-I30-2,SF-M22-2,9,3,1,0,8,3,0.1111111111111111,0.8888888888888888,0.0,1.0
SF-I30-2,SF-L22,7,3,1,2,6,1,0.14285714285714285,0.8571428571428571,0.6666666666666666,0.3333333333333333
SF-I30-2,SF-F27,32,46,11,28,21,18,0.34375,0.65625,0.6086956521739131,0.391304347826087
SF-I30-2,SF-N22-2,5,9,1,2,4,7,0.2,0.8,0.2222222222222222,0.7777777777777778
SF-I30-2,SF-G28-2,7,1,4,0,3,1,0.5714285714285714,0.42857142857142855,0.0,1.0
SF-I30-2,SF-G28-1,2,4,0,2,2,2,0.0,1.0,0.5,0.5
SF-I30-2,SF-M22-1,15,6,1,1,14,5,0.06666666666666667,0.9333333333333333,0.16666666666666666,0.8333333333333334
SF-I30-2,SF-O25-1,2,2,2,2,0,0,1.0,0.0,1.0,0.0
SF-I30-2,SF-K24,12,14,12,13,0,1,1.0,0.0,0.9285714285714286,0.07142857142857142
SF-I30-2,SF-J23-2,2,4,2,0,0,4,1.0,0.0,0.0,1.0
SF-I30-2,SF-G24,12,14,8,2,4,12,0.6666666666666666,0.3333333333333333,0.14285714285714285,0.8571428571428571
SF-I30-2,SF-G25,19,15,11,5,8,10,0.5789473684210527,0.42105263157894735,0.3333333333333333,0.6666666666666666
SF-I30-2,SF-F23,1,4,0,0,1,4,0.0,1.0,0.0,1.0
SF-I30-2,SF-E23,5,9,2,1,3,8,0.4,0.6,0.1111111111111111,0.8888888888888888
SF-I30-2,SF-B22,7,15,7,10,0,5,1.0,0.0,0.6666666666666666,0.3333333333333333
SF-I30-2,SF-J17,16,15,1,0,15,15,0.0625,0.9375,0.0,1.0
SF-I30-2,SF-I19,2,1,0,0,2,1,0.0,1.0,0.0,1.0
SF-I30-2,SF-H19,3,3,2,2,1,1,0.6666666666666666,0.3333333333333333,0.6666666666666666,0.3333333333333333
SF-I30-2,SF-H20,2,3,1,1,1,2,0.5,0.5,0.3333333333333333,0.6666666666666666
SF-I30-2,SF-H18,1,2,1,2,0,0,1.0,0.0,1.0,0.0
SF-I30-2,SF-G19,2,4,2,1,0,3,1.0,0.0,0.25,0.75
SF-I30-2,SF-G20,1,2,0,0,1,2,0.0,1.0,0.0,1.0
SF-I30-2,SF-E20,1,1,0,0,1,1,0.0,1.0,0.0,1.0
SF-I30-2,SF-H30,9,24,7,14,2,10,0.7777777777777778,0.2222222222222222,0.5833333333333334,0.4166666666666667
SF-I30-2,SF-G30-2,19,10,13,9,6,1,0.6842105263157895,0.3157894736842105,0.9,0.1
SF-I30-2,SF-F30-1,8,8,6,4,2,4,0.75,0.25,0.5,0.5
SF-I30-2,SF-E29-2,8,20,4,16,4,4,0.5,0.5,0.8,0.2
SF-I30-2,SF-E29-1,32,27,27,25,5,2,0.84375,0.15625,0.9259259259259259,0.07407407407407407
SF-I30-2,SF-D29,17,20,12,8,5,12,0.7058823529411765,0.29411764705882354,0.4,0.6
SF-I30-2,SF-D28,22,22,8,8,14,14,0.36363636363636365,0.6363636363636364,0.36363636363636365,0.6363636363636364
SF-I30-2,SF-A27,11,16,7,8,4,8,0.6363636363636364,0.36363636363636365,0.5,0.5
SF-I30-2,SF-G29-2,10,12,7,6,3,6,0.7,0.3,0.5,0.5
SF-I30-2,SF-G29-1,23,30,22,23,1,7,0.9565217391304348,0.043478260869565216,0.7666666666666667,0.23333333333333334
SF-I30-2,SF-G30-1,18,20,10,18,8,2,0.5555555555555556,0.4444444444444444,0.9,0.1
SF-I30-2,SF-G29-3,41,60,38,51,3,9,0.926829268292683,0.07317073170731707,0.85,0.15
SF-I30-2,SF-F30-2,3,12,0,9,3,3,0.0,1.0,0.75,0.25
SF-I30-2,SF-F29,1,12,1,8,0,4,1.0,0.0,0.6666666666666666,0.3333333333333333
SF-I30-2,SF-E29-3,7,3,3,2,4,1,0.42857142857142855,0.5714285714285714,0.6666666666666666,0.3333333333333333
SF-I30-2,SF-F28-1,5,11,3,10,2,1,0.6,0.4,0.9090909090909091,0.09090909090909091
SF-I30-2,SF-E28-2,8,4,2,3,6,1,0.25,0.75,0.75,0.25
SF-I30-2,SF-E28,4,4,3,3,1,1,0.75,0.25,0.75,0.25
SF-I30-2,SF-G12,2,1,1,0,1,1,0.5,0.5,0.0,1.0
SF-I30-2,SF-F16,3,8,0,0,3,8,0.0,1.0,0.0,1.0
SF-I30-2,SF-C20,3,1,0,1,3,0,0.0,1.0,1.0,0.0
SF-I30-2,SF-B19,26,9,0,1,26,8,0.0,1.0,0.1111111111111111,0.8888888888888888
SF-I30-2,SF-A20,8,11,2,6,6,5,0.25,0.75,0.5454545454545454,0.45454545454545453
SF-I30-2,SF-C26,17,9,3,5,14,4,0.17647058823529413,0.8235294117647058,0.5555555555555556,0.4444444444444444
SF-I30-2,SF-C25,131,6,16,2,115,4,0.12213740458015267,0.8778625954198473,0.3333333333333333,0.6666666666666666
SF-I30-2,SF-B25,14,10,5,5,9,5,0.35714285714285715,0.6428571428571429,0.5,0.5
SF-I30-2,SF-E27,6,2,2,0,4,2,0.3333333333333333,0.6666666666666666,0.0,1.0
SF-I30-2,SF-B28-2,1,4,1,4,0,0,1.0,0.0,1.0,0.0
SF-I30-2,SF-D27,3,7,0,4,3,3,0.0,1.0,0.5714285714285714,0.42857142857142855
SF-I30-2,SF-C28-2,3,1,1,1,2,0,0.3333333333333333,0.6666666666666666,1.0,0.0
SF-I30-2,SF-C28-1,1,1,0,1,1,0,0.0,1.0,1.0,0.0
SF-I30-2,SF-B28,3,7,3,5,0,2,1.0,0.0,0.7142857142857143,0.2857142857142857
SF-I30-2,SF-G7,4,1,0,0,4,1,0.0,1.0,0.0,1.0
SF-I30-2,SF-H25,5,2,1,0,4,2,0.2,0.8,0.0,1.0
SF-I30-2,SF-G26,8,12,7,9,1,3,0.875,0.125,0.75,0.25
SF-I30-2,SF-K21,1,2,0,0,1,2,0.0,1.0,0.0,1.0
SF-I30-2,SF-K22-1,5,3,4,2,1,1,0.8,0.2,0.6666666666666666,0.3333333333333333
SF-I30-2,SF-J23-1,14,8,9,3,5,5,0.6428571428571429,0.35714285714285715,0.375,0.625
SF-I30-2,SF-J22-1,1,1,0,1,1,0,0.0,1.0,1.0,0.0
SF-I30-2,SF-J22-2,5,5,2,4,3,1,0.4,0.6,0.8,0.2
SF-I30-2,SF-J21,3,5,2,1,1,4,0.6666666666666666,0.3333333333333333,0.2,0.8
SF-I30-2,SF-I21,5,3,0,1,5,2,0.0,1.0,0.3333333333333333,0.6666666666666666
SF-I30-2,SF-I22,2,32,0,0,2,32,0.0,1.0,0.0,1.0
SF-I30-2,SF-I23-2,6,9,1,0,5,9,0.16666666666666666,0.8333333333333334,0.0,1.0
SF-I30-2,SF-I24,2,6,1,3,1,3,0.5,0.5,0.5,0.5
SF-I30-2,SF-I23-1,3,9,1,8,2,1,0.3333333333333333,0.6666666666666666,0.8888888888888888,0.1111111111111111
SF-I30-2,SF-F26,33,40,12,9,21,31,0.36363636363636365,0.6363636363636364,0.225,0.775
SF-I30-2,SF-M15,2,1,1,0,1,1,0.5,0.5,0.0,1.0
SF-I30-2,SF-L20,2,1,0,0,2,1,0.0,1.0,0.0,1.0
SF-I30-2,SF-N20-1,2,3,1,0,1,3,0.5,0.5,0.0,1.0
SF-I30-2,SF-M20,4,4,0,2,4,2,0.0,1.0,0.5,0.5
SF-I30-2,SF-K20,3,1,2,0,1,1,0.6666666666666666,0.3333333333333333,0.0,1.0
SF-I30-2,SF-K15-,2,1,0,1,2,0,0.0,1.0,1.0,0.0
SF-I30-2,SF-K19,1,3,1,0,0,3,1.0,0.0,0.0,1.0
SF-I30-2,SF-J18,5,2,2,0,3,2,0.4,0.6,0.0,1.0
SF-I30-2,SF-J19,2,1,0,0,2,1,0.0,1.0,0.0,1.0
SF-I30-2,SF-M12,3,1,0,0,3,1,0.0,1.0,0.0,1.0
SF-I30-2,SF-M11,2,2,0,1,2,1,0.0,1.0,0.5,0.5
SF-I30-2,SF-Q21-1,7,12,0,0,7,12,0.0,1.0,0.0,1.0
SF-I30-2,SF-O18,1,1,0,1,1,0,0.0,1.0,1.0,0.0
SF-I30-2,SF-O19,3,4,0,0,3,4,0.0,1.0,0.0,1.0
SF-I30-2,SF-O21,6,12,4,1,2,11,0.6666666666666666,0.3333333333333333,0.08333333333333333,0.9166666666666666
SF-I30-2,SF-O22,3,1,0,0,3,1,0.0,1.0,0.0,1.0
SF-I30-2,SF-N21,2,4,0,1,2,3,0.0,1.0,0.25,0.75
SF-I30-2,SF-N20-2,1,1,0,1,1,0,0.0,1.0,1.0,0.0
SF-I30-2,SF-M21,2,6,0,1,2,5,0.0,1.0,0.16666666666666666,0.8333333333333334
SF-I30-2,SF-L21,7,6,0,4,7,2,0.0,1.0,0.6666666666666666,0.3333333333333333
SF-I30-2,SF-Q30,3,14,0,1,3,13,0.0,1.0,0.07142857142857142,0.9285714285714286
SF-I30-2,SF-P30,3,3,0,0,3,3,0.0,1.0,0.0,1.0
SF-I30-2,SF-O30-2,5,15,2,9,3,6,0.4,0.6,0.6,0.4
SF-I30-2,SF-O30,12,15,2,5,10,10,0.16666666666666666,0.8333333333333334,0.3333333333333333,0.6666666666666666
SF-I30-2,SF-N27,5,7,5,2,0,5,1.0,0.0,0.2857142857142857,0.7142857142857143
SF-I30-2,SF-N29,6,5,5,3,1,2,0.8333333333333334,0.16666666666666666,0.6,0.4
SF-I30-2,SF-N28,1,2,1,2,0,0,1.0,0.0,1.0,0.0
SF-I30-2,SF-L30-1,19,43,7,23,12,20,0.3684210526315789,0.631578947368421,0.5348837209302325,0.46511627906976744
SF-I30-2,SF-L31-1,3,5,2,4,1,1,0.6666666666666666,0.3333333333333333,0.8,0.2
SF-I30-2,SF-K30-2,5,7,1,4,4,3,0.2,0.8,0.5714285714285714,0.42857142857142855
SF-I30-2,SF-L29,3,6,1,2,2,4,0.3333333333333333,0.6666666666666666,0.3333333333333333,0.6666666666666666
SF-I30-2,SF-J29-1,18,12,4,10,14,2,0.2222222222222222,0.7777777777777778,0.8333333333333334,0.16666666666666666
SF-I30-2,SF-I30,22,17,14,16,8,1,0.6363636363636364,0.36363636363636365,0.9411764705882353,0.058823529411764705
SF-I30-2,SF-I29-2,18,16,8,14,10,2,0.4444444444444444,0.5555555555555556,0.875,0.125
SF-I30-2,SF-I27,8,8,5,4,3,4,0.625,0.375,0.5,0.5
SF-I30-2,SF-I28,24,27,21,20,3,7,0.875,0.125,0.7407407407407407,0.25925925925925924
SF-I30-2,SF I29-1,12,19,7,17,5,2,0.5833333333333334,0.4166666666666667,0.8947368421052632,0.10526315789473684
SF-I30-2,SF-H28,18,22,13,17,5,5,0.7222222222222222,0.2777777777777778,0.7727272727272727,0.22727272727272727
SF-I30-2,SF-H29,6,5,4,5,2,0,0.6666666666666666,0.3333333333333333,1.0,0.0
SF-I30-2,SF-S24,2,2,0,1,2,1,0.0,1.0,0.5,0.5
SF-I30-2,SF-P26,4,1,0,0,4,1,0.0,1.0,0.0,1.0
SF-I30-2,SF-N22-1B,4,2,1,0,3,2,0.25,0.75,0.0,1.0
SF-I30-2,SF-N26,1,5,0,0,1,5,0.0,1.0,0.0,1.0
SF-I30-2,SF-Q23-3,1,5,0,2,1,3,0.0,1.0,0.4,0.6
SF-I30-2,SF-Q22-1,5,3,0,0,5,3,0.0,1.0,0.0,1.0
SF-I30-2,SF-P22,3,4,1,1,2,3,0.3333333333333333,0.6666666666666666,0.25,0.75
SF-I30-2,SF-W19,2,1,1,0,1,1,0.5,0.5,0.0,1.0
SF I29-1,SF-M26-2,2,2,0,0,2,2,0.0,1.0,0.0,1.0
SF I29-1,SF-L27,1,4,1,0,0,4,1.0,0.0,0.0,1.0
SF I29-1,SF-K26,1,3,0,0,1,3,0.0,1.0,0.0,1.0
SF I29-1,SF-J27,4,6,2,1,2,5,0.5,0.5,0.16666666666666666,0.8333333333333334
SF I29-1,SF-M30,6,32,0,28,6,4,0.0,1.0,0.875,0.125
SF I29-1,SF-L27-2,1,3,1,1,0,2,1.0,0.0,0.3333333333333333,0.6666666666666666
SF I29-1,SF-J29-3,6,8,2,5,4,3,0.3333333333333333,0.6666666666666666,0.625,0.375
SF I29-1,SF-J29,9,18,3,6,6,12,0.3333333333333333,0.6666666666666666,0.3333333333333333,0.6666666666666666
SF I29-1,SF-M28,1,2,0,0,1,2,0.0,1.0,0.0,1.0
SF I29-1,SF-M27,1,1,1,1,0,0,1.0,0.0,1.0,0.0
SF I29-1,SF-L25,1,3,1,1,0,2,1.0,0.0,0.3333333333333333,0.6666666666666666
SF I29-1,SF-M24,3,9,2,3,1,6,0.6666666666666666,0.3333333333333333,0.3333333333333333,0.6666666666666666
SF I29-1,SF-L24,4,1,0,0,4,1,0.0,1.0,0.0,1.0
SF I29-1,SF-N23,1,1,0,0,1,1,0.0,1.0,0.0,1.0
SF I29-1,SF-K27-2,11,7,4,3,7,4,0.36363636363636365,0.6363636363636364,0.42857142857142855,0.5714285714285714
SF I29-1,SF-J26-2,15,4,2,2,13,2,0.13333333333333333,0.8666666666666667,0.5,0.5
SF I29-1,SF-L28,13,1,2,0,11,1,0.15384615384615385,0.8461538461538461,0.0,1.0
SF I29-1,SF-K28,2,8,1,2,1,6,0.5,0.5,0.25,0.75
SF I29-1,SF-K29-1,22,11,2,3,20,8,0.09090909090909091,0.9090909090909091,0.2727272727272727,0.7272727272727273
SF I29-1,SF-J28-2,7,5,3,2,4,3,0.42857142857142855,0.5714285714285714,0.4,0.6
SF I29-1,SF-K25,6,1,1,1,5,0,0.16666666666666666,0.8333333333333334,1.0,0.0
SF I29-1,SF-J25,7,16,2,3,5,13,0.2857142857142857,0.7142857142857143,0.1875,0.8125
SF I29-1,SF-H26-2,4,1,1,1,3,0,0.25,0.75,1.0,0.0
SF I29-1,SF-P24,4,3,0,0,4,3,0.0,1.0,0.0,1.0
SF I29-1,SF-J24,19,8,2,0,17,8,0.10526315789473684,0.8947368421052632,0.0,1.0
SF I29-1,SF-J26,4,4,1,1,3,3,0.25,0.75,0.25,0.75
SF I29-1,SF-I26-,2,3,2,1,0,2,1.0,0.0,0.3333333333333333,0.6666666666666666
SF I29-1,SF-I25,38,10,10,2,28,8,0.2631578947368421,0.7368421052631579,0.2,0.8
SF I29-1,SF-H26,6,19,2,7,4,12,0.3333333333333333,0.6666666666666666,0.3684210526315789,0.631578947368421
SF I29-1,SF-H27-1,6,20,4,11,2,9,0.6666666666666666,0.3333333333333333,0.55,0.45
SF I29-1,SF-F28-2,68,90,22,56,46,34,0.3235294117647059,0.6764705882352942,0.6222222222222222,0.37777777777777777
SF I29-1,SF-G27,30,60,7,25,23,35,0.23333333333333334,0.7666666666666667,0.4166666666666667,0.5833333333333334
SF I29-1,SF-M22-2,3,5,1,0,2,5,0.3333333333333333,0.6666666666666666,0.0,1.0
SF I29-1,SF-L22,1,2,1,2,0,0,1.0,0.0,1.0,0.0
SF I29-1,SF-F27,21,33,5,10,16,23,0.23809523809523808,0.7619047619047619,0.30303030303030304,0.696969696969697
SF I29-1,SF-N22-2,7,11,1,2,6,9,0.14285714285714285,0.8571428571428571,0.18181818181818182,0.8181818181818182
SF I29-1,SF-G28-2,9,11,0,8,9,3,0.0,1.0,0.7272727272727273,0.2727272727272727
SF I29-1,SF-G28-1,16,27,3,24,13,3,0.1875,0.8125,0.8888888888888888,0.1111111111111111
SF I29-1,SF-K22-2,3,2,1,0,2,2,0.3333333333333333,0.6666666666666666,0.0,1.0
SF I29-1,SF-K24,2,1,1,0,1,1,0.5,0.5,0.0,1.0
SF I29-1,SF-J23-2,29,22,1,0,28,22,0.034482758620689655,0.9655172413793104,0.0,1.0
SF I29-1,SF-G23,1,4,0,0,1,4,0.0,1.0,0.0,1.0
SF I29-1,SF-G24,25,12,0,0,25,12,0.0,1.0,0.0,1.0
SF I29-1,SF-G25,9,34,3,1,6,33,0.3333333333333333,0.6666666666666666,0.029411764705882353,0.9705882352941176
SF I29-1,SF-F23,7,4,1,1,6,3,0.14285714285714285,0.8571428571428571,0.25,0.75
SF I29-1,SF-E23,4,5,3,1,1,4,0.75,0.25,0.2,0.8
SF I29-1,SF-D24,14,2,1,0,13,2,0.07142857142857142,0.9285714285714286,0.0,1.0
SF I29-1,SF-B22,2,5,0,1,2,4,0.0,1.0,0.2,0.8
SF I29-1,SF-J17,21,13,0,0,21,13,0.0,1.0,0.0,1.0
SF I29-1,SF-I19,5,13,0,0,5,13,0.0,1.0,0.0,1.0
SF I29-1,SF-I20,1,2,0,0,1,2,0.0,1.0,0.0,1.0
SF I29-1,SF-G19,2,2,0,0,2,2,0.0,1.0,0.0,1.0
SF I29-1,SF-G17,3,2,0,1,3,1,0.0,1.0,0.5,0.5
SF I29-1,SF-G18,3,2,0,0,3,2,0.0,1.0,0.0,1.0
SF I29-1,SF-G20,36,21,2,2,34,19,0.05555555555555555,0.9444444444444444,0.09523809523809523,0.9047619047619048
SF I29-1,SF-F19,8,18,1,3,7,15,0.125,0.875,0.16666666666666666,0.8333333333333334
SF I29-1,SF-H30,1,1,1,0,0,1,1.0,0.0,0.0,1.0
SF I29-1,SF-G30-2,8,19,3,12,5,7,0.375,0.625,0.631578947368421,0.3684210526315789
SF I29-1,SF-F30-1,13,16,0,2,13,14,0.0,1.0,0.125,0.875
SF I29-1,SF-E29-2,16,9,4,5,12,4,0.25,0.75,0.5555555555555556,0.4444444444444444
SF I29-1,SF-E29-1,38,55,6,23,32,32,0.15789473684210525,0.8421052631578947,0.41818181818181815,0.5818181818181818
SF I29-1,SF-D29,1,7,0,3,1,4,0.0,1.0,0.42857142857142855,0.5714285714285714
SF I29-1,SF-D28,7,14,4,11,3,3,0.5714285714285714,0.42857142857142855,0.7857142857142857,0.21428571428571427
SF I29-1,SF-A27,3,16,2,2,1,14,0.6666666666666666,0.3333333333333333,0.125,0.875
SF I29-1,SF-G29-2,4,7,2,1,2,6,0.5,0.5,0.14285714285714285,0.8571428571428571
SF I29-1,SF-G29-1,55,85,7,25,48,60,0.12727272727272726,0.8727272727272727,0.29411764705882354,0.7058823529411765
SF I29-1,SF-G30-1,40,41,4,13,36,28,0.1,0.9,0.3170731707317073,0.6829268292682927
SF I29-1,SF-G29-3,11,7,2,5,9,2,0.18181818181818182,0.8181818181818182,0.7142857142857143,0.2857142857142857
SF I29-1,SF-F30-2,4,4,0,2,4,2,0.0,1.0,0.5,0.5
SF I29-1,SF-F29,2,7,0,3,2,4,0.0,1.0,0.42857142857142855,0.5714285714285714
SF I29-1,SF-E29-3,3,4,1,1,2,3,0.3333333333333333,0.6666666666666666,0.25,0.75
SF I29-1,SF-F28-1,9,4,1,2,8,2,0.1111111111111111,0.8888888888888888,0.5,0.5
SF I29-1,SF-E28-2,1,1,0,0,1,1,0.0,1.0,0.0,1.0
SF I29-1,SF-E28,7,11,0,7,7,4,0.0,1.0,0.6363636363636364,0.36363636363636365
SF I29-1,SF-H12,1,1,0,0,1,1,0.0,1.0,0.0,1.0
SF I29-1,SF-C20,1,3,0,0,1,3,0.0,1.0,0.0,1.0
SF I29-1,SF-B19,2,3,0,0,2,3,0.0,1.0,0.0,1.0
SF I29-1,SF-A20,1,6,0,0,1,6,0.0,1.0,0.0,1.0
SF I29-1,SF-C26,2,5,0,0,2,5,0.0,1.0,0.0,1.0
SF I29-1,SF-C25,8,9,1,0,7,9,0.125,0.875,0.0,1.0
SF I29-1,SF-B25,18,4,0,1,18,3,0.0,1.0,0.25,0.75
SF I29-1,SF-E27,2,1,0,0,2,1,0.0,1.0,0.0,1.0
SF I29-1,SF-D27,2,4,2,2,0,2,1.0,0.0,0.5,0.5
SF I29-1,SF-C28-2,3,4,1,0,2,4,0.3333333333333333,0.6666666666666666,0.0,1.0
SF I29-1,SF-B28,3,6,3,3,0,3,1.0,0.0,0.5,0.5
SF I29-1,SF-G8,10,16,0,0,10,16,0.0,1.0,0.0,1.0
SF I29-1,SF-H25,2,2,0,1,2,1,0.0,1.0,0.5,0.5
SF I29-1,SF-G26,5,7,2,4,3,3,0.4,0.6,0.5714285714285714,0.42857142857142855
SF I29-1,SF-K22-1,2,5,0,2,2,3,0.0,1.0,0.4,0.6
SF I29-1,SF-J23-1,18,39,1,10,17,29,0.05555555555555555,0.9444444444444444,0.2564102564102564,0.7435897435897436
SF I29-1,SF-J22-2,9,4,5,2,4,2,0.5555555555555556,0.4444444444444444,0.5,0.5
SF I29-1,SF-J21,2,9,1,5,1,4,0.5,0.5,0.5555555555555556,0.4444444444444444
SF I29-1,SF-I22,1,7,0,0,1,7,0.0,1.0,0.0,1.0
SF I29-1,SF-I23-2,4,19,1,0,3,19,0.25,0.75,0.0,1.0
SF I29-1,SF-I24,3,4,1,0,2,4,0.3333333333333333,0.6666666666666666,0.0,1.0
SF I29-1,SF-I23-1,14,13,11,8,3,5,0.7857142857142857,0.21428571428571427,0.6153846153846154,0.38461538461538464
SF I29-1,SF-F26,15,16,3,3,12,13,0.2,0.8,0.1875,0.8125
SF I29-1,SF-M13,1,2,0,0,1,2,0.0,1.0,0.0,1.0
SF I29-1,SF-M20,6,3,1,0,5,3,0.16666666666666666,0.8333333333333334,0.0,1.0
SF I29-1,SF-K17-2,1,1,0,0,1,1,0.0,1.0,0.0,1.0
SF I29-1,SF-K15-,1,1,0,0,1,1,0.0,1.0,0.0,1.0
SF I29-1,SF-K19,2,1,0,0,2,1,0.0,1.0,0.0,1.0
SF I29-1,SF-K17,1,1,1,0,0,1,1.0,0.0,0.0,1.0
SF I29-1,SF-J18,4,8,0,0,4,8,0.0,1.0,0.0,1.0
SF I29-1,SF-J20,71,57,66,22,5,35,0.9295774647887324,0.07042253521126761,0.38596491228070173,0.6140350877192983
SF I29-1,SF-J19,1,5,0,1,1,4,0.0,1.0,0.2,0.8
SF I29-1,SF-M10,1,1,0,0,1,1,0.0,1.0,0.0,1.0
SF I29-1,SF-Q21-2,2,2,0,0,2,2,0.0,1.0,0.0,1.0
SF I29-1,SF-Q21-1,70,51,0,0,70,51,0.0,1.0,0.0,1.0
SF I29-1,SF-P21,2,4,0,0,2,4,0.0,1.0,0.0,1.0
SF I29-1,SF-O18,2,9,0,1,2,8,0.0,1.0,0.1111111111111111,0.8888888888888888
SF I29-1,SF-O19,1,5,0,0,1,5,0.0,1.0,0.0,1.0
SF I29-1,SF-O21,1,13,0,2,1,11,0.0,1.0,0.15384615384615385,0.8461538461538461
SF I29-1,SF-O22,25,5,8,1,17,4,0.32,0.68,0.2,0.8
SF I29-1,SF-L21,5,2,0,0,5,2,0.0,1.0,0.0,1.0
SF I29-1,SF-Q30,4,3,1,0,3,3,0.25,0.75,0.0,1.0
SF I29-1,SF-O30-2,3,4,2,2,1,2,0.6666666666666666,0.3333333333333333,0.5,0.5
SF I29-1,SF-O30,9,6,5,4,4,2,0.5555555555555556,0.4444444444444444,0.6666666666666666,0.3333333333333333
SF I29-1,SF-N27,9,11,0,2,9,9,0.0,1.0,0.18181818181818182,0.8181818181818182
SF I29-1,SF-N29,2,3,1,2,1,1,0.5,0.5,0.6666666666666666,0.3333333333333333
SF I29-1,SF-N28,2,6,2,5,0,1,1.0,0.0,0.8333333333333334,0.16666666666666666
SF I29-1,SF-L30-1,15,21,4,12,11,9,0.26666666666666666,0.7333333333333333,0.5714285714285714,0.42857142857142855
SF I29-1,SF-L31-1,2,3,1,2,1,1,0.5,0.5,0.6666666666666666,0.3333333333333333
SF I29-1,SF-K30-2,5,8,2,1,3,7,0.4,0.6,0.125,0.875
SF I29-1,SF-L29,4,6,1,2,3,4,0.25,0.75,0.3333333333333333,0.6666666666666666
SF I29-1,SF-J29-1,7,9,3,4,4,5,0.42857142857142855,0.5714285714285714,0.4444444444444444,0.5555555555555556
SF I29-1,SF-I30,11,11,7,6,4,5,0.6363636363636364,0.36363636363636365,0.5454545454545454,0.45454545454545453
SF I29-1,SF-I29-2,13,9,7,5,6,4,0.5384615384615384,0.46153846153846156,0.5555555555555556,0.4444444444444444
SF I29-1,SF-I27,5,3,1,1,4,2,0.2,0.8,0.3333333333333333,0.6666666666666666
SF I29-1,SF-I28,5,7,1,2,4,5,0.2,0.8,0.2857142857142857,0.7142857142857143
SF I29-1,SF-I30-2,19,12,17,7,2,5,0.8947368421052632,0.10526315789473684,0.5833333333333334,0.4166666666666667
SF I29-1,SF-H28,3,11,1,9,2,2,0.3333333333333333,0.6666666666666666,0.8181818181818182,0.18181818181818182
SF I29-1,SF-H29,5,7,3,5,2,2,0.6,0.4,0.7142857142857143,0.2857142857142857
SF I29-1,SF-R24,7,5,7,3,0,2,1.0,0.0,0.6,0.4
SF I29-1,SF-N22-1B,2,1,1,0,1,1,0.5,0.5,0.0,1.0
SF I29-1,SF-S22-2,2,1,0,0,2,1,0.0,1.0,0.0,1.0
SF I29-1,SF-Q22-1,14,4,1,0,13,4,0.07142857142857142,0.9285714285714286,0.0,1.0
SF I29-1,SF-Q22-2,3,3,0,1,3,2,0.0,1.0,0.3333333333333333,0.6666666666666666
SF I29-1,SF-P22,55,17,11,1,44,16,0.2,0.8,0.058823529411764705,0.9411764705882353
SF I29-1,SF-T20,1,4,0,3,1,1,0.0,1.0,0.75,0.25
SF I29-1,SF-V28,7,8,0,0,7,8,0.0,1.0,0.0,1.0
SF I29-1,SF-V29,4,4,0,0,4,4,0.0,1.0,0.0,1.0
SF-H28,SF-M26,1,7,0,7,1,0,0.0,1.0,1.0,0.0
SF-H28,SF-M25,12,12,7,9,5,3,0.5833333333333334,0.4166666666666667,0.75,0.25
SF-H28,SF-M26-2,5,8,2,6,3,2,0.4,0.6,0.75,0.25
SF-H28,SF-L27,13,8,5,3,8,5,0.38461538461538464,0.6153846153846154,0.375,0.625
SF-H28,SF-K26,9,8,3,4,6,4,0.3333333333333333,0.6666666666666666,0.5,0.5
SF-H28,SF-J27,18,8,10,3,8,5,0.5555555555555556,0.4444444444444444,0.375,0.625
SF-H28,SF-M30,22,6,12,5,10,1,0.5454545454545454,0.45454545454545453,0.8333333333333334,0.16666666666666666
SF-H28,SF-L27-2,5,3,2,1,3,2,0.4,0.6,0.3333333333333333,0.6666666666666666
SF-H28,SF-J29-3,56,79,53,60,3,19,0.9464285714285714,0.05357142857142857,0.759493670886076,0.24050632911392406
SF-H28,SF-J29,29,46,19,29,10,17,0.6551724137931034,0.3448275862068966,0.6304347826086957,0.3695652173913043
SF-H28,SF-L26,3,3,2,2,1,1,0.6666666666666666,0.3333333333333333,0.6666666666666666,0.3333333333333333
SF-H28,SF-M28,13,6,3,5,10,1,0.23076923076923078,0.7692307692307693,0.8333333333333334,0.16666666666666666
SF-H28,SF-L25,41,19,23,12,18,7,0.5609756097560976,0.43902439024390244,0.631578947368421,0.3684210526315789
SF-H28,SF-M24,7,8,4,7,3,1,0.5714285714285714,0.42857142857142855,0.875,0.125
SF-H28,SF-L24,49,14,40,5,9,9,0.8163265306122449,0.1836734693877551,0.35714285714285715,0.6428571428571429
SF-H28,SF-N23,15,11,4,7,11,4,0.26666666666666666,0.7333333333333333,0.6363636363636364,0.36363636363636365
SF-H28,SF-N24-2,20,37,20,27,0,10,1.0,0.0,0.7297297297297297,0.2702702702702703
SF-H28,SF-K27-2,31,10,28,7,3,3,0.9032258064516129,0.0967741935483871,0.7,0.3
SF-H28,SF-J26-2,45,9,34,5,11,4,0.7555555555555555,0.24444444444444444,0.5555555555555556,0.4444444444444444
SF-H28,SF-L28,7,7,5,3,2,4,0.7142857142857143,0.2857142857142857,0.42857142857142855,0.5714285714285714
SF-H28,SF-K28,35,19,20,12,15,7,0.5714285714285714,0.42857142857142855,0.631578947368421,0.3684210526315789
SF-H28,SF-K29-1,57,34,35,18,22,16,0.6140350877192983,0.38596491228070173,0.5294117647058824,0.47058823529411764
SF-H28,SF-J28-2,8,9,7,6,1,3,0.875,0.125,0.6666666666666666,0.3333333333333333
SF-H28,SF-K27,7,7,5,5,2,2,0.7142857142857143,0.2857142857142857,0.7142857142857143,0.2857142857142857
SF-H28,SF-K25,73,20,48,7,25,13,0.6575342465753424,0.3424657534246575,0.35,0.65
SF-H28,SF-J25,21,22,20,14,1,8,0.9523809523809523,0.047619047619047616,0.6363636363636364,0.36363636363636365
SF-H28,SF-H26-2,6,14,3,8,3,6,0.5,0.5,0.5714285714285714,0.42857142857142855
SF-H28,SF-P24,2,3,2,0,0,3,1.0,0.0,0.0,1.0
SF-H28,SF-N22-1A,1,3,0,2,1,1,0.0,1.0,0.6666666666666666,0.3333333333333333
SF-H28,SF-J24,35,38,16,17,19,21,0.45714285714285713,0.5428571428571428,0.4473684210526316,0.5526315789473685
SF-H28,SF-O24,5,1,3,1,2,0,0.6,0.4,1.0,0.0
SF-H28,SF-J26,33,23,20,15,13,8,0.6060606060606061,0.3939393939393939,0.6521739130434783,0.34782608695652173
SF-H28,SF-I26-,4,6,3,4,1,2,0.75,0.25,0.6666666666666666,0.3333333333333333
SF-H28,SF-I25,16,11,11,9,5,2,0.6875,0.3125,0.8181818181818182,0.18181818181818182
SF-H28,SF-K23,2,1,1,1,1,0,0.5,0.5,1.0,0.0
SF-H28,SF-H26,104,127,96,115,8,12,0.9230769230769231,0.07692307692307693,0.905511811023622,0.09448818897637795
SF-H28,SF-O23,12,8,6,3,6,5,0.5,0.5,0.375,0.625
SF-H28,SF-H27-1,37,43,29,39,8,4,0.7837837837837838,0.21621621621621623,0.9069767441860465,0.09302325581395349
SF-H28,SF-F28-2,42,83,25,67,17,16,0.5952380952380952,0.40476190476190477,0.8072289156626506,0.1927710843373494
SF-H28,SF-G27,43,53,34,42,9,11,0.7906976744186046,0.20930232558139536,0.7924528301886793,0.20754716981132076
SF-H28,SF-M22-2,21,9,13,3,8,6,0.6190476190476191,0.38095238095238093,0.3333333333333333,0.6666666666666666
SF-H28,SF-L22,5,5,2,2,3,3,0.4,0.6,0.4,0.6
SF-H28,SF-F27,65,102,51,84,14,18,0.7846153846153846,0.2153846153846154,0.8235294117647058,0.17647058823529413
SF-H28,SF-N22-2,14,11,6,2,8,9,0.42857142857142855,0.5714285714285714,0.18181818181818182,0.8181818181818182
SF-H28,SF-G28-2,3,3,1,1,2,2,0.3333333333333333,0.6666666666666666,0.3333333333333333,0.6666666666666666
SF-H28,SF-G28-1,24,11,11,10,13,1,0.4583333333333333,0.5416666666666666,0.9090909090909091,0.09090909090909091
SF-H28,SF-M22-1,24,6,6,1,18,5,0.25,0.75,0.16666666666666666,0.8333333333333334
SF-H28,SF-O25-1,3,6,1,5,2,1,0.3333333333333333,0.6666666666666666,0.8333333333333334,0.16666666666666666
SF-H28,SF-K22-2,1,9,0,4,1,5,0.0,1.0,0.4444444444444444,0.5555555555555556
SF-H28,SF-K24,25,25,18,20,7,5,0.72,0.28,0.8,0.2
SF-H28,SF-J23-2,6,6,6,5,0,1,1.0,0.0,0.8333333333333334,0.16666666666666666
SF-H28,SF-G24,15,17,8,9,7,8,0.5333333333333333,0.4666666666666667,0.5294117647058824,0.47058823529411764
SF-H28,SF-G25,10,10,6,4,4,6,0.6,0.4,0.4,0.6
SF-H28,SF-F23,8,5,5,3,3,2,0.625,0.375,0.6,0.4
SF-H28,SF-E23,5,53,3,2,2,51,0.6,0.4,0.03773584905660377,0.9622641509433962
SF-H28,SF-C22,2,5,0,1,2,4,0.0,1.0,0.2,0.8
SF-H28,SF-B22,4,13,1,9,3,4,0.25,0.75,0.6923076923076923,0.3076923076923077
SF-H28,SF-J17,3,3,1,1,2,2,0.3333333333333333,0.6666666666666666,0.3333333333333333,0.6666666666666666
SF-H28,SF-I19,1,1,1,0,0,1,1.0,0.0,0.0,1.0
SF-H28,SF-I20,4,2,4,0,0,2,1.0,0.0,0.0,1.0
SF-H28,SF-H19,12,13,11,13,1,0,0.9166666666666666,0.08333333333333333,1.0,0.0
SF-H28,SF-H20,10,6,6,3,4,3,0.6,0.4,0.5,0.5
SF-H28,SF-G19,5,6,0,3,5,3,0.0,1.0,0.5,0.5
SF-H28,SF-G20,11,4,6,2,5,2,0.5454545454545454,0.45454545454545453,0.5,0.5
SF-H28,SF-F19,3,5,2,1,1,4,0.6666666666666666,0.3333333333333333,0.2,0.8
SF-H28,SF-E18,2,1,0,0,2,1,0.0,1.0,0.0,1.0
SF-H28,SF-H30,8,6,4,1,4,5,0.5,0.5,0.16666666666666666,0.8333333333333334
SF-H28,SF-G30-2,15,33,6,14,9,19,0.4,0.6,0.42424242424242425,0.5757575757575758
SF-H28,SF-F30-1,10,20,6,12,4,8,0.6,0.4,0.6,0.4
SF-H28,SF-E29-2,33,24,19,21,14,3,0.5757575757575758,0.42424242424242425,0.875,0.125
SF-H28,SF-E29-1,89,151,24,61,65,90,0.2696629213483146,0.7303370786516854,0.40397350993377484,0.5960264900662252
SF-H28,SF-D29,20,46,17,39,3,7,0.85,0.15,0.8478260869565217,0.15217391304347827
SF-H28,SF-D28,64,53,54,48,10,5,0.84375,0.15625,0.9056603773584906,0.09433962264150944
SF-H28,SF-A27,18,19,10,13,8,6,0.5555555555555556,0.4444444444444444,0.6842105263157895,0.3157894736842105
SF-H28,SF-G29-2,38,50,28,25,10,25,0.7368421052631579,0.2631578947368421,0.5,0.5
SF-H28,SF-G29-1,32,38,15,32,17,6,0.46875,0.53125,0.8421052631578947,0.15789473684210525
SF-H28,SF-G30-1,11,50,6,27,5,23,0.5454545454545454,0.45454545454545453,0.54,0.46
SF-H28,SF-G29-3,6,30,3,26,3,4,0.5,0.5,0.8666666666666667,0.13333333333333333
SF-H28,SF-F30-2,10,20,4,11,6,9,0.4,0.6,0.55,0.45
SF-H28,SF-F29,14,28,5,9,9,19,0.35714285714285715,0.6428571428571429,0.32142857142857145,0.6785714285714286
SF-H28,SF-E29-3,6,9,3,7,3,2,0.5,0.5,0.7777777777777778,0.2222222222222222
SF-H28,SF-F28-1,7,9,3,6,4,3,0.42857142857142855,0.5714285714285714,0.6666666666666666,0.3333333333333333
SF-H28,SF-E28-2,7,13,1,1,6,12,0.14285714285714285,0.8571428571428571,0.07692307692307693,0.9230769230769231
SF-H28,SF-E28,7,3,6,0,1,3,0.8571428571428571,0.14285714285714285,0.0,1.0
SF-H28,SF-J10,1,4,0,2,1,2,0.0,1.0,0.5,0.5
SF-H28,SF-J13,1,3,0,0,1,3,0.0,1.0,0.0,1.0
SF-H28,SF-I16,2,1,0,0,2,1,0.0,1.0,0.0,1.0
SF-H28,SF-C20,1,3,0,0,1,3,0.0,1.0,0.0,1.0
SF-H28,SF-B21,2,1,2,0,0,1,1.0,0.0,0.0,1.0
SF-H28,SF-B19,1,16,0,9,1,7,0.0,1.0,0.5625,0.4375
SF-H28,SF-A20,3,17,1,9,2,8,0.3333333333333333,0.6666666666666666,0.5294117647058824,0.47058823529411764
SF-H28,SF-A19,3,3,0,2,3,1,0.0,1.0,0.6666666666666666,0.3333333333333333
SF-H28,SF-C26,17,26,7,16,10,10,0.4117647058823529,0.5882352941176471,0.6153846153846154,0.38461538461538464
SF-H28,SF-C25,11,19,4,3,7,16,0.36363636363636365,0.6363636363636364,0.15789473684210525,0.8421052631578947
SF-H28,SF-B25,39,44,7,14,32,30,0.1794871794871795,0.8205128205128205,0.3181818181818182,0.6818181818181818
SF-H28,SF-E27,14,3,11,1,3,2,0.7857142857142857,0.21428571428571427,0.3333333333333333,0.6666666666666666
SF-H28,SF-B28-2,1,1,0,0,1,1,0.0,1.0,0.0,1.0
SF-H28,SF-D27,25,19,19,17,6,2,0.76,0.24,0.8947368421052632,0.10526315789473684
SF-H28,SF-C28-2,7,3,5,0,2,3,0.7142857142857143,0.2857142857142857,0.0,1.0
SF-H28,SF-C28-1,6,10,5,8,1,2,0.8333333333333334,0.16666666666666666,0.8,0.2
SF-H28,SF-B28,20,20,11,12,9,8,0.55,0.45,0.6,0.4
SF-H28,SF-J1,7,2,0,0,7,2,0.0,1.0,0.0,1.0
SF-H28,SF-H0,2,1,0,1,2,0,0.0,1.0,1.0,0.0
SF-H28,SF-H25,14,24,2,4,12,20,0.14285714285714285,0.8571428571428571,0.16666666666666666,0.8333333333333334
SF-H28,SF-G26,20,13,16,8,4,5,0.8,0.2,0.6153846153846154,0.38461538461538464
SF-H28,SF-K21,5,2,2,0,3,2,0.4,0.6,0.0,1.0
SF-H28,SF-K22-1,11,11,7,2,4,9,0.6363636363636364,0.36363636363636365,0.18181818181818182,0.8181818181818182
SF-H28,SF-J23-1,73,68,59,33,14,35,0.8082191780821918,0.1917808219178082,0.4852941176470588,0.5147058823529411
SF-H28,SF-J22-1,4,4,0,2,4,2,0.0,1.0,0.5,0.5
SF-H28,SF-J22-2,11,13,8,6,3,7,0.7272727272727273,0.2727272727272727,0.46153846153846156,0.5384615384615384
SF-H28,SF-J21,4,8,2,4,2,4,0.5,0.5,0.5,0.5
SF-H28,SF-I21,1,1,1,0,0,1,1.0,0.0,0.0,1.0
SF-H28,SF-I22,4,2,3,1,1,1,0.75,0.25,0.5,0.5
SF-H28,SF-I23-2,3,5,1,2,2,3,0.3333333333333333,0.6666666666666666,0.4,0.6
SF-H28,SF-I24,6,6,4,6,2,0,0.6666666666666666,0.3333333333333333,1.0,0.0
SF-H28,SF-I23-1,5,1,2,0,3,1,0.4,0.6,0.0,1.0
SF-H28,SF-F26,30,29,15,14,15,15,0.5,0.5,0.4827586206896552,0.5172413793103449
SF-H28,SF-M15,4,3,1,0,3,3,0.25,0.75,0.0,1.0
SF-H28,SF-L19,1,8,1,3,0,5,1.0,0.0,0.375,0.625
SF-H28,SF-L20,2,5,1,4,1,1,0.5,0.5,0.8,0.2
SF-H28,SF-N20-1,3,2,1,1,2,1,0.3333333333333333,0.6666666666666666,0.5,0.5
SF-H28,SF-M20,23,8,13,2,10,6,0.5652173913043478,0.43478260869565216,0.25,0.75
SF-H28,SF-K17-2,1,2,1,0,0,2,1.0,0.0,0.0,1.0
SF-H28,SF-K20,6,1,4,0,2,1,0.6666666666666666,0.3333333333333333,0.0,1.0
SF-H28,SF-K15-,3,4,0,2,3,2,0.0,1.0,0.5,0.5
SF-H28,SF-K19,2,4,0,3,2,1,0.0,1.0,0.75,0.25
SF-H28,SF-K18,5,1,3,0,2,1,0.6,0.4,0.0,1.0
SF-H28,SF-K17,4,2,3,0,1,2,0.75,0.25,0.0,1.0
SF-H28,SF-J16,2,3,0,0,2,3,0.0,1.0,0.0,1.0
SF-H28,SF-J18,9,7,1,0,8,7,0.1111111111111111,0.8888888888888888,0.0,1.0
SF-H28,SF-J19,6,5,6,5,0,0,1.0,0.0,1.0,0.0
SF-H28,SF-M10,2,2,2,0,0,2,1.0,0.0,0.0,1.0
SF-H28,SF-R19,2,2,1,0,1,2,0.5,0.5,0.0,1.0
SF-H28,SF-R20,1,1,1,0,0,1,1.0,0.0,0.0,1.0
SF-H28,SF-Q21-1,2,2,0,0,2,2,0.0,1.0,0.0,1.0
SF-H28,SF-P21,3,4,3,2,0,2,1.0,0.0,0.5,0.5
SF-H28,SF-O18,58,55,54,51,4,4,0.9310344827586207,0.06896551724137931,0.9272727272727272,0.07272727272727272
SF-H28,SF-O19,5,1,0,0,5,1,0.0,1.0,0.0,1.0
SF-H28,SF-O21,27,24,17,13,10,11,0.6296296296296297,0.37037037037037035,0.5416666666666666,0.4583333333333333
SF-H28,SF-O22,7,7,3,3,4,4,0.42857142857142855,0.5714285714285714,0.42857142857142855,0.5714285714285714
SF-H28,SF-N21,5,4,5,2,0,2,1.0,0.0,0.5,0.5
SF-H28,SF-N20-2,2,1,2,0,0,1,1.0,0.0,0.0,1.0
SF-H28,SF-M21,6,3,1,0,5,3,0.16666666666666666,0.8333333333333334,0.0,1.0
SF-H28,SF-L21,9,8,4,7,5,1,0.4444444444444444,0.5555555555555556,0.875,0.125
SF-H28,SF-S29,3,4,2,4,1,0,0.6666666666666666,0.3333333333333333,1.0,0.0
SF-H28,SF-S30,1,3,0,1,1,2,0.0,1.0,0.3333333333333333,0.6666666666666666
SF-H28,SF-Q30,3,3,3,1,0,2,1.0,0.0,0.3333333333333333,0.6666666666666666
SF-H28,SF-P30,3,6,1,2,2,4,0.3333333333333333,0.6666666666666666,0.3333333333333333,0.6666666666666666
SF-H28,SF-O30-2,14,9,5,5,9,4,0.35714285714285715,0.6428571428571429,0.5555555555555556,0.4444444444444444
SF-H28,SF-O30,15,20,11,15,4,5,0.7333333333333333,0.26666666666666666,0.75,0.25
SF-H28,SF-N27,6,6,4,6,2,0,0.6666666666666666,0.3333333333333333,1.0,0.0
SF-H28,SF-N29,34,10,4,4,30,6,0.11764705882352941,0.8823529411764706,0.4,0.6
SF-H28,SF-N28,36,23,8,15,28,8,0.2222222222222222,0.7777777777777778,0.6521739130434783,0.34782608695652173
SF-H28,SF-L30-1,46,52,38,44,8,8,0.8260869565217391,0.17391304347826086,0.8461538461538461,0.15384615384615385
SF-H28,SF-L31-1,12,13,6,8,6,5,0.5,0.5,0.6153846153846154,0.38461538461538464
SF-H28,SF-K30-2,9,10,5,4,4,6,0.5555555555555556,0.4444444444444444,0.4,0.6
SF-H28,SF-L29,10,17,6,7,4,10,0.6,0.4,0.4117647058823529,0.5882352941176471
SF-H28,SF-J29-1,50,34,34,24,16,10,0.68,0.32,0.7058823529411765,0.29411764705882354
SF-H28,SF-I30,12,29,6,16,6,13,0.5,0.5,0.5517241379310345,0.4482758620689655
SF-H28,SF-I29-2,24,37,19,36,5,1,0.7916666666666666,0.20833333333333334,0.972972972972973,0.02702702702702703
SF-H28,SF-I27,59,27,52,19,7,8,0.8813559322033898,0.11864406779661017,0.7037037037037037,0.2962962962962963
SF-H28,SF-I28,34,23,20,11,14,12,0.5882352941176471,0.4117647058823529,0.4782608695652174,0.5217391304347826
SF-H28,SF-I30-2,22,18,17,13,5,5,0.7727272727272727,0.22727272727272727,0.7222222222222222,0.2777777777777778
SF-H28,SF I29-1,11,3,9,1,2,2,0.8181818181818182,0.18181818181818182,0.3333333333333333,0.6666666666666666
SF-H28,SF-H29,14,20,11,15,3,5,0.7857142857142857,0.21428571428571427,0.75,0.25
SF-H28,SF-S24,10,4,5,1,5,3,0.5,0.5,0.25,0.75
SF-H28,SF-R24,19,9,1,2,18,7,0.05263157894736842,0.9473684210526315,0.2222222222222222,0.7777777777777778
SF-H28,SF-R26,3,1,2,1,1,0,0.6666666666666666,0.3333333333333333,1.0,0.0
SF-H28,SF-N22-1B,4,1,2,0,2,1,0.5,0.5,0.0,1.0
SF-H28,SF-N26,2,2,0,2,2,0,0.0,1.0,1.0,0.0
SF-H28,SF-N25,5,4,3,3,2,1,0.6,0.4,0.75,0.25
SF-H28,SF-T22,3,3,0,0,3,3,0.0,1.0,0.0,1.0
SF-H28,SF-S22-2,3,2,2,0,1,2,0.6666666666666666,0.3333333333333333,0.0,1.0
SF-H28,SF-S22-1,3,2,0,1,3,1,0.0,1.0,0.5,0.5
SF-H28,SF-Q23-3,3,2,3,2,0,0,1.0,0.0,1.0,0.0
SF-H28,SF-Q22-1,4,2,3,1,1,1,0.75,0.25,0.5,0.5
SF-H28,SF-Q22-2,8,3,0,3,8,0,0.0,1.0,1.0,0.0
SF-H28,SF-P22,4,4,1,3,3,1,0.25,0.75,0.75,0.25
SF-H28,SF-T20,1,2,1,1,0,1,1.0,0.0,0.5,0.5
SF-H28,SF-V30,5,5,1,1,4,4,0.2,0.8,0.2,0.8
SF-H28,SF-V31,2,1,0,1,2,0,0.0,1.0,1.0,0.0
SF-H28,SF-V32,10,19,1,14,9,5,0.1,0.9,0.7368421052631579,0.2631578947368421
SF-H28,SF-U30,20,31,1,24,19,7,0.05,0.95,0.7741935483870968,0.22580645161290322
SF-H29,SF-M25,1,3,0,3,1,0,0.0,1.0,1.0,0.0
SF-H29,SF-M26-2,3,2,2,1,1,1,0.6666666666666666,0.3333333333333333,0.5,0.5
SF-H29,SF-L27,1,1,0,1,1,0,0.0,1.0,1.0,0.0
SF-H29,SF-J27,3,4,0,2,3,2,0.0,1.0,0.5,0.5
SF-H29,SF-M30,2,18,0,14,2,4,0.0,1.0,0.7777777777777778,0.2222222222222222
SF-H29,SF-L27-2,2,2,2,1,0,1,1.0,0.0,0.5,0.5
SF-H29,SF-J29-3,3,6,2,2,1,4,0.6666666666666666,0.3333333333333333,0.3333333333333333,0.6666666666666666
SF-H29,SF-J29,8,9,2,4,6,5,0.25,0.75,0.4444444444444444,0.5555555555555556
SF-H29,SF-M28,3,4,2,4,1,0,0.6666666666666666,0.3333333333333333,1.0,0.0
SF-H29,SF-L25,2,2,1,2,1,0,0.5,0.5,1.0,0.0
SF-H29,SF-M24,2,2,0,0,2,2,0.0,1.0,0.0,1.0
SF-H29,SF-L24,15,3,7,0,8,3,0.4666666666666667,0.5333333333333333,0.0,1.0
SF-H29,SF-N23,1,1,0,0,1,1,0.0,1.0,0.0,1.0
SF-H29,SF-K27-2,3,2,1,2,2,0,0.3333333333333333,0.6666666666666666,1.0,0.0
SF-H29,SF-J26-2,12,6,6,3,6,3,0.5,0.5,0.5,0.5
SF-H29,SF-L28,1,7,0,3,1,4,0.0,1.0,0.42857142857142855,0.5714285714285714
SF-H29,SF-K29-1,10,6,3,2,7,4,0.3,0.7,0.3333333333333333,0.6666666666666666
SF-H29,SF-J28-2,10,8,7,3,3,5,0.7,0.3,0.375,0.625
SF-H29,SF-K27,2,7,2,7,0,0,1.0,0.0,1.0,0.0
SF-H29,SF-K25,20,4,4,3,16,1,0.2,0.8,0.75,0.25
SF-H29,SF-J25,7,4,2,3,5,1,0.2857142857142857,0.7142857142857143,0.75,0.25
SF-H29,SF-H26-2,1,4,1,3,0,1,1.0,0.0,0.75,0.25
SF-H29,SF-J24,8,5,6,3,2,2,0.75,0.25,0.6,0.4
SF-H29,SF-J26,5,2,4,1,1,1,0.8,0.2,0.5,0.5
SF-H29,SF-I26-,1,4,0,1,1,3,0.0,1.0,0.25,0.75
SF-H29,SF-H26,9,15,6,9,3,6,0.6666666666666666,0.3333333333333333,0.6,0.4
SF-H29,SF-O23,4,3,0,0,4,3,0.0,1.0,0.0,1.0
SF-H29,SF-H27-1,2,3,1,2,1,1,0.5,0.5,0.6666666666666666,0.3333333333333333
SF-H29,SF-F28-2,11,26,9,21,2,5,0.8181818181818182,0.18181818181818182,0.8076923076923077,0.19230769230769232
SF-H29,SF-G27,10,9,5,5,5,4,0.5,0.5,0.5555555555555556,0.4444444444444444
SF-H29,SF-M22-2,1,6,0,0,1,6,0.0,1.0,0.0,1.0
SF-H29,SF-L22,1,2,1,1,0,1,1.0,0.0,0.5,0.5
SF-H29,SF-F27,7,10,2,6,5,4,0.2857142857142857,0.7142857142857143,0.6,0.4
SF-H29,SF-N22-2,3,1,1,0,2,1,0.3333333333333333,0.6666666666666666,0.0,1.0
SF-H29,SF-G28-2,3,2,1,1,2,1,0.3333333333333333,0.6666666666666666,0.5,0.5
SF-H29,SF-G28-1,5,2,3,2,2,0,0.6,0.4,1.0,0.0
SF-H29,SF-K22-2,1,1,1,0,0,1,1.0,0.0,0.0,1.0
SF-H29,SF-K24,4,3,2,1,2,2,0.5,0.5,0.3333333333333333,0.6666666666666666
SF-H29,SF-J23-2,3,1,1,1,2,0,0.3333333333333333,0.6666666666666666,1.0,0.0
SF-H29,SF-G23,1,1,1,1,0,0,1.0,0.0,1.0,0.0
SF-H29,SF-F23,11,4,1,3,10,1,0.09090909090909091,0.9090909090909091,0.75,0.25
SF-H29,SF-E23,10,27,0,0,10,27,0.0,1.0,0.0,1.0
SF-H29,SF-J17,1,2,0,0,1,2,0.0,1.0,0.0,1.0
SF-H29,SF-G20,1,1,0,0,1,1,0.0,1.0,0.0,1.0
SF-H29,SF-G30-2,2,5,1,1,1,4,0.5,0.5,0.2,0.8
SF-H29,SF-F30-1,2,3,1,2,1,1,0.5,0.5,0.6666666666666666,0.3333333333333333
SF-H29,SF-E29-2,4,5,3,3,1,2,0.75,0.25,0.6,0.4
SF-H29,SF-E29-1,1,39,0,17,1,22,0.0,1.0,0.4358974358974359,0.5641025641025641
SF-H29,SF-D29,4,8,2,4,2,4,0.5,0.5,0.5,0.5
SF-H29,SF-D28,2,1,2,0,0,1,1.0,0.0,0.0,1.0
SF-H29,SF-A27,1,4,0,3,1,1,0.0,1.0,0.75,0.25
SF-H29,SF-G29-2,20,7,12,5,8,2,0.6,0.4,0.7142857142857143,0.2857142857142857
SF-H29,SF-G29-1,18,12,9,11,9,1,0.5,0.5,0.9166666666666666,0.08333333333333333
SF-H29,SF-G30-1,2,5,1,2,1,3,0.5,0.5,0.4,0.6
SF-H29,SF-G29-3,8,13,6,10,2,3,0.75,0.25,0.7692307692307693,0.23076923076923078
SF-H29,SF-F30-2,3,5,2,5,1,0,0.6666666666666666,0.3333333333333333,1.0,0.0
SF-H29,SF-F29,2,2,2,1,0,1,1.0,0.0,0.5,0.5
SF-H29,SF-G12,2,1,0,1,2,0,0.0,1.0,1.0,0.0
SF-H29,SF-A20,1,4,0,2,1,2,0.0,1.0,0.5,0.5
SF-H29,SF-C26,2,3,1,0,1,3,0.5,0.5,0.0,1.0
SF-H29,SF-C25,3,3,0,2,3,1,0.0,1.0,0.6666666666666666,0.3333333333333333
SF-H29,SF-E27,3,3,1,2,2,1,0.3333333333333333,0.6666666666666666,0.6666666666666666,0.3333333333333333
SF-H29,SF-G26,2,1,1,1,1,0,0.5,0.5,1.0,0.0
SF-H29,SF-K21,3,1,2,0,1,1,0.6666666666666666,0.3333333333333333,0.0,1.0
SF-H29,SF-K22-1,3,1,1,0,2,1,0.3333333333333333,0.6666666666666666,0.0,1.0
SF-H29,SF-J23-1,11,5,5,1,6,4,0.45454545454545453,0.5454545454545454,0.2,0.8
SF-H29,SF-J22-1,1,2,1,0,0,2,1.0,0.0,0.0,1.0
SF-H29,SF-J22-2,1,2,0,2,1,0,0.0,1.0,1.0,0.0
SF-H29,SF-J21,2,1,1,0,1,1,0.5,0.5,0.0,1.0
SF-H29,SF-I22,1,1,0,0,1,1,0.0,1.0,0.0,1.0
SF-H29,SF-I23-2,2,3,1,1,1,2,0.5,0.5,0.3333333333333333,0.6666666666666666
SF-H29,SF-F26,2,10,2,5,0,5,1.0,0.0,0.5,0.5
SF-H29,SF-M13,1,5,1,0,0,5,1.0,0.0,0.0,1.0
SF-H29,SF-L19,3,5,1,0,2,5,0.3333333333333333,0.6666666666666666,0.0,1.0
SF-H29,SF-K18,1,2,0,0,1,2,0.0,1.0,0.0,1.0
SF-H29,SF-J18,1,1,0,0,1,1,0.0,1.0,0.0,1.0
SF-H29,SF-O19,1,1,1,1,0,0,1.0,0.0,1.0,0.0
SF-H29,SF-O21,2,2,0,0,2,2,0.0,1.0,0.0,1.0
SF-H29,SF-N21,2,2,1,1,1,1,0.5,0.5,0.5,0.5
SF-H29,SF-L21,1,4,0,0,1,4,0.0,1.0,0.0,1.0
SF-H29,SF-S30,2,1,0,0,2,1,0.0,1.0,0.0,1.0
SF-H29,SF-Q30,2,3,1,2,1,1,0.5,0.5,0.6666666666666666,0.3333333333333333
SF-H29,SF-P30,3,4,0,1,3,3,0.0,1.0,0.25,0.75
SF-H29,SF-O30-2,2,4,1,4,1,0,0.5,0.5,1.0,0.0
SF-H29,SF-O30,2,2,1,1,1,1,0.5,0.5,0.5,0.5
SF-H29,SF-N27,2,7,0,3,2,4,0.0,1.0,0.42857142857142855,0.5714285714285714
SF-H29,SF-N29,2,3,2,3,0,0,1.0,0.0,1.0,0.0
SF-H29,SF-N28,3,2,1,1,2,1,0.3333333333333333,0.6666666666666666,0.5,0.5
SF-H29,SF-L30-1,10,9,7,7,3,2,0.7,0.3,0.7777777777777778,0.2222222222222222
SF-H29,SF-L31-1,3,4,1,4,2,0,0.3333333333333333,0.6666666666666666,1.0,0.0
SF-H29,SF-K30-2,11,6,4,5,7,1,0.36363636363636365,0.6363636363636364,0.8333333333333334,0.16666666666666666
SF-H29,SF-L29,8,7,5,4,3,3,0.625,0.375,0.5714285714285714,0.42857142857142855
SF-H29,SF-J29-1,6,20,2,12,4,8,0.3333333333333333,0.6666666666666666,0.6,0.4
SF-H29,SF-I30,23,33,23,31,0,2,1.0,0.0,0.9393939393939394,0.06060606060606061
SF-H29,SF-I29-2,1,3,0,1,1,2,0.0,1.0,0.3333333333333333,0.6666666666666666
SF-H29,SF-I27,18,14,13,10,5,4,0.7222222222222222,0.2777777777777778,0.7142857142857143,0.2857142857142857
SF-H29,SF-I28,2,1,1,1,1,0,0.5,0.5,1.0,0.0
SF-H29,SF-I30-2,5,6,5,4,0,2,1.0,0.0,0.6666666666666666,0.3333333333333333
SF-H29,SF I29-1,7,5,5,3,2,2,0.7142857142857143,0.2857142857142857,0.6,0.4
SF-H29,SF-H28,20,14,15,11,5,3,0.75,0.25,0.7857142857142857,0.21428571428571427
SF-H29,SF-S24,5,1,2,1,3,0,0.4,0.6,1.0,0.0
SF-H29,SF-T21,1,1,0,0,1,1,0.0,1.0,0.0,1.0
SF-H29,SF-Q23-3,1,1,0,0,1,1,0.0,1.0,0.0,1.0
SF-S24,SF-M25,20,9,2,4,18,5,0.1,0.9,0.4444444444444444,0.5555555555555556
SF-S24,SF-M26-2,3,4,0,0,3,4,0.0,1.0,0.0,1.0
SF-S24,SF-K26,10,15,4,5,6,10,0.4,0.6,0.3333333333333333,0.6666666666666666
SF-S24,SF-M30,31,24,4,5,27,19,0.12903225806451613,0.8709677419354839,0.20833333333333334,0.7916666666666666
SF-S24,SF-J29,12,9,2,2,10,7,0.16666666666666666,0.8333333333333334,0.2222222222222222,0.7777777777777778
SF-S24,SF-L26,68,78,24,19,44,59,0.35294117647058826,0.6470588235294118,0.24358974358974358,0.7564102564102564
SF-S24,SF-M28,8,12,6,7,2,5,0.75,0.25,0.5833333333333334,0.4166666666666667
SF-S24,SF-L25,16,9,3,3,13,6,0.1875,0.8125,0.3333333333333333,0.6666666666666666
SF-S24,SF-M24,46,45,27,28,19,17,0.5869565217391305,0.41304347826086957,0.6222222222222222,0.37777777777777777
SF-S24,SF-L24,36,28,14,12,22,16,0.3888888888888889,0.6111111111111112,0.42857142857142855,0.5714285714285714
SF-S24,SF-N23,18,14,8,7,10,7,0.4444444444444444,0.5555555555555556,0.5,0.5
SF-S24,SF-N24-2,37,18,25,9,12,9,0.6756756756756757,0.32432432432432434,0.5,0.5
SF-S24,SF-K27-2,7,9,5,5,2,4,0.7142857142857143,0.2857142857142857,0.5555555555555556,0.4444444444444444
SF-S24,SF-J26-2,4,11,1,6,3,5,0.25,0.75,0.5454545454545454,0.45454545454545453
SF-S24,SF-L28,5,2,5,1,0,1,1.0,0.0,0.5,0.5
SF-S24,SF-K28,53,17,52,9,1,8,0.9811320754716981,0.018867924528301886,0.5294117647058824,0.47058823529411764
SF-S24,SF-K29-1,9,5,3,1,6,4,0.3333333333333333,0.6666666666666666,0.2,0.8
SF-S24,SF-K27,4,1,2,0,2,1,0.5,0.5,0.0,1.0
SF-S24,SF-K25,18,19,12,13,6,6,0.6666666666666666,0.3333333333333333,0.6842105263157895,0.3157894736842105
SF-S24,SF-J25,9,7,4,2,5,5,0.4444444444444444,0.5555555555555556,0.2857142857142857,0.7142857142857143
SF-S24,SF-H26-2,6,7,3,0,3,7,0.5,0.5,0.0,1.0
SF-S24,SF-P24,38,58,22,31,16,27,0.5789473684210527,0.42105263157894735,0.5344827586206896,0.46551724137931033
SF-S24,SF-J24,22,36,1,4,21,32,0.045454545454545456,0.9545454545454546,0.1111111111111111,0.8888888888888888
SF-S24,SF-O24,35,22,15,9,20,13,0.42857142857142855,0.5714285714285714,0.4090909090909091,0.5909090909090909
SF-S24,SF-J26,5,3,2,1,3,2,0.4,0.6,0.3333333333333333,0.6666666666666666
SF-S24,SF-I25,4,8,2,3,2,5,0.5,0.5,0.375,0.625
SF-S24,SF-H26,10,15,4,6,6,9,0.4,0.6,0.4,0.6
SF-S24,SF-O23,44,54,21,15,23,39,0.4772727272727273,0.5227272727272727,0.2777777777777778,0.7222222222222222
SF-S24,SF-H27-1,5,5,2,1,3,4,0.4,0.6,0.2,0.8
SF-S24,SF-F28-2,18,24,12,19,6,5,0.6666666666666666,0.3333333333333333,0.7916666666666666,0.20833333333333334
SF-S24,SF-G27,13,12,5,4,8,8,0.38461538461538464,0.6153846153846154,0.3333333333333333,0.6666666666666666
SF-S24,SF-M22-2,16,15,9,9,7,6,0.5625,0.4375,0.6,0.4
SF-S24,SF-L22,17,16,4,8,13,8,0.23529411764705882,0.7647058823529411,0.5,0.5
SF-S24,SF-F27,19,17,2,4,17,13,0.10526315789473684,0.8947368421052632,0.23529411764705882,0.7647058823529411
SF-S24,SF-N22-2,37,24,15,10,22,14,0.40540540540540543,0.5945945945945946,0.4166666666666667,0.5833333333333334
SF-S24,SF-G28-2,27,39,22,35,5,4,0.8148148148148148,0.18518518518518517,0.8974358974358975,0.10256410256410256
SF-S24,SF-M22-1,14,6,7,4,7,2,0.5,0.5,0.6666666666666666,0.3333333333333333
SF-S24,SF-O25-1,13,8,2,4,11,4,0.15384615384615385,0.8461538461538461,0.5,0.5
SF-S24,SF-K22-2,6,8,6,4,0,4,1.0,0.0,0.5,0.5
SF-S24,SF-K24,19,21,11,12,8,9,0.5789473684210527,0.42105263157894735,0.5714285714285714,0.42857142857142855
SF-S24,SF-J23-2,2,6,2,3,0,3,1.0,0.0,0.5,0.5
SF-S24,SF-G23,1,5,0,3,1,2,0.0,1.0,0.6,0.4
SF-S24,SF-G24,17,7,7,2,10,5,0.4117647058823529,0.5882352941176471,0.2857142857142857,0.7142857142857143
SF-S24,SF-G25,6,2,3,0,3,2,0.5,0.5,0.0,1.0
SF-S24,SF-F23,5,5,1,0,4,5,0.2,0.8,0.0,1.0
SF-S24,SF-E23,3,4,1,0,2,4,0.3333333333333333,0.6666666666666666,0.0,1.0
SF-S24,SF-C22,1,2,1,1,0,1,1.0,0.0,0.5,0.5
SF-S24,SF-J17,5,4,3,1,2,3,0.6,0.4,0.25,0.75
SF-S24,SF-H20,4,3,0,0,4,3,0.0,1.0,0.0,1.0
SF-S24,SF-G19,1,2,0,0,1,2,0.0,1.0,0.0,1.0
SF-S24,SF-G17,2,2,0,0,2,2,0.0,1.0,0.0,1.0
SF-S24,SF-G18,1,5,0,3,1,2,0.0,1.0,0.6,0.4
SF-S24,SF-F19,3,1,1,1,2,0,0.3333333333333333,0.6666666666666666,1.0,0.0
SF-S24,SF-E18,1,2,0,0,1,2,0.0,1.0,0.0,1.0
SF-S24,SF-E20,5,2,1,0,4,2,0.2,0.8,0.0,1.0
SF-S24,SF-H30,5,6,2,2,3,4,0.4,0.6,0.3333333333333333,0.6666666666666666
SF-S24,SF-G30-2,3,3,1,0,2,3,0.3333333333333333,0.6666666666666666,0.0,1.0
SF-S24,SF-E29-2,9,4,4,3,5,1,0.4444444444444444,0.5555555555555556,0.75,0.25
SF-S24,SF-E29-1,6,5,3,2,3,3,0.5,0.5,0.4,0.6
SF-S24,SF-D29,4,5,0,1,4,4,0.0,1.0,0.2,0.8
SF-S24,SF-D28,6,3,1,0,5,3,0.16666666666666666,0.8333333333333334,0.0,1.0
SF-S24,SF-A27,6,3,4,0,2,3,0.6666666666666666,0.3333333333333333,0.0,1.0
SF-S24,SF-G29-2,4,16,0,2,4,14,0.0,1.0,0.125,0.875
SF-S24,SF-G29-1,15,16,3,1,12,15,0.2,0.8,0.0625,0.9375
SF-S24,SF-G30-1,3,9,0,0,3,9,0.0,1.0,0.0,1.0
SF-S24,SF-G29-3,2,1,1,0,1,1,0.5,0.5,0.0,1.0
SF-S24,SF-F30-2,3,2,1,2,2,0,0.3333333333333333,0.6666666666666666,1.0,0.0
SF-S24,SF-E28-2,1,1,1,0,0,1,1.0,0.0,0.0,1.0
SF-S24,SF-E28,7,23,6,21,1,2,0.8571428571428571,0.14285714285714285,0.9130434782608695,0.08695652173913043
SF-S24,SF-H12,1,1,0,0,1,1,0.0,1.0,0.0,1.0
SF-S24,SF-F15,1,2,0,0,1,2,0.0,1.0,0.0,1.0
SF-S24,SF-A20,5,3,0,1,5,2,0.0,1.0,0.3333333333333333,0.6666666666666666
SF-S24,SF-C26,5,2,0,0,5,2,0.0,1.0,0.0,1.0
SF-S24,SF-C25,16,6,3,0,13,6,0.1875,0.8125,0.0,1.0
SF-S24,SF-B25,6,3,4,3,2,0,0.6666666666666666,0.3333333333333333,1.0,0.0
SF-S24,SF-E27,5,4,1,1,4,3,0.2,0.8,0.25,0.75
SF-S24,SF-C28-2,2,1,1,0,1,1,0.5,0.5,0.0,1.0
SF-S24,SF-B28,2,6,0,3,2,3,0.0,1.0,0.5,0.5
SF-S24,SF-G5,1,1,1,0,0,1,1.0,0.0,0.0,1.0
SF-S24,SF-G26,7,4,2,2,5,2,0.2857142857142857,0.7142857142857143,0.5,0.5
SF-S24,SF-K21,8,3,2,0,6,3,0.25,0.75,0.0,1.0
SF-S24,SF-K22-1,1,3,1,2,0,1,1.0,0.0,0.6666666666666666,0.3333333333333333
SF-S24,SF-J23-1,14,12,5,4,9,8,0.35714285714285715,0.6428571428571429,0.3333333333333333,0.6666666666666666
SF-S24,SF-J22-1,8,18,1,6,7,12,0.125,0.875,0.3333333333333333,0.6666666666666666
SF-S24,SF-J22-2,3,3,2,0,1,3,0.6666666666666666,0.3333333333333333,0.0,1.0
SF-S24,SF-J21,4,8,2,1,2,7,0.5,0.5,0.125,0.875
SF-S24,SF-I22,4,1,1,0,3,1,0.25,0.75,0.0,1.0
SF-S24,SF-I24,8,3,2,1,6,2,0.25,0.75,0.3333333333333333,0.6666666666666666
SF-S24,SF-I23-1,4,1,2,0,2,1,0.5,0.5,0.0,1.0
SF-S24,SF-F26,11,11,1,2,10,9,0.09090909090909091,0.9090909090909091,0.18181818181818182,0.8181818181818182
SF-S24,SF-M13,4,4,2,0,2,4,0.5,0.5,0.0,1.0
SF-S24,SF-M15,9,5,3,1,6,4,0.3333333333333333,0.6666666666666666,0.2,0.8
SF-S24,SF-L19,8,13,3,0,5,13,0.375,0.625,0.0,1.0
SF-S24,SF-L20,16,4,3,0,13,4,0.1875,0.8125,0.0,1.0
SF-S24,SF-N20-1,19,27,3,5,16,22,0.15789473684210525,0.8421052631578947,0.18518518518518517,0.8148148148148148
SF-S24,SF-M20,24,20,4,3,20,17,0.16666666666666666,0.8333333333333334,0.15,0.85
SF-S24,SF-K17-2,4,4,3,0,1,4,0.75,0.25,0.0,1.0
SF-S24,SF-K20,8,6,1,2,7,4,0.125,0.875,0.3333333333333333,0.6666666666666666
SF-S24,SF-K15-,6,9,4,1,2,8,0.6666666666666666,0.3333333333333333,0.1111111111111111,0.8888888888888888
SF-S24,SF-K19,11,8,3,1,8,7,0.2727272727272727,0.7272727272727273,0.125,0.875
SF-S24,SF-K18,4,1,0,1,4,0,0.0,1.0,1.0,0.0
SF-S24,SF-K17,7,12,5,9,2,3,0.7142857142857143,0.2857142857142857,0.75,0.25
SF-S24,SF-J16,3,1,1,1,2,0,0.3333333333333333,0.6666666666666666,1.0,0.0
SF-S24,SF-J18,4,2,2,0,2,2,0.5,0.5,0.0,1.0
SF-S24,SF-J20,2,2,1,0,1,2,0.5,0.5,0.0,1.0
SF-S24,SF-J19,11,7,3,0,8,7,0.2727272727272727,0.7272727272727273,0.0,1.0
SF-S24,SF-M12,3,3,0,1,3,2,0.0,1.0,0.3333333333333333,0.6666666666666666
SF-S24,SF-M11,5,4,0,1,5,3,0.0,1.0,0.25,0.75
SF-S24,SF-R19,20,5,9,1,11,4,0.45,0.55,0.2,0.8
SF-S24,SF-R20,12,9,8,2,4,7,0.6666666666666666,0.3333333333333333,0.2222222222222222,0.7777777777777778
SF-S24,SF-Q21-2,18,5,8,1,10,4,0.4444444444444444,0.5555555555555556,0.2,0.8
SF-S24,SF-Q21-1,15,7,7,1,8,6,0.4666666666666667,0.5333333333333333,0.14285714285714285,0.8571428571428571
SF-S24,SF-P21,22,19,8,4,14,15,0.36363636363636365,0.6363636363636364,0.21052631578947367,0.7894736842105263
SF-S24,SF-O18,11,7,3,0,8,7,0.2727272727272727,0.7272727272727273,0.0,1.0
SF-S24,SF-O19,18,14,8,5,10,9,0.4444444444444444,0.5555555555555556,0.35714285714285715,0.6428571428571429
SF-S24,SF-O21,29,42,9,13,20,29,0.3103448275862069,0.6896551724137931,0.30952380952380953,0.6904761904761905
SF-S24,SF-O22,60,33,8,7,52,26,0.13333333333333333,0.8666666666666667,0.21212121212121213,0.7878787878787878
SF-S24,SF-N21,20,18,5,7,15,11,0.25,0.75,0.3888888888888889,0.6111111111111112
SF-S24,SF-N20-2,8,6,3,2,5,4,0.375,0.625,0.3333333333333333,0.6666666666666666
SF-S24,SF-M21,45,32,8,1,37,31,0.17777777777777778,0.8222222222222222,0.03125,0.96875
SF-S24,SF-L21,4,6,0,2,4,4,0.0,1.0,0.3333333333333333,0.6666666666666666
SF-S24,SF-S29,7,4,2,2,5,2,0.2857142857142857,0.7142857142857143,0.5,0.5
SF-S24,SF-S30,3,4,1,2,2,2,0.3333333333333333,0.6666666666666666,0.5,0.5
SF-S24,SF-Q30,12,6,2,0,10,6,0.16666666666666666,0.8333333333333334,0.0,1.0
SF-S24,SF-P30,22,22,11,6,11,16,0.5,0.5,0.2727272727272727,0.7272727272727273
SF-S24,SF-O30-2,16,3,8,1,8,2,0.5,0.5,0.3333333333333333,0.6666666666666666
SF-S24,SF-O30,6,15,2,2,4,13,0.3333333333333333,0.6666666666666666,0.13333333333333333,0.8666666666666667
SF-S24,SF-N27,12,11,7,2,5,9,0.5833333333333334,0.4166666666666667,0.18181818181818182,0.8181818181818182
SF-S24,SF-N29,17,7,8,3,9,4,0.47058823529411764,0.5294117647058824,0.42857142857142855,0.5714285714285714
SF-S24,SF-N28,7,8,1,3,6,5,0.14285714285714285,0.8571428571428571,0.375,0.625
SF-S24,SF-L30-1,21,19,4,6,17,13,0.19047619047619047,0.8095238095238095,0.3157894736842105,0.6842105263157895
SF-S24,SF-L31-1,3,2,2,1,1,1,0.6666666666666666,0.3333333333333333,0.5,0.5
SF-S24,SF-L29,7,8,0,0,7,8,0.0,1.0,0.0,1.0
SF-S24,SF-J29-1,4,2,1,1,3,1,0.25,0.75,0.5,0.5
SF-S24,SF-I30,8,5,4,0,4,5,0.5,0.5,0.0,1.0
SF-S24,SF-I29-2,3,3,0,0,3,3,0.0,1.0,0.0,1.0
SF-S24,SF-I27,7,3,1,2,6,1,0.14285714285714285,0.8571428571428571,0.6666666666666666,0.3333333333333333
SF-S24,SF-I28,3,1,3,1,0,0,1.0,0.0,1.0,0.0
SF-S24,SF-I30-2,2,2,1,0,1,2,0.5,0.5,0.0,1.0
SF-S24,SF-H28,4,10,1,5,3,5,0.25,0.75,0.5,0.5
SF-S24,SF-H29,1,5,1,2,0,3,1.0,0.0,0.4,0.6
SF-S24,SF-R24,53,96,30,68,23,28,0.5660377358490566,0.4339622641509434,0.7083333333333334,0.2916666666666667
SF-S24,SF-R26,7,8,1,4,6,4,0.14285714285714285,0.8571428571428571,0.5,0.5
SF-S24,SF-Q26,32,28,10,6,22,22,0.3125,0.6875,0.21428571428571427,0.7857142857142857
SF-S24,SF-P26,59,30,40,19,19,11,0.6779661016949152,0.3220338983050847,0.6333333333333333,0.36666666666666664
SF-S24,SF-O25-2,23,28,11,8,12,20,0.4782608695652174,0.5217391304347826,0.2857142857142857,0.7142857142857143
SF-S24,SF-N22-1B,4,7,3,2,1,5,0.75,0.25,0.2857142857142857,0.7142857142857143
SF-S24,SF-N26,10,13,8,6,2,7,0.8,0.2,0.46153846153846156,0.5384615384615384
SF-S24,SF-N25,14,10,3,4,11,6,0.21428571428571427,0.7857142857142857,0.4,0.6
SF-S24,SF-T21,4,10,2,5,2,5,0.5,0.5,0.5,0.5
SF-S24,SF-T22,50,59,20,18,30,41,0.4,0.6,0.3050847457627119,0.6949152542372882
SF-S24,SF-S22-2,13,9,11,5,2,4,0.8461538461538461,0.15384615384615385,0.5555555555555556,0.4444444444444444
SF-S24,SF-S22-1,17,34,14,27,3,7,0.8235294117647058,0.17647058823529413,0.7941176470588235,0.20588235294117646
SF-S24,SF-Q23-3,20,33,10,15,10,18,0.5,0.5,0.45454545454545453,0.5454545454545454
SF-S24,SF-Q22-1,36,34,16,15,20,19,0.4444444444444444,0.5555555555555556,0.4411764705882353,0.5588235294117647
SF-S24,SF-Q22-2,46,35,31,21,15,14,0.6739130434782609,0.32608695652173914,0.6,0.4
SF-S24,SF-P22,25,34,7,13,18,21,0.28,0.72,0.38235294117647056,0.6176470588235294
SF-S24,SF-W19,10,15,2,3,8,12,0.2,0.8,0.2,0.8
SF-S24,SF-W19-2,14,3,2,0,12,3,0.14285714285714285,0.8571428571428571,0.0,1.0
SF-S24,SF-U21,13,5,4,0,9,5,0.3076923076923077,0.6923076923076923,0.0,1.0
SF-S24,SF-T20,19,17,9,5,10,12,0.47368421052631576,0.5263157894736842,0.29411764705882354,0.7058823529411765
SF-S24,SF-S21,17,8,10,0,7,8,0.5882352941176471,0.4117647058823529,0.0,1.0
SF-S24,SF-V29,1,3,1,2,0,1,1.0,0.0,0.6666666666666666,0.3333333333333333
SF-S24,SF-V31,1,3,1,2,0,1,1.0,0.0,0.6666666666666666,0.3333333333333333
SF-S24,SF-V32,7,2,1,1,6,1,0.14285714285714285,0.8571428571428571,0.5,0.5
SF-S24,SF-U30,3,2,0,0,3,2,0.0,1.0,0.0,1.0
SF-S24,SF-W14,2,2,0,0,2,2,0.0,1.0,0.0,1.0
SF-R24,SF-M26,3,4,0,0,3,4,0.0,1.0,0.0,1.0
SF-R24,SF-M25,34,47,10,13,24,34,0.29411764705882354,0.7058823529411765,0.2765957446808511,0.723404255319149
SF-R24,SF-M26-2,26,29,4,2,22,27,0.15384615384615385,0.8461538461538461,0.06896551724137931,0.9310344827586207
SF-R24,SF-L27,5,4,4,3,1,1,0.8,0.2,0.75,0.25
SF-R24,SF-K26,21,11,7,9,14,2,0.3333333333333333,0.6666666666666666,0.8181818181818182,0.18181818181818182
SF-R24,SF-J27,10,5,6,2,4,3,0.6,0.4,0.4,0.6
SF-R24,SF-M30,29,25,6,6,23,19,0.20689655172413793,0.7931034482758621,0.24,0.76
SF-R24,SF-J29-3,2,5,2,3,0,2,1.0,0.0,0.6,0.4
SF-R24,SF-J29,10,4,2,4,8,0,0.2,0.8,1.0,0.0
SF-R24,SF-L26,129,114,52,47,77,67,0.40310077519379844,0.5968992248062015,0.41228070175438597,0.5877192982456141
SF-R24,SF-M28,13,6,4,0,9,6,0.3076923076923077,0.6923076923076923,0.0,1.0
SF-R24,SF-M27,2,1,1,1,1,0,0.5,0.5,1.0,0.0
SF-R24,SF-L25,16,14,12,6,4,8,0.75,0.25,0.42857142857142855,0.5714285714285714
SF-R24,SF-M24,34,26,18,11,16,15,0.5294117647058824,0.47058823529411764,0.4230769230769231,0.5769230769230769
SF-R24,SF-L24,45,50,23,16,22,34,0.5111111111111111,0.4888888888888889,0.32,0.68
SF-R24,SF-N23,36,40,27,25,9,15,0.75,0.25,0.625,0.375
SF-R24,SF-N24-2,112,76,56,39,56,37,0.5,0.5,0.5131578947368421,0.4868421052631579
SF-R24,SF-K27-2,28,16,11,5,17,11,0.39285714285714285,0.6071428571428571,0.3125,0.6875
SF-R24,SF-J26-2,17,25,11,17,6,8,0.6470588235294118,0.35294117647058826,0.68,0.32
SF-R24,SF-L28,5,1,3,0,2,1,0.6,0.4,0.0,1.0
SF-R24,SF-K28,13,3,4,2,9,1,0.3076923076923077,0.6923076923076923,0.6666666666666666,0.3333333333333333
SF-R24,SF-K29-1,3,5,2,1,1,4,0.6666666666666666,0.3333333333333333,0.2,0.8
SF-R24,SF-J28-2,2,2,2,0,0,2,1.0,0.0,0.0,1.0
SF-R24,SF-K27,3,3,0,0,3,3,0.0,1.0,0.0,1.0
SF-R24,SF-K25,17,34,9,15,8,19,0.5294117647058824,0.47058823529411764,0.4411764705882353,0.5588235294117647
SF-R24,SF-J25,28,10,13,7,15,3,0.4642857142857143,0.5357142857142857,0.7,0.3
SF-R24,SF-H26-2,21,38,2,4,19,34,0.09523809523809523,0.9047619047619048,0.10526315789473684,0.8947368421052632
SF-R24,SF-P24,45,71,29,58,16,13,0.6444444444444445,0.35555555555555557,0.8169014084507042,0.18309859154929578
SF-R24,SF-N22-1A,5,4,2,3,3,1,0.4,0.6,0.75,0.25
SF-R24,SF-J24,6,5,2,0,4,5,0.3333333333333333,0.6666666666666666,0.0,1.0
SF-R24,SF-O24,24,36,14,25,10,11,0.5833333333333334,0.4166666666666667,0.6944444444444444,0.3055555555555556
SF-R24,SF-J26,3,5,1,1,2,4,0.3333333333333333,0.6666666666666666,0.2,0.8
SF-R24,SF-I26-,15,6,2,3,13,3,0.13333333333333333,0.8666666666666667,0.5,0.5
SF-R24,SF-I25,13,14,7,7,6,7,0.5384615384615384,0.46153846153846156,0.5,0.5
SF-R24,SF-H26,27,15,17,5,10,10,0.6296296296296297,0.37037037037037035,0.3333333333333333,0.6666666666666666
SF-R24,SF-O23,36,30,24,22,12,8,0.6666666666666666,0.3333333333333333,0.7333333333333333,0.26666666666666666
SF-R24,SF-H27-1,10,2,3,1,7,1,0.3,0.7,0.5,0.5
SF-R24,SF-F28-2,9,6,4,4,5,2,0.4444444444444444,0.5555555555555556,0.6666666666666666,0.3333333333333333
SF-R24,SF-G27,22,12,7,4,15,8,0.3181818181818182,0.6818181818181818,0.3333333333333333,0.6666666666666666
SF-R24,SF-M22-2,21,26,13,14,8,12,0.6190476190476191,0.38095238095238093,0.5384615384615384,0.46153846153846156
SF-R24,SF-L22,30,25,16,13,14,12,0.5333333333333333,0.4666666666666667,0.52,0.48
SF-R24,SF-F27,7,9,0,3,7,6,0.0,1.0,0.3333333333333333,0.6666666666666666
SF-R24,SF-N22-2,64,63,22,33,42,30,0.34375,0.65625,0.5238095238095238,0.47619047619047616
SF-R24,SF-G28-2,2,2,0,1,2,1,0.0,1.0,0.5,0.5
SF-R24,SF-G28-1,5,2,0,2,5,0,0.0,1.0,1.0,0.0
SF-R24,SF-M22-1,15,8,8,3,7,5,0.5333333333333333,0.4666666666666667,0.375,0.625
SF-R24,SF-O25-1,8,8,6,5,2,3,0.75,0.25,0.625,0.375
SF-R24,SF-K22-2,14,13,9,8,5,5,0.6428571428571429,0.35714285714285715,0.6153846153846154,0.38461538461538464
SF-R24,SF-K24,25,26,17,19,8,7,0.68,0.32,0.7307692307692307,0.2692307692307692
SF-R24,SF-J23-2,7,6,2,1,5,5,0.2857142857142857,0.7142857142857143,0.16666666666666666,0.8333333333333334
SF-R24,SF-G23,4,3,2,1,2,2,0.5,0.5,0.3333333333333333,0.6666666666666666
SF-R24,SF-G24,15,11,9,3,6,8,0.6,0.4,0.2727272727272727,0.7272727272727273
SF-R24,SF-G25,20,4,1,0,19,4,0.05,0.95,0.0,1.0
SF-R24,SF-F23,28,12,5,0,23,12,0.17857142857142858,0.8214285714285714,0.0,1.0
SF-R24,SF-E23,13,5,4,0,9,5,0.3076923076923077,0.6923076923076923,0.0,1.0
SF-R24,SF-D24,1,1,0,0,1,1,0.0,1.0,0.0,1.0
SF-R24,SF-C22,2,3,0,0,2,3,0.0,1.0,0.0,1.0
SF-R24,SF-B22,7,12,5,7,2,5,0.7142857142857143,0.2857142857142857,0.5833333333333334,0.4166666666666667
SF-R24,SF-J17,7,5,2,1,5,4,0.2857142857142857,0.7142857142857143,0.2,0.8
SF-R24,SF-I19,4,1,1,0,3,1,0.25,0.75,0.0,1.0
SF-R24,SF-H20,4,5,3,2,1,3,0.75,0.25,0.4,0.6
SF-R24,SF-H18,4,3,1,0,3,3,0.25,0.75,0.0,1.0
SF-R24,SF-G19,6,7,4,0,2,7,0.6666666666666666,0.3333333333333333,0.0,1.0
SF-R24,SF-G18,16,14,6,1,10,13,0.375,0.625,0.07142857142857142,0.9285714285714286
SF-R24,SF-G20,6,2,3,1,3,1,0.5,0.5,0.5,0.5
SF-R24,SF-F19,3,5,1,1,2,4,0.3333333333333333,0.6666666666666666,0.2,0.8
SF-R24,SF-E18,2,6,0,0,2,6,0.0,1.0,0.0,1.0
SF-R24,SF-E20,2,2,0,0,2,2,0.0,1.0,0.0,1.0
SF-R24,SF-H30,10,4,4,3,6,1,0.4,0.6,0.75,0.25
SF-R24,SF-G30-2,13,12,7,5,6,7,0.5384615384615384,0.46153846153846156,0.4166666666666667,0.5833333333333334
SF-R24,SF-F30-1,8,4,1,1,7,3,0.125,0.875,0.25,0.75
SF-R24,SF-E29-2,5,6,2,4,3,2,0.4,0.6,0.6666666666666666,0.3333333333333333
SF-R24,SF-E29-1,6,22,1,9,5,13,0.16666666666666666,0.8333333333333334,0.4090909090909091,0.5909090909090909
SF-R24,SF-D29,3,3,1,0,2,3,0.3333333333333333,0.6666666666666666,0.0,1.0
SF-R24,SF-D28,3,4,0,2,3,2,0.0,1.0,0.5,0.5
SF-R24,SF-A27,1,11,1,0,0,11,1.0,0.0,0.0,1.0
SF-R24,SF-G29-2,15,94,1,1,14,93,0.06666666666666667,0.9333333333333333,0.010638297872340425,0.9893617021276596
SF-R24,SF-G29-1,19,18,3,2,16,16,0.15789473684210525,0.8421052631578947,0.1111111111111111,0.8888888888888888
SF-R24,SF-G30-1,27,6,1,2,26,4,0.037037037037037035,0.9629629629629629,0.3333333333333333,0.6666666666666666
SF-R24,SF-G29-3,2,4,1,2,1,2,0.5,0.5,0.5,0.5
SF-R24,SF-F30-2,7,3,2,2,5,1,0.2857142857142857,0.7142857142857143,0.6666666666666666,0.3333333333333333
SF-R24,SF-F29,18,1,2,0,16,1,0.1111111111111111,0.8888888888888888,0.0,1.0
SF-R24,SF-F28-1,3,2,0,0,3,2,0.0,1.0,0.0,1.0
SF-R24,SF-E28,4,2,1,2,3,0,0.25,0.75,1.0,0.0
SF-R24,SF-J10,2,5,0,2,2,3,0.0,1.0,0.4,0.6
SF-R24,SF-J12,9,8,4,2,5,6,0.4444444444444444,0.5555555555555556,0.25,0.75
SF-R24,SF-J13,5,3,0,0,5,3,0.0,1.0,0.0,1.0
SF-R24,SF-J15,3,1,0,0,3,1,0.0,1.0,0.0,1.0
SF-R24,SF-H13,4,2,1,0,3,2,0.25,0.75,0.0,1.0
SF-R24,SF-G13,1,1,0,1,1,0,0.0,1.0,1.0,0.0
SF-R24,SF-G12,4,4,3,2,1,2,0.75,0.25,0.5,0.5
SF-R24,SF-F15,2,1,2,0,0,1,1.0,0.0,0.0,1.0
SF-R24,SF-C20,1,4,0,0,1,4,0.0,1.0,0.0,1.0
SF-R24,SF-A20,2,3,0,0,2,3,0.0,1.0,0.0,1.0
SF-R24,SF-A19,1,1,0,1,1,0,0.0,1.0,1.0,0.0
SF-R24,SF-C25,9,4,1,0,8,4,0.1111111111111111,0.8888888888888888,0.0,1.0
SF-R24,SF-B25,7,6,1,1,6,5,0.14285714285714285,0.8571428571428571,0.16666666666666666,0.8333333333333334
SF-R24,SF-B28-2,2,1,1,1,1,0,0.5,0.5,1.0,0.0
SF-R24,SF-D27,2,8,2,3,0,5,1.0,0.0,0.375,0.625
SF-R24,SF-C28-1,1,1,0,0,1,1,0.0,1.0,0.0,1.0
SF-R24,SF-J1,2,7,0,3,2,4,0.0,1.0,0.42857142857142855,0.5714285714285714
SF-R24,SF-H0,3,2,2,2,1,0,0.6666666666666666,0.3333333333333333,1.0,0.0
SF-R24,SF-G5,1,1,0,0,1,1,0.0,1.0,0.0,1.0
SF-R24,SF-G7,4,3,0,0,4,3,0.0,1.0,0.0,1.0
SF-R24,SF-G26,21,11,8,5,13,6,0.38095238095238093,0.6190476190476191,0.45454545454545453,0.5454545454545454
SF-R24,SF-K21,8,8,6,0,2,8,0.75,0.25,0.0,1.0
SF-R24,SF-K22-1,7,5,5,2,2,3,0.7142857142857143,0.2857142857142857,0.4,0.6
SF-R24,SF-J23-1,67,64,45,39,22,25,0.6716417910447762,0.3283582089552239,0.609375,0.390625
SF-R24,SF-J22-1,31,27,6,4,25,23,0.1935483870967742,0.8064516129032258,0.14814814814814814,0.8518518518518519
SF-R24,SF-J22-2,1,9,1,4,0,5,1.0,0.0,0.4444444444444444,0.5555555555555556
SF-R24,SF-J21,14,15,5,11,9,4,0.35714285714285715,0.6428571428571429,0.7333333333333333,0.26666666666666666
SF-R24,SF-I22,10,1,0,0,10,1,0.0,1.0,0.0,1.0
SF-R24,SF-I23-2,11,6,5,4,6,2,0.45454545454545453,0.5454545454545454,0.6666666666666666,0.3333333333333333
SF-R24,SF-I24,7,8,3,4,4,4,0.42857142857142855,0.5714285714285714,0.5,0.5
SF-R24,SF-I23-1,18,20,8,13,10,7,0.4444444444444444,0.5555555555555556,0.65,0.35
SF-R24,SF-F26,41,26,13,5,28,21,0.3170731707317073,0.6829268292682927,0.19230769230769232,0.8076923076923077
SF-R24,SF-M13,15,8,7,2,8,6,0.4666666666666667,0.5333333333333333,0.25,0.75
SF-R24,SF-M15,43,9,5,2,38,7,0.11627906976744186,0.8837209302325582,0.2222222222222222,0.7777777777777778
SF-R24,SF-L19,51,8,11,2,40,6,0.21568627450980393,0.7843137254901961,0.25,0.75
SF-R24,SF-L20,15,8,4,1,11,7,0.26666666666666666,0.7333333333333333,0.125,0.875
SF-R24,SF-N20-1,19,14,5,6,14,8,0.2631578947368421,0.7368421052631579,0.42857142857142855,0.5714285714285714
SF-R24,SF-M20,36,48,11,5,25,43,0.3055555555555556,0.6944444444444444,0.10416666666666667,0.8958333333333334
SF-R24,SF-K17-2,5,4,0,1,5,3,0.0,1.0,0.25,0.75
SF-R24,SF-K20,12,15,3,6,9,9,0.25,0.75,0.4,0.6
SF-R24,SF-K15-,14,19,4,3,10,16,0.2857142857142857,0.7142857142857143,0.15789473684210525,0.8421052631578947
SF-R24,SF-K19,26,21,2,7,24,14,0.07692307692307693,0.9230769230769231,0.3333333333333333,0.6666666666666666
SF-R24,SF-K18,20,14,6,3,14,11,0.3,0.7,0.21428571428571427,0.7857142857142857
SF-R24,SF-K17,9,12,1,2,8,10,0.1111111111111111,0.8888888888888888,0.16666666666666666,0.8333333333333334
SF-R24,SF-J16,1,2,1,1,0,1,1.0,0.0,0.5,0.5
SF-R24,SF-J18,9,7,2,1,7,6,0.2222222222222222,0.7777777777777778,0.14285714285714285,0.8571428571428571
SF-R24,SF-J20,3,1,2,0,1,1,0.6666666666666666,0.3333333333333333,0.0,1.0
SF-R24,SF-J19,5,2,0,2,5,0,0.0,1.0,1.0,0.0
SF-R24,SF-M12,4,1,1,1,3,0,0.25,0.75,1.0,0.0
SF-R24,SF-M10,3,3,3,1,0,2,1.0,0.0,0.3333333333333333,0.6666666666666666
SF-R24,SF-M11,2,3,1,0,1,3,0.5,0.5,0.0,1.0
SF-R24,SF-R19,20,9,6,2,14,7,0.3,0.7,0.2222222222222222,0.7777777777777778
SF-R24,SF-R20,2,7,2,3,0,4,1.0,0.0,0.42857142857142855,0.5714285714285714
SF-R24,SF-Q21-2,23,30,15,7,8,23,0.6521739130434783,0.34782608695652173,0.23333333333333334,0.7666666666666667
SF-R24,SF-Q21-1,8,6,5,3,3,3,0.625,0.375,0.5,0.5
SF-R24,SF-P21,20,31,12,10,8,21,0.6,0.4,0.3225806451612903,0.6774193548387096
SF-R24,SF-O18,11,6,2,3,9,3,0.18181818181818182,0.8181818181818182,0.5,0.5
SF-R24,SF-O19,18,60,8,19,10,41,0.4444444444444444,0.5555555555555556,0.31666666666666665,0.6833333333333333
SF-R24,SF-O21,64,80,22,42,42,38,0.34375,0.65625,0.525,0.475
SF-R24,SF-O22,78,53,34,30,44,23,0.4358974358974359,0.5641025641025641,0.5660377358490566,0.4339622641509434
SF-R24,SF-N21,8,20,0,10,8,10,0.0,1.0,0.5,0.5
SF-R24,SF-N20-2,30,19,6,5,24,14,0.2,0.8,0.2631578947368421,0.7368421052631579
SF-R24,SF-M21,19,18,5,6,14,12,0.2631578947368421,0.7368421052631579,0.3333333333333333,0.6666666666666666
SF-R24,SF-L21,14,22,1,5,13,17,0.07142857142857142,0.9285714285714286,0.22727272727272727,0.7727272727272727
SF-R24,SF-S29,12,6,5,5,7,1,0.4166666666666667,0.5833333333333334,0.8333333333333334,0.16666666666666666
SF-R24,SF-S30,5,6,0,2,5,4,0.0,1.0,0.3333333333333333,0.6666666666666666
SF-R24,SF-Q30,22,15,4,6,18,9,0.18181818181818182,0.8181818181818182,0.4,0.6
SF-R24,SF-P30,18,16,5,2,13,14,0.2777777777777778,0.7222222222222222,0.125,0.875
SF-R24,SF-O30-2,2,3,1,0,1,3,0.5,0.5,0.0,1.0
SF-R24,SF-O30,13,23,8,14,5,9,0.6153846153846154,0.38461538461538464,0.6086956521739131,0.391304347826087
SF-R24,SF-N27,38,22,15,10,23,12,0.39473684210526316,0.6052631578947368,0.45454545454545453,0.5454545454545454
SF-R24,SF-N29,11,15,2,0,9,15,0.18181818181818182,0.8181818181818182,0.0,1.0
SF-R24,SF-N28,18,14,6,3,12,11,0.3333333333333333,0.6666666666666666,0.21428571428571427,0.7857142857142857
SF-R24,SF-L30-1,30,25,12,3,18,22,0.4,0.6,0.12,0.88
SF-R24,SF-L31-1,3,5,2,5,1,0,0.6666666666666666,0.3333333333333333,1.0,0.0
SF-R24,SF-K30-2,3,4,1,3,2,1,0.3333333333333333,0.6666666666666666,0.75,0.25
SF-R24,SF-L29,4,4,2,2,2,2,0.5,0.5,0.5,0.5
SF-R24,SF-J29-1,7,8,1,4,6,4,0.14285714285714285,0.8571428571428571,0.5,0.5
SF-R24,SF-I30,5,6,0,1,5,5,0.0,1.0,0.16666666666666666,0.8333333333333334
SF-R24,SF-I29-2,2,3,1,1,1,2,0.5,0.5,0.3333333333333333,0.6666666666666666
SF-R24,SF-I27,8,9,2,3,6,6,0.25,0.75,0.3333333333333333,0.6666666666666666
SF-R24,SF-I28,3,1,1,0,2,1,0.3333333333333333,0.6666666666666666,0.0,1.0
SF-R24,SF I29-1,5,7,3,7,2,0,0.6,0.4,1.0,0.0
SF-R24,SF-H28,9,19,2,1,7,18,0.2222222222222222,0.7777777777777778,0.05263157894736842,0.9473684210526315
SF-R24,SF-S24,96,53,68,30,28,23,0.7083333333333334,0.2916666666666667,0.5660377358490566,0.4339622641509434
SF-R24,SF-R26,17,17,11,16,6,1,0.6470588235294118,0.35294117647058826,0.9411764705882353,0.058823529411764705
SF-R24,SF-Q26,28,20,10,9,18,11,0.35714285714285715,0.6428571428571429,0.45,0.55
SF-R24,SF-P26,20,15,4,10,16,5,0.2,0.8,0.6666666666666666,0.3333333333333333
SF-R24,SF-O25-2,13,22,5,9,8,13,0.38461538461538464,0.6153846153846154,0.4090909090909091,0.5909090909090909
SF-R24,SF-N22-1B,3,5,2,3,1,2,0.6666666666666666,0.3333333333333333,0.6,0.4
SF-R24,SF-N26,14,5,4,4,10,1,0.2857142857142857,0.7142857142857143,0.8,0.2
SF-R24,SF-N25,31,38,16,18,15,20,0.5161290322580645,0.4838709677419355,0.47368421052631576,0.5263157894736842
SF-R24,SF-T21,8,10,5,5,3,5,0.625,0.375,0.5,0.5
SF-R24,SF-T22,32,31,10,13,22,18,0.3125,0.6875,0.41935483870967744,0.5806451612903226
SF-R24,SF-S22-2,12,4,4,1,8,3,0.3333333333333333,0.6666666666666666,0.25,0.75
SF-R24,SF-S22-1,41,14,13,7,28,7,0.3170731707317073,0.6829268292682927,0.5,0.5
SF-R24,SF-Q23-3,19,29,14,20,5,9,0.7368421052631579,0.2631578947368421,0.6896551724137931,0.3103448275862069
SF-R24,SF-Q22-1,21,26,18,18,3,8,0.8571428571428571,0.14285714285714285,0.6923076923076923,0.3076923076923077
SF-R24,SF-Q22-2,37,29,29,17,8,12,0.7837837837837838,0.21621621621621623,0.5862068965517241,0.41379310344827586
SF-R24,SF-P22,39,33,21,22,18,11,0.5384615384615384,0.46153846153846156,0.6666666666666666,0.3333333333333333
SF-R24,SF-W19,4,2,2,0,2,2,0.5,0.5,0.0,1.0
SF-R24,SF-W19-2,4,2,1,1,3,1,0.25,0.75,0.5,0.5
SF-R24,SF-U21,4,2,2,0,2,2,0.5,0.5,0.0,1.0
SF-R24,SF-T20,23,28,5,5,18,23,0.21739130434782608,0.782608695652174,0.17857142857142858,0.8214285714285714
SF-R24,SF-S21,6,10,1,3,5,7,0.16666666666666666,0.8333333333333334,0.3,0.7
SF-R24,SF-Y29,6,8,1,5,5,3,0.16666666666666666,0.8333333333333334,0.625,0.375
SF-R24,SF-X29,5,3,1,0,4,3,0.2,0.8,0.0,1.0
SF-R24,SF-V28,11,10,1,4,10,6,0.09090909090909091,0.9090909090909091,0.4,0.6
SF-R24,SF-V29,2,1,0,0,2,1,0.0,1.0,0.0,1.0
SF-R24,SF-V31,2,3,0,0,2,3,0.0,1.0,0.0,1.0
SF-R24,SF-V32,5,4,1,0,4,4,0.2,0.8,0.0,1.0
SF-R24,SF-U30,5,2,2,0,3,2,0.4,0.6,0.0,1.0
SF-R24,SF-W14,2,6,1,0,1,6,0.5,0.5,0.0,1.0
SF-R24,SF-Y14,1,2,0,0,1,2,0.0,1.0,0.0,1.0
SF-R24,SF-X19,3,3,2,2,1,1,0.6666666666666666,0.3333333333333333,0.6666666666666666,0.3333333333333333
SF-R26,SF-M25,4,1,2,1,2,0,0.5,0.5,1.0,0.0
SF-R26,SF-M26-2,1,2,0,0,1,2,0.0,1.0,0.0,1.0
SF-R26,SF-K26,7,3,2,3,5,0,0.2857142857142857,0.7142857142857143,1.0,0.0
SF-R26,SF-M30,10,6,3,3,7,3,0.3,0.7,0.5,0.5
SF-R26,SF-J29,1,6,0,4,1,2,0.0,1.0,0.6666666666666666,0.3333333333333333
SF-R26,SF-L26,3,2,1,1,2,1,0.3333333333333333,0.6666666666666666,0.5,0.5
SF-R26,SF-M28,1,2,0,0,1,2,0.0,1.0,0.0,1.0
SF-R26,SF-M24,5,4,4,3,1,1,0.8,0.2,0.75,0.25
SF-R26,SF-L24,2,2,1,1,1,1,0.5,0.5,0.5,0.5
SF-R26,SF-N23,4,2,3,1,1,1,0.75,0.25,0.5,0.5
SF-R26,SF-K27-2,8,5,1,1,7,4,0.125,0.875,0.2,0.8
SF-R26,SF-J26-2,1,2,1,1,0,1,1.0,0.0,0.5,0.5
SF-R26,SF-K29-1,1,4,1,1,0,3,1.0,0.0,0.25,0.75
SF-R26,SF-J28-2,3,1,0,0,3,1,0.0,1.0,0.0,1.0
SF-R26,SF-K25,3,6,1,5,2,1,0.3333333333333333,0.6666666666666666,0.8333333333333334,0.16666666666666666
SF-R26,SF-J25,19,17,18,16,1,1,0.9473684210526315,0.05263157894736842,0.9411764705882353,0.058823529411764705
SF-R26,SF-P24,5,7,4,4,1,3,0.8,0.2,0.5714285714285714,0.42857142857142855
SF-R26,SF-O24,1,7,1,5,0,2,1.0,0.0,0.7142857142857143,0.2857142857142857
SF-R26,SF-I25,2,1,0,0,2,1,0.0,1.0,0.0,1.0
SF-R26,SF-H26,2,1,2,1,0,0,1.0,0.0,1.0,0.0
SF-R26,SF-O23,10,4,5,0,5,4,0.5,0.5,0.0,1.0
SF-R26,SF-H27-1,1,3,1,1,0,2,1.0,0.0,0.3333333333333333,0.6666666666666666
SF-R26,SF-F28-2,1,1,0,0,1,1,0.0,1.0,0.0,1.0
SF-R26,SF-G27,3,4,2,2,1,2,0.6666666666666666,0.3333333333333333,0.5,0.5
SF-R26,SF-M22-2,9,6,4,6,5,0,0.4444444444444444,0.5555555555555556,1.0,0.0
SF-R26,SF-L22,13,11,3,3,10,8,0.23076923076923078,0.7692307692307693,0.2727272727272727,0.7272727272727273
SF-R26,SF-F27,1,4,0,1,1,3,0.0,1.0,0.25,0.75
SF-R26,SF-N22-2,4,6,0,1,4,5,0.0,1.0,0.16666666666666666,0.8333333333333334
SF-R26,SF-M22-1,1,1,0,1,1,0,0.0,1.0,1.0,0.0
SF-R26,SF-K22-2,4,3,0,2,4,1,0.0,1.0,0.6666666666666666,0.3333333333333333
SF-R26,SF-K24,4,4,3,4,1,0,0.75,0.25,1.0,0.0
SF-R26,SF-G24,3,2,2,1,1,1,0.6666666666666666,0.3333333333333333,0.5,0.5
SF-R26,SF-F23,2,3,1,0,1,3,0.5,0.5,0.0,1.0
SF-R26,SF-E23,1,5,0,0,1,5,0.0,1.0,0.0,1.0
SF-R26,SF-C22,1,1,0,0,1,1,0.0,1.0,0.0,1.0
SF-R26,SF-F19,1,2,0,1,1,1,0.0,1.0,0.5,0.5
SF-R26,SF-H30,1,5,0,0,1,5,0.0,1.0,0.0,1.0
SF-R26,SF-G30-2,4,2,1,1,3,1,0.25,0.75,0.5,0.5
SF-R26,SF-F30-1,1,1,1,0,0,1,1.0,0.0,0.0,1.0
SF-R26,SF-E29-2,3,5,0,0,3,5,0.0,1.0,0.0,1.0
SF-R26,SF-E29-1,1,4,1,2,0,2,1.0,0.0,0.5,0.5
SF-R26,SF-G29-2,1,1,0,0,1,1,0.0,1.0,0.0,1.0
SF-R26,SF-G29-1,1,4,0,0,1,4,0.0,1.0,0.0,1.0
SF-R26,SF-G29-3,1,2,0,0,1,2,0.0,1.0,0.0,1.0
SF-R26,SF-E28,1,2,0,0,1,2,0.0,1.0,0.0,1.0
SF-R26,SF-A20,1,1,0,1,1,0,0.0,1.0,1.0,0.0
SF-R26,SF-C28-1,2,2,2,2,0,0,1.0,0.0,1.0,0.0
SF-R26,SF-K21,5,10,0,0,5,10,0.0,1.0,0.0,1.0
SF-R26,SF-J23-1,4,2,1,0,3,2,0.25,0.75,0.0,1.0
SF-R26,SF-J22-1,1,4,1,2,0,2,1.0,0.0,0.5,0.5
SF-R26,SF-I23-2,1,1,0,0,1,1,0.0,1.0,0.0,1.0
SF-R26,SF-F26,4,2,1,0,3,2,0.25,0.75,0.0,1.0
SF-R26,SF-M15,1,3,0,0,1,3,0.0,1.0,0.0,1.0
SF-R26,SF-L19,1,2,0,0,1,2,0.0,1.0,0.0,1.0
SF-R26,SF-N20-1,2,8,0,0,2,8,0.0,1.0,0.0,1.0
SF-R26,SF-K20,2,4,2,1,0,3,1.0,0.0,0.25,0.75
SF-R26,SF-K15-,2,2,0,0,2,2,0.0,1.0,0.0,1.0
SF-R26,SF-K19,1,3,0,0,1,3,0.0,1.0,0.0,1.0
SF-R26,SF-K18,4,2,2,0,2,2,0.5,0.5,0.0,1.0
SF-R26,SF-K17,3,4,1,0,2,4,0.3333333333333333,0.6666666666666666,0.0,1.0
SF-R26,SF-J18,4,2,0,0,4,2,0.0,1.0,0.0,1.0
SF-R26,SF-J19,1,4,0,2,1,2,0.0,1.0,0.5,0.5
SF-R26,SF-M12,2,1,1,0,1,1,0.5,0.5,0.0,1.0
SF-R26,SF-Q21-2,5,1,4,0,1,1,0.8,0.2,0.0,1.0
SF-R26,SF-Q21-1,1,3,0,0,1,3,0.0,1.0,0.0,1.0
SF-R26,SF-P21,7,8,4,2,3,6,0.5714285714285714,0.42857142857142855,0.25,0.75
SF-R26,SF-O18,2,2,2,0,0,2,1.0,0.0,0.0,1.0
SF-R26,SF-O19,6,8,3,1,3,7,0.5,0.5,0.125,0.875
SF-R26,SF-O21,9,15,8,12,1,3,0.8888888888888888,0.1111111111111111,0.8,0.2
SF-R26,SF-O22,15,7,5,7,10,0,0.3333333333333333,0.6666666666666666,1.0,0.0
SF-R26,SF-N21,1,1,0,0,1,1,0.0,1.0,0.0,1.0
SF-R26,SF-N20-2,5,8,1,1,4,7,0.2,0.8,0.125,0.875
SF-R26,SF-M21,5,5,4,2,1,3,0.8,0.2,0.4,0.6
SF-R26,SF-L21,5,4,0,0,5,4,0.0,1.0,0.0,1.0
SF-R26,SF-S29,6,3,3,1,3,2,0.5,0.5,0.3333333333333333,0.6666666666666666
SF-R26,SF-S30,1,1,1,0,0,1,1.0,0.0,0.0,1.0
SF-R26,SF-P30,9,7,3,2,6,5,0.3333333333333333,0.6666666666666666,0.2857142857142857,0.7142857142857143
SF-R26,SF-O30,8,6,5,0,3,6,0.625,0.375,0.0,1.0
SF-R26,SF-N27,4,7,2,5,2,2,0.5,0.5,0.7142857142857143,0.2857142857142857
SF-R26,SF-N29,5,3,1,2,4,1,0.2,0.8,0.6666666666666666,0.3333333333333333
SF-R26,SF-N28,8,4,2,2,6,2,0.25,0.75,0.5,0.5
SF-R26,SF-L30-1,42,30,4,9,38,21,0.09523809523809523,0.9047619047619048,0.3,0.7
SF-R26,SF-L31-1,1,3,1,0,0,3,1.0,0.0,0.0,1.0
SF-R26,SF-K30-2,3,2,2,1,1,1,0.6666666666666666,0.3333333333333333,0.5,0.5
SF-R26,SF-L29,1,2,0,1,1,1,0.0,1.0,0.5,0.5
SF-R26,SF-J29-1,4,3,2,2,2,1,0.5,0.5,0.6666666666666666,0.3333333333333333
SF-R26,SF-I30,18,26,18,25,0,1,1.0,0.0,0.9615384615384616,0.038461538461538464
SF-R26,SF-I29-2,2,2,1,0,1,2,0.5,0.5,0.0,1.0
SF-R26,SF-I27,5,4,3,0,2,4,0.6,0.4,0.0,1.0
SF-R26,SF-H28,1,3,1,2,0,1,1.0,0.0,0.6666666666666666,0.3333333333333333
SF-R26,SF-S24,8,7,4,1,4,6,0.5,0.5,0.14285714285714285,0.8571428571428571
SF-R26,SF-R24,17,17,16,11,1,6,0.9411764705882353,0.058823529411764705,0.6470588235294118,0.35294117647058826
SF-R26,SF-Q26,6,6,2,4,4,2,0.3333333333333333,0.6666666666666666,0.6666666666666666,0.3333333333333333
SF-R26,SF-P26,2,8,1,5,1,3,0.5,0.5,0.625,0.375
SF-R26,SF-O25-2,4,3,4,1,0,2,1.0,0.0,0.3333333333333333,0.6666666666666666
SF-R26,SF-T21,1,1,0,1,1,0,0.0,1.0,1.0,0.0
SF-R26,SF-T22,4,9,2,5,2,4,0.5,0.5,0.5555555555555556,0.4444444444444444
SF-R26,SF-S22-2,2,6,1,3,1,3,0.5,0.5,0.5,0.5
SF-R26,SF-S22-1,7,5,3,1,4,4,0.42857142857142855,0.5714285714285714,0.2,0.8
SF-R26,SF-Q23-3,11,11,11,10,0,1,1.0,0.0,0.9090909090909091,0.09090909090909091
SF-R26,SF-Q22-1,3,5,1,3,2,2,0.3333333333333333,0.6666666666666666,0.6,0.4
SF-R26,SF-Q22-2,4,3,2,2,2,1,0.5,0.5,0.6666666666666666,0.3333333333333333
SF-R26,SF-P22,7,8,5,4,2,4,0.7142857142857143,0.2857142857142857,0.5,0.5
SF-R26,SF-W19,2,27,0,24,2,3,0.0,1.0,0.8888888888888888,0.1111111111111111
SF-R26,SF-S21,11,7,1,1,10,6,0.09090909090909091,0.9090909090909091,0.14285714285714285,0.8571428571428571
SF-R26,SF-Z28,1,1,0,0,1,1,0.0,1.0,0.0,1.0
SF-R26,SF-V28,10,2,0,1,10,1,0.0,1.0,0.5,0.5
SF-R26,SF-V29,1,1,1,1,0,0,1.0,0.0,1.0,0.0
SF-R26,SF-W14,3,2,0,0,3,2,0.0,1.0,0.0,1.0
SF-R26,SF-BB17,5,3,4,3,1,0,0.8,0.2,1.0,0.0
SF-R26,SF-X19,1,4,1,3,0,1,1.0,0.0,0.75,0.25
SF-R26,SF-Y25,2,2,2,2,0,0,1.0,0.0,1.0,0.0
SF-Q26,SF-M26,3,5,0,3,3,2,0.0,1.0,0.6,0.4
SF-Q26,SF-M25,10,5,3,3,7,2,0.3,0.7,0.6,0.4
SF-Q26,SF-M26-2,3,4,1,2,2,2,0.3333333333333333,0.6666666666666666,0.5,0.5
SF-Q26,SF-L27,2,1,0,0,2,1,0.0,1.0,0.0,1.0
SF-Q26,SF-K26,6,8,0,1,6,7,0.0,1.0,0.125,0.875
SF-Q26,SF-M30,6,12,2,6,4,6,0.3333333333333333,0.6666666666666666,0.5,0.5
SF-Q26,SF-J29,2,5,1,5,1,0,0.5,0.5,1.0,0.0
SF-Q26,SF-L26,46,62,3,13,43,49,0.06521739130434782,0.9347826086956522,0.20967741935483872,0.7903225806451613
SF-Q26,SF-M28,8,8,4,3,4,5,0.5,0.5,0.375,0.625
SF-Q26,SF-L25,6,3,4,2,2,1,0.6666666666666666,0.3333333333333333,0.6666666666666666,0.3333333333333333
SF-Q26,SF-M24,17,16,16,12,1,4,0.9411764705882353,0.058823529411764705,0.75,0.25
SF-Q26,SF-L24,6,6,3,4,3,2,0.5,0.5,0.6666666666666666,0.3333333333333333
SF-Q26,SF-N24-2,17,20,8,3,9,17,0.47058823529411764,0.5294117647058824,0.15,0.85
SF-Q26,SF-K27-2,2,10,1,3,1,7,0.5,0.5,0.3,0.7
SF-Q26,SF-K29-1,13,12,2,2,11,10,0.15384615384615385,0.8461538461538461,0.16666666666666666,0.8333333333333334
SF-Q26,SF-K25,4,2,1,0,3,2,0.25,0.75,0.0,1.0
SF-Q26,SF-J25,2,3,2,2,0,1,1.0,0.0,0.6666666666666666,0.3333333333333333
SF-Q26,SF-H26-2,1,1,0,1,1,0,0.0,1.0,1.0,0.0
SF-Q26,SF-P24,11,4,7,1,4,3,0.6363636363636364,0.36363636363636365,0.25,0.75
SF-Q26,SF-J24,4,3,2,0,2,3,0.5,0.5,0.0,1.0
SF-Q26,SF-I25,1,5,0,1,1,4,0.0,1.0,0.2,0.8
SF-Q26,SF-H26,8,2,0,0,8,2,0.0,1.0,0.0,1.0
SF-Q26,SF-O23,12,11,4,3,8,8,0.3333333333333333,0.6666666666666666,0.2727272727272727,0.7272727272727273
SF-Q26,SF-H27-1,3,10,3,5,0,5,1.0,0.0,0.5,0.5
SF-Q26,SF-F28-2,2,2,0,0,2,2,0.0,1.0,0.0,1.0
SF-Q26,SF-G27,5,4,3,2,2,2,0.6,0.4,0.5,0.5
SF-Q26,SF-M22-2,11,8,1,4,10,4,0.09090909090909091,0.9090909090909091,0.5,0.5
SF-Q26,SF-L22,12,12,9,1,3,11,0.75,0.25,0.08333333333333333,0.9166666666666666
SF-Q26,SF-F27,1,2,0,0,1,2,0.0,1.0,0.0,1.0
SF-Q26,SF-N22-2,16,18,5,6,11,12,0.3125,0.6875,0.3333333333333333,0.6666666666666666
SF-Q26,SF-O25-1,6,7,3,6,3,1,0.5,0.5,0.8571428571428571,0.14285714285714285
SF-Q26,SF-K22-2,6,3,3,0,3,3,0.5,0.5,0.0,1.0
SF-Q26,SF-K24,6,3,5,2,1,1,0.8333333333333334,0.16666666666666666,0.6666666666666666,0.3333333333333333
SF-Q26,SF-G24,3,2,0,0,3,2,0.0,1.0,0.0,1.0
SF-Q26,SF-G25,3,1,1,0,2,1,0.3333333333333333,0.6666666666666666,0.0,1.0
SF-Q26,SF-F23,4,1,3,1,1,0,0.75,0.25,1.0,0.0
SF-Q26,SF-E23,10,2,2,1,8,1,0.2,0.8,0.5,0.5
SF-Q26,SF-D24,1,2,0,0,1,2,0.0,1.0,0.0,1.0
SF-Q26,SF-C22,2,2,0,1,2,1,0.0,1.0,0.5,0.5
SF-Q26,SF-J17,1,2,0,1,1,1,0.0,1.0,0.5,0.5
SF-Q26,SF-F19,2,3,0,0,2,3,0.0,1.0,0.0,1.0
SF-Q26,SF-H30,3,3,2,2,1,1,0.6666666666666666,0.3333333333333333,0.6666666666666666,0.3333333333333333
SF-Q26,SF-G30-2,4,5,3,3,1,2,0.75,0.25,0.6,0.4
SF-Q26,SF-E29-2,6,8,0,0,6,8,0.0,1.0,0.0,1.0
SF-Q26,SF-E29-1,6,12,1,3,5,9,0.16666666666666666,0.8333333333333334,0.25,0.75
SF-Q26,SF-D29,4,5,2,1,2,4,0.5,0.5,0.2,0.8
SF-Q26,SF-A27,3,3,1,3,2,0,0.3333333333333333,0.6666666666666666,1.0,0.0
SF-Q26,SF-G29-3,1,1,1,1,0,0,1.0,0.0,1.0,0.0
SF-Q26,SF-E28,1,3,0,0,1,3,0.0,1.0,0.0,1.0
SF-Q26,SF-J12,4,1,1,0,3,1,0.25,0.75,0.0,1.0
SF-Q26,SF-J13,5,6,1,0,4,6,0.2,0.8,0.0,1.0
SF-Q26,SF-C20,5,1,0,0,5,1,0.0,1.0,0.0,1.0
SF-Q26,SF-A19,1,1,1,0,0,1,1.0,0.0,0.0,1.0
SF-Q26,SF-B25,1,1,0,1,1,0,0.0,1.0,1.0,0.0
SF-Q26,SF-C28-2,1,1,0,0,1,1,0.0,1.0,0.0,1.0
SF-Q26,SF-K21,16,7,2,0,14,7,0.125,0.875,0.0,1.0
SF-Q26,SF-J23-1,19,7,10,3,9,4,0.5263157894736842,0.47368421052631576,0.42857142857142855,0.5714285714285714
SF-Q26,SF-J22-1,3,10,1,4,2,6,0.3333333333333333,0.6666666666666666,0.4,0.6
SF-Q26,SF-J21,3,5,2,1,1,4,0.6666666666666666,0.3333333333333333,0.2,0.8
SF-Q26,SF-I24,3,2,2,1,1,1,0.6666666666666666,0.3333333333333333,0.5,0.5
SF-Q26,SF-I23-1,3,2,1,0,2,2,0.3333333333333333,0.6666666666666666,0.0,1.0
SF-Q26,SF-F26,10,4,3,3,7,1,0.3,0.7,0.75,0.25
SF-Q26,SF-M13,4,5,2,2,2,3,0.5,0.5,0.4,0.6
SF-Q26,SF-M15,6,4,1,2,5,2,0.16666666666666666,0.8333333333333334,0.5,0.5
SF-Q26,SF-L19,3,2,0,0,3,2,0.0,1.0,0.0,1.0
SF-Q26,SF-L20,3,2,2,0,1,2,0.6666666666666666,0.3333333333333333,0.0,1.0
SF-Q26,SF-N20-1,5,4,3,0,2,4,0.6,0.4,0.0,1.0
SF-Q26,SF-M20,1,4,1,1,0,3,1.0,0.0,0.25,0.75
SF-Q26,SF-K20,3,21,1,1,2,20,0.3333333333333333,0.6666666666666666,0.047619047619047616,0.9523809523809523
SF-Q26,SF-K15-,5,3,3,1,2,2,0.6,0.4,0.3333333333333333,0.6666666666666666
SF-Q26,SF-K19,7,7,2,0,5,7,0.2857142857142857,0.7142857142857143,0.0,1.0
SF-Q26,SF-K18,2,3,0,0,2,3,0.0,1.0,0.0,1.0
SF-Q26,SF-K17,7,4,1,2,6,2,0.14285714285714285,0.8571428571428571,0.5,0.5
SF-Q26,SF-J18,1,2,1,1,0,1,1.0,0.0,0.5,0.5
SF-Q26,SF-M12,28,6,13,1,15,5,0.4642857142857143,0.5357142857142857,0.16666666666666666,0.8333333333333334
SF-Q26,SF-M10,3,3,0,0,3,3,0.0,1.0,0.0,1.0
SF-Q26,SF-M11,1,4,0,0,1,4,0.0,1.0,0.0,1.0
SF-Q26,SF-R19,1,5,0,0,1,5,0.0,1.0,0.0,1.0
SF-Q26,SF-R20,2,1,1,0,1,1,0.5,0.5,0.0,1.0
SF-Q26,SF-Q21-2,8,10,4,4,4,6,0.5,0.5,0.4,0.6
SF-Q26,SF-Q21-1,6,11,6,8,0,3,1.0,0.0,0.7272727272727273,0.2727272727272727
SF-Q26,SF-P21,4,10,2,4,2,6,0.5,0.5,0.4,0.6
SF-Q26,SF-O18,34,2,28,0,6,2,0.8235294117647058,0.17647058823529413,0.0,1.0
SF-Q26,SF-O19,7,6,0,1,7,5,0.0,1.0,0.16666666666666666,0.8333333333333334
SF-Q26,SF-O21,14,30,1,9,13,21,0.07142857142857142,0.9285714285714286,0.3,0.7
SF-Q26,SF-O22,22,15,7,7,15,8,0.3181818181818182,0.6818181818181818,0.4666666666666667,0.5333333333333333
SF-Q26,SF-N21,5,4,1,1,4,3,0.2,0.8,0.25,0.75
SF-Q26,SF-N20-2,9,24,1,0,8,24,0.1111111111111111,0.8888888888888888,0.0,1.0
SF-Q26,SF-M21,73,14,2,0,71,14,0.0273972602739726,0.9726027397260274,0.0,1.0
SF-Q26,SF-L21,11,6,6,3,5,3,0.5454545454545454,0.45454545454545453,0.5,0.5
SF-Q26,SF-S29,2,3,2,0,0,3,1.0,0.0,0.0,1.0
SF-Q26,SF-Q30,8,5,1,0,7,5,0.125,0.875,0.0,1.0
SF-Q26,SF-P30,2,4,1,2,1,2,0.5,0.5,0.5,0.5
SF-Q26,SF-O30-2,5,3,2,1,3,2,0.4,0.6,0.3333333333333333,0.6666666666666666
SF-Q26,SF-O30,33,29,7,6,26,23,0.21212121212121213,0.7878787878787878,0.20689655172413793,0.7931034482758621
SF-Q26,SF-N27,14,11,2,4,12,7,0.14285714285714285,0.8571428571428571,0.36363636363636365,0.6363636363636364
SF-Q26,SF-N29,20,22,1,2,19,20,0.05,0.95,0.09090909090909091,0.9090909090909091
SF-Q26,SF-N28,11,11,4,3,7,8,0.36363636363636365,0.6363636363636364,0.2727272727272727,0.7272727272727273
SF-Q26,SF-L30-1,12,10,8,6,4,4,0.6666666666666666,0.3333333333333333,0.6,0.4
SF-Q26,SF-L31-1,3,10,1,5,2,5,0.3333333333333333,0.6666666666666666,0.5,0.5
SF-Q26,SF-K30-2,8,3,4,1,4,2,0.5,0.5,0.3333333333333333,0.6666666666666666
SF-Q26,SF-L29,2,2,1,2,1,0,0.5,0.5,1.0,0.0
SF-Q26,SF-I30,1,13,1,12,0,1,1.0,0.0,0.9230769230769231,0.07692307692307693
SF-Q26,SF-I29-2,1,1,0,1,1,0,0.0,1.0,1.0,0.0
SF-Q26,SF-I27,2,1,0,0,2,1,0.0,1.0,0.0,1.0
SF-Q26,SF-S24,28,32,6,10,22,22,0.21428571428571427,0.7857142857142857,0.3125,0.6875
SF-Q26,SF-R24,20,28,9,10,11,18,0.45,0.55,0.35714285714285715,0.6428571428571429
SF-Q26,SF-R26,6,6,4,2,2,4,0.6666666666666666,0.3333333333333333,0.3333333333333333,0.6666666666666666
SF-Q26,SF-P26,1,13,1,10,0,3,1.0,0.0,0.7692307692307693,0.23076923076923078
SF-Q26,SF-O25-2,5,8,1,5,4,3,0.2,0.8,0.625,0.375
SF-Q26,SF-N22-1B,1,3,0,1,1,2,0.0,1.0,0.3333333333333333,0.6666666666666666
SF-Q26,SF-N26,16,10,11,9,5,1,0.6875,0.3125,0.9,0.1
SF-Q26,SF-N25,12,4,5,2,7,2,0.4166666666666667,0.5833333333333334,0.5,0.5
SF-Q26,SF-T21,1,2,0,0,1,2,0.0,1.0,0.0,1.0
SF-Q26,SF-T22,6,8,0,2,6,6,0.0,1.0,0.25,0.75
SF-Q26,SF-S22-2,2,1,1,0,1,1,0.5,0.5,0.0,1.0
SF-Q26,SF-S22-1,11,13,1,4,10,9,0.09090909090909091,0.9090909090909091,0.3076923076923077,0.6923076923076923
SF-Q26,SF-Q23-3,53,40,42,23,11,17,0.7924528301886793,0.20754716981132076,0.575,0.425
SF-Q26,SF-Q22-1,5,15,2,10,3,5,0.4,0.6,0.6666666666666666,0.3333333333333333
SF-Q26,SF-Q22-2,7,13,2,7,5,6,0.2857142857142857,0.7142857142857143,0.5384615384615384,0.46153846153846156
SF-Q26,SF-P22,30,20,5,8,25,12,0.16666666666666666,0.8333333333333334,0.4,0.6
SF-Q26,SF-W19,2,5,0,2,2,3,0.0,1.0,0.4,0.6
SF-Q26,SF-W19-2,4,2,1,1,3,1,0.25,0.75,0.5,0.5
SF-Q26,SF-U21,4,3,0,2,4,1,0.0,1.0,0.6666666666666666,0.3333333333333333
SF-Q26,SF-T20,6,9,0,0,6,9,0.0,1.0,0.0,1.0
SF-Q26,SF-W29,1,2,0,1,1,1,0.0,1.0,0.5,0.5
SF-Q26,SF-U30,1,1,0,1,1,0,0.0,1.0,1.0,0.0
SF-Q26,SF-W14,1,1,0,0,1,1,0.0,1.0,0.0,1.0
SF-Q26,SF-Y25,1,2,0,0,1,2,0.0,1.0,0.0,1.0
SF-P26,SF-M26,3,8,0,4,3,4,0.0,1.0,0.5,0.5
SF-P26,SF-M25,8,22,0,4,8,18,0.0,1.0,0.18181818181818182,0.8181818181818182
SF-P26,SF-M26-2,4,3,3,0,1,3,0.75,0.25,0.0,1.0
SF-P26,SF-K26,8,9,0,2,8,7,0.0,1.0,0.2222222222222222,0.7777777777777778
SF-P26,SF-J27,2,1,0,1,2,0,0.0,1.0,1.0,0.0
SF-P26,SF-M30,128,229,22,65,106,164,0.171875,0.828125,0.2838427947598253,0.7161572052401747
SF-P26,SF-J29,5,12,3,10,2,2,0.6,0.4,0.8333333333333334,0.16666666666666666
SF-P26,SF-L26,6,11,0,5,6,6,0.0,1.0,0.45454545454545453,0.5454545454545454
SF-P26,SF-M28,88,92,58,49,30,43,0.6590909090909091,0.3409090909090909,0.532608695652174,0.4673913043478261
SF-P26,SF-M27,1,1,0,0,1,1,0.0,1.0,0.0,1.0
SF-P26,SF-L25,2,10,1,6,1,4,0.5,0.5,0.6,0.4
SF-P26,SF-M24,27,37,11,18,16,19,0.4074074074074074,0.5925925925925926,0.4864864864864865,0.5135135135135135
SF-P26,SF-L24,9,17,1,5,8,12,0.1111111111111111,0.8888888888888888,0.29411764705882354,0.7058823529411765
SF-P26,SF-N23,7,10,3,6,4,4,0.42857142857142855,0.5714285714285714,0.6,0.4
SF-P26,SF-N24-2,15,38,4,17,11,21,0.26666666666666666,0.7333333333333333,0.4473684210526316,0.5526315789473685
SF-P26,SF-K27-2,11,18,2,9,9,9,0.18181818181818182,0.8181818181818182,0.5,0.5
SF-P26,SF-J26-2,15,13,1,4,14,9,0.06666666666666667,0.9333333333333333,0.3076923076923077,0.6923076923076923
SF-P26,SF-K28-3,1,1,1,1,0,0,1.0,0.0,1.0,0.0
SF-P26,SF-L28,7,8,5,7,2,1,0.7142857142857143,0.2857142857142857,0.875,0.125
SF-P26,SF-K28,8,1,2,0,6,1,0.25,0.75,0.0,1.0
SF-P26,SF-K29-1,3,7,0,1,3,6,0.0,1.0,0.14285714285714285,0.8571428571428571
SF-P26,SF-J28-2,19,10,0,2,19,8,0.0,1.0,0.2,0.8
SF-P26,SF-K27,1,2,0,1,1,1,0.0,1.0,0.5,0.5
SF-P26,SF-K25,7,7,2,0,5,7,0.2857142857142857,0.7142857142857143,0.0,1.0
SF-P26,SF-J25,10,7,3,1,7,6,0.3,0.7,0.14285714285714285,0.8571428571428571
SF-P26,SF-P24,4,12,2,9,2,3,0.5,0.5,0.75,0.25
SF-P26,SF-N22-1A,2,2,1,0,1,2,0.5,0.5,0.0,1.0
SF-P26,SF-J24,19,37,2,10,17,27,0.10526315789473684,0.8947368421052632,0.2702702702702703,0.7297297297297297
SF-P26,SF-O24,4,3,1,2,3,1,0.25,0.75,0.6666666666666666,0.3333333333333333
SF-P26,SF-I25,8,10,4,6,4,4,0.5,0.5,0.6,0.4
SF-P26,SF-H26,7,2,3,0,4,2,0.42857142857142855,0.5714285714285714,0.0,1.0
SF-P26,SF-O23,26,23,13,10,13,13,0.5,0.5,0.43478260869565216,0.5652173913043478
SF-P26,SF-G27,8,8,2,3,6,5,0.25,0.75,0.375,0.625
SF-P26,SF-M22-2,8,6,5,1,3,5,0.625,0.375,0.16666666666666666,0.8333333333333334
SF-P26,SF-L22,5,13,1,3,4,10,0.2,0.8,0.23076923076923078,0.7692307692307693
SF-P26,SF-F27,24,32,10,11,14,21,0.4166666666666667,0.5833333333333334,0.34375,0.65625
SF-P26,SF-N22-2,22,27,4,7,18,20,0.18181818181818182,0.8181818181818182,0.25925925925925924,0.7407407407407407
SF-P26,SF-M22-1,5,4,1,1,4,3,0.2,0.8,0.25,0.75
SF-P26,SF-K22-2,2,5,1,1,1,4,0.5,0.5,0.2,0.8
SF-P26,SF-K24,3,11,2,2,1,9,0.6666666666666666,0.3333333333333333,0.18181818181818182,0.8181818181818182
SF-P26,SF-J23-2,6,1,1,0,5,1,0.16666666666666666,0.8333333333333334,0.0,1.0
SF-P26,SF-G23,3,5,1,0,2,5,0.3333333333333333,0.6666666666666666,0.0,1.0
SF-P26,SF-G24,39,12,0,0,39,12,0.0,1.0,0.0,1.0
SF-P26,SF-G25,12,7,4,3,8,4,0.3333333333333333,0.6666666666666666,0.42857142857142855,0.5714285714285714
SF-P26,SF-E23,4,1,0,0,4,1,0.0,1.0,0.0,1.0
SF-P26,SF-D24,2,2,0,0,2,2,0.0,1.0,0.0,1.0
SF-P26,SF-C22,3,2,0,0,3,2,0.0,1.0,0.0,1.0
SF-P26,SF-B22,50,25,1,2,49,23,0.02,0.98,0.08,0.92
SF-P26,SF-J17,10,12,0,0,10,12,0.0,1.0,0.0,1.0
SF-P26,SF-I19,1,1,0,0,1,1,0.0,1.0,0.0,1.0
SF-P26,SF-I20,22,19,0,0,22,19,0.0,1.0,0.0,1.0
SF-P26,SF-H20,4,4,2,0,2,4,0.5,0.5,0.0,1.0
SF-P26,SF-G19,1,1,0,1,1,0,0.0,1.0,1.0,0.0
SF-P26,SF-G17,8,2,0,0,8,2,0.0,1.0,0.0,1.0
SF-P26,SF-G18,4,4,0,0,4,4,0.0,1.0,0.0,1.0
SF-P26,SF-G20,4,3,0,1,4,2,0.0,1.0,0.3333333333333333,0.6666666666666666
SF-P26,SF-H30,5,3,0,0,5,3,0.0,1.0,0.0,1.0
SF-P26,SF-G30-2,10,13,0,7,10,6,0.0,1.0,0.5384615384615384,0.46153846153846156
SF-P26,SF-E29-2,2,1,1,0,1,1,0.5,0.5,0.0,1.0
SF-P26,SF-E29-1,3,18,1,8,2,10,0.3333333333333333,0.6666666666666666,0.4444444444444444,0.5555555555555556
SF-P26,SF-D29,6,3,3,1,3,2,0.5,0.5,0.3333333333333333,0.6666666666666666
SF-P26,SF-D28,2,3,0,2,2,1,0.0,1.0,0.6666666666666666,0.3333333333333333
SF-P26,SF-G29-2,2,2,0,0,2,2,0.0,1.0,0.0,1.0
SF-P26,SF-G29-1,1,4,0,1,1,3,0.0,1.0,0.25,0.75
SF-P26,SF-G30-1,4,1,0,0,4,1,0.0,1.0,0.0,1.0
SF-P26,SF-G29-3,1,15,0,6,1,9,0.0,1.0,0.4,0.6
SF-P26,SF-F30-2,1,1,1,1,0,0,1.0,0.0,1.0,0.0
SF-P26,SF-E28-2,1,1,0,1,1,0,0.0,1.0,1.0,0.0
SF-P26,SF-E28,2,1,1,1,1,0,0.5,0.5,1.0,0.0
SF-P26,SF-J10,1,2,1,0,0,2,1.0,0.0,0.0,1.0
SF-P26,SF-J12,4,2,2,0,2,2,0.5,0.5,0.0,1.0
SF-P26,SF-J13,6,5,0,0,6,5,0.0,1.0,0.0,1.0
SF-P26,SF-G13,17,30,2,5,15,25,0.11764705882352941,0.8823529411764706,0.16666666666666666,0.8333333333333334
SF-P26,SF-B19,1,1,1,1,0,0,1.0,0.0,1.0,0.0
SF-P26,SF-E27,5,2,3,2,2,0,0.6,0.4,1.0,0.0
SF-P26,SF-D27,143,114,92,110,51,4,0.6433566433566433,0.35664335664335667,0.9649122807017544,0.03508771929824561
SF-P26,SF-B28,1,6,0,3,1,3,0.0,1.0,0.5,0.5
SF-P26,SF-J1,11,11,3,0,8,11,0.2727272727272727,0.7272727272727273,0.0,1.0
SF-P26,SF-G5,1,6,0,0,1,6,0.0,1.0,0.0,1.0
SF-P26,SF-H25,10,6,9,6,1,0,0.9,0.1,1.0,0.0
SF-P26,SF-G26,6,5,4,0,2,5,0.6666666666666666,0.3333333333333333,0.0,1.0
SF-P26,SF-K21,3,1,3,0,0,1,1.0,0.0,0.0,1.0
SF-P26,SF-K22-1,4,4,0,0,4,4,0.0,1.0,0.0,1.0
SF-P26,SF-J23-1,22,19,4,6,18,13,0.18181818181818182,0.8181818181818182,0.3157894736842105,0.6842105263157895
SF-P26,SF-J22-1,4,4,0,1,4,3,0.0,1.0,0.25,0.75
SF-P26,SF-J21,3,2,2,2,1,0,0.6666666666666666,0.3333333333333333,1.0,0.0
SF-P26,SF-I21,1,1,0,0,1,1,0.0,1.0,0.0,1.0
SF-P26,SF-I22,30,28,6,16,24,12,0.2,0.8,0.5714285714285714,0.42857142857142855
SF-P26,SF-I23-2,4,3,1,1,3,2,0.25,0.75,0.3333333333333333,0.6666666666666666
SF-P26,SF-I24,4,13,1,7,3,6,0.25,0.75,0.5384615384615384,0.46153846153846156
SF-P26,SF-I23-1,8,7,1,1,7,6,0.125,0.875,0.14285714285714285,0.8571428571428571
SF-P26,SF-F26,2,7,0,0,2,7,0.0,1.0,0.0,1.0
SF-P26,SF-M13,23,14,11,1,12,13,0.4782608695652174,0.5217391304347826,0.07142857142857142,0.9285714285714286
SF-P26,SF-M15,23,11,12,1,11,10,0.5217391304347826,0.4782608695652174,0.09090909090909091,0.9090909090909091
SF-P26,SF-L19,7,4,0,0,7,4,0.0,1.0,0.0,1.0
SF-P26,SF-L20,16,8,1,3,15,5,0.0625,0.9375,0.375,0.625
SF-P26,SF-N20-1,7,10,1,0,6,10,0.14285714285714285,0.8571428571428571,0.0,1.0
SF-P26,SF-M20,22,14,1,1,21,13,0.045454545454545456,0.9545454545454546,0.07142857142857142,0.9285714285714286
SF-P26,SF-K17-2,8,3,1,0,7,3,0.125,0.875,0.0,1.0
SF-P26,SF-K20,84,41,2,3,82,38,0.023809523809523808,0.9761904761904762,0.07317073170731707,0.926829268292683
SF-P26,SF-K15-,12,12,3,0,9,12,0.25,0.75,0.0,1.0
SF-P26,SF-K19,45,32,2,2,43,30,0.044444444444444446,0.9555555555555556,0.0625,0.9375
SF-P26,SF-K18,49,44,1,0,48,44,0.02040816326530612,0.9795918367346939,0.0,1.0
SF-P26,SF-K17,9,4,0,0,9,4,0.0,1.0,0.0,1.0
SF-P26,SF-J18,8,4,1,2,7,2,0.125,0.875,0.5,0.5
SF-P26,SF-J20,51,55,0,1,51,54,0.0,1.0,0.01818181818181818,0.9818181818181818
SF-P26,SF-J19,10,31,3,0,7,31,0.3,0.7,0.0,1.0
SF-P26,SF-M12,31,21,17,3,14,18,0.5483870967741935,0.45161290322580644,0.14285714285714285,0.8571428571428571
SF-P26,SF-M11,5,3,0,0,5,3,0.0,1.0,0.0,1.0
SF-P26,SF-R19,19,5,2,0,17,5,0.10526315789473684,0.8947368421052632,0.0,1.0
SF-P26,SF-R20,8,3,1,0,7,3,0.125,0.875,0.0,1.0
SF-P26,SF-Q21-2,19,17,2,0,17,17,0.10526315789473684,0.8947368421052632,0.0,1.0
SF-P26,SF-Q21-1,62,70,30,11,32,59,0.4838709677419355,0.5161290322580645,0.15714285714285714,0.8428571428571429
SF-P26,SF-P21,29,29,14,4,15,25,0.4827586206896552,0.5172413793103449,0.13793103448275862,0.8620689655172413
SF-P26,SF-O18,44,20,0,1,44,19,0.0,1.0,0.05,0.95
SF-P26,SF-O19,12,15,1,2,11,13,0.08333333333333333,0.9166666666666666,0.13333333333333333,0.8666666666666667
SF-P26,SF-O21,15,48,7,16,8,32,0.4666666666666667,0.5333333333333333,0.3333333333333333,0.6666666666666666
SF-P26,SF-O22,22,12,6,4,16,8,0.2727272727272727,0.7272727272727273,0.3333333333333333,0.6666666666666666
SF-P26,SF-N21,35,21,14,11,21,10,0.4,0.6,0.5238095238095238,0.47619047619047616
SF-P26,SF-N20-2,3,3,0,1,3,2,0.0,1.0,0.3333333333333333,0.6666666666666666
SF-P26,SF-M21,75,131,7,4,68,127,0.09333333333333334,0.9066666666666666,0.030534351145038167,0.9694656488549618
SF-P26,SF-L21,12,6,0,1,12,5,0.0,1.0,0.16666666666666666,0.8333333333333334
SF-P26,SF-S30,1,1,0,1,1,0,0.0,1.0,1.0,0.0
SF-P26,SF-O30-2,2,4,0,1,2,3,0.0,1.0,0.25,0.75
SF-P26,SF-O30,98,91,12,12,86,79,0.12244897959183673,0.8775510204081632,0.13186813186813187,0.8681318681318682
SF-P26,SF-N27,13,40,3,23,10,17,0.23076923076923078,0.7692307692307693,0.575,0.425
SF-P26,SF-N29,10,7,0,1,10,6,0.0,1.0,0.14285714285714285,0.8571428571428571
SF-P26,SF-N28,5,16,1,4,4,12,0.2,0.8,0.25,0.75
SF-P26,SF-L30-1,32,28,9,12,23,16,0.28125,0.71875,0.42857142857142855,0.5714285714285714
SF-P26,SF-L31-1,2,3,0,0,2,3,0.0,1.0,0.0,1.0
SF-P26,SF-K30-2,3,2,0,1,3,1,0.0,1.0,0.5,0.5
SF-P26,SF-L29,29,36,5,4,24,32,0.1724137931034483,0.8275862068965517,0.1111111111111111,0.8888888888888888
SF-P26,SF-J29-1,1,21,1,1,0,20,1.0,0.0,0.047619047619047616,0.9523809523809523
SF-P26,SF-I30,2,8,0,7,2,1,0.0,1.0,0.875,0.125
SF-P26,SF-I28,2,1,0,0,2,1,0.0,1.0,0.0,1.0
SF-P26,SF-I30-2,1,4,0,0,1,4,0.0,1.0,0.0,1.0
SF-P26,SF-S24,30,59,19,40,11,19,0.6333333333333333,0.36666666666666664,0.6779661016949152,0.3220338983050847
SF-P26,SF-R24,15,20,10,4,5,16,0.6666666666666666,0.3333333333333333,0.2,0.8
SF-P26,SF-R26,8,2,5,1,3,1,0.625,0.375,0.5,0.5
SF-P26,SF-Q26,13,1,10,1,3,0,0.7692307692307693,0.23076923076923078,1.0,0.0
SF-P26,SF-O25-2,3,21,3,14,0,7,1.0,0.0,0.6666666666666666,0.3333333333333333
SF-P26,SF-N22-1B,5,5,2,4,3,1,0.4,0.6,0.8,0.2
SF-P26,SF-N26,19,17,10,10,9,7,0.5263157894736842,0.47368421052631576,0.5882352941176471,0.4117647058823529
SF-P26,SF-N25,6,19,3,8,3,11,0.5,0.5,0.42105263157894735,0.5789473684210527
SF-P26,SF-T21,12,3,5,2,7,1,0.4166666666666667,0.5833333333333334,0.6666666666666666,0.3333333333333333
SF-P26,SF-T22,10,6,2,4,8,2,0.2,0.8,0.6666666666666666,0.3333333333333333
SF-P26,SF-S22-2,2,3,1,1,1,2,0.5,0.5,0.3333333333333333,0.6666666666666666
SF-P26,SF-S22-1,7,38,2,1,5,37,0.2857142857142857,0.7142857142857143,0.02631578947368421,0.9736842105263158
SF-P26,SF-Q23-3,29,27,18,19,11,8,0.6206896551724138,0.3793103448275862,0.7037037037037037,0.2962962962962963
SF-P26,SF-Q22-1,8,10,5,5,3,5,0.625,0.375,0.5,0.5
SF-P26,SF-Q22-2,18,19,8,10,10,9,0.4444444444444444,0.5555555555555556,0.5263157894736842,0.47368421052631576
SF-P26,SF-P22,50,37,34,26,16,11,0.68,0.32,0.7027027027027027,0.2972972972972973
SF-P26,SF-W19,1,6,0,1,1,5,0.0,1.0,0.16666666666666666,0.8333333333333334
SF-P26,SF-W19-2,1,1,0,0,1,1,0.0,1.0,0.0,1.0
SF-P26,SF-T20,25,21,1,4,24,17,0.04,0.96,0.19047619047619047,0.8095238095238095
SF-P26,SF-S21,10,5,1,0,9,5,0.1,0.9,0.0,1.0
SF-P26,SF-W29,2,2,1,0,1,2,0.5,0.5,0.0,1.0
SF-P26,SF-V29,2,4,1,0,1,4,0.5,0.5,0.0,1.0
SF-P26,SF-BB17,2,2,0,1,2,1,0.0,1.0,0.5,0.5
SF-P26,SF-Y14,2,2,0,0,2,2,0.0,1.0,0.0,1.0
SF-O25-2,SF-M25,19,48,9,42,10,6,0.47368421052631576,0.5263157894736842,0.875,0.125
SF-O25-2,SF-M26-2,8,4,3,0,5,4,0.375,0.625,0.0,1.0
SF-O25-2,SF-K26,18,14,8,5,10,9,0.4444444444444444,0.5555555555555556,0.35714285714285715,0.6428571428571429
SF-O25-2,SF-J27,3,1,2,1,1,0,0.6666666666666666,0.3333333333333333,1.0,0.0
SF-O25-2,SF-M30,138,63,83,42,55,21,0.6014492753623188,0.39855072463768115,0.6666666666666666,0.3333333333333333
SF-O25-2,SF-J29,7,2,4,1,3,1,0.5714285714285714,0.42857142857142855,0.5,0.5
SF-O25-2,SF-L26,10,4,6,2,4,2,0.6,0.4,0.5,0.5
SF-O25-2,SF-M28,9,5,5,0,4,5,0.5555555555555556,0.4444444444444444,0.0,1.0
SF-O25-2,SF-L25,29,13,9,8,20,5,0.3103448275862069,0.6896551724137931,0.6153846153846154,0.38461538461538464
SF-O25-2,SF-M24,16,18,7,9,9,9,0.4375,0.5625,0.5,0.5
SF-O25-2,SF-L24,15,11,8,7,7,4,0.5333333333333333,0.4666666666666667,0.6363636363636364,0.36363636363636365
SF-O25-2,SF-N23,10,10,4,8,6,2,0.4,0.6,0.8,0.2
SF-O25-2,SF-N24-2,29,16,11,12,18,4,0.3793103448275862,0.6206896551724138,0.75,0.25
SF-O25-2,SF-K27-2,7,11,3,4,4,7,0.42857142857142855,0.5714285714285714,0.36363636363636365,0.6363636363636364
SF-O25-2,SF-J26-2,29,65,0,0,29,65,0.0,1.0,0.0,1.0
SF-O25-2,SF-K28-3,3,1,1,0,2,1,0.3333333333333333,0.6666666666666666,0.0,1.0
SF-O25-2,SF-L28,2,1,1,0,1,1,0.5,0.5,0.0,1.0
SF-O25-2,SF-K28,3,1,0,1,3,0,0.0,1.0,1.0,0.0
SF-O25-2,SF-K29-1,9,1,3,0,6,1,0.3333333333333333,0.6666666666666666,0.0,1.0
SF-O25-2,SF-J28-2,3,2,1,0,2,2,0.3333333333333333,0.6666666666666666,0.0,1.0
SF-O25-2,SF-K27,3,1,0,1,3,0,0.0,1.0,1.0,0.0
SF-O25-2,SF-K25,10,7,2,3,8,4,0.2,0.8,0.42857142857142855,0.5714285714285714
SF-O25-2,SF-J25,6,7,4,1,2,6,0.6666666666666666,0.3333333333333333,0.14285714285714285,0.8571428571428571
SF-O25-2,SF-H26-2,2,1,1,0,1,1,0.5,0.5,0.0,1.0
SF-O25-2,SF-P24,14,25,4,20,10,5,0.2857142857142857,0.7142857142857143,0.8,0.2
SF-O25-2,SF-N22-1A,2,7,1,5,1,2,0.5,0.5,0.7142857142857143,0.2857142857142857
SF-O25-2,SF-J24,18,4,2,1,16,3,0.1111111111111111,0.8888888888888888,0.25,0.75
SF-O25-2,SF-O24,8,3,7,2,1,1,0.875,0.125,0.6666666666666666,0.3333333333333333
SF-O25-2,SF-I25,8,3,4,2,4,1,0.5,0.5,0.6666666666666666,0.3333333333333333
SF-O25-2,SF-K23,3,3,1,0,2,3,0.3333333333333333,0.6666666666666666,0.0,1.0
SF-O25-2,SF-H26,8,7,2,1,6,6,0.25,0.75,0.14285714285714285,0.8571428571428571
SF-O25-2,SF-O23,14,14,9,9,5,5,0.6428571428571429,0.35714285714285715,0.6428571428571429,0.35714285714285715
SF-O25-2,SF-F28-2,4,2,3,2,1,0,0.75,0.25,1.0,0.0
SF-O25-2,SF-G27,5,7,1,0,4,7,0.2,0.8,0.0,1.0
SF-O25-2,SF-M22-2,24,12,13,6,11,6,0.5416666666666666,0.4583333333333333,0.5,0.5
SF-O25-2,SF-L22,14,7,5,2,9,5,0.35714285714285715,0.6428571428571429,0.2857142857142857,0.7142857142857143
SF-O25-2,SF-F27,10,8,3,2,7,6,0.3,0.7,0.25,0.75
SF-O25-2,SF-N22-2,40,30,14,14,26,16,0.35,0.65,0.4666666666666667,0.5333333333333333
SF-O25-2,SF-M22-1,11,5,8,3,3,2,0.7272727272727273,0.2727272727272727,0.6,0.4
SF-O25-2,SF-O25-1,14,22,7,12,7,10,0.5,0.5,0.5454545454545454,0.45454545454545453
SF-O25-2,SF-K22-2,17,12,10,6,7,6,0.5882352941176471,0.4117647058823529,0.5,0.5
SF-O25-2,SF-K24,14,7,8,3,6,4,0.5714285714285714,0.42857142857142855,0.42857142857142855,0.5714285714285714
SF-O25-2,SF-J23-2,14,13,4,0,10,13,0.2857142857142857,0.7142857142857143,0.0,1.0
SF-O25-2,SF-G23,5,1,0,0,5,1,0.0,1.0,0.0,1.0
SF-O25-2,SF-G24,17,3,1,0,16,3,0.058823529411764705,0.9411764705882353,0.0,1.0
SF-O25-2,SF-G25,3,3,0,0,3,3,0.0,1.0,0.0,1.0
SF-O25-2,SF-F23,11,2,0,0,11,2,0.0,1.0,0.0,1.0
SF-O25-2,SF-E23,6,3,1,1,5,2,0.16666666666666666,0.8333333333333334,0.3333333333333333,0.6666666666666666
SF-O25-2,SF-C22,1,1,0,1,1,0,0.0,1.0,1.0,0.0
SF-O25-2,SF-I19,1,1,0,0,1,1,0.0,1.0,0.0,1.0
SF-O25-2,SF-H20,2,2,2,0,0,2,1.0,0.0,0.0,1.0
SF-O25-2,SF-G18,2,2,0,0,2,2,0.0,1.0,0.0,1.0
SF-O25-2,SF-G20,5,1,4,0,1,1,0.8,0.2,0.0,1.0
SF-O25-2,SF-F19,1,5,1,0,0,5,1.0,0.0,0.0,1.0
SF-O25-2,SF-E18,1,3,1,1,0,2,1.0,0.0,0.3333333333333333,0.6666666666666666
SF-O25-2,SF-E20,3,3,0,0,3,3,0.0,1.0,0.0,1.0
SF-O25-2,SF-H30,10,9,5,5,5,4,0.5,0.5,0.5555555555555556,0.4444444444444444
SF-O25-2,SF-G30-2,5,1,3,1,2,0,0.6,0.4,1.0,0.0
SF-O25-2,SF-E29-2,4,5,2,3,2,2,0.5,0.5,0.6,0.4
SF-O25-2,SF-E29-1,6,4,0,0,6,4,0.0,1.0,0.0,1.0
SF-O25-2,SF-D29,1,2,0,0,1,2,0.0,1.0,0.0,1.0
SF-O25-2,SF-F28-1,1,3,0,0,1,3,0.0,1.0,0.0,1.0
SF-O25-2,SF-E28-2,2,1,0,0,2,1,0.0,1.0,0.0,1.0
SF-O25-2,SF-E28,1,2,0,0,1,2,0.0,1.0,0.0,1.0
SF-O25-2,SF-J12,1,1,0,0,1,1,0.0,1.0,0.0,1.0
SF-O25-2,SF-I16,1,2,0,0,1,2,0.0,1.0,0.0,1.0
SF-O25-2,SF-G13,1,1,0,0,1,1,0.0,1.0,0.0,1.0
SF-O25-2,SF-A20,1,6,0,0,1,6,0.0,1.0,0.0,1.0
SF-O25-2,SF-C25,1,4,0,0,1,4,0.0,1.0,0.0,1.0
SF-O25-2,SF-B25,1,3,0,1,1,2,0.0,1.0,0.3333333333333333,0.6666666666666666
SF-O25-2,SF-E27,1,1,0,0,1,1,0.0,1.0,0.0,1.0
SF-O25-2,SF-C28-2,3,1,0,0,3,1,0.0,1.0,0.0,1.0
SF-O25-2,SF-C28-1,1,3,0,0,1,3,0.0,1.0,0.0,1.0
SF-O25-2,SF-B28,4,3,1,1,3,2,0.25,0.75,0.3333333333333333,0.6666666666666666
SF-O25-2,SF-J1,2,1,1,0,1,1,0.5,0.5,0.0,1.0
SF-O25-2,SF-G26,4,6,1,3,3,3,0.25,0.75,0.5,0.5
SF-O25-2,SF-K21,5,3,1,0,4,3,0.2,0.8,0.0,1.0
SF-O25-2,SF-K22-1,11,6,2,0,9,6,0.18181818181818182,0.8181818181818182,0.0,1.0
SF-O25-2,SF-J23-1,7,7,1,2,6,5,0.14285714285714285,0.8571428571428571,0.2857142857142857,0.7142857142857143
SF-O25-2,SF-J22-1,18,11,0,4,18,7,0.0,1.0,0.36363636363636365,0.6363636363636364
SF-O25-2,SF-J22-2,2,2,0,1,2,1,0.0,1.0,0.5,0.5
SF-O25-2,SF-J21,10,9,2,7,8,2,0.2,0.8,0.7777777777777778,0.2222222222222222
SF-O25-2,SF-I21,1,3,1,3,0,0,1.0,0.0,1.0,0.0
SF-O25-2,SF-I22,6,8,0,0,6,8,0.0,1.0,0.0,1.0
SF-O25-2,SF-I23-2,8,4,5,3,3,1,0.625,0.375,0.75,0.25
SF-O25-2,SF-I23-1,3,1,1,0,2,1,0.3333333333333333,0.6666666666666666,0.0,1.0
SF-O25-2,SF-F26,8,3,1,2,7,1,0.125,0.875,0.6666666666666666,0.3333333333333333
SF-O25-2,SF-M15,3,12,2,0,1,12,0.6666666666666666,0.3333333333333333,0.0,1.0
SF-O25-2,SF-L19,62,40,54,5,8,35,0.8709677419354839,0.12903225806451613,0.125,0.875
SF-O25-2,SF-L20,4,10,0,1,4,9,0.0,1.0,0.1,0.9
SF-O25-2,SF-N20-1,4,3,0,0,4,3,0.0,1.0,0.0,1.0
SF-O25-2,SF-M20,17,7,8,1,9,6,0.47058823529411764,0.5294117647058824,0.14285714285714285,0.8571428571428571
SF-O25-2,SF-K17-2,2,2,0,0,2,2,0.0,1.0,0.0,1.0
SF-O25-2,SF-K20,5,1,1,0,4,1,0.2,0.8,0.0,1.0
SF-O25-2,SF-K15-,15,7,12,4,3,3,0.8,0.2,0.5714285714285714,0.42857142857142855
SF-O25-2,SF-K19,9,14,3,2,6,12,0.3333333333333333,0.6666666666666666,0.14285714285714285,0.8571428571428571
SF-O25-2,SF-K18,3,12,0,1,3,11,0.0,1.0,0.08333333333333333,0.9166666666666666
SF-O25-2,SF-K17,5,11,2,8,3,3,0.4,0.6,0.7272727272727273,0.2727272727272727
SF-O25-2,SF-J16,4,1,1,0,3,1,0.25,0.75,0.0,1.0
SF-O25-2,SF-J18,8,13,5,1,3,12,0.625,0.375,0.07692307692307693,0.9230769230769231
SF-O25-2,SF-J20,1,2,0,0,1,2,0.0,1.0,0.0,1.0
SF-O25-2,SF-J19,10,7,5,1,5,6,0.5,0.5,0.14285714285714285,0.8571428571428571
SF-O25-2,SF-M12,2,3,0,0,2,3,0.0,1.0,0.0,1.0
SF-O25-2,SF-M11,1,1,0,1,1,0,0.0,1.0,1.0,0.0
SF-O25-2,SF-R19,11,3,5,2,6,1,0.45454545454545453,0.5454545454545454,0.6666666666666666,0.3333333333333333
SF-O25-2,SF-R20,5,1,2,0,3,1,0.4,0.6,0.0,1.0
SF-O25-2,SF-Q21-2,7,4,3,2,4,2,0.42857142857142855,0.5714285714285714,0.5,0.5
SF-O25-2,SF-Q21-1,3,3,2,1,1,2,0.6666666666666666,0.3333333333333333,0.3333333333333333,0.6666666666666666
SF-O25-2,SF-P21,18,19,6,9,12,10,0.3333333333333333,0.6666666666666666,0.47368421052631576,0.5263157894736842
SF-O25-2,SF-O18,5,5,1,2,4,3,0.2,0.8,0.4,0.6
SF-O25-2,SF-O19,9,8,4,3,5,5,0.4444444444444444,0.5555555555555556,0.375,0.625
SF-O25-2,SF-O21,20,29,10,20,10,9,0.5,0.5,0.6896551724137931,0.3103448275862069
SF-O25-2,SF-O22,38,49,22,27,16,22,0.5789473684210527,0.42105263157894735,0.5510204081632653,0.4489795918367347
SF-O25-2,SF-N21,10,8,8,2,2,6,0.8,0.2,0.25,0.75
SF-O25-2,SF-N20-2,5,5,3,2,2,3,0.6,0.4,0.4,0.6
SF-O25-2,SF-M21,11,22,6,8,5,14,0.5454545454545454,0.45454545454545453,0.36363636363636365,0.6363636363636364
SF-O25-2,SF-L21,6,3,3,1,3,2,0.5,0.5,0.3333333333333333,0.6666666666666666
SF-O25-2,SF-Q30,11,3,0,1,11,2,0.0,1.0,0.3333333333333333,0.6666666666666666
SF-O25-2,SF-P30,5,7,0,2,5,5,0.0,1.0,0.2857142857142857,0.7142857142857143
SF-O25-2,SF-O30-2,3,2,1,0,2,2,0.3333333333333333,0.6666666666666666,0.0,1.0
SF-O25-2,SF-O30,16,9,3,3,13,6,0.1875,0.8125,0.3333333333333333,0.6666666666666666
SF-O25-2,SF-N27,11,10,2,5,9,5,0.18181818181818182,0.8181818181818182,0.5,0.5
SF-O25-2,SF-N29,9,11,1,5,8,6,0.1111111111111111,0.8888888888888888,0.45454545454545453,0.5454545454545454
SF-O25-2,SF-N28,6,7,3,3,3,4,0.5,0.5,0.42857142857142855,0.5714285714285714
SF-O25-2,SF-L30-1,11,13,3,7,8,6,0.2727272727272727,0.7272727272727273,0.5384615384615384,0.46153846153846156
SF-O25-2,SF-L31-1,2,2,1,2,1,0,0.5,0.5,1.0,0.0
SF-O25-2,SF-L29,9,3,2,0,7,3,0.2222222222222222,0.7777777777777778,0.0,1.0
SF-O25-2,SF-J29-1,11,7,1,3,10,4,0.09090909090909091,0.9090909090909091,0.42857142857142855,0.5714285714285714
SF-O25-2,SF-I29-2,1,2,0,0,1,2,0.0,1.0,0.0,1.0
SF-O25-2,SF-I27,2,1,0,0,2,1,0.0,1.0,0.0,1.0
SF-O25-2,SF-I28,1,2,1,1,0,1,1.0,0.0,0.5,0.5
SF-O25-2,SF-S24,28,23,8,11,20,12,0.2857142857142857,0.7142857142857143,0.4782608695652174,0.5217391304347826
SF-O25-2,SF-R24,22,13,9,5,13,8,0.4090909090909091,0.5909090909090909,0.38461538461538464,0.6153846153846154
SF-O25-2,SF-R26,3,4,1,4,2,0,0.3333333333333333,0.6666666666666666,1.0,0.0
SF-O25-2,SF-Q26,8,5,5,1,3,4,0.625,0.375,0.2,0.8
SF-O25-2,SF-P26,21,3,14,3,7,0,0.6666666666666666,0.3333333333333333,1.0,0.0
SF-O25-2,SF-N22-1B,8,8,4,3,4,5,0.5,0.5,0.375,0.625
SF-O25-2,SF-N26,13,3,8,2,5,1,0.6153846153846154,0.38461538461538464,0.6666666666666666,0.3333333333333333
SF-O25-2,SF-N25,30,39,25,27,5,12,0.8333333333333334,0.16666666666666666,0.6923076923076923,0.3076923076923077
SF-O25-2,SF-T22,2,3,0,0,2,3,0.0,1.0,0.0,1.0
SF-O25-2,SF-S22-2,3,2,3,1,0,1,1.0,0.0,0.5,0.5
SF-O25-2,SF-S22-1,12,9,8,3,4,6,0.6666666666666666,0.3333333333333333,0.3333333333333333,0.6666666666666666
SF-O25-2,SF-Q23-3,17,19,13,10,4,9,0.7647058823529411,0.23529411764705882,0.5263157894736842,0.47368421052631576
SF-O25-2,SF-Q22-1,14,21,6,9,8,12,0.42857142857142855,0.5714285714285714,0.42857142857142855,0.5714285714285714
SF-O25-2,SF-Q22-2,14,6,9,4,5,2,0.6428571428571429,0.35714285714285715,0.6666666666666666,0.3333333333333333
SF-O25-2,SF-P22,20,14,12,7,8,7,0.6,0.4,0.5,0.5
SF-O25-2,SF-U21,2,1,0,0,2,1,0.0,1.0,0.0,1.0
SF-O25-2,SF-S21,1,2,0,0,1,2,0.0,1.0,0.0,1.0
SF-O25-2,SF-V29,1,5,0,2,1,3,0.0,1.0,0.4,0.6
SF-O25-2,SF-V31,1,2,0,1,1,1,0.0,1.0,0.5,0.5
SF-O25-2,SF-U30,2,2,0,0,2,2,0.0,1.0,0.0,1.0
SF-O25-2,SF-Y25,1,1,1,1,0,0,1.0,0.0,1.0,0.0
SF-N22-1B,SF-M26,2,2,2,1,0,1,1.0,0.0,0.5,0.5
SF-N22-1B,SF-M25,83,54,51,28,32,26,0.6144578313253012,0.3855421686746988,0.5185185185185185,0.48148148148148145
SF-N22-1B,SF-M26-2,7,6,3,3,4,3,0.42857142857142855,0.5714285714285714,0.5,0.5
SF-N22-1B,SF-L27,1,2,0,1,1,1,0.0,1.0,0.5,0.5
SF-N22-1B,SF-K26,4,3,3,2,1,1,0.75,0.25,0.6666666666666666,0.3333333333333333
SF-N22-1B,SF-J27,4,2,0,1,4,1,0.0,1.0,0.5,0.5
SF-N22-1B,SF-M30,15,5,9,3,6,2,0.6,0.4,0.6,0.4
SF-N22-1B,SF-J29,25,26,5,3,20,23,0.2,0.8,0.11538461538461539,0.8846153846153846
SF-N22-1B,SF-L26,13,18,4,7,9,11,0.3076923076923077,0.6923076923076923,0.3888888888888889,0.6111111111111112
SF-N22-1B,SF-M28,25,12,4,3,21,9,0.16,0.84,0.25,0.75
SF-N22-1B,SF-L25,6,6,3,5,3,1,0.5,0.5,0.8333333333333334,0.16666666666666666
SF-N22-1B,SF-M24,16,48,10,31,6,17,0.625,0.375,0.6458333333333334,0.3541666666666667
SF-N22-1B,SF-L24,60,59,48,52,12,7,0.8,0.2,0.8813559322033898,0.11864406779661017
SF-N22-1B,SF-N23,28,14,26,13,2,1,0.9285714285714286,0.07142857142857142,0.9285714285714286,0.07142857142857142
SF-N22-1B,SF-N24-2,16,19,5,9,11,10,0.3125,0.6875,0.47368421052631576,0.5263157894736842
SF-N22-1B,SF-K27-2,4,1,2,0,2,1,0.5,0.5,0.0,1.0
SF-N22-1B,SF-J26-2,6,3,3,2,3,1,0.5,0.5,0.6666666666666666,0.3333333333333333
SF-N22-1B,SF-K28-3,2,1,0,0,2,1,0.0,1.0,0.0,1.0
SF-N22-1B,SF-L28,3,5,3,1,0,4,1.0,0.0,0.2,0.8
SF-N22-1B,SF-K28,1,4,1,0,0,4,1.0,0.0,0.0,1.0
SF-N22-1B,SF-K29-1,6,4,0,0,6,4,0.0,1.0,0.0,1.0
SF-N22-1B,SF-K25,7,9,6,5,1,4,0.8571428571428571,0.14285714285714285,0.5555555555555556,0.4444444444444444
SF-N22-1B,SF-J25,10,5,2,1,8,4,0.2,0.8,0.2,0.8
SF-N22-1B,SF-H26-2,1,5,0,5,1,0,0.0,1.0,1.0,0.0
SF-N22-1B,SF-P24,8,10,5,6,3,4,0.625,0.375,0.6,0.4
SF-N22-1B,SF-J24,6,3,2,0,4,3,0.3333333333333333,0.6666666666666666,0.0,1.0
SF-N22-1B,SF-O24,19,24,16,19,3,5,0.8421052631578947,0.15789473684210525,0.7916666666666666,0.20833333333333334
SF-N22-1B,SF-J26,3,3,2,2,1,1,0.6666666666666666,0.3333333333333333,0.6666666666666666,0.3333333333333333
SF-N22-1B,SF-I26-,6,1,5,0,1,1,0.8333333333333334,0.16666666666666666,0.0,1.0
SF-N22-1B,SF-I25,9,7,4,3,5,4,0.4444444444444444,0.5555555555555556,0.42857142857142855,0.5714285714285714
SF-N22-1B,SF-K23,4,5,2,5,2,0,0.5,0.5,1.0,0.0
SF-N22-1B,SF-H26,11,7,8,2,3,5,0.7272727272727273,0.2727272727272727,0.2857142857142857,0.7142857142857143
SF-N22-1B,SF-O23,16,14,13,8,3,6,0.8125,0.1875,0.5714285714285714,0.42857142857142855
SF-N22-1B,SF-H27-1,1,2,0,2,1,0,0.0,1.0,1.0,0.0
SF-N22-1B,SF-F28-2,1,2,0,0,1,2,0.0,1.0,0.0,1.0
SF-N22-1B,SF-G27,8,9,4,5,4,4,0.5,0.5,0.5555555555555556,0.4444444444444444
SF-N22-1B,SF-M22-2,12,17,6,11,6,6,0.5,0.5,0.6470588235294118,0.35294117647058826
SF-N22-1B,SF-L22,37,25,20,12,17,13,0.5405405405405406,0.4594594594594595,0.48,0.52
SF-N22-1B,SF-F27,5,5,4,2,1,3,0.8,0.2,0.4,0.6
SF-N22-1B,SF-N22-2,7,11,3,7,4,4,0.42857142857142855,0.5714285714285714,0.6363636363636364,0.36363636363636365
SF-N22-1B,SF-G28-2,6,6,2,3,4,3,0.3333333333333333,0.6666666666666666,0.5,0.5
SF-N22-1B,SF-M22-1,5,7,5,7,0,0,1.0,0.0,1.0,0.0
SF-N22-1B,SF-O25-1,6,6,6,4,0,2,1.0,0.0,0.6666666666666666,0.3333333333333333
SF-N22-1B,SF-K22-2,12,14,5,9,7,5,0.4166666666666667,0.5833333333333334,0.6428571428571429,0.35714285714285715
SF-N22-1B,SF-K24,9,2,5,1,4,1,0.5555555555555556,0.4444444444444444,0.5,0.5
SF-N22-1B,SF-J23-2,13,5,10,4,3,1,0.7692307692307693,0.23076923076923078,0.8,0.2
SF-N22-1B,SF-G23,1,4,1,2,0,2,1.0,0.0,0.5,0.5
SF-N22-1B,SF-G24,13,10,3,0,10,10,0.23076923076923078,0.7692307692307693,0.0,1.0
SF-N22-1B,SF-G25,8,3,5,1,3,2,0.625,0.375,0.3333333333333333,0.6666666666666666
SF-N22-1B,SF-E23,10,3,4,1,6,2,0.4,0.6,0.3333333333333333,0.6666666666666666
SF-N22-1B,SF-B22,1,8,0,2,1,6,0.0,1.0,0.25,0.75
SF-N22-1B,SF-J17,3,10,0,1,3,9,0.0,1.0,0.1,0.9
SF-N22-1B,SF-H16,1,2,1,0,0,2,1.0,0.0,0.0,1.0
SF-N22-1B,SF-H18,1,1,0,0,1,1,0.0,1.0,0.0,1.0
SF-N22-1B,SF-G20,2,1,2,0,0,1,1.0,0.0,0.0,1.0
SF-N22-1B,SF-H30,5,1,5,0,0,1,1.0,0.0,0.0,1.0
SF-N22-1B,SF-G30-2,2,1,2,1,0,0,1.0,0.0,1.0,0.0
SF-N22-1B,SF-E29-2,2,5,0,0,2,5,0.0,1.0,0.0,1.0
SF-N22-1B,SF-E29-1,3,2,1,0,2,2,0.3333333333333333,0.6666666666666666,0.0,1.0
SF-N22-1B,SF-D29,1,4,1,4,0,0,1.0,0.0,1.0,0.0
SF-N22-1B,SF-G29-2,2,4,0,2,2,2,0.0,1.0,0.5,0.5
SF-N22-1B,SF-G29-1,6,5,1,1,5,4,0.16666666666666666,0.8333333333333334,0.2,0.8
SF-N22-1B,SF-G30-1,1,1,0,0,1,1,0.0,1.0,0.0,1.0
SF-N22-1B,SF-F29,1,1,0,0,1,1,0.0,1.0,0.0,1.0
SF-N22-1B,SF-E29-3,2,2,2,2,0,0,1.0,0.0,1.0,0.0
SF-N22-1B,SF-F28-1,1,1,1,1,0,0,1.0,0.0,1.0,0.0
SF-N22-1B,SF-G10-2,2,2,0,0,2,2,0.0,1.0,0.0,1.0
SF-N22-1B,SF-G12,1,1,0,0,1,1,0.0,1.0,0.0,1.0
SF-N22-1B,SF-G10-1,1,1,0,1,1,0,0.0,1.0,1.0,0.0
SF-N22-1B,SF-C26,1,1,0,0,1,1,0.0,1.0,0.0,1.0
SF-N22-1B,SF-C25,3,4,0,1,3,3,0.0,1.0,0.25,0.75
SF-N22-1B,SF-G7,3,2,1,0,2,2,0.3333333333333333,0.6666666666666666,0.0,1.0
SF-N22-1B,SF-H25,4,5,3,3,1,2,0.75,0.25,0.6,0.4
SF-N22-1B,SF-G26,1,2,0,2,1,0,0.0,1.0,1.0,0.0
SF-N22-1B,SF-K21,8,3,5,1,3,2,0.625,0.375,0.3333333333333333,0.6666666666666666
SF-N22-1B,SF-K22-1,4,2,4,2,0,0,1.0,0.0,1.0,0.0
SF-N22-1B,SF-J23-1,17,14,13,7,4,7,0.7647058823529411,0.23529411764705882,0.5,0.5
SF-N22-1B,SF-J22-1,4,3,3,1,1,2,0.75,0.25,0.3333333333333333,0.6666666666666666
SF-N22-1B,SF-J22-2,5,3,4,3,1,0,0.8,0.2,1.0,0.0
SF-N22-1B,SF-J21,3,4,2,2,1,2,0.6666666666666666,0.3333333333333333,0.5,0.5
SF-N22-1B,SF-I21,1,4,0,1,1,3,0.0,1.0,0.25,0.75
SF-N22-1B,SF-I22,5,1,3,0,2,1,0.6,0.4,0.0,1.0
SF-N22-1B,SF-I24,4,2,1,2,3,0,0.25,0.75,1.0,0.0
SF-N22-1B,SF-I23-1,3,15,1,2,2,13,0.3333333333333333,0.6666666666666666,0.13333333333333333,0.8666666666666667
SF-N22-1B,SF-F26,2,3,0,0,2,3,0.0,1.0,0.0,1.0
SF-N22-1B,SF-M13,6,4,5,0,1,4,0.8333333333333334,0.16666666666666666,0.0,1.0
SF-N22-1B,SF-M15,21,11,12,1,9,10,0.5714285714285714,0.42857142857142855,0.09090909090909091,0.9090909090909091
SF-N22-1B,SF-L19,71,14,61,2,10,12,0.8591549295774648,0.14084507042253522,0.14285714285714285,0.8571428571428571
SF-N22-1B,SF-L20,29,10,14,3,15,7,0.4827586206896552,0.5172413793103449,0.3,0.7
SF-N22-1B,SF-N20-1,52,33,41,19,11,14,0.7884615384615384,0.21153846153846154,0.5757575757575758,0.42424242424242425
SF-N22-1B,SF-M20,36,14,17,5,19,9,0.4722222222222222,0.5277777777777778,0.35714285714285715,0.6428571428571429
SF-N22-1B,SF-K17-2,4,1,2,0,2,1,0.5,0.5,0.0,1.0
SF-N22-1B,SF-K20,18,15,6,3,12,12,0.3333333333333333,0.6666666666666666,0.2,0.8
SF-N22-1B,SF-K15-,7,4,0,1,7,3,0.0,1.0,0.25,0.75
SF-N22-1B,SF-K19,31,11,21,4,10,7,0.6774193548387096,0.3225806451612903,0.36363636363636365,0.6363636363636364
SF-N22-1B,SF-K18,9,6,2,2,7,4,0.2222222222222222,0.7777777777777778,0.3333333333333333,0.6666666666666666
SF-N22-1B,SF-K17,14,3,12,0,2,3,0.8571428571428571,0.14285714285714285,0.0,1.0
SF-N22-1B,SF-J16,3,3,1,0,2,3,0.3333333333333333,0.6666666666666666,0.0,1.0
SF-N22-1B,SF-J18,14,5,9,1,5,4,0.6428571428571429,0.35714285714285715,0.2,0.8
SF-N22-1B,SF-J20,3,3,1,0,2,3,0.3333333333333333,0.6666666666666666,0.0,1.0
SF-N22-1B,SF-J19,1,1,1,0,0,1,1.0,0.0,0.0,1.0
SF-N22-1B,SF-M12,2,2,0,0,2,2,0.0,1.0,0.0,1.0
SF-N22-1B,SF-R19,2,2,1,0,1,2,0.5,0.5,0.0,1.0
SF-N22-1B,SF-R20,4,6,3,2,1,4,0.75,0.25,0.3333333333333333,0.6666666666666666
SF-N22-1B,SF-Q21-2,6,2,3,0,3,2,0.5,0.5,0.0,1.0
SF-N22-1B,SF-P21,28,16,12,7,16,9,0.42857142857142855,0.5714285714285714,0.4375,0.5625
SF-N22-1B,SF-O18,12,2,7,0,5,2,0.5833333333333334,0.4166666666666667,0.0,1.0
SF-N22-1B,SF-O19,39,24,11,8,28,16,0.28205128205128205,0.717948717948718,0.3333333333333333,0.6666666666666666
SF-N22-1B,SF-O21,41,29,11,16,30,13,0.2682926829268293,0.7317073170731707,0.5517241379310345,0.4482758620689655
SF-N22-1B,SF-O22,24,20,15,13,9,7,0.625,0.375,0.65,0.35
SF-N22-1B,SF-N21,8,17,5,12,3,5,0.625,0.375,0.7058823529411765,0.29411764705882354
SF-N22-1B,SF-N20-2,62,29,32,9,30,20,0.5161290322580645,0.4838709677419355,0.3103448275862069,0.6896551724137931
SF-N22-1B,SF-M21,23,14,12,6,11,8,0.5217391304347826,0.4782608695652174,0.42857142857142855,0.5714285714285714
SF-N22-1B,SF-L21,147,34,123,3,24,31,0.8367346938775511,0.16326530612244897,0.08823529411764706,0.9117647058823529
SF-N22-1B,SF-Q30,1,2,1,0,0,2,1.0,0.0,0.0,1.0
SF-N22-1B,SF-P30,6,2,0,0,6,2,0.0,1.0,0.0,1.0
SF-N22-1B,SF-O30-2,1,5,1,3,0,2,1.0,0.0,0.6,0.4
SF-N22-1B,SF-O30,16,23,6,7,10,16,0.375,0.625,0.30434782608695654,0.6956521739130435
SF-N22-1B,SF-N27,13,13,5,6,8,7,0.38461538461538464,0.6153846153846154,0.46153846153846156,0.5384615384615384
SF-N22-1B,SF-N29,5,4,3,0,2,4,0.6,0.4,0.0,1.0
SF-N22-1B,SF-N28,11,7,6,5,5,2,0.5454545454545454,0.45454545454545453,0.7142857142857143,0.2857142857142857
SF-N22-1B,SF-L30-1,16,14,11,9,5,5,0.6875,0.3125,0.6428571428571429,0.35714285714285715
SF-N22-1B,SF-K30-2,34,20,34,19,0,1,1.0,0.0,0.95,0.05
SF-N22-1B,SF-L29,5,3,1,2,4,1,0.2,0.8,0.6666666666666666,0.3333333333333333
SF-N22-1B,SF-I27,1,2,0,2,1,0,0.0,1.0,1.0,0.0
SF-N22-1B,SF-I28,2,2,1,0,1,2,0.5,0.5,0.0,1.0
SF-N22-1B,SF-I30-2,2,4,0,1,2,3,0.0,1.0,0.25,0.75
SF-N22-1B,SF I29-1,1,2,0,1,1,1,0.0,1.0,0.5,0.5
SF-N22-1B,SF-H28,1,4,0,2,1,2,0.0,1.0,0.5,0.5
SF-N22-1B,SF-S24,7,4,2,3,5,1,0.2857142857142857,0.7142857142857143,0.75,0.25
SF-N22-1B,SF-R24,5,3,3,2,2,1,0.6,0.4,0.6666666666666666,0.3333333333333333
SF-N22-1B,SF-Q26,3,1,1,0,2,1,0.3333333333333333,0.6666666666666666,0.0,1.0
SF-N22-1B,SF-P26,5,5,4,2,1,3,0.8,0.2,0.4,0.6
SF-N22-1B,SF-O25-2,8,8,3,4,5,4,0.375,0.625,0.5,0.5
SF-N22-1B,SF-N26,10,6,5,3,5,3,0.5,0.5,0.5,0.5
SF-N22-1B,SF-N25,5,21,2,5,3,16,0.4,0.6,0.23809523809523808,0.7619047619047619
SF-N22-1B,SF-T21,4,6,3,4,1,2,0.75,0.25,0.6666666666666666,0.3333333333333333
SF-N22-1B,SF-T22,4,5,2,0,2,5,0.5,0.5,0.0,1.0
SF-N22-1B,SF-S22-1,8,5,3,1,5,4,0.375,0.625,0.2,0.8
SF-N22-1B,SF-Q23-3,5,9,3,3,2,6,0.6,0.4,0.3333333333333333,0.6666666666666666
SF-N22-1B,SF-Q22-1,7,4,3,3,4,1,0.42857142857142855,0.5714285714285714,0.75,0.25
SF-N22-1B,SF-Q22-2,9,2,8,2,1,0,0.8888888888888888,0.1111111111111111,1.0,0.0
SF-N22-1B,SF-P22,13,9,7,6,6,3,0.5384615384615384,0.46153846153846156,0.6666666666666666,0.3333333333333333
SF-N22-1B,SF-T20,2,2,0,1,2,1,0.0,1.0,0.5,0.5
SF-N26,SF-M26,3,7,3,4,0,3,1.0,0.0,0.5714285714285714,0.42857142857142855
SF-N26,SF-M25,7,5,4,4,3,1,0.5714285714285714,0.42857142857142855,0.8,0.2
SF-N26,SF-M26-2,4,4,4,1,0,3,1.0,0.0,0.25,0.75
SF-N26,SF-K26,8,13,1,1,7,12,0.125,0.875,0.07692307692307693,0.9230769230769231
SF-N26,SF-J27,2,2,0,0,2,2,0.0,1.0,0.0,1.0
SF-N26,SF-M30,15,16,9,6,6,10,0.6,0.4,0.375,0.625
SF-N26,SF-J29,1,7,0,2,1,5,0.0,1.0,0.2857142857142857,0.7142857142857143
SF-N26,SF-L26,12,17,3,12,9,5,0.25,0.75,0.7058823529411765,0.29411764705882354
SF-N26,SF-M28,5,4,2,0,3,4,0.4,0.6,0.0,1.0
SF-N26,SF-L25,7,14,4,10,3,4,0.5714285714285714,0.42857142857142855,0.7142857142857143,0.2857142857142857
SF-N26,SF-M24,13,21,6,5,7,16,0.46153846153846156,0.5384615384615384,0.23809523809523808,0.7619047619047619
SF-N26,SF-L24,2,10,1,6,1,4,0.5,0.5,0.6,0.4
SF-N26,SF-N23,5,11,4,8,1,3,0.8,0.2,0.7272727272727273,0.2727272727272727
SF-N26,SF-N24-2,11,19,1,12,10,7,0.09090909090909091,0.9090909090909091,0.631578947368421,0.3684210526315789
SF-N26,SF-K27-2,6,4,4,2,2,2,0.6666666666666666,0.3333333333333333,0.5,0.5
SF-N26,SF-J26-2,2,1,0,1,2,0,0.0,1.0,1.0,0.0
SF-N26,SF-L28,4,3,4,3,0,0,1.0,0.0,1.0,0.0
SF-N26,SF-K29-1,6,6,0,1,6,5,0.0,1.0,0.16666666666666666,0.8333333333333334
SF-N26,SF-K27,3,4,3,3,0,1,1.0,0.0,0.75,0.25
SF-N26,SF-K25,5,8,0,1,5,7,0.0,1.0,0.125,0.875
SF-N26,SF-H26-2,2,2,1,2,1,0,0.5,0.5,1.0,0.0
SF-N26,SF-P24,6,7,5,4,1,3,0.8333333333333334,0.16666666666666666,0.5714285714285714,0.42857142857142855
SF-N26,SF-N22-1A,3,3,2,2,1,1,0.6666666666666666,0.3333333333333333,0.6666666666666666,0.3333333333333333
SF-N26,SF-J24,4,4,3,4,1,0,0.75,0.25,1.0,0.0
SF-N26,SF-O24,3,4,2,4,1,0,0.6666666666666666,0.3333333333333333,1.0,0.0
SF-N26,SF-J26,5,3,0,3,5,0,0.0,1.0,1.0,0.0
SF-N26,SF-I25,5,8,2,5,3,3,0.4,0.6,0.625,0.375
SF-N26,SF-H26,5,9,3,5,2,4,0.6,0.4,0.5555555555555556,0.4444444444444444
SF-N26,SF-O23,9,10,1,6,8,4,0.1111111111111111,0.8888888888888888,0.6,0.4
SF-N26,SF-H27-1,1,2,0,0,1,2,0.0,1.0,0.0,1.0
SF-N26,SF-F28-2,4,5,1,2,3,3,0.25,0.75,0.4,0.6
SF-N26,SF-G27,4,1,0,1,4,0,0.0,1.0,1.0,0.0
SF-N26,SF-M22-2,5,10,2,8,3,2,0.4,0.6,0.8,0.2
SF-N26,SF-L22,2,5,0,2,2,3,0.0,1.0,0.4,0.6
SF-N26,SF-F27,9,14,9,12,0,2,1.0,0.0,0.8571428571428571,0.14285714285714285
SF-N26,SF-N22-2,16,13,6,4,10,9,0.375,0.625,0.3076923076923077,0.6923076923076923
SF-N26,SF-G28-2,1,1,1,0,0,1,1.0,0.0,0.0,1.0
SF-N26,SF-M22-1,6,4,0,2,6,2,0.0,1.0,0.5,0.5
SF-N26,SF-O25-1,7,8,6,6,1,2,0.8571428571428571,0.14285714285714285,0.75,0.25
SF-N26,SF-K22-2,1,5,1,4,0,1,1.0,0.0,0.8,0.2
SF-N26,SF-K24,1,5,0,2,1,3,0.0,1.0,0.4,0.6
SF-N26,SF-J23-2,3,3,1,2,2,1,0.3333333333333333,0.6666666666666666,0.6666666666666666,0.3333333333333333
SF-N26,SF-G23,4,2,0,1,4,1,0.0,1.0,0.5,0.5
SF-N26,SF-G24,2,3,1,0,1,3,0.5,0.5,0.0,1.0
SF-N26,SF-G25,3,2,1,0,2,2,0.3333333333333333,0.6666666666666666,0.0,1.0
SF-N26,SF-F23,6,4,0,0,6,4,0.0,1.0,0.0,1.0
SF-N26,SF-E23,3,4,0,2,3,2,0.0,1.0,0.5,0.5
SF-N26,SF-G18,2,3,0,2,2,1,0.0,1.0,0.6666666666666666,0.3333333333333333
SF-N26,SF-E18,5,9,0,0,5,9,0.0,1.0,0.0,1.0
SF-N26,SF-H30,3,3,2,0,1,3,0.6666666666666666,0.3333333333333333,0.0,1.0
SF-N26,SF-G30-2,4,6,1,4,3,2,0.25,0.75,0.6666666666666666,0.3333333333333333
SF-N26,SF-F30-1,2,6,0,3,2,3,0.0,1.0,0.5,0.5
SF-N26,SF-E29-1,3,3,0,2,3,1,0.0,1.0,0.6666666666666666,0.3333333333333333
SF-N26,SF-D29,1,4,0,2,1,2,0.0,1.0,0.5,0.5
SF-N26,SF-D28,2,4,2,2,0,2,1.0,0.0,0.5,0.5
SF-N26,SF-A27,1,1,0,1,1,0,0.0,1.0,1.0,0.0
SF-N26,SF-G29-1,4,4,0,0,4,4,0.0,1.0,0.0,1.0
SF-N26,SF-G30-1,9,3,0,0,9,3,0.0,1.0,0.0,1.0
SF-N26,SF-J12,1,2,0,0,1,2,0.0,1.0,0.0,1.0
SF-N26,SF-A19,2,1,0,0,2,1,0.0,1.0,0.0,1.0
SF-N26,SF-C26,3,3,2,2,1,1,0.6666666666666666,0.3333333333333333,0.6666666666666666,0.3333333333333333
SF-N26,SF-C25,6,5,1,1,5,4,0.16666666666666666,0.8333333333333334,0.2,0.8
SF-N26,SF-B28-2,9,11,6,7,3,4,0.6666666666666666,0.3333333333333333,0.6363636363636364,0.36363636363636365
SF-N26,SF-D27,1,4,0,4,1,0,0.0,1.0,1.0,0.0
SF-N26,SF-C28-2,1,1,1,0,0,1,1.0,0.0,0.0,1.0
SF-N26,SF-H0,1,2,0,0,1,2,0.0,1.0,0.0,1.0
SF-N26,SF-K21,3,1,2,0,1,1,0.6666666666666666,0.3333333333333333,0.0,1.0
SF-N26,SF-J23-1,9,8,1,0,8,8,0.1111111111111111,0.8888888888888888,0.0,1.0
SF-N26,SF-J22-1,2,1,1,1,1,0,0.5,0.5,1.0,0.0
SF-N26,SF-J21,3,4,0,3,3,1,0.0,1.0,0.75,0.25
SF-N26,SF-I23-1,4,3,0,0,4,3,0.0,1.0,0.0,1.0
SF-N26,SF-F26,6,6,0,2,6,4,0.0,1.0,0.3333333333333333,0.6666666666666666
SF-N26,SF-M15,7,10,0,0,7,10,0.0,1.0,0.0,1.0
SF-N26,SF-L19,15,15,4,2,11,13,0.26666666666666666,0.7333333333333333,0.13333333333333333,0.8666666666666667
SF-N26,SF-L20,4,5,2,1,2,4,0.5,0.5,0.2,0.8
SF-N26,SF-N20-1,4,3,0,1,4,2,0.0,1.0,0.3333333333333333,0.6666666666666666
SF-N26,SF-M20,6,8,1,3,5,5,0.16666666666666666,0.8333333333333334,0.375,0.625
SF-N26,SF-K17-2,8,4,0,0,8,4,0.0,1.0,0.0,1.0
SF-N26,SF-K20,5,6,2,1,3,5,0.4,0.6,0.16666666666666666,0.8333333333333334
SF-N26,SF-K15-,5,5,0,0,5,5,0.0,1.0,0.0,1.0
SF-N26,SF-K19,2,10,0,1,2,9,0.0,1.0,0.1,0.9
SF-N26,SF-K18,6,7,0,3,6,4,0.0,1.0,0.42857142857142855,0.5714285714285714
SF-N26,SF-K17,4,5,0,1,4,4,0.0,1.0,0.2,0.8
SF-N26,SF-J18,1,1,0,0,1,1,0.0,1.0,0.0,1.0
SF-N26,SF-J20,1,2,1,1,0,1,1.0,0.0,0.5,0.5
SF-N26,SF-J19,3,1,1,0,2,1,0.3333333333333333,0.6666666666666666,0.0,1.0
SF-N26,SF-M12,1,1,0,0,1,1,0.0,1.0,0.0,1.0
SF-N26,SF-R19,2,2,0,0,2,2,0.0,1.0,0.0,1.0
SF-N26,SF-Q21-2,1,1,0,0,1,1,0.0,1.0,0.0,1.0
SF-N26,SF-Q21-1,8,4,2,0,6,4,0.25,0.75,0.0,1.0
SF-N26,SF-P21,4,4,0,0,4,4,0.0,1.0,0.0,1.0
SF-N26,SF-O18,1,3,0,1,1,2,0.0,1.0,0.3333333333333333,0.6666666666666666
SF-N26,SF-O19,2,2,0,0,2,2,0.0,1.0,0.0,1.0
SF-N26,SF-O21,28,29,15,15,13,14,0.5357142857142857,0.4642857142857143,0.5172413793103449,0.4827586206896552
SF-N26,SF-O22,18,22,1,7,17,15,0.05555555555555555,0.9444444444444444,0.3181818181818182,0.6818181818181818
SF-N26,SF-N21,1,3,1,2,0,1,1.0,0.0,0.6666666666666666,0.3333333333333333
SF-N26,SF-N20-2,13,14,1,1,12,13,0.07692307692307693,0.9230769230769231,0.07142857142857142,0.9285714285714286
SF-N26,SF-M21,4,6,2,2,2,4,0.5,0.5,0.3333333333333333,0.6666666666666666
SF-N26,SF-L21,5,4,0,2,5,2,0.0,1.0,0.5,0.5
SF-N26,SF-S29,3,1,0,0,3,1,0.0,1.0,0.0,1.0
SF-N26,SF-Q30,11,6,0,0,11,6,0.0,1.0,0.0,1.0
SF-N26,SF-P30,5,4,4,2,1,2,0.8,0.2,0.5,0.5
SF-N26,SF-O30-2,4,4,3,1,1,3,0.75,0.25,0.25,0.75
SF-N26,SF-O30,9,16,4,8,5,8,0.4444444444444444,0.5555555555555556,0.5,0.5
SF-N26,SF-N27,47,46,9,12,38,34,0.19148936170212766,0.8085106382978723,0.2608695652173913,0.7391304347826086
SF-N26,SF-N29,5,11,2,10,3,1,0.4,0.6,0.9090909090909091,0.09090909090909091
SF-N26,SF-N28,12,13,7,6,5,7,0.5833333333333334,0.4166666666666667,0.46153846153846156,0.5384615384615384
SF-N26,SF-L30-1,5,18,0,7,5,11,0.0,1.0,0.3888888888888889,0.6111111111111112
SF-N26,SF-L31-1,1,5,0,1,1,4,0.0,1.0,0.2,0.8
SF-N26,SF-K30-2,2,1,1,1,1,0,0.5,0.5,1.0,0.0
SF-N26,SF-L29,14,19,3,10,11,9,0.21428571428571427,0.7857142857142857,0.5263157894736842,0.47368421052631576
SF-N26,SF-J29-1,1,1,1,1,0,0,1.0,0.0,1.0,0.0
SF-N26,SF-I30,7,1,5,0,2,1,0.7142857142857143,0.2857142857142857,0.0,1.0
SF-N26,SF-I29-2,1,1,0,1,1,0,0.0,1.0,1.0,0.0
SF-N26,SF-I30-2,5,1,0,0,5,1,0.0,1.0,0.0,1.0
SF-N26,SF-H28,2,2,2,0,0,2,1.0,0.0,0.0,1.0
SF-N26,SF-S24,13,10,6,8,7,2,0.46153846153846156,0.5384615384615384,0.8,0.2
SF-N26,SF-R24,5,14,4,4,1,10,0.8,0.2,0.2857142857142857,0.7142857142857143
SF-N26,SF-Q26,10,16,9,11,1,5,0.9,0.1,0.6875,0.3125
SF-N26,SF-P26,17,19,10,10,7,9,0.5882352941176471,0.4117647058823529,0.5263157894736842,0.47368421052631576
SF-N26,SF-O25-2,3,13,2,8,1,5,0.6666666666666666,0.3333333333333333,0.6153846153846154,0.38461538461538464
SF-N26,SF-N22-1B,6,10,3,5,3,5,0.5,0.5,0.5,0.5
SF-N26,SF-N25,6,12,3,9,3,3,0.5,0.5,0.75,0.25
SF-N26,SF-T22,4,13,1,4,3,9,0.25,0.75,0.3076923076923077,0.6923076923076923
SF-N26,SF-S22-2,32,4,0,0,32,4,0.0,1.0,0.0,1.0
SF-N26,SF-S22-1,4,5,0,1,4,4,0.0,1.0,0.2,0.8
SF-N26,SF-Q23-3,4,4,2,4,2,0,0.5,0.5,1.0,0.0
SF-N26,SF-Q22-1,3,5,1,1,2,4,0.3333333333333333,0.6666666666666666,0.2,0.8
SF-N26,SF-Q22-2,3,5,0,3,3,2,0.0,1.0,0.6,0.4
SF-N26,SF-P22,8,17,2,5,6,12,0.25,0.75,0.29411764705882354,0.7058823529411765
SF-N26,SF-S21,1,4,0,0,1,4,0.0,1.0,0.0,1.0
SF-N25,SF-M26,1,3,1,3,0,0,1.0,0.0,1.0,0.0
SF-N25,SF-M25,3,8,1,5,2,3,0.3333333333333333,0.6666666666666666,0.625,0.375
SF-N25,SF-K26,4,12,0,4,4,8,0.0,1.0,0.3333333333333333,0.6666666666666666
SF-N25,SF-J27,3,1,2,0,1,1,0.6666666666666666,0.3333333333333333,0.0,1.0
SF-N25,SF-M30,4,10,1,3,3,7,0.25,0.75,0.3,0.7
SF-N25,SF-J29,5,7,1,3,4,4,0.2,0.8,0.42857142857142855,0.5714285714285714
SF-N25,SF-L26,18,6,6,3,12,3,0.3333333333333333,0.6666666666666666,0.5,0.5
SF-N25,SF-M28,7,6,1,2,6,4,0.14285714285714285,0.8571428571428571,0.3333333333333333,0.6666666666666666
SF-N25,SF-M27,2,1,2,0,0,1,1.0,0.0,0.0,1.0
SF-N25,SF-L25,16,11,1,1,15,10,0.0625,0.9375,0.09090909090909091,0.9090909090909091
SF-N25,SF-M24,10,22,3,16,7,6,0.3,0.7,0.7272727272727273,0.2727272727272727
SF-N25,SF-L24,8,13,7,11,1,2,0.875,0.125,0.8461538461538461,0.15384615384615385
SF-N25,SF-N23,10,12,3,7,7,5,0.3,0.7,0.5833333333333334,0.4166666666666667
SF-N25,SF-N24-2,11,16,8,11,3,5,0.7272727272727273,0.2727272727272727,0.6875,0.3125
SF-N25,SF-K27-2,7,4,3,3,4,1,0.42857142857142855,0.5714285714285714,0.75,0.25
SF-N25,SF-J26-2,8,8,1,2,7,6,0.125,0.875,0.25,0.75
SF-N25,SF-L28,1,16,0,3,1,13,0.0,1.0,0.1875,0.8125
SF-N25,SF-K28,4,3,4,3,0,0,1.0,0.0,1.0,0.0
SF-N25,SF-K29-1,5,4,1,1,4,3,0.2,0.8,0.25,0.75
SF-N25,SF-J28-2,7,14,3,11,4,3,0.42857142857142855,0.5714285714285714,0.7857142857142857,0.21428571428571427
SF-N25,SF-K27,10,4,8,3,2,1,0.8,0.2,0.75,0.25
SF-N25,SF-K25,4,2,2,1,2,1,0.5,0.5,0.5,0.5
SF-N25,SF-J25,7,10,4,7,3,3,0.5714285714285714,0.42857142857142855,0.7,0.3
SF-N25,SF-P24,25,24,6,11,19,13,0.24,0.76,0.4583333333333333,0.5416666666666666
SF-N25,SF-N22-1A,2,6,2,4,0,2,1.0,0.0,0.6666666666666666,0.3333333333333333
SF-N25,SF-J24,6,12,3,9,3,3,0.5,0.5,0.75,0.25
SF-N25,SF-O24,5,5,5,3,0,2,1.0,0.0,0.6,0.4
SF-N25,SF-I26-,4,1,1,1,3,0,0.25,0.75,1.0,0.0
SF-N25,SF-I25,11,13,7,6,4,7,0.6363636363636364,0.36363636363636365,0.46153846153846156,0.5384615384615384
SF-N25,SF-H26,4,5,2,3,2,2,0.5,0.5,0.6,0.4
SF-N25,SF-O23,5,10,4,8,1,2,0.8,0.2,0.8,0.2
SF-N25,SF-F28-2,4,1,0,0,4,1,0.0,1.0,0.0,1.0
SF-N25,SF-G27,2,4,0,1,2,3,0.0,1.0,0.25,0.75
SF-N25,SF-M22-2,13,9,2,4,11,5,0.15384615384615385,0.8461538461538461,0.4444444444444444,0.5555555555555556
SF-N25,SF-L22,6,17,2,12,4,5,0.3333333333333333,0.6666666666666666,0.7058823529411765,0.29411764705882354
SF-N25,SF-N22-2,70,57,52,41,18,16,0.7428571428571429,0.2571428571428571,0.7192982456140351,0.2807017543859649
SF-N25,SF-M22-1,14,11,0,5,14,6,0.0,1.0,0.45454545454545453,0.5454545454545454
SF-N25,SF-O25-1,15,21,7,10,8,11,0.4666666666666667,0.5333333333333333,0.47619047619047616,0.5238095238095238
SF-N25,SF-K22-2,1,2,0,0,1,2,0.0,1.0,0.0,1.0
SF-N25,SF-K24,1,4,1,2,0,2,1.0,0.0,0.5,0.5
SF-N25,SF-J23-2,1,4,0,1,1,3,0.0,1.0,0.25,0.75
SF-N25,SF-G23,4,1,2,1,2,0,0.5,0.5,1.0,0.0
SF-N25,SF-G24,1,7,1,1,0,6,1.0,0.0,0.14285714285714285,0.8571428571428571
SF-N25,SF-G25,1,3,0,0,1,3,0.0,1.0,0.0,1.0
SF-N25,SF-F23,1,2,0,0,1,2,0.0,1.0,0.0,1.0
SF-N25,SF-E23,4,1,0,1,4,0,0.0,1.0,1.0,0.0
SF-N25,SF-C22,1,4,1,1,0,3,1.0,0.0,0.25,0.75
SF-N25,SF-B22,1,5,0,3,1,2,0.0,1.0,0.6,0.4
SF-N25,SF-H30,3,1,3,0,0,1,1.0,0.0,0.0,1.0
SF-N25,SF-G30-2,2,2,1,1,1,1,0.5,0.5,0.5,0.5
SF-N25,SF-E29-2,1,1,0,1,1,0,0.0,1.0,1.0,0.0
SF-N25,SF-D28,1,1,1,0,0,1,1.0,0.0,0.0,1.0
SF-N25,SF-G29-2,2,4,1,0,1,4,0.5,0.5,0.0,1.0
SF-N25,SF-G30-1,1,4,0,0,1,4,0.0,1.0,0.0,1.0
SF-N25,SF-E28-2,2,2,0,1,2,1,0.0,1.0,0.5,0.5
SF-N25,SF-E28,1,1,0,0,1,1,0.0,1.0,0.0,1.0
SF-N25,SF-B19,1,1,0,1,1,0,0.0,1.0,1.0,0.0
SF-N25,SF-C26,1,3,1,0,0,3,1.0,0.0,0.0,1.0
SF-N25,SF-K22-1,2,1,2,0,0,1,1.0,0.0,0.0,1.0
SF-N25,SF-J23-1,7,3,1,2,6,1,0.14285714285714285,0.8571428571428571,0.6666666666666666,0.3333333333333333
SF-N25,SF-J22-1,4,1,1,0,3,1,0.25,0.75,0.0,1.0
SF-N25,SF-J22-2,4,3,2,0,2,3,0.5,0.5,0.0,1.0
SF-N25,SF-J21,3,3,1,0,2,3,0.3333333333333333,0.6666666666666666,0.0,1.0
SF-N25,SF-I21,3,1,1,0,2,1,0.3333333333333333,0.6666666666666666,0.0,1.0
SF-N25,SF-I24,1,4,0,1,1,3,0.0,1.0,0.25,0.75
SF-N25,SF-I23-1,1,2,0,1,1,1,0.0,1.0,0.5,0.5
SF-N25,SF-F26,2,3,0,0,2,3,0.0,1.0,0.0,1.0
SF-N25,SF-M13,2,4,2,3,0,1,1.0,0.0,0.75,0.25
SF-N25,SF-M15,3,2,1,0,2,2,0.3333333333333333,0.6666666666666666,0.0,1.0
SF-N25,SF-L19,5,6,2,2,3,4,0.4,0.6,0.3333333333333333,0.6666666666666666
SF-N25,SF-L20,2,2,0,0,2,2,0.0,1.0,0.0,1.0
SF-N25,SF-N20-1,5,6,3,1,2,5,0.6,0.4,0.16666666666666666,0.8333333333333334
SF-N25,SF-M20,14,13,4,3,10,10,0.2857142857142857,0.7142857142857143,0.23076923076923078,0.7692307692307693
SF-N25,SF-K17-2,3,5,3,1,0,4,1.0,0.0,0.2,0.8
SF-N25,SF-K20,5,7,1,2,4,5,0.2,0.8,0.2857142857142857,0.7142857142857143
SF-N25,SF-K15-,3,8,2,5,1,3,0.6666666666666666,0.3333333333333333,0.625,0.375
SF-N25,SF-K19,14,11,2,1,12,10,0.14285714285714285,0.8571428571428571,0.09090909090909091,0.9090909090909091
SF-N25,SF-K18,8,5,0,0,8,5,0.0,1.0,0.0,1.0
SF-N25,SF-K17,5,4,0,0,5,4,0.0,1.0,0.0,1.0
SF-N25,SF-J16,4,8,1,0,3,8,0.25,0.75,0.0,1.0
SF-N25,SF-J18,2,3,0,0,2,3,0.0,1.0,0.0,1.0
SF-N25,SF-J20,2,1,2,1,0,0,1.0,0.0,1.0,0.0
SF-N25,SF-J19,1,1,1,0,0,1,1.0,0.0,0.0,1.0
SF-N25,SF-M10,2,4,0,4,2,0,0.0,1.0,1.0,0.0
SF-N25,SF-R19,2,1,0,1,2,0,0.0,1.0,1.0,0.0
SF-N25,SF-Q21-2,1,3,1,0,0,3,1.0,0.0,0.0,1.0
SF-N25,SF-Q21-1,3,4,1,1,2,3,0.3333333333333333,0.6666666666666666,0.25,0.75
SF-N25,SF-P21,4,6,4,0,0,6,1.0,0.0,0.0,1.0
SF-N25,SF-O18,63,27,55,18,8,9,0.873015873015873,0.12698412698412698,0.6666666666666666,0.3333333333333333
SF-N25,SF-O19,22,56,10,46,12,10,0.45454545454545453,0.5454545454545454,0.8214285714285714,0.17857142857142858
SF-N25,SF-O21,15,12,5,6,10,6,0.3333333333333333,0.6666666666666666,0.5,0.5
SF-N25,SF-O22,11,14,1,3,10,11,0.09090909090909091,0.9090909090909091,0.21428571428571427,0.7857142857142857
SF-N25,SF-N21,9,13,5,5,4,8,0.5555555555555556,0.4444444444444444,0.38461538461538464,0.6153846153846154
SF-N25,SF-N20-2,3,11,0,7,3,4,0.0,1.0,0.6363636363636364,0.36363636363636365
SF-N25,SF-M21,17,13,6,5,11,8,0.35294117647058826,0.6470588235294118,0.38461538461538464,0.6153846153846154
SF-N25,SF-L21,9,9,2,1,7,8,0.2222222222222222,0.7777777777777778,0.1111111111111111,0.8888888888888888
SF-N25,SF-Q30,1,9,1,0,0,9,1.0,0.0,0.0,1.0
SF-N25,SF-P30,5,10,1,3,4,7,0.2,0.8,0.3,0.7
SF-N25,SF-O30-2,5,5,1,1,4,4,0.2,0.8,0.2,0.8
SF-N25,SF-O30,25,20,10,9,15,11,0.4,0.6,0.45,0.55
SF-N25,SF-N27,25,19,18,12,7,7,0.72,0.28,0.631578947368421,0.3684210526315789
SF-N25,SF-N29,12,36,10,32,2,4,0.8333333333333334,0.16666666666666666,0.8888888888888888,0.1111111111111111
SF-N25,SF-N28,19,21,9,11,10,10,0.47368421052631576,0.5263157894736842,0.5238095238095238,0.47619047619047616
SF-N25,SF-L30-1,5,12,3,4,2,8,0.6,0.4,0.3333333333333333,0.6666666666666666
SF-N25,SF-K30-2,2,4,0,2,2,2,0.0,1.0,0.5,0.5
SF-N25,SF-L29,18,10,13,7,5,3,0.7222222222222222,0.2777777777777778,0.7,0.3
SF-N25,SF-I30,2,1,2,1,0,0,1.0,0.0,1.0,0.0
SF-N25,SF-H28,4,5,3,3,1,2,0.75,0.25,0.6,0.4
SF-N25,SF-S24,10,14,4,3,6,11,0.4,0.6,0.21428571428571427,0.7857142857142857
SF-N25,SF-R24,38,31,18,16,20,15,0.47368421052631576,0.5263157894736842,0.5161290322580645,0.4838709677419355
SF-N25,SF-Q26,4,12,2,5,2,7,0.5,0.5,0.4166666666666667,0.5833333333333334
SF-N25,SF-P26,19,6,8,3,11,3,0.42105263157894735,0.5789473684210527,0.5,0.5
SF-N25,SF-O25-2,39,30,27,25,12,5,0.6923076923076923,0.3076923076923077,0.8333333333333334,0.16666666666666666
SF-N25,SF-N22-1B,21,5,5,2,16,3,0.23809523809523808,0.7619047619047619,0.4,0.6
SF-N25,SF-N26,12,6,9,3,3,3,0.75,0.25,0.5,0.5
SF-N25,SF-T21,1,1,0,1,1,0,0.0,1.0,1.0,0.0
SF-N25,SF-T22,6,5,3,3,3,2,0.5,0.5,0.6,0.4
SF-N25,SF-S22-2,1,11,0,0,1,11,0.0,1.0,0.0,1.0
SF-N25,SF-S22-1,4,6,1,1,3,5,0.25,0.75,0.16666666666666666,0.8333333333333334
SF-N25,SF-Q23-3,7,7,2,5,5,2,0.2857142857142857,0.7142857142857143,0.7142857142857143,0.2857142857142857
SF-N25,SF-Q22-1,26,24,20,8,6,16,0.7692307692307693,0.23076923076923078,0.3333333333333333,0.6666666666666666
SF-N25,SF-Q22-2,9,4,5,3,4,1,0.5555555555555556,0.4444444444444444,0.75,0.25
SF-N25,SF-P22,18,15,4,5,14,10,0.2222222222222222,0.7777777777777778,0.3333333333333333,0.6666666666666666
SF-N25,SF-W19,2,1,0,0,2,1,0.0,1.0,0.0,1.0
SF-N25,SF-S21,3,1,0,0,3,1,0.0,1.0,0.0,1.0
SF-N25,SF-V28,1,2,0,2,1,0,0.0,1.0,1.0,0.0
SF-N25,SF-Z7,4,2,0,0,4,2,0.0,1.0,0.0,1.0
SF-T21,SF-K26,11,2,1,0,10,2,0.09090909090909091,0.9090909090909091,0.0,1.0
SF-T21,SF-M30,2,2,1,1,1,1,0.5,0.5,0.5,0.5
SF-T21,SF-L26,5,8,0,7,5,1,0.0,1.0,0.875,0.125
SF-T21,SF-M24,6,5,3,5,3,0,0.5,0.5,1.0,0.0
SF-T21,SF-L24,2,5,0,2,2,3,0.0,1.0,0.4,0.6
SF-T21,SF-N23,11,4,2,0,9,4,0.18181818181818182,0.8181818181818182,0.0,1.0
SF-T21,SF-J25,6,6,4,2,2,4,0.6666666666666666,0.3333333333333333,0.3333333333333333,0.6666666666666666
SF-T21,SF-H26-2,3,4,2,4,1,0,0.6666666666666666,0.3333333333333333,1.0,0.0
SF-T21,SF-P24,3,2,3,2,0,0,1.0,0.0,1.0,0.0
SF-T21,SF-J24,1,3,0,2,1,1,0.0,1.0,0.6666666666666666,0.3333333333333333
SF-T21,SF-O24,3,1,0,1,3,0,0.0,1.0,1.0,0.0
SF-T21,SF-J26,4,9,2,8,2,1,0.5,0.5,0.8888888888888888,0.1111111111111111
SF-T21,SF-I25,3,5,3,2,0,3,1.0,0.0,0.4,0.6
SF-T21,SF-O23,9,1,1,1,8,0,0.1111111111111111,0.8888888888888888,1.0,0.0
SF-T21,SF-H27-1,2,1,0,0,2,1,0.0,1.0,0.0,1.0
SF-T21,SF-G27,8,10,1,5,7,5,0.125,0.875,0.5,0.5
SF-T21,SF-M22-2,12,18,3,8,9,10,0.25,0.75,0.4444444444444444,0.5555555555555556
SF-T21,SF-L22,6,4,3,2,3,2,0.5,0.5,0.5,0.5
SF-T21,SF-F27,1,10,0,7,1,3,0.0,1.0,0.7,0.3
SF-T21,SF-N22-2,22,28,3,10,19,18,0.13636363636363635,0.8636363636363636,0.35714285714285715,0.6428571428571429
SF-T21,SF-M22-1,2,6,0,4,2,2,0.0,1.0,0.6666666666666666,0.3333333333333333
SF-T21,SF-K22-2,1,2,0,1,1,1,0.0,1.0,0.5,0.5
SF-T21,SF-K24,1,4,1,3,0,1,1.0,0.0,0.75,0.25
SF-T21,SF-G24,9,2,1,1,8,1,0.1111111111111111,0.8888888888888888,0.5,0.5
SF-T21,SF-F23,1,1,0,0,1,1,0.0,1.0,0.0,1.0
SF-T21,SF-E23,1,1,0,1,1,0,0.0,1.0,1.0,0.0
SF-T21,SF-J17,1,1,1,0,0,1,1.0,0.0,0.0,1.0
SF-T21,SF-I19,1,1,0,0,1,1,0.0,1.0,0.0,1.0
SF-T21,SF-F19,2,4,0,0,2,4,0.0,1.0,0.0,1.0
SF-T21,SF-E28,1,7,0,7,1,0,0.0,1.0,1.0,0.0
SF-T21,SF-J12,1,1,0,0,1,1,0.0,1.0,0.0,1.0
SF-T21,SF-G12,1,1,1,1,0,0,1.0,0.0,1.0,0.0
SF-T21,SF-C26,2,2,0,0,2,2,0.0,1.0,0.0,1.0
SF-T21,SF-E27,4,7,3,7,1,0,0.75,0.25,1.0,0.0
SF-T21,SF-D27,2,31,0,29,2,2,0.0,1.0,0.9354838709677419,0.06451612903225806
SF-T21,SF-H25,2,3,0,0,2,3,0.0,1.0,0.0,1.0
SF-T21,SF-K21,1,3,0,0,1,3,0.0,1.0,0.0,1.0
SF-T21,SF-K22-1,2,2,1,0,1,2,0.5,0.5,0.0,1.0
SF-T21,SF-J23-1,5,4,0,1,5,3,0.0,1.0,0.25,0.75
SF-T21,SF-J21,2,3,0,1,2,2,0.0,1.0,0.3333333333333333,0.6666666666666666
SF-T21,SF-I23-2,2,7,0,5,2,2,0.0,1.0,0.7142857142857143,0.2857142857142857
SF-T21,SF-I23-1,6,3,3,0,3,3,0.5,0.5,0.0,1.0
SF-T21,SF-M15,2,1,0,0,2,1,0.0,1.0,0.0,1.0
SF-T21,SF-L20,27,33,0,0,27,33,0.0,1.0,0.0,1.0
SF-T21,SF-N20-1,1,9,0,4,1,5,0.0,1.0,0.4444444444444444,0.5555555555555556
SF-T21,SF-M20,10,4,2,1,8,3,0.2,0.8,0.25,0.75
SF-T21,SF-K20,2,3,0,2,2,1,0.0,1.0,0.6666666666666666,0.3333333333333333
SF-T21,SF-K15-,7,3,0,0,7,3,0.0,1.0,0.0,1.0
SF-T21,SF-K19,4,2,1,0,3,2,0.25,0.75,0.0,1.0
SF-T21,SF-J16,1,1,1,0,0,1,1.0,0.0,0.0,1.0
SF-T21,SF-J18,5,2,4,0,1,2,0.8,0.2,0.0,1.0
SF-T21,SF-J19,3,1,0,0,3,1,0.0,1.0,0.0,1.0
SF-T21,SF-M12,1,1,0,0,1,1,0.0,1.0,0.0,1.0
SF-T21,SF-R19,17,11,11,3,6,8,0.6470588235294118,0.35294117647058826,0.2727272727272727,0.7272727272727273
SF-T21,SF-R20,22,5,18,2,4,3,0.8181818181818182,0.18181818181818182,0.4,0.6
SF-T21,SF-Q21-2,4,8,1,4,3,4,0.25,0.75,0.5,0.5
SF-T21,SF-Q21-1,14,6,12,6,2,0,0.8571428571428571,0.14285714285714285,1.0,0.0
SF-T21,SF-P21,4,10,2,3,2,7,0.5,0.5,0.3,0.7
SF-T21,SF-O18,2,2,0,0,2,2,0.0,1.0,0.0,1.0
SF-T21,SF-O19,8,11,0,4,8,7,0.0,1.0,0.36363636363636365,0.6363636363636364
SF-T21,SF-O21,20,22,3,9,17,13,0.15,0.85,0.4090909090909091,0.5909090909090909
SF-T21,SF-O22,28,23,6,8,22,15,0.21428571428571427,0.7857142857142857,0.34782608695652173,0.6521739130434783
SF-T21,SF-N21,2,9,2,8,0,1,1.0,0.0,0.8888888888888888,0.1111111111111111
SF-T21,SF-N20-2,14,8,12,8,2,0,0.8571428571428571,0.14285714285714285,1.0,0.0
SF-T21,SF-M21,9,2,3,0,6,2,0.3333333333333333,0.6666666666666666,0.0,1.0
SF-T21,SF-L21,6,3,1,3,5,0,0.16666666666666666,0.8333333333333334,1.0,0.0
SF-T21,SF-P30,2,2,1,0,1,2,0.5,0.5,0.0,1.0
SF-T21,SF-N29,1,2,1,2,0,0,1.0,0.0,1.0,0.0
SF-T21,SF-N28,1,2,0,1,1,1,0.0,1.0,0.5,0.5
SF-T21,SF-L30-1,2,3,1,1,1,2,0.5,0.5,0.3333333333333333,0.6666666666666666
SF-T21,SF-I28,4,7,4,5,0,2,1.0,0.0,0.7142857142857143,0.2857142857142857
SF-T21,SF-H29,1,1,0,0,1,1,0.0,1.0,0.0,1.0
SF-T21,SF-S24,10,4,5,2,5,2,0.5,0.5,0.5,0.5
SF-T21,SF-R24,10,8,5,5,5,3,0.5,0.5,0.625,0.375
SF-T21,SF-R26,1,1,1,0,0,1,1.0,0.0,0.0,1.0
SF-T21,SF-Q26,2,1,0,0,2,1,0.0,1.0,0.0,1.0
SF-T21,SF-P26,3,12,2,5,1,7,0.6666666666666666,0.3333333333333333,0.4166666666666667,0.5833333333333334
SF-T21,SF-N22-1B,6,4,4,3,2,1,0.6666666666666666,0.3333333333333333,0.75,0.25
SF-T21,SF-N25,1,1,1,0,0,1,1.0,0.0,0.0,1.0
SF-T21,SF-T22,11,22,5,8,6,14,0.45454545454545453,0.5454545454545454,0.36363636363636365,0.6363636363636364
SF-T21,SF-S22-2,5,10,3,3,2,7,0.6,0.4,0.3,0.7
SF-T21,SF-S22-1,20,16,14,12,6,4,0.7,0.3,0.75,0.25
SF-T21,SF-Q23-3,52,14,48,12,4,2,0.9230769230769231,0.07692307692307693,0.8571428571428571,0.14285714285714285
SF-T21,SF-Q22-1,12,9,5,4,7,5,0.4166666666666667,0.5833333333333334,0.4444444444444444,0.5555555555555556
SF-T21,SF-Q22-2,11,8,9,5,2,3,0.8181818181818182,0.18181818181818182,0.625,0.375
SF-T21,SF-P22,8,27,4,16,4,11,0.5,0.5,0.5925925925925926,0.4074074074074074
SF-T21,SF-W19,9,9,2,2,7,7,0.2222222222222222,0.7777777777777778,0.2222222222222222,0.7777777777777778
SF-T21,SF-W19-2,12,6,6,0,6,6,0.5,0.5,0.0,1.0
SF-T21,SF-U21,54,47,19,5,35,42,0.35185185185185186,0.6481481481481481,0.10638297872340426,0.8936170212765957
SF-T21,SF-T20,5,12,4,6,1,6,0.8,0.2,0.5,0.5
SF-T21,SF-S21,2,2,1,1,1,1,0.5,0.5,0.5,0.5
SF-T21,SF-W14,7,6,3,1,4,5,0.42857142857142855,0.5714285714285714,0.16666666666666666,0.8333333333333334
SF-T21,SF-AA15,10,8,3,7,7,1,0.3,0.7,0.875,0.125
SF-T21,SF-Z16,1,5,1,1,0,4,1.0,0.0,0.2,0.8
SF-T21,SF-Y14,4,1,0,0,4,1,0.0,1.0,0.0,1.0
SF-T21,SF-X19,3,1,2,1,1,0,0.6666666666666666,0.3333333333333333,1.0,0.0
SF-T22,SF-M26,4,2,1,1,3,1,0.25,0.75,0.5,0.5
SF-T22,SF-M25,11,13,8,7,3,6,0.7272727272727273,0.2727272727272727,0.5384615384615384,0.46153846153846156
SF-T22,SF-M26-2,6,10,6,7,0,3,1.0,0.0,0.7,0.3
SF-T22,SF-K26,4,3,1,1,3,2,0.25,0.75,0.3333333333333333,0.6666666666666666
SF-T22,SF-J27,3,1,1,0,2,1,0.3333333333333333,0.6666666666666666,0.0,1.0
SF-T22,SF-M30,31,32,28,21,3,11,0.9032258064516129,0.0967741935483871,0.65625,0.34375
SF-T22,SF-J29,2,1,1,0,1,1,0.5,0.5,0.0,1.0
SF-T22,SF-L26,31,11,17,3,14,8,0.5483870967741935,0.45161290322580644,0.2727272727272727,0.7272727272727273
SF-T22,SF-L25,9,3,8,1,1,2,0.8888888888888888,0.1111111111111111,0.3333333333333333,0.6666666666666666
SF-T22,SF-M24,10,7,6,4,4,3,0.6,0.4,0.5714285714285714,0.42857142857142855
SF-T22,SF-L24,11,5,4,4,7,1,0.36363636363636365,0.6363636363636364,0.8,0.2
SF-T22,SF-N23,10,11,5,6,5,5,0.5,0.5,0.5454545454545454,0.45454545454545453
SF-T22,SF-N24-2,6,8,4,5,2,3,0.6666666666666666,0.3333333333333333,0.625,0.375
SF-T22,SF-K27-2,10,1,2,0,8,1,0.2,0.8,0.0,1.0
SF-T22,SF-J26-2,3,2,1,0,2,2,0.3333333333333333,0.6666666666666666,0.0,1.0
SF-T22,SF-J28-2,7,7,1,2,6,5,0.14285714285714285,0.8571428571428571,0.2857142857142857,0.7142857142857143
SF-T22,SF-K25,2,10,2,2,0,8,1.0,0.0,0.2,0.8
SF-T22,SF-J25,11,16,1,2,10,14,0.09090909090909091,0.9090909090909091,0.125,0.875
SF-T22,SF-H26-2,2,1,1,0,1,1,0.5,0.5,0.0,1.0
SF-T22,SF-P24,15,10,6,4,9,6,0.4,0.6,0.4,0.6
SF-T22,SF-J24,4,1,0,0,4,1,0.0,1.0,0.0,1.0
SF-T22,SF-O24,5,4,2,0,3,4,0.4,0.6,0.0,1.0
SF-T22,SF-I25,4,3,1,2,3,1,0.25,0.75,0.6666666666666666,0.3333333333333333
SF-T22,SF-H26,12,17,2,2,10,15,0.16666666666666666,0.8333333333333334,0.11764705882352941,0.8823529411764706
SF-T22,SF-O23,32,34,12,13,20,21,0.375,0.625,0.38235294117647056,0.6176470588235294
SF-T22,SF-H27-1,2,5,1,0,1,5,0.5,0.5,0.0,1.0
SF-T22,SF-F28-2,12,28,6,25,6,3,0.5,0.5,0.8928571428571429,0.10714285714285714
SF-T22,SF-G27,16,16,6,10,10,6,0.375,0.625,0.625,0.375
SF-T22,SF-M22-2,96,91,12,19,84,72,0.125,0.875,0.2087912087912088,0.7912087912087912
SF-T22,SF-L22,20,17,14,6,6,11,0.7,0.3,0.35294117647058826,0.6470588235294118
SF-T22,SF-N22-2,68,66,25,29,43,37,0.36764705882352944,0.6323529411764706,0.4393939393939394,0.5606060606060606
SF-T22,SF-G28-2,1,1,1,1,0,0,1.0,0.0,1.0,0.0
SF-T22,SF-M22-1,15,14,3,3,12,11,0.2,0.8,0.21428571428571427,0.7857142857142857
SF-T22,SF-O25-1,5,3,4,2,1,1,0.8,0.2,0.6666666666666666,0.3333333333333333
SF-T22,SF-K22-2,12,12,7,8,5,4,0.5833333333333334,0.4166666666666667,0.6666666666666666,0.3333333333333333
SF-T22,SF-K24,4,1,2,0,2,1,0.5,0.5,0.0,1.0
SF-T22,SF-J23-2,10,7,6,0,4,7,0.6,0.4,0.0,1.0
SF-T22,SF-G23,4,4,1,0,3,4,0.25,0.75,0.0,1.0
SF-T22,SF-G24,25,18,2,1,23,17,0.08,0.92,0.05555555555555555,0.9444444444444444
SF-T22,SF-G25,13,7,3,0,10,7,0.23076923076923078,0.7692307692307693,0.0,1.0
SF-T22,SF-F23,16,8,1,2,15,6,0.0625,0.9375,0.25,0.75
SF-T22,SF-E23,5,1,2,0,3,1,0.4,0.6,0.0,1.0
SF-T22,SF-D24,1,1,1,0,0,1,1.0,0.0,0.0,1.0
SF-T22,SF-C22,2,1,1,0,1,1,0.5,0.5,0.0,1.0
SF-T22,SF-B22,1,3,0,2,1,1,0.0,1.0,0.6666666666666666,0.3333333333333333
SF-T22,SF-J17,6,8,0,0,6,8,0.0,1.0,0.0,1.0
SF-T22,SF-I19,2,5,1,0,1,5,0.5,0.5,0.0,1.0
SF-T22,SF-H16,1,2,0,0,1,2,0.0,1.0,0.0,1.0
SF-T22,SF-H20,1,3,1,3,0,0,1.0,0.0,1.0,0.0
SF-T22,SF-H18,1,1,1,0,0,1,1.0,0.0,0.0,1.0
SF-T22,SF-G19,2,2,1,1,1,1,0.5,0.5,0.5,0.5
SF-T22,SF-G17,4,12,1,0,3,12,0.25,0.75,0.0,1.0
SF-T22,SF-G18,4,3,0,1,4,2,0.0,1.0,0.3333333333333333,0.6666666666666666
SF-T22,SF-G20,6,5,3,0,3,5,0.5,0.5,0.0,1.0
SF-T22,SF-E18,2,1,0,0,2,1,0.0,1.0,0.0,1.0
SF-T22,SF-E20,1,2,0,0,1,2,0.0,1.0,0.0,1.0
SF-T22,SF-H30,1,3,1,0,0,3,1.0,0.0,0.0,1.0
SF-T22,SF-G30-2,2,2,0,0,2,2,0.0,1.0,0.0,1.0
SF-T22,SF-F30-1,1,1,0,0,1,1,0.0,1.0,0.0,1.0
SF-T22,SF-E29-2,6,12,1,2,5,10,0.16666666666666666,0.8333333333333334,0.16666666666666666,0.8333333333333334
SF-T22,SF-E29-1,3,5,0,5,3,0,0.0,1.0,1.0,0.0
SF-T22,SF-D29,3,2,0,0,3,2,0.0,1.0,0.0,1.0
SF-T22,SF-D28,2,1,1,1,1,0,0.5,0.5,1.0,0.0
SF-T22,SF-G29-2,4,2,0,0,4,2,0.0,1.0,0.0,1.0
SF-T22,SF-G29-1,4,1,2,0,2,1,0.5,0.5,0.0,1.0
SF-T22,SF-G30-1,2,1,0,1,2,0,0.0,1.0,1.0,0.0
SF-T22,SF-E29-3,2,2,1,0,1,2,0.5,0.5,0.0,1.0
SF-T22,SF-F28-1,2,7,0,1,2,6,0.0,1.0,0.14285714285714285,0.8571428571428571
SF-T22,SF-E28-2,1,1,0,0,1,1,0.0,1.0,0.0,1.0
SF-T22,SF-E28,6,1,5,1,1,0,0.8333333333333334,0.16666666666666666,1.0,0.0
SF-T22,SF-J12,1,1,0,0,1,1,0.0,1.0,0.0,1.0
SF-T22,SF-J13,1,1,0,0,1,1,0.0,1.0,0.0,1.0
SF-T22,SF-J15,1,1,1,0,0,1,1.0,0.0,0.0,1.0
SF-T22,SF-I16,1,2,0,0,1,2,0.0,1.0,0.0,1.0
SF-T22,SF-G13,7,3,0,0,7,3,0.0,1.0,0.0,1.0
SF-T22,SF-G11,1,2,0,0,1,2,0.0,1.0,0.0,1.0
SF-T22,SF-F15,1,2,0,0,1,2,0.0,1.0,0.0,1.0
SF-T22,SF-B19,2,2,0,0,2,2,0.0,1.0,0.0,1.0
SF-T22,SF-A20,3,1,3,0,0,1,1.0,0.0,0.0,1.0
SF-T22,SF-C26,3,1,0,1,3,0,0.0,1.0,1.0,0.0
SF-T22,SF-C25,7,4,2,1,5,3,0.2857142857142857,0.7142857142857143,0.25,0.75
SF-T22,SF-B25,2,2,0,0,2,2,0.0,1.0,0.0,1.0
SF-T22,SF-E27,1,6,0,1,1,5,0.0,1.0,0.16666666666666666,0.8333333333333334
SF-T22,SF-D27,16,4,13,2,3,2,0.8125,0.1875,0.5,0.5
SF-T22,SF-B28,2,1,0,0,2,1,0.0,1.0,0.0,1.0
SF-T22,SF-J1,1,1,0,0,1,1,0.0,1.0,0.0,1.0
SF-T22,SF-G8,3,2,1,0,2,2,0.3333333333333333,0.6666666666666666,0.0,1.0
SF-T22,SF-G7,3,2,0,0,3,2,0.0,1.0,0.0,1.0
SF-T22,SF-H25,4,5,0,0,4,5,0.0,1.0,0.0,1.0
SF-T22,SF-G26,6,3,2,2,4,1,0.3333333333333333,0.6666666666666666,0.6666666666666666,0.3333333333333333
SF-T22,SF-K21,9,4,4,3,5,1,0.4444444444444444,0.5555555555555556,0.75,0.25
SF-T22,SF-K22-1,17,8,7,6,10,2,0.4117647058823529,0.5882352941176471,0.75,0.25
SF-T22,SF-J23-1,30,43,7,8,23,35,0.23333333333333334,0.7666666666666667,0.18604651162790697,0.813953488372093
SF-T22,SF-J22-1,12,10,2,6,10,4,0.16666666666666666,0.8333333333333334,0.6,0.4
SF-T22,SF-J21,19,9,5,8,14,1,0.2631578947368421,0.7368421052631579,0.8888888888888888,0.1111111111111111
SF-T22,SF-I22,1,1,0,0,1,1,0.0,1.0,0.0,1.0
SF-T22,SF-I23-2,12,7,5,4,7,3,0.4166666666666667,0.5833333333333334,0.5714285714285714,0.42857142857142855
SF-T22,SF-I24,2,4,0,0,2,4,0.0,1.0,0.0,1.0
SF-T22,SF-I23-1,5,10,1,1,4,9,0.2,0.8,0.1,0.9
SF-T22,SF-F26,10,9,3,4,7,5,0.3,0.7,0.4444444444444444,0.5555555555555556
SF-T22,SF-M13,1,2,1,1,0,1,1.0,0.0,0.5,0.5
SF-T22,SF-M15,7,4,0,0,7,4,0.0,1.0,0.0,1.0
SF-T22,SF-L19,25,5,3,0,22,5,0.12,0.88,0.0,1.0
SF-T22,SF-L20,46,55,39,44,7,11,0.8478260869565217,0.15217391304347827,0.8,0.2
SF-T22,SF-N20-1,10,9,6,4,4,5,0.6,0.4,0.4444444444444444,0.5555555555555556
SF-T22,SF-M20,20,11,4,0,16,11,0.2,0.8,0.0,1.0
SF-T22,SF-K20,70,84,2,4,68,80,0.02857142857142857,0.9714285714285714,0.047619047619047616,0.9523809523809523
SF-T22,SF-K15-,25,12,4,0,21,12,0.16,0.84,0.0,1.0
SF-T22,SF-K19,13,4,0,0,13,4,0.0,1.0,0.0,1.0
SF-T22,SF-K18,3,6,0,0,3,6,0.0,1.0,0.0,1.0
SF-T22,SF-K17,1,3,0,1,1,2,0.0,1.0,0.3333333333333333,0.6666666666666666
SF-T22,SF-J16,2,2,1,0,1,2,0.5,0.5,0.0,1.0
SF-T22,SF-J18,7,7,1,1,6,6,0.14285714285714285,0.8571428571428571,0.14285714285714285,0.8571428571428571
SF-T22,SF-J20,2,4,0,2,2,2,0.0,1.0,0.5,0.5
SF-T22,SF-J19,43,12,6,1,37,11,0.13953488372093023,0.8604651162790697,0.08333333333333333,0.9166666666666666
SF-T22,SF-M12,2,3,0,1,2,2,0.0,1.0,0.3333333333333333,0.6666666666666666
SF-T22,SF-M10,2,1,0,0,2,1,0.0,1.0,0.0,1.0
SF-T22,SF-M11,2,3,0,0,2,3,0.0,1.0,0.0,1.0
SF-T22,SF-R19,21,31,6,10,15,21,0.2857142857142857,0.7142857142857143,0.3225806451612903,0.6774193548387096
SF-T22,SF-R20,24,24,10,4,14,20,0.4166666666666667,0.5833333333333334,0.16666666666666666,0.8333333333333334
SF-T22,SF-Q21-2,17,13,8,2,9,11,0.47058823529411764,0.5294117647058824,0.15384615384615385,0.8461538461538461
SF-T22,SF-Q21-1,9,11,4,5,5,6,0.4444444444444444,0.5555555555555556,0.45454545454545453,0.5454545454545454
SF-T22,SF-P21,72,52,44,5,28,47,0.6111111111111112,0.3888888888888889,0.09615384615384616,0.9038461538461539
SF-T22,SF-O18,9,10,5,2,4,8,0.5555555555555556,0.4444444444444444,0.2,0.8
SF-T22,SF-O19,19,14,7,4,12,10,0.3684210526315789,0.631578947368421,0.2857142857142857,0.7142857142857143
SF-T22,SF-O21,47,50,14,18,33,32,0.2978723404255319,0.7021276595744681,0.36,0.64
SF-T22,SF-O22,125,57,54,32,71,25,0.432,0.568,0.5614035087719298,0.43859649122807015
SF-T22,SF-N21,19,30,9,21,10,9,0.47368421052631576,0.5263157894736842,0.7,0.3
SF-T22,SF-N20-2,8,7,2,3,6,4,0.25,0.75,0.42857142857142855,0.5714285714285714
SF-T22,SF-M21,15,12,6,7,9,5,0.4,0.6,0.5833333333333334,0.4166666666666667
SF-T22,SF-L21,19,16,3,2,16,14,0.15789473684210525,0.8421052631578947,0.125,0.875
SF-T22,SF-S29,3,3,1,3,2,0,0.3333333333333333,0.6666666666666666,1.0,0.0
SF-T22,SF-S30,2,1,0,1,2,0,0.0,1.0,1.0,0.0
SF-T22,SF-Q30,2,4,0,0,2,4,0.0,1.0,0.0,1.0
SF-T22,SF-P30,2,4,0,1,2,3,0.0,1.0,0.25,0.75
SF-T22,SF-O30-2,1,3,0,1,1,2,0.0,1.0,0.3333333333333333,0.6666666666666666
SF-T22,SF-O30,7,6,0,0,7,6,0.0,1.0,0.0,1.0
SF-T22,SF-N27,3,3,1,1,2,2,0.3333333333333333,0.6666666666666666,0.3333333333333333,0.6666666666666666
SF-T22,SF-N29,8,1,2,0,6,1,0.25,0.75,0.0,1.0
SF-T22,SF-N28,5,8,2,4,3,4,0.4,0.6,0.5,0.5
SF-T22,SF-L30-1,10,16,3,7,7,9,0.3,0.7,0.4375,0.5625
SF-T22,SF-L31-1,1,3,0,0,1,3,0.0,1.0,0.0,1.0
SF-T22,SF-K30-2,1,1,0,1,1,0,0.0,1.0,1.0,0.0
SF-T22,SF-L29,3,3,1,1,2,2,0.3333333333333333,0.6666666666666666,0.3333333333333333,0.6666666666666666
SF-T22,SF-J29-1,1,1,1,0,0,1,1.0,0.0,0.0,1.0
SF-T22,SF-I30,1,2,1,0,0,2,1.0,0.0,0.0,1.0
SF-T22,SF-I29-2,1,4,1,2,0,2,1.0,0.0,0.5,0.5
SF-T22,SF-I27,5,2,0,1,5,1,0.0,1.0,0.5,0.5
SF-T22,SF-H28,3,3,0,0,3,3,0.0,1.0,0.0,1.0
SF-T22,SF-S24,59,50,18,20,41,30,0.3050847457627119,0.6949152542372882,0.4,0.6
SF-T22,SF-R24,31,32,13,10,18,22,0.41935483870967744,0.5806451612903226,0.3125,0.6875
SF-T22,SF-R26,9,4,5,2,4,2,0.5555555555555556,0.4444444444444444,0.5,0.5
SF-T22,SF-Q26,8,6,2,0,6,6,0.25,0.75,0.0,1.0
SF-T22,SF-P26,6,10,4,2,2,8,0.6666666666666666,0.3333333333333333,0.2,0.8
SF-T22,SF-O25-2,3,2,0,0,3,2,0.0,1.0,0.0,1.0
SF-T22,SF-N22-1B,5,4,0,2,5,2,0.0,1.0,0.5,0.5
SF-T22,SF-N26,13,4,4,1,9,3,0.3076923076923077,0.6923076923076923,0.25,0.75
SF-T22,SF-N25,5,6,3,3,2,3,0.6,0.4,0.5,0.5
SF-T22,SF-T21,22,11,8,5,14,6,0.36363636363636365,0.6363636363636364,0.45454545454545453,0.5454545454545454
SF-T22,SF-S22-2,12,34,7,12,5,22,0.5833333333333334,0.4166666666666667,0.35294117647058826,0.6470588235294118
SF-T22,SF-S22-1,37,60,26,46,11,14,0.7027027027027027,0.2972972972972973,0.7666666666666667,0.23333333333333334
SF-T22,SF-Q23-3,26,45,18,33,8,12,0.6923076923076923,0.3076923076923077,0.7333333333333333,0.26666666666666666
SF-T22,SF-Q22-1,55,25,27,16,28,9,0.4909090909090909,0.509090909090909,0.64,0.36
SF-T22,SF-Q22-2,46,77,30,47,16,30,0.6521739130434783,0.34782608695652173,0.6103896103896104,0.38961038961038963
SF-T22,SF-P22,52,65,21,31,31,34,0.40384615384615385,0.5961538461538461,0.47692307692307695,0.5230769230769231
SF-T22,SF-W19,13,21,2,4,11,17,0.15384615384615385,0.8461538461538461,0.19047619047619047,0.8095238095238095
SF-T22,SF-W19-2,13,7,4,3,9,4,0.3076923076923077,0.6923076923076923,0.42857142857142855,0.5714285714285714
SF-T22,SF-U21,30,11,16,4,14,7,0.5333333333333333,0.4666666666666667,0.36363636363636365,0.6363636363636364
SF-T22,SF-T20,79,49,54,23,25,26,0.6835443037974683,0.31645569620253167,0.46938775510204084,0.5306122448979592
SF-T22,SF-S21,2,2,1,0,1,2,0.5,0.5,0.0,1.0
SF-T22,SF-X29,1,3,0,0,1,3,0.0,1.0,0.0,1.0
SF-T22,SF-V30,1,1,0,1,1,0,0.0,1.0,1.0,0.0
SF-T22,SF-V32,1,1,0,0,1,1,0.0,1.0,0.0,1.0
SF-T22,SF-U30,1,1,0,1,1,0,0.0,1.0,1.0,0.0
SF-T22,SF-W14,4,6,3,0,1,6,0.75,0.25,0.0,1.0
SF-T22,SF-AA15,3,2,1,1,2,1,0.3333333333333333,0.6666666666666666,0.5,0.5
SF-T22,SF-Z16,1,5,0,0,1,5,0.0,1.0,0.0,1.0
SF-T22,SF-Y14,2,4,1,2,1,2,0.5,0.5,0.5,0.5
SF-T22,SF-X19,4,5,2,0,2,5,0.5,0.5,0.0,1.0
SF-S22-2,SF-M25,6,1,1,0,5,1,0.16666666666666666,0.8333333333333334,0.0,1.0
SF-S22-2,SF-M26-2,4,1,1,0,3,1,0.25,0.75,0.0,1.0
SF-S22-2,SF-K26,3,2,1,2,2,0,0.3333333333333333,0.6666666666666666,1.0,0.0
SF-S22-2,SF-M30,10,17,2,4,8,13,0.2,0.8,0.23529411764705882,0.7647058823529411
SF-S22-2,SF-M28,2,1,0,0,2,1,0.0,1.0,0.0,1.0
SF-S22-2,SF-L25,2,3,0,0,2,3,0.0,1.0,0.0,1.0
SF-S22-2,SF-M24,3,4,0,1,3,3,0.0,1.0,0.25,0.75
SF-S22-2,SF-L24,3,5,1,0,2,5,0.3333333333333333,0.6666666666666666,0.0,1.0
SF-S22-2,SF-N23,5,1,2,1,3,0,0.4,0.6,1.0,0.0
SF-S22-2,SF-K27-2,1,2,0,0,1,2,0.0,1.0,0.0,1.0
SF-S22-2,SF-J26-2,4,8,1,1,3,7,0.25,0.75,0.125,0.875
SF-S22-2,SF-J28-2,1,1,0,0,1,1,0.0,1.0,0.0,1.0
SF-S22-2,SF-K27,1,1,0,0,1,1,0.0,1.0,0.0,1.0
SF-S22-2,SF-K25,2,7,0,4,2,3,0.0,1.0,0.5714285714285714,0.42857142857142855
SF-S22-2,SF-J25,3,1,1,1,2,0,0.3333333333333333,0.6666666666666666,1.0,0.0
SF-S22-2,SF-P24,2,1,2,1,0,0,1.0,0.0,1.0,0.0
SF-S22-2,SF-J24,2,1,1,1,1,0,0.5,0.5,1.0,0.0
SF-S22-2,SF-O24,2,1,0,1,2,0,0.0,1.0,1.0,0.0
SF-S22-2,SF-J26,1,3,0,1,1,2,0.0,1.0,0.3333333333333333,0.6666666666666666
SF-S22-2,SF-I26-,1,5,0,0,1,5,0.0,1.0,0.0,1.0
SF-S22-2,SF-I25,1,5,0,0,1,5,0.0,1.0,0.0,1.0
SF-S22-2,SF-H26,3,3,0,1,3,2,0.0,1.0,0.3333333333333333,0.6666666666666666
SF-S22-2,SF-O23,3,7,0,4,3,3,0.0,1.0,0.5714285714285714,0.42857142857142855
SF-S22-2,SF-F28-2,2,2,2,0,0,2,1.0,0.0,0.0,1.0
SF-S22-2,SF-G27,5,6,0,0,5,6,0.0,1.0,0.0,1.0
SF-S22-2,SF-M22-2,29,63,8,14,21,49,0.27586206896551724,0.7241379310344828,0.2222222222222222,0.7777777777777778
SF-S22-2,SF-L22,3,11,2,3,1,8,0.6666666666666666,0.3333333333333333,0.2727272727272727,0.7272727272727273
SF-S22-2,SF-N22-2,27,21,6,8,21,13,0.2222222222222222,0.7777777777777778,0.38095238095238093,0.6190476190476191
SF-S22-2,SF-M22-1,2,3,0,0,2,3,0.0,1.0,0.0,1.0
SF-S22-2,SF-O25-1,1,1,0,0,1,1,0.0,1.0,0.0,1.0
SF-S22-2,SF-K22-2,1,5,1,0,0,5,1.0,0.0,0.0,1.0
SF-S22-2,SF-K24,5,1,1,0,4,1,0.2,0.8,0.0,1.0
SF-S22-2,SF-G23,4,1,3,0,1,1,0.75,0.25,0.0,1.0
SF-S22-2,SF-G24,1,8,0,1,1,7,0.0,1.0,0.125,0.875
SF-S22-2,SF-F23,1,1,0,1,1,0,0.0,1.0,1.0,0.0
SF-S22-2,SF-E23,3,1,0,0,3,1,0.0,1.0,0.0,1.0
SF-S22-2,SF-H30,3,2,0,0,3,2,0.0,1.0,0.0,1.0
SF-S22-2,SF-E29-2,3,5,1,3,2,2,0.3333333333333333,0.6666666666666666,0.6,0.4
SF-S22-2,SF-E29-1,2,3,1,1,1,2,0.5,0.5,0.3333333333333333,0.6666666666666666
SF-S22-2,SF-G29-2,1,2,1,0,0,2,1.0,0.0,0.0,1.0
SF-S22-2,SF-J13,3,1,0,0,3,1,0.0,1.0,0.0,1.0
SF-S22-2,SF-G13,1,1,0,1,1,0,0.0,1.0,1.0,0.0
SF-S22-2,SF-G12,1,1,0,1,1,0,0.0,1.0,1.0,0.0
SF-S22-2,SF-C20,3,1,0,0,3,1,0.0,1.0,0.0,1.0
SF-S22-2,SF-C25,3,3,0,0,3,3,0.0,1.0,0.0,1.0
SF-S22-2,SF-E27,4,3,0,0,4,3,0.0,1.0,0.0,1.0
SF-S22-2,SF-H25,5,11,0,0,5,11,0.0,1.0,0.0,1.0
SF-S22-2,SF-K21,1,1,0,0,1,1,0.0,1.0,0.0,1.0
SF-S22-2,SF-K22-1,7,2,3,0,4,2,0.42857142857142855,0.5714285714285714,0.0,1.0
SF-S22-2,SF-J23-1,9,9,0,1,9,8,0.0,1.0,0.1111111111111111,0.8888888888888888
SF-S22-2,SF-J22-1,3,12,1,3,2,9,0.3333333333333333,0.6666666666666666,0.25,0.75
SF-S22-2,SF-J22-2,1,1,0,0,1,1,0.0,1.0,0.0,1.0
SF-S22-2,SF-J21,8,5,1,1,7,4,0.125,0.875,0.2,0.8
SF-S22-2,SF-I22,2,3,0,1,2,2,0.0,1.0,0.3333333333333333,0.6666666666666666
SF-S22-2,SF-I23-2,1,4,0,2,1,2,0.0,1.0,0.5,0.5
SF-S22-2,SF-I24,2,4,0,0,2,4,0.0,1.0,0.0,1.0
SF-S22-2,SF-I23-1,3,1,0,0,3,1,0.0,1.0,0.0,1.0
SF-S22-2,SF-F26,2,2,2,1,0,1,1.0,0.0,0.5,0.5
SF-S22-2,SF-M15,1,3,0,0,1,3,0.0,1.0,0.0,1.0
SF-S22-2,SF-L19,2,7,0,1,2,6,0.0,1.0,0.14285714285714285,0.8571428571428571
SF-S22-2,SF-L20,5,5,4,1,1,4,0.8,0.2,0.2,0.8
SF-S22-2,SF-M20,11,13,0,0,11,13,0.0,1.0,0.0,1.0
SF-S22-2,SF-K20,2,5,1,1,1,4,0.5,0.5,0.2,0.8
SF-S22-2,SF-K15-,1,5,0,1,1,4,0.0,1.0,0.2,0.8
SF-S22-2,SF-K19,5,1,0,0,5,1,0.0,1.0,0.0,1.0
SF-S22-2,SF-K18,1,4,0,0,1,4,0.0,1.0,0.0,1.0
SF-S22-2,SF-K17,3,3,0,0,3,3,0.0,1.0,0.0,1.0
SF-S22-2,SF-J18,7,5,3,0,4,5,0.42857142857142855,0.5714285714285714,0.0,1.0
SF-S22-2,SF-J19,13,8,0,0,13,8,0.0,1.0,0.0,1.0
SF-S22-2,SF-R19,8,5,3,0,5,5,0.375,0.625,0.0,1.0
SF-S22-2,SF-R20,5,4,1,2,4,2,0.2,0.8,0.5,0.5
SF-S22-2,SF-Q21-2,2,1,0,1,2,0,0.0,1.0,1.0,0.0
SF-S22-2,SF-P21,11,13,1,3,10,10,0.09090909090909091,0.9090909090909091,0.23076923076923078,0.7692307692307693
SF-S22-2,SF-O18,1,1,1,0,0,1,1.0,0.0,0.0,1.0
SF-S22-2,SF-O19,8,17,0,2,8,15,0.0,1.0,0.11764705882352941,0.8823529411764706
SF-S22-2,SF-O21,19,25,2,7,17,18,0.10526315789473684,0.8947368421052632,0.28,0.72
SF-S22-2,SF-O22,26,21,4,10,22,11,0.15384615384615385,0.8461538461538461,0.47619047619047616,0.5238095238095238
SF-S22-2,SF-N21,9,8,0,3,9,5,0.0,1.0,0.375,0.625
SF-S22-2,SF-N20-2,1,4,0,0,1,4,0.0,1.0,0.0,1.0
SF-S22-2,SF-M21,6,12,0,1,6,11,0.0,1.0,0.08333333333333333,0.9166666666666666
SF-S22-2,SF-L21,6,5,0,0,6,5,0.0,1.0,0.0,1.0
SF-S22-2,SF-Q30,3,5,0,2,3,3,0.0,1.0,0.4,0.6
SF-S22-2,SF-P30,1,1,0,0,1,1,0.0,1.0,0.0,1.0
SF-S22-2,SF-O30,2,5,0,2,2,3,0.0,1.0,0.4,0.6
SF-S22-2,SF-N27,2,2,0,0,2,2,0.0,1.0,0.0,1.0
SF-S22-2,SF-N28,4,5,0,1,4,4,0.0,1.0,0.2,0.8
SF-S22-2,SF-L30-1,2,1,0,0,2,1,0.0,1.0,0.0,1.0
SF-S22-2,SF I29-1,1,2,0,0,1,2,0.0,1.0,0.0,1.0
SF-S22-2,SF-H28,2,3,0,2,2,1,0.0,1.0,0.6666666666666666,0.3333333333333333
SF-S22-2,SF-S24,9,13,5,11,4,2,0.5555555555555556,0.4444444444444444,0.8461538461538461,0.15384615384615385
SF-S22-2,SF-R24,4,12,1,4,3,8,0.25,0.75,0.3333333333333333,0.6666666666666666
SF-S22-2,SF-R26,6,2,3,1,3,1,0.5,0.5,0.5,0.5
SF-S22-2,SF-Q26,1,2,0,1,1,1,0.0,1.0,0.5,0.5
SF-S22-2,SF-P26,3,2,1,1,2,1,0.3333333333333333,0.6666666666666666,0.5,0.5
SF-S22-2,SF-O25-2,2,3,1,3,1,0,0.5,0.5,1.0,0.0
SF-S22-2,SF-N26,4,32,0,0,4,32,0.0,1.0,0.0,1.0
SF-S22-2,SF-N25,11,1,0,0,11,1,0.0,1.0,0.0,1.0
SF-S22-2,SF-T21,10,5,3,3,7,2,0.3,0.7,0.6,0.4
SF-S22-2,SF-T22,34,12,12,7,22,5,0.35294117647058826,0.6470588235294118,0.5833333333333334,0.4166666666666667
SF-S22-2,SF-S22-1,22,52,7,46,15,6,0.3181818181818182,0.6818181818181818,0.8846153846153846,0.11538461538461539
SF-S22-2,SF-Q23-3,21,35,5,17,16,18,0.23809523809523808,0.7619047619047619,0.4857142857142857,0.5142857142857142
SF-S22-2,SF-Q22-1,14,13,5,7,9,6,0.35714285714285715,0.6428571428571429,0.5384615384615384,0.46153846153846156
SF-S22-2,SF-Q22-2,32,30,2,22,30,8,0.0625,0.9375,0.7333333333333333,0.26666666666666666
SF-S22-2,SF-P22,27,34,9,16,18,18,0.3333333333333333,0.6666666666666666,0.47058823529411764,0.5294117647058824
SF-S22-2,SF-W19,4,8,1,1,3,7,0.25,0.75,0.125,0.875
SF-S22-2,SF-W19-2,1,3,1,1,0,2,1.0,0.0,0.3333333333333333,0.6666666666666666
SF-S22-2,SF-U21,8,7,7,2,1,5,0.875,0.125,0.2857142857142857,0.7142857142857143
SF-S22-2,SF-T20,9,5,5,2,4,3,0.5555555555555556,0.4444444444444444,0.4,0.6
SF-S22-2,SF-S21,1,4,1,4,0,0,1.0,0.0,1.0,0.0
SF-S22-2,SF-W14,5,4,2,2,3,2,0.4,0.6,0.5,0.5
SF-S22-2,SF-AA15,3,4,0,0,3,4,0.0,1.0,0.0,1.0
SF-S22-2,SF-X19,1,3,1,1,0,2,1.0,0.0,0.3333333333333333,0.6666666666666666
SF-S22-1,SF-M26,4,2,3,2,1,0,0.75,0.25,1.0,0.0
SF-S22-1,SF-M25,9,5,3,1,6,4,0.3333333333333333,0.6666666666666666,0.2,0.8
SF-S22-1,SF-M26-2,7,3,4,1,3,2,0.5714285714285714,0.42857142857142855,0.3333333333333333,0.6666666666666666
SF-S22-1,SF-L27,2,7,0,1,2,6,0.0,1.0,0.14285714285714285,0.8571428571428571
SF-S22-1,SF-J27,7,5,0,1,7,4,0.0,1.0,0.2,0.8
SF-S22-1,SF-M30,1,15,0,1,1,14,0.0,1.0,0.06666666666666667,0.9333333333333333
SF-S22-1,SF-J29-3,3,2,0,0,3,2,0.0,1.0,0.0,1.0
SF-S22-1,SF-J29,2,4,1,0,1,4,0.5,0.5,0.0,1.0
SF-S22-1,SF-L26,15,25,1,8,14,17,0.06666666666666667,0.9333333333333333,0.32,0.68
SF-S22-1,SF-M28,1,2,0,0,1,2,0.0,1.0,0.0,1.0
SF-S22-1,SF-L25,9,7,1,2,8,5,0.1111111111111111,0.8888888888888888,0.2857142857142857,0.7142857142857143
SF-S22-1,SF-M24,10,10,4,3,6,7,0.4,0.6,0.3,0.7
SF-S22-1,SF-L24,12,4,8,1,4,3,0.6666666666666666,0.3333333333333333,0.25,0.75
SF-S22-1,SF-N23,15,5,8,3,7,2,0.5333333333333333,0.4666666666666667,0.6,0.4
SF-S22-1,SF-N24-2,4,3,1,1,3,2,0.25,0.75,0.3333333333333333,0.6666666666666666
SF-S22-1,SF-K27-2,3,9,2,4,1,5,0.6666666666666666,0.3333333333333333,0.4444444444444444,0.5555555555555556
SF-S22-1,SF-J26-2,5,5,2,0,3,5,0.4,0.6,0.0,1.0
SF-S22-1,SF-L28,2,3,0,1,2,2,0.0,1.0,0.3333333333333333,0.6666666666666666
SF-S22-1,SF-K28,2,1,1,0,1,1,0.5,0.5,0.0,1.0
SF-S22-1,SF-K25,9,8,0,0,9,8,0.0,1.0,0.0,1.0
SF-S22-1,SF-J25,8,6,1,2,7,4,0.125,0.875,0.3333333333333333,0.6666666666666666
SF-S22-1,SF-H26-2,6,3,2,0,4,3,0.3333333333333333,0.6666666666666666,0.0,1.0
SF-S22-1,SF-P24,7,5,4,4,3,1,0.5714285714285714,0.42857142857142855,0.8,0.2
SF-S22-1,SF-J24,1,1,1,0,0,1,1.0,0.0,0.0,1.0
SF-S22-1,SF-O24,3,5,2,2,1,3,0.6666666666666666,0.3333333333333333,0.4,0.6
SF-S22-1,SF-J26,2,6,0,4,2,2,0.0,1.0,0.6666666666666666,0.3333333333333333
SF-S22-1,SF-I26-,7,4,3,2,4,2,0.42857142857142855,0.5714285714285714,0.5,0.5
SF-S22-1,SF-I25,10,11,6,6,4,5,0.6,0.4,0.5454545454545454,0.45454545454545453
SF-S22-1,SF-H26,12,15,3,6,9,9,0.25,0.75,0.4,0.6
SF-S22-1,SF-O23,26,18,17,10,9,8,0.6538461538461539,0.34615384615384615,0.5555555555555556,0.4444444444444444
SF-S22-1,SF-H27-1,1,2,0,2,1,0,0.0,1.0,1.0,0.0
SF-S22-1,SF-F28-2,11,2,7,2,4,0,0.6363636363636364,0.36363636363636365,1.0,0.0
SF-S22-1,SF-G27,10,13,5,6,5,7,0.5,0.5,0.46153846153846156,0.5384615384615384
SF-S22-1,SF-M22-2,41,78,21,39,20,39,0.5121951219512195,0.4878048780487805,0.5,0.5
SF-S22-1,SF-L22,30,42,16,17,14,25,0.5333333333333333,0.4666666666666667,0.40476190476190477,0.5952380952380952
SF-S22-1,SF-F27,6,6,2,1,4,5,0.3333333333333333,0.6666666666666666,0.16666666666666666,0.8333333333333334
SF-S22-1,SF-N22-2,37,48,22,25,15,23,0.5945945945945946,0.40540540540540543,0.5208333333333334,0.4791666666666667
SF-S22-1,SF-M22-1,9,10,4,4,5,6,0.4444444444444444,0.5555555555555556,0.4,0.6
SF-S22-1,SF-O25-1,2,2,2,0,0,2,1.0,0.0,0.0,1.0
SF-S22-1,SF-K22-2,21,35,16,22,5,13,0.7619047619047619,0.23809523809523808,0.6285714285714286,0.37142857142857144
SF-S22-1,SF-K24,2,6,1,3,1,3,0.5,0.5,0.5,0.5
SF-S22-1,SF-J23-2,13,6,8,3,5,3,0.6153846153846154,0.38461538461538464,0.5,0.5
SF-S22-1,SF-G23,1,1,0,0,1,1,0.0,1.0,0.0,1.0
SF-S22-1,SF-G24,4,6,0,0,4,6,0.0,1.0,0.0,1.0
SF-S22-1,SF-G25,12,6,2,3,10,3,0.16666666666666666,0.8333333333333334,0.5,0.5
SF-S22-1,SF-F23,6,12,2,0,4,12,0.3333333333333333,0.6666666666666666,0.0,1.0
SF-S22-1,SF-E23,16,13,6,2,10,11,0.375,0.625,0.15384615384615385,0.8461538461538461
SF-S22-1,SF-D24,5,2,2,1,3,1,0.4,0.6,0.5,0.5
SF-S22-1,SF-C22,4,2,0,0,4,2,0.0,1.0,0.0,1.0
SF-S22-1,SF-J17,26,19,4,0,22,19,0.15384615384615385,0.8461538461538461,0.0,1.0
SF-S22-1,SF-I20,2,1,0,0,2,1,0.0,1.0,0.0,1.0
SF-S22-1,SF-H16,6,11,0,0,6,11,0.0,1.0,0.0,1.0
SF-S22-1,SF-H20,36,37,0,2,36,35,0.0,1.0,0.05405405405405406,0.9459459459459459
SF-S22-1,SF-H18,1,3,1,0,0,3,1.0,0.0,0.0,1.0
SF-S22-1,SF-G19,1,1,0,0,1,1,0.0,1.0,0.0,1.0
SF-S22-1,SF-G18,3,2,1,0,2,2,0.3333333333333333,0.6666666666666666,0.0,1.0
SF-S22-1,SF-G20,11,2,1,0,10,2,0.09090909090909091,0.9090909090909091,0.0,1.0
SF-S22-1,SF-F19,1,1,0,0,1,1,0.0,1.0,0.0,1.0
SF-S22-1,SF-E18,1,2,1,1,0,1,1.0,0.0,0.5,0.5
SF-S22-1,SF-G30-2,5,2,1,0,4,2,0.2,0.8,0.0,1.0
SF-S22-1,SF-E29-2,2,4,1,0,1,4,0.5,0.5,0.0,1.0
SF-S22-1,SF-E29-1,6,8,5,5,1,3,0.8333333333333334,0.16666666666666666,0.625,0.375
SF-S22-1,SF-D28,4,2,3,0,1,2,0.75,0.25,0.0,1.0
SF-S22-1,SF-G29-2,3,6,0,1,3,5,0.0,1.0,0.16666666666666666,0.8333333333333334
SF-S22-1,SF-G29-1,2,2,2,0,0,2,1.0,0.0,0.0,1.0
SF-S22-1,SF-F28-1,13,10,8,6,5,4,0.6153846153846154,0.38461538461538464,0.6,0.4
SF-S22-1,SF-E28,1,2,1,2,0,0,1.0,0.0,1.0,0.0
SF-S22-1,SF-J12,23,26,1,7,22,19,0.043478260869565216,0.9565217391304348,0.2692307692307692,0.7307692307692307
SF-S22-1,SF-H14,1,1,0,0,1,1,0.0,1.0,0.0,1.0
SF-S22-1,SF-G13,4,3,0,0,4,3,0.0,1.0,0.0,1.0
SF-S22-1,SF-F15,1,2,1,0,0,2,1.0,0.0,0.0,1.0
SF-S22-1,SF-B19,4,1,0,0,4,1,0.0,1.0,0.0,1.0
SF-S22-1,SF-A20,1,1,0,0,1,1,0.0,1.0,0.0,1.0
SF-S22-1,SF-C26,4,3,1,0,3,3,0.25,0.75,0.0,1.0
SF-S22-1,SF-C25,8,5,1,2,7,3,0.125,0.875,0.4,0.6
SF-S22-1,SF-B28-2,2,1,2,0,0,1,1.0,0.0,0.0,1.0
SF-S22-1,SF-B28,3,4,2,1,1,3,0.6666666666666666,0.3333333333333333,0.25,0.75
SF-S22-1,SF-G8,2,2,0,0,2,2,0.0,1.0,0.0,1.0
SF-S22-1,SF-G7,2,3,0,0,2,3,0.0,1.0,0.0,1.0
SF-S22-1,SF-G26,4,3,3,0,1,3,0.75,0.25,0.0,1.0
SF-S22-1,SF-K21,14,3,3,0,11,3,0.21428571428571427,0.7857142857142857,0.0,1.0
SF-S22-1,SF-K22-1,5,4,5,2,0,2,1.0,0.0,0.5,0.5
SF-S22-1,SF-J23-1,32,38,9,16,23,22,0.28125,0.71875,0.42105263157894735,0.5789473684210527
SF-S22-1,SF-J22-1,8,21,4,12,4,9,0.5,0.5,0.5714285714285714,0.42857142857142855
SF-S22-1,SF-J22-2,7,8,2,2,5,6,0.2857142857142857,0.7142857142857143,0.25,0.75
SF-S22-1,SF-J21,25,16,11,8,14,8,0.44,0.56,0.5,0.5
SF-S22-1,SF-I21,2,3,0,2,2,1,0.0,1.0,0.6666666666666666,0.3333333333333333
SF-S22-1,SF-I22,2,2,0,1,2,1,0.0,1.0,0.5,0.5
SF-S22-1,SF-I23-2,5,9,5,5,0,4,1.0,0.0,0.5555555555555556,0.4444444444444444
SF-S22-1,SF-I23-1,3,5,1,2,2,3,0.3333333333333333,0.6666666666666666,0.4,0.6
SF-S22-1,SF-F26,6,8,4,0,2,8,0.6666666666666666,0.3333333333333333,0.0,1.0
SF-S22-1,SF-M13,4,20,0,7,4,13,0.0,1.0,0.35,0.65
SF-S22-1,SF-M15,6,4,1,1,5,3,0.16666666666666666,0.8333333333333334,0.25,0.75
SF-S22-1,SF-L19,7,11,2,3,5,8,0.2857142857142857,0.7142857142857143,0.2727272727272727,0.7272727272727273
SF-S22-1,SF-L20,31,8,21,6,10,2,0.6774193548387096,0.3225806451612903,0.75,0.25
SF-S22-1,SF-N20-1,33,21,7,1,26,20,0.21212121212121213,0.7878787878787878,0.047619047619047616,0.9523809523809523
SF-S22-1,SF-M20,26,13,6,5,20,8,0.23076923076923078,0.7692307692307693,0.38461538461538464,0.6153846153846154
SF-S22-1,SF-K17-2,6,4,4,0,2,4,0.6666666666666666,0.3333333333333333,0.0,1.0
SF-S22-1,SF-K20,30,24,4,4,26,20,0.13333333333333333,0.8666666666666667,0.16666666666666666,0.8333333333333334
SF-S22-1,SF-K15-,21,39,9,22,12,17,0.42857142857142855,0.5714285714285714,0.5641025641025641,0.4358974358974359
SF-S22-1,SF-K19,28,9,9,3,19,6,0.32142857142857145,0.6785714285714286,0.3333333333333333,0.6666666666666666
SF-S22-1,SF-K18,59,4,5,0,54,4,0.0847457627118644,0.9152542372881356,0.0,1.0
SF-S22-1,SF-K17,8,13,3,5,5,8,0.375,0.625,0.38461538461538464,0.6153846153846154
SF-S22-1,SF-J16,2,1,0,0,2,1,0.0,1.0,0.0,1.0
SF-S22-1,SF-J18,9,10,3,2,6,8,0.3333333333333333,0.6666666666666666,0.2,0.8
SF-S22-1,SF-J20,63,22,11,8,52,14,0.1746031746031746,0.8253968253968254,0.36363636363636365,0.6363636363636364
SF-S22-1,SF-J19,10,4,1,0,9,4,0.1,0.9,0.0,1.0
SF-S22-1,SF-M12,8,3,5,0,3,3,0.625,0.375,0.0,1.0
SF-S22-1,SF-M10,1,2,1,1,0,1,1.0,0.0,0.5,0.5
SF-S22-1,SF-M11,2,5,0,2,2,3,0.0,1.0,0.4,0.6
SF-S22-1,SF-R19,5,12,0,3,5,9,0.0,1.0,0.25,0.75
SF-S22-1,SF-R20,11,4,6,2,5,2,0.5454545454545454,0.45454545454545453,0.5,0.5
SF-S22-1,SF-Q21-2,9,10,7,1,2,9,0.7777777777777778,0.2222222222222222,0.1,0.9
SF-S22-1,SF-Q21-1,21,17,18,16,3,1,0.8571428571428571,0.14285714285714285,0.9411764705882353,0.058823529411764705
SF-S22-1,SF-P21,18,32,8,15,10,17,0.4444444444444444,0.5555555555555556,0.46875,0.53125
SF-S22-1,SF-O18,12,6,10,2,2,4,0.8333333333333334,0.16666666666666666,0.3333333333333333,0.6666666666666666
SF-S22-1,SF-O19,22,23,7,6,15,17,0.3181818181818182,0.6818181818181818,0.2608695652173913,0.7391304347826086
SF-S22-1,SF-O21,47,48,19,21,28,27,0.40425531914893614,0.5957446808510638,0.4375,0.5625
SF-S22-1,SF-O22,100,66,43,40,57,26,0.43,0.57,0.6060606060606061,0.3939393939393939
SF-S22-1,SF-N21,27,17,21,9,6,8,0.7777777777777778,0.2222222222222222,0.5294117647058824,0.47058823529411764
SF-S22-1,SF-N20-2,3,13,1,9,2,4,0.3333333333333333,0.6666666666666666,0.6923076923076923,0.3076923076923077
SF-S22-1,SF-M21,20,15,7,9,13,6,0.35,0.65,0.6,0.4
SF-S22-1,SF-L21,15,16,5,7,10,9,0.3333333333333333,0.6666666666666666,0.4375,0.5625
SF-S22-1,SF-S29,21,21,7,8,14,13,0.3333333333333333,0.6666666666666666,0.38095238095238093,0.6190476190476191
SF-S22-1,SF-S30,1,1,0,0,1,1,0.0,1.0,0.0,1.0
SF-S22-1,SF-Q30,4,1,1,0,3,1,0.25,0.75,0.0,1.0
SF-S22-1,SF-P30,8,5,3,2,5,3,0.375,0.625,0.4,0.6
SF-S22-1,SF-O30-2,6,5,3,1,3,4,0.5,0.5,0.2,0.8
SF-S22-1,SF-O30,2,2,0,0,2,2,0.0,1.0,0.0,1.0
SF-S22-1,SF-N27,2,2,1,1,1,1,0.5,0.5,0.5,0.5
SF-S22-1,SF-N29,1,2,0,0,1,2,0.0,1.0,0.0,1.0
SF-S22-1,SF-N28,10,5,4,2,6,3,0.4,0.6,0.4,0.6
SF-S22-1,SF-L30-1,8,8,2,4,6,4,0.25,0.75,0.5,0.5
SF-S22-1,SF-L31-1,2,3,1,0,1,3,0.5,0.5,0.0,1.0
SF-S22-1,SF-L29,6,2,2,0,4,2,0.3333333333333333,0.6666666666666666,0.0,1.0
SF-S22-1,SF-I30,1,2,0,0,1,2,0.0,1.0,0.0,1.0
SF-S22-1,SF-I27,3,8,2,6,1,2,0.6666666666666666,0.3333333333333333,0.75,0.25
SF-S22-1,SF-H28,2,3,1,0,1,3,0.5,0.5,0.0,1.0
SF-S22-1,SF-S24,34,17,27,14,7,3,0.7941176470588235,0.20588235294117646,0.8235294117647058,0.17647058823529413
SF-S22-1,SF-R24,14,41,7,13,7,28,0.5,0.5,0.3170731707317073,0.6829268292682927
SF-S22-1,SF-R26,5,7,1,3,4,4,0.2,0.8,0.42857142857142855,0.5714285714285714
SF-S22-1,SF-Q26,13,11,4,1,9,10,0.3076923076923077,0.6923076923076923,0.09090909090909091,0.9090909090909091
SF-S22-1,SF-P26,38,7,1,2,37,5,0.02631578947368421,0.9736842105263158,0.2857142857142857,0.7142857142857143
SF-S22-1,SF-O25-2,9,12,3,8,6,4,0.3333333333333333,0.6666666666666666,0.6666666666666666,0.3333333333333333
SF-S22-1,SF-N22-1B,5,8,1,3,4,5,0.2,0.8,0.375,0.625
SF-S22-1,SF-N26,5,4,1,0,4,4,0.2,0.8,0.0,1.0
SF-S22-1,SF-N25,6,4,1,1,5,3,0.16666666666666666,0.8333333333333334,0.25,0.75
SF-S22-1,SF-T21,16,20,12,14,4,6,0.75,0.25,0.7,0.3
SF-S22-1,SF-T22,60,37,46,26,14,11,0.7666666666666667,0.23333333333333334,0.7027027027027027,0.2972972972972973
SF-S22-1,SF-S22-2,52,22,46,7,6,15,0.8846153846153846,0.11538461538461539,0.3181818181818182,0.6818181818181818
SF-S22-1,SF-Q23-3,20,22,12,13,8,9,0.6,0.4,0.5909090909090909,0.4090909090909091
SF-S22-1,SF-Q22-1,21,20,15,11,6,9,0.7142857142857143,0.2857142857142857,0.55,0.45
SF-S22-1,SF-Q22-2,19,87,12,68,7,19,0.631578947368421,0.3684210526315789,0.7816091954022989,0.21839080459770116
SF-S22-1,SF-P22,44,70,32,40,12,30,0.7272727272727273,0.2727272727272727,0.5714285714285714,0.42857142857142855
SF-S22-1,SF-W19,12,12,7,6,5,6,0.5833333333333334,0.4166666666666667,0.5,0.5
SF-S22-1,SF-W19-2,1,3,0,0,1,3,0.0,1.0,0.0,1.0
SF-S22-1,SF-U21,14,8,8,3,6,5,0.5714285714285714,0.42857142857142855,0.375,0.625
SF-S22-1,SF-T20,50,28,36,11,14,17,0.72,0.28,0.39285714285714285,0.6071428571428571
SF-S22-1,SF-S21,19,4,17,4,2,0,0.8947368421052632,0.10526315789473684,1.0,0.0
SF-S22-1,SF-Z28,2,2,0,0,2,2,0.0,1.0,0.0,1.0
SF-S22-1,SF-X29,11,19,0,0,11,19,0.0,1.0,0.0,1.0
SF-S22-1,SF-V28,8,5,1,1,7,4,0.125,0.875,0.2,0.8
SF-S22-1,SF-V29,2,1,0,1,2,0,0.0,1.0,1.0,0.0
SF-S22-1,SF-V32,4,2,0,0,4,2,0.0,1.0,0.0,1.0
SF-S22-1,SF-W14,2,4,2,0,0,4,1.0,0.0,0.0,1.0
SF-S22-1,SF-BB17,1,2,0,2,1,0,0.0,1.0,1.0,0.0
SF-S22-1,SF-AA15,4,2,0,0,4,2,0.0,1.0,0.0,1.0
SF-S22-1,SF-Z16,2,2,1,0,1,2,0.5,0.5,0.0,1.0
SF-S22-1,SF-X14,1,2,0,2,1,0,0.0,1.0,1.0,0.0
SF-S22-1,SF-X19,2,2,0,1,2,1,0.0,1.0,0.5,0.5
SF-S22-1,SF-Y25,2,1,1,1,1,0,0.5,0.5,1.0,0.0
SF-Q23-3,SF-M26,2,1,1,0,1,1,0.5,0.5,0.0,1.0
SF-Q23-3,SF-M25,5,3,2,2,3,1,0.4,0.6,0.6666666666666666,0.3333333333333333
SF-Q23-3,SF-M26-2,3,4,3,3,0,1,1.0,0.0,0.75,0.25
SF-Q23-3,SF-K26,10,4,3,1,7,3,0.3,0.7,0.25,0.75
SF-Q23-3,SF-J27,7,2,3,1,4,1,0.42857142857142855,0.5714285714285714,0.5,0.5
SF-Q23-3,SF-M30,16,41,4,20,12,21,0.25,0.75,0.4878048780487805,0.5121951219512195
SF-Q23-3,SF-L27-2,2,1,1,0,1,1,0.5,0.5,0.0,1.0
SF-Q23-3,SF-J29,6,10,5,5,1,5,0.8333333333333334,0.16666666666666666,0.5,0.5
SF-Q23-3,SF-L26,29,17,19,4,10,13,0.6551724137931034,0.3448275862068966,0.23529411764705882,0.7647058823529411
SF-Q23-3,SF-M28,3,9,2,2,1,7,0.6666666666666666,0.3333333333333333,0.2222222222222222,0.7777777777777778
SF-Q23-3,SF-L25,16,3,8,1,8,2,0.5,0.5,0.3333333333333333,0.6666666666666666
SF-Q23-3,SF-M24,19,14,10,9,9,5,0.5263157894736842,0.47368421052631576,0.6428571428571429,0.35714285714285715
SF-Q23-3,SF-L24,19,7,12,4,7,3,0.631578947368421,0.3684210526315789,0.5714285714285714,0.42857142857142855
SF-Q23-3,SF-N23,10,4,8,2,2,2,0.8,0.2,0.5,0.5
SF-Q23-3,SF-N24-2,12,7,5,5,7,2,0.4166666666666667,0.5833333333333334,0.7142857142857143,0.2857142857142857
SF-Q23-3,SF-K27-2,3,9,0,2,3,7,0.0,1.0,0.2222222222222222,0.7777777777777778
SF-Q23-3,SF-J26-2,11,17,3,4,8,13,0.2727272727272727,0.7272727272727273,0.23529411764705882,0.7647058823529411
SF-Q23-3,SF-L28,8,4,5,2,3,2,0.625,0.375,0.5,0.5
SF-Q23-3,SF-K28,2,1,1,1,1,0,0.5,0.5,1.0,0.0
SF-Q23-3,SF-K29-1,2,3,2,3,0,0,1.0,0.0,1.0,0.0
SF-Q23-3,SF-K27,2,1,0,0,2,1,0.0,1.0,0.0,1.0
SF-Q23-3,SF-K25,7,22,0,9,7,13,0.0,1.0,0.4090909090909091,0.5909090909090909
SF-Q23-3,SF-J25,20,15,9,8,11,7,0.45,0.55,0.5333333333333333,0.4666666666666667
SF-Q23-3,SF-H26-2,3,14,2,8,1,6,0.6666666666666666,0.3333333333333333,0.5714285714285714,0.42857142857142855
SF-Q23-3,SF-P24,23,17,15,8,8,9,0.6521739130434783,0.34782608695652173,0.47058823529411764,0.5294117647058824
SF-Q23-3,SF-N22-1A,3,5,3,4,0,1,1.0,0.0,0.8,0.2
SF-Q23-3,SF-J24,4,4,1,2,3,2,0.25,0.75,0.5,0.5
SF-Q23-3,SF-O24,5,10,3,9,2,1,0.6,0.4,0.9,0.1
SF-Q23-3,SF-J26,5,4,0,1,5,3,0.0,1.0,0.25,0.75
SF-Q23-3,SF-I25,25,45,6,2,19,43,0.24,0.76,0.044444444444444446,0.9555555555555556
SF-Q23-3,SF-K23,3,2,0,0,3,2,0.0,1.0,0.0,1.0
SF-Q23-3,SF-H26,14,13,8,7,6,6,0.5714285714285714,0.42857142857142855,0.5384615384615384,0.46153846153846156
SF-Q23-3,SF-O23,14,22,6,16,8,6,0.42857142857142855,0.5714285714285714,0.7272727272727273,0.2727272727272727
SF-Q23-3,SF-F28-2,5,13,5,6,0,7,1.0,0.0,0.46153846153846156,0.5384615384615384
SF-Q23-3,SF-G27,7,14,1,7,6,7,0.14285714285714285,0.8571428571428571,0.5,0.5
SF-Q23-3,SF-M22-2,26,43,11,20,15,23,0.4230769230769231,0.5769230769230769,0.46511627906976744,0.5348837209302325
SF-Q23-3,SF-L22,19,35,11,20,8,15,0.5789473684210527,0.42105263157894735,0.5714285714285714,0.42857142857142855
SF-Q23-3,SF-F27,6,16,0,7,6,9,0.0,1.0,0.4375,0.5625
SF-Q23-3,SF-N22-2,29,36,13,27,16,9,0.4482758620689655,0.5517241379310345,0.75,0.25
SF-Q23-3,SF-G28-2,3,2,3,0,0,2,1.0,0.0,0.0,1.0
SF-Q23-3,SF-M22-1,8,9,1,4,7,5,0.125,0.875,0.4444444444444444,0.5555555555555556
SF-Q23-3,SF-O25-1,9,10,7,8,2,2,0.7777777777777778,0.2222222222222222,0.8,0.2
SF-Q23-3,SF-K22-2,15,18,7,11,8,7,0.4666666666666667,0.5333333333333333,0.6111111111111112,0.3888888888888889
SF-Q23-3,SF-K24,11,16,7,13,4,3,0.6363636363636364,0.36363636363636365,0.8125,0.1875
SF-Q23-3,SF-J23-2,11,6,7,2,4,4,0.6363636363636364,0.36363636363636365,0.3333333333333333,0.6666666666666666
SF-Q23-3,SF-G23,3,7,1,3,2,4,0.3333333333333333,0.6666666666666666,0.42857142857142855,0.5714285714285714
SF-Q23-3,SF-G24,21,15,4,0,17,15,0.19047619047619047,0.8095238095238095,0.0,1.0
SF-Q23-3,SF-G25,10,9,3,2,7,7,0.3,0.7,0.2222222222222222,0.7777777777777778
SF-Q23-3,SF-F23,10,5,1,2,9,3,0.1,0.9,0.4,0.6
SF-Q23-3,SF-E23,5,9,1,0,4,9,0.2,0.8,0.0,1.0
SF-Q23-3,SF-D24,3,2,2,0,1,2,0.6666666666666666,0.3333333333333333,0.0,1.0
SF-Q23-3,SF-C22,5,5,0,0,5,5,0.0,1.0,0.0,1.0
SF-Q23-3,SF-B22,1,2,1,1,0,1,1.0,0.0,0.5,0.5
SF-Q23-3,SF-J17,10,6,2,0,8,6,0.2,0.8,0.0,1.0
SF-Q23-3,SF-I19,2,3,0,0,2,3,0.0,1.0,0.0,1.0
SF-Q23-3,SF-H16,2,1,0,0,2,1,0.0,1.0,0.0,1.0
SF-Q23-3,SF-H19,2,1,0,0,2,1,0.0,1.0,0.0,1.0
SF-Q23-3,SF-H20,1,4,0,0,1,4,0.0,1.0,0.0,1.0
SF-Q23-3,SF-H18,1,1,0,0,1,1,0.0,1.0,0.0,1.0
SF-Q23-3,SF-G18,3,3,0,0,3,3,0.0,1.0,0.0,1.0
SF-Q23-3,SF-G20,5,2,3,0,2,2,0.6,0.4,0.0,1.0
SF-Q23-3,SF-F19,3,2,0,0,3,2,0.0,1.0,0.0,1.0
SF-Q23-3,SF-H30,6,6,3,0,3,6,0.5,0.5,0.0,1.0
SF-Q23-3,SF-G30-2,9,4,2,0,7,4,0.2222222222222222,0.7777777777777778,0.0,1.0
SF-Q23-3,SF-F30-1,2,2,0,2,2,0,0.0,1.0,1.0,0.0
SF-Q23-3,SF-E29-2,11,13,6,6,5,7,0.5454545454545454,0.45454545454545453,0.46153846153846156,0.5384615384615384
SF-Q23-3,SF-E29-1,5,4,2,3,3,1,0.4,0.6,0.75,0.25
SF-Q23-3,SF-D29,2,3,0,2,2,1,0.0,1.0,0.6666666666666666,0.3333333333333333
SF-Q23-3,SF-G29-2,4,3,1,1,3,2,0.25,0.75,0.3333333333333333,0.6666666666666666
SF-Q23-3,SF-G29-1,1,5,0,0,1,5,0.0,1.0,0.0,1.0
SF-Q23-3,SF-G30-1,2,4,2,2,0,2,1.0,0.0,0.5,0.5
SF-Q23-3,SF-F30-2,2,1,0,0,2,1,0.0,1.0,0.0,1.0
SF-Q23-3,SF-F29,1,3,1,0,0,3,1.0,0.0,0.0,1.0
SF-Q23-3,SF-E29-3,2,4,2,2,0,2,1.0,0.0,0.5,0.5
SF-Q23-3,SF-F28-1,3,2,1,1,2,1,0.3333333333333333,0.6666666666666666,0.5,0.5
SF-Q23-3,SF-E28,2,3,2,3,0,0,1.0,0.0,1.0,0.0
SF-Q23-3,SF-J10,1,1,0,0,1,1,0.0,1.0,0.0,1.0
SF-Q23-3,SF-J12,3,3,0,0,3,3,0.0,1.0,0.0,1.0
SF-Q23-3,SF-J13,1,1,1,0,0,1,1.0,0.0,0.0,1.0
SF-Q23-3,SF-I16,17,9,2,3,15,6,0.11764705882352941,0.8823529411764706,0.3333333333333333,0.6666666666666666
SF-Q23-3,SF-H12,1,13,0,0,1,13,0.0,1.0,0.0,1.0
SF-Q23-3,SF-G10-2,1,2,0,0,1,2,0.0,1.0,0.0,1.0
SF-Q23-3,SF-G12,3,3,1,0,2,3,0.3333333333333333,0.6666666666666666,0.0,1.0
SF-Q23-3,SF-G10-1,3,1,0,0,3,1,0.0,1.0,0.0,1.0
SF-Q23-3,SF-C21,1,2,0,0,1,2,0.0,1.0,0.0,1.0
SF-Q23-3,SF-C20,1,1,0,0,1,1,0.0,1.0,0.0,1.0
SF-Q23-3,SF-A20,1,5,0,0,1,5,0.0,1.0,0.0,1.0
SF-Q23-3,SF-C25,5,6,0,0,5,6,0.0,1.0,0.0,1.0
SF-Q23-3,SF-D27,2,1,0,1,2,0,0.0,1.0,1.0,0.0
SF-Q23-3,SF-J1,4,1,1,0,3,1,0.25,0.75,0.0,1.0
SF-Q23-3,SF-G7,2,1,0,0,2,1,0.0,1.0,0.0,1.0
SF-Q23-3,SF-H25,13,5,1,0,12,5,0.07692307692307693,0.9230769230769231,0.0,1.0
SF-Q23-3,SF-G26,6,2,3,2,3,0,0.5,0.5,1.0,0.0
SF-Q23-3,SF-K21,19,6,7,0,12,6,0.3684210526315789,0.631578947368421,0.0,1.0
SF-Q23-3,SF-K22-1,9,7,1,2,8,5,0.1111111111111111,0.8888888888888888,0.2857142857142857,0.7142857142857143
SF-Q23-3,SF-J23-1,30,21,9,5,21,16,0.3,0.7,0.23809523809523808,0.7619047619047619
SF-Q23-3,SF-J22-1,13,20,6,3,7,17,0.46153846153846156,0.5384615384615384,0.15,0.85
SF-Q23-3,SF-J22-2,8,1,2,0,6,1,0.25,0.75,0.0,1.0
SF-Q23-3,SF-J21,10,9,1,5,9,4,0.1,0.9,0.5555555555555556,0.4444444444444444
SF-Q23-3,SF-I21,2,2,1,2,1,0,0.5,0.5,1.0,0.0
SF-Q23-3,SF-I22,2,3,2,2,0,1,1.0,0.0,0.6666666666666666,0.3333333333333333
SF-Q23-3,SF-I23-2,7,7,3,4,4,3,0.42857142857142855,0.5714285714285714,0.5714285714285714,0.42857142857142855
SF-Q23-3,SF-I23-1,5,4,2,2,3,2,0.4,0.6,0.5,0.5
SF-Q23-3,SF-F26,6,3,3,0,3,3,0.5,0.5,0.0,1.0
SF-Q23-3,SF-M13,6,17,3,0,3,17,0.5,0.5,0.0,1.0
SF-Q23-3,SF-M15,5,9,2,2,3,7,0.4,0.6,0.2222222222222222,0.7777777777777778
SF-Q23-3,SF-L19,6,7,0,0,6,7,0.0,1.0,0.0,1.0
SF-Q23-3,SF-L20,10,7,2,1,8,6,0.2,0.8,0.14285714285714285,0.8571428571428571
SF-Q23-3,SF-N20-1,9,12,3,5,6,7,0.3333333333333333,0.6666666666666666,0.4166666666666667,0.5833333333333334
SF-Q23-3,SF-M20,23,20,6,4,17,16,0.2608695652173913,0.7391304347826086,0.2,0.8
SF-Q23-3,SF-K17-2,6,6,2,1,4,5,0.3333333333333333,0.6666666666666666,0.16666666666666666,0.8333333333333334
SF-Q23-3,SF-K20,17,21,4,5,13,16,0.23529411764705882,0.7647058823529411,0.23809523809523808,0.7619047619047619
SF-Q23-3,SF-K15-,13,13,1,1,12,12,0.07692307692307693,0.9230769230769231,0.07692307692307693,0.9230769230769231
SF-Q23-3,SF-K19,16,29,4,6,12,23,0.25,0.75,0.20689655172413793,0.7931034482758621
SF-Q23-3,SF-K18,6,8,1,0,5,8,0.16666666666666666,0.8333333333333334,0.0,1.0
SF-Q23-3,SF-K17,5,11,5,2,0,9,1.0,0.0,0.18181818181818182,0.8181818181818182
SF-Q23-3,SF-J16,1,2,0,0,1,2,0.0,1.0,0.0,1.0
SF-Q23-3,SF-J18,16,3,5,1,11,2,0.3125,0.6875,0.3333333333333333,0.6666666666666666
SF-Q23-3,SF-J20,2,1,2,0,0,1,1.0,0.0,0.0,1.0
SF-Q23-3,SF-J19,11,8,1,1,10,7,0.09090909090909091,0.9090909090909091,0.125,0.875
SF-Q23-3,SF-M12,3,4,2,1,1,3,0.6666666666666666,0.3333333333333333,0.25,0.75
SF-Q23-3,SF-M11,4,4,1,0,3,4,0.25,0.75,0.0,1.0
SF-Q23-3,SF-R19,44,26,16,10,28,16,0.36363636363636365,0.6363636363636364,0.38461538461538464,0.6153846153846154
SF-Q23-3,SF-R20,21,9,14,1,7,8,0.6666666666666666,0.3333333333333333,0.1111111111111111,0.8888888888888888
SF-Q23-3,SF-Q21-2,52,31,31,1,21,30,0.5961538461538461,0.40384615384615385,0.03225806451612903,0.967741935483871
SF-Q23-3,SF-Q21-1,8,10,6,7,2,3,0.75,0.25,0.7,0.3
SF-Q23-3,SF-P21,21,43,7,19,14,24,0.3333333333333333,0.6666666666666666,0.4418604651162791,0.5581395348837209
SF-Q23-3,SF-O18,11,5,1,0,10,5,0.09090909090909091,0.9090909090909091,0.0,1.0
SF-Q23-3,SF-O19,20,25,7,7,13,18,0.35,0.65,0.28,0.72
SF-Q23-3,SF-O21,49,62,26,34,23,28,0.5306122448979592,0.46938775510204084,0.5483870967741935,0.45161290322580644
SF-Q23-3,SF-O22,59,39,26,23,33,16,0.4406779661016949,0.559322033898305,0.5897435897435898,0.41025641025641024
SF-Q23-3,SF-N21,23,15,15,11,8,4,0.6521739130434783,0.34782608695652173,0.7333333333333333,0.26666666666666666
SF-Q23-3,SF-N20-2,14,11,8,3,6,8,0.5714285714285714,0.42857142857142855,0.2727272727272727,0.7272727272727273
SF-Q23-3,SF-M21,23,16,12,5,11,11,0.5217391304347826,0.4782608695652174,0.3125,0.6875
SF-Q23-3,SF-L21,9,15,3,3,6,12,0.3333333333333333,0.6666666666666666,0.2,0.8
SF-Q23-3,SF-S29,4,4,2,2,2,2,0.5,0.5,0.5,0.5
SF-Q23-3,SF-S30,3,2,1,1,2,1,0.3333333333333333,0.6666666666666666,0.5,0.5
SF-Q23-3,SF-Q30,17,11,8,10,9,1,0.47058823529411764,0.5294117647058824,0.9090909090909091,0.09090909090909091
SF-Q23-3,SF-P30,11,10,3,2,8,8,0.2727272727272727,0.7272727272727273,0.2,0.8
SF-Q23-3,SF-O30-2,2,2,0,2,2,0,0.0,1.0,1.0,0.0
SF-Q23-3,SF-O30,7,5,3,1,4,4,0.42857142857142855,0.5714285714285714,0.2,0.8
SF-Q23-3,SF-N27,4,4,2,1,2,3,0.5,0.5,0.25,0.75
SF-Q23-3,SF-N28,7,14,3,9,4,5,0.42857142857142855,0.5714285714285714,0.6428571428571429,0.35714285714285715
SF-Q23-3,SF-L30-1,14,5,5,2,9,3,0.35714285714285715,0.6428571428571429,0.4,0.6
SF-Q23-3,SF-L31-1,10,2,3,2,7,0,0.3,0.7,1.0,0.0
SF-Q23-3,SF-K30-2,1,4,0,1,1,3,0.0,1.0,0.25,0.75
SF-Q23-3,SF-L29,3,3,1,0,2,3,0.3333333333333333,0.6666666666666666,0.0,1.0
SF-Q23-3,SF-I27,4,5,1,1,3,4,0.25,0.75,0.2,0.8
SF-Q23-3,SF-I28,3,3,2,2,1,1,0.6666666666666666,0.3333333333333333,0.6666666666666666,0.3333333333333333
SF-Q23-3,SF-I30-2,5,1,2,0,3,1,0.4,0.6,0.0,1.0
SF-Q23-3,SF-H28,2,3,2,3,0,0,1.0,0.0,1.0,0.0
SF-Q23-3,SF-H29,1,1,0,0,1,1,0.0,1.0,0.0,1.0
SF-Q23-3,SF-S24,33,20,15,10,18,10,0.45454545454545453,0.5454545454545454,0.5,0.5
SF-Q23-3,SF-R24,29,19,20,14,9,5,0.6896551724137931,0.3103448275862069,0.7368421052631579,0.2631578947368421
SF-Q23-3,SF-R26,11,11,10,11,1,0,0.9090909090909091,0.09090909090909091,1.0,0.0
SF-Q23-3,SF-Q26,40,53,23,42,17,11,0.575,0.425,0.7924528301886793,0.20754716981132076
SF-Q23-3,SF-P26,27,29,19,18,8,11,0.7037037037037037,0.2962962962962963,0.6206896551724138,0.3793103448275862
SF-Q23-3,SF-O25-2,19,17,10,13,9,4,0.5263157894736842,0.47368421052631576,0.7647058823529411,0.23529411764705882
SF-Q23-3,SF-N22-1B,9,5,3,3,6,2,0.3333333333333333,0.6666666666666666,0.6,0.4
SF-Q23-3,SF-N26,4,4,4,2,0,2,1.0,0.0,0.5,0.5
SF-Q23-3,SF-N25,7,7,5,2,2,5,0.7142857142857143,0.2857142857142857,0.2857142857142857,0.7142857142857143
SF-Q23-3,SF-T21,14,52,12,48,2,4,0.8571428571428571,0.14285714285714285,0.9230769230769231,0.07692307692307693
SF-Q23-3,SF-T22,45,26,33,18,12,8,0.7333333333333333,0.26666666666666666,0.6923076923076923,0.3076923076923077
SF-Q23-3,SF-S22-2,35,21,17,5,18,16,0.4857142857142857,0.5142857142857142,0.23809523809523808,0.7619047619047619
SF-Q23-3,SF-S22-1,22,20,13,12,9,8,0.5909090909090909,0.4090909090909091,0.6,0.4
SF-Q23-3,SF-Q22-1,22,20,6,11,16,9,0.2727272727272727,0.7272727272727273,0.55,0.45
SF-Q23-3,SF-Q22-2,26,26,10,19,16,7,0.38461538461538464,0.6153846153846154,0.7307692307692307,0.2692307692307692
SF-Q23-3,SF-P22,24,15,11,10,13,5,0.4583333333333333,0.5416666666666666,0.6666666666666666,0.3333333333333333
SF-Q23-3,SF-W19,8,3,2,2,6,1,0.25,0.75,0.6666666666666666,0.3333333333333333
SF-Q23-3,SF-U21,13,4,4,1,9,3,0.3076923076923077,0.6923076923076923,0.25,0.75
SF-Q23-3,SF-T20,37,27,18,4,19,23,0.4864864864864865,0.5135135135135135,0.14814814814814814,0.8518518518518519
SF-Q23-3,SF-S21,5,8,2,2,3,6,0.4,0.6,0.25,0.75
SF-Q23-3,SF-X29,7,4,0,1,7,3,0.0,1.0,0.25,0.75
SF-Q23-3,SF-V28,4,54,2,0,2,54,0.5,0.5,0.0,1.0
SF-Q23-3,SF-V29,1,1,0,0,1,1,0.0,1.0,0.0,1.0
SF-Q23-3,SF-V30,2,4,0,0,2,4,0.0,1.0,0.0,1.0
SF-Q23-3,SF-W14,5,4,1,0,4,4,0.2,0.8,0.0,1.0
SF-Q23-3,SF-Y25,1,2,1,2,0,0,1.0,0.0,1.0,0.0
SF-Q22-1,SF-M26,2,2,0,2,2,0,0.0,1.0,1.0,0.0
SF-Q22-1,SF-M25,5,14,1,8,4,6,0.2,0.8,0.5714285714285714,0.42857142857142855
SF-Q22-1,SF-M26-2,10,8,0,4,10,4,0.0,1.0,0.5,0.5
SF-Q22-1,SF-K26,11,12,2,4,9,8,0.18181818181818182,0.8181818181818182,0.3333333333333333,0.6666666666666666
SF-Q22-1,SF-J27,3,5,0,0,3,5,0.0,1.0,0.0,1.0
SF-Q22-1,SF-M30,48,24,19,1,29,23,0.3958333333333333,0.6041666666666666,0.041666666666666664,0.9583333333333334
SF-Q22-1,SF-L27-2,2,1,0,0,2,1,0.0,1.0,0.0,1.0
SF-Q22-1,SF-J29-3,1,1,0,0,1,1,0.0,1.0,0.0,1.0
SF-Q22-1,SF-J29,15,12,4,5,11,7,0.26666666666666666,0.7333333333333333,0.4166666666666667,0.5833333333333334
SF-Q22-1,SF-L26,71,68,39,42,32,26,0.5492957746478874,0.4507042253521127,0.6176470588235294,0.38235294117647056
SF-Q22-1,SF-M28,9,13,1,2,8,11,0.1111111111111111,0.8888888888888888,0.15384615384615385,0.8461538461538461
SF-Q22-1,SF-M27,1,1,1,1,0,0,1.0,0.0,1.0,0.0
SF-Q22-1,SF-L25,10,10,5,7,5,3,0.5,0.5,0.7,0.3
SF-Q22-1,SF-M24,9,8,3,4,6,4,0.3333333333333333,0.6666666666666666,0.5,0.5
SF-Q22-1,SF-L24,14,13,7,7,7,6,0.5,0.5,0.5384615384615384,0.46153846153846156
SF-Q22-1,SF-N23,11,8,6,6,5,2,0.5454545454545454,0.45454545454545453,0.75,0.25
SF-Q22-1,SF-N24-2,14,9,7,6,7,3,0.5,0.5,0.6666666666666666,0.3333333333333333
SF-Q22-1,SF-K27-2,8,10,4,4,4,6,0.5,0.5,0.4,0.6
SF-Q22-1,SF-J26-2,8,19,2,8,6,11,0.25,0.75,0.42105263157894735,0.5789473684210527
SF-Q22-1,SF-K28-3,2,2,1,1,1,1,0.5,0.5,0.5,0.5
SF-Q22-1,SF-L28,2,3,1,2,1,1,0.5,0.5,0.6666666666666666,0.3333333333333333
SF-Q22-1,SF-K28,4,7,2,1,2,6,0.5,0.5,0.14285714285714285,0.8571428571428571
SF-Q22-1,SF-K29-1,10,5,1,0,9,5,0.1,0.9,0.0,1.0
SF-Q22-1,SF-J28-2,7,1,1,0,6,1,0.14285714285714285,0.8571428571428571,0.0,1.0
SF-Q22-1,SF-K27,2,2,0,0,2,2,0.0,1.0,0.0,1.0
SF-Q22-1,SF-K25,10,17,3,7,7,10,0.3,0.7,0.4117647058823529,0.5882352941176471
SF-Q22-1,SF-J25,17,6,10,2,7,4,0.5882352941176471,0.4117647058823529,0.3333333333333333,0.6666666666666666
SF-Q22-1,SF-H26-2,3,1,1,0,2,1,0.3333333333333333,0.6666666666666666,0.0,1.0
SF-Q22-1,SF-P24,19,10,10,6,9,4,0.5263157894736842,0.47368421052631576,0.6,0.4
SF-Q22-1,SF-J24,19,19,5,8,14,11,0.2631578947368421,0.7368421052631579,0.42105263157894735,0.5789473684210527
SF-Q22-1,SF-O24,13,19,10,11,3,8,0.7692307692307693,0.23076923076923078,0.5789473684210527,0.42105263157894735
SF-Q22-1,SF-J26,4,4,4,4,0,0,1.0,0.0,1.0,0.0
SF-Q22-1,SF-I26-,3,2,2,1,1,1,0.6666666666666666,0.3333333333333333,0.5,0.5
SF-Q22-1,SF-I25,15,13,6,5,9,8,0.4,0.6,0.38461538461538464,0.6153846153846154
SF-Q22-1,SF-K23,6,4,6,0,0,4,1.0,0.0,0.0,1.0
SF-Q22-1,SF-H26,20,13,11,4,9,9,0.55,0.45,0.3076923076923077,0.6923076923076923
SF-Q22-1,SF-O23,8,9,4,6,4,3,0.5,0.5,0.6666666666666666,0.3333333333333333
SF-Q22-1,SF-H27-1,9,4,2,0,7,4,0.2222222222222222,0.7777777777777778,0.0,1.0
SF-Q22-1,SF-F28-2,18,13,5,8,13,5,0.2777777777777778,0.7222222222222222,0.6153846153846154,0.38461538461538464
SF-Q22-1,SF-G27,26,13,8,5,18,8,0.3076923076923077,0.6923076923076923,0.38461538461538464,0.6153846153846154
SF-Q22-1,SF-M22-2,52,65,24,41,28,24,0.46153846153846156,0.5384615384615384,0.6307692307692307,0.36923076923076925
SF-Q22-1,SF-L22,80,114,51,68,29,46,0.6375,0.3625,0.5964912280701754,0.40350877192982454
SF-Q22-1,SF-F27,5,7,5,2,0,5,1.0,0.0,0.2857142857142857,0.7142857142857143
SF-Q22-1,SF-N22-2,61,57,33,34,28,23,0.5409836065573771,0.45901639344262296,0.5964912280701754,0.40350877192982454
SF-Q22-1,SF-G28-2,9,1,3,0,6,1,0.3333333333333333,0.6666666666666666,0.0,1.0
SF-Q22-1,SF-G28-1,3,3,0,0,3,3,0.0,1.0,0.0,1.0
SF-Q22-1,SF-M22-1,66,93,10,13,56,80,0.15151515151515152,0.8484848484848485,0.13978494623655913,0.8602150537634409
SF-Q22-1,SF-O25-1,10,7,5,5,5,2,0.5,0.5,0.7142857142857143,0.2857142857142857
SF-Q22-1,SF-K22-2,28,30,17,20,11,10,0.6071428571428571,0.39285714285714285,0.6666666666666666,0.3333333333333333
SF-Q22-1,SF-K24,9,10,3,4,6,6,0.3333333333333333,0.6666666666666666,0.4,0.6
SF-Q22-1,SF-J23-2,9,11,7,9,2,2,0.7777777777777778,0.2222222222222222,0.8181818181818182,0.18181818181818182
SF-Q22-1,SF-G23,3,7,0,1,3,6,0.0,1.0,0.14285714285714285,0.8571428571428571
SF-Q22-1,SF-G24,15,16,3,0,12,16,0.2,0.8,0.0,1.0
SF-Q22-1,SF-G25,14,5,3,0,11,5,0.21428571428571427,0.7857142857142857,0.0,1.0
SF-Q22-1,SF-F23,9,7,2,1,7,6,0.2222222222222222,0.7777777777777778,0.14285714285714285,0.8571428571428571
SF-Q22-1,SF-E23,14,8,3,2,11,6,0.21428571428571427,0.7857142857142857,0.25,0.75
SF-Q22-1,SF-C22,17,4,0,1,17,3,0.0,1.0,0.25,0.75
SF-Q22-1,SF-B22,5,5,1,2,4,3,0.2,0.8,0.4,0.6
SF-Q22-1,SF-J17,10,12,3,4,7,8,0.3,0.7,0.3333333333333333,0.6666666666666666
SF-Q22-1,SF-I19,6,6,6,2,0,4,1.0,0.0,0.3333333333333333,0.6666666666666666
SF-Q22-1,SF-H20,2,5,1,1,1,4,0.5,0.5,0.2,0.8
SF-Q22-1,SF-G19,5,2,1,0,4,2,0.2,0.8,0.0,1.0
SF-Q22-1,SF-G17,1,2,0,1,1,1,0.0,1.0,0.5,0.5
SF-Q22-1,SF-G18,8,8,1,1,7,7,0.125,0.875,0.125,0.875
SF-Q22-1,SF-G20,25,12,3,0,22,12,0.12,0.88,0.0,1.0
SF-Q22-1,SF-F19,4,12,3,0,1,12,0.75,0.25,0.0,1.0
SF-Q22-1,SF-H30,5,3,1,3,4,0,0.2,0.8,1.0,0.0
SF-Q22-1,SF-G30-2,5,4,1,0,4,4,0.2,0.8,0.0,1.0
SF-Q22-1,SF-F30-1,1,3,0,2,1,1,0.0,1.0,0.6666666666666666,0.3333333333333333
SF-Q22-1,SF-E29-2,13,15,5,6,8,9,0.38461538461538464,0.6153846153846154,0.4,0.6
SF-Q22-1,SF-E29-1,4,2,1,1,3,1,0.25,0.75,0.5,0.5
SF-Q22-1,SF-D29,4,5,2,1,2,4,0.5,0.5,0.2,0.8
SF-Q22-1,SF-A27,3,6,3,4,0,2,1.0,0.0,0.6666666666666666,0.3333333333333333
SF-Q22-1,SF-G29-2,6,4,2,1,4,3,0.3333333333333333,0.6666666666666666,0.25,0.75
SF-Q22-1,SF-G29-1,5,4,1,2,4,2,0.2,0.8,0.5,0.5
SF-Q22-1,SF-G30-1,3,2,1,0,2,2,0.3333333333333333,0.6666666666666666,0.0,1.0
SF-Q22-1,SF-G29-3,5,1,1,1,4,0,0.2,0.8,1.0,0.0
SF-Q22-1,SF-F29,2,2,1,2,1,0,0.5,0.5,1.0,0.0
SF-Q22-1,SF-E29-3,17,22,16,21,1,1,0.9411764705882353,0.058823529411764705,0.9545454545454546,0.045454545454545456
SF-Q22-1,SF-F28-1,9,6,3,1,6,5,0.3333333333333333,0.6666666666666666,0.16666666666666666,0.8333333333333334
SF-Q22-1,SF-E28-2,4,1,1,0,3,1,0.25,0.75,0.0,1.0
SF-Q22-1,SF-J10,3,4,1,1,2,3,0.3333333333333333,0.6666666666666666,0.25,0.75
SF-Q22-1,SF-J12,1,2,0,0,1,2,0.0,1.0,0.0,1.0
SF-Q22-1,SF-J13,4,3,0,0,4,3,0.0,1.0,0.0,1.0
SF-Q22-1,SF-I16,1,1,0,0,1,1,0.0,1.0,0.0,1.0
SF-Q22-1,SF-G10-2,3,4,1,0,2,4,0.3333333333333333,0.6666666666666666,0.0,1.0
SF-Q22-1,SF-G13,5,5,1,1,4,4,0.2,0.8,0.2,0.8
SF-Q22-1,SF-G11,16,14,2,0,14,14,0.125,0.875,0.0,1.0
SF-Q22-1,SF-G12,11,6,0,0,11,6,0.0,1.0,0.0,1.0
SF-Q22-1,SF-C21,2,2,0,0,2,2,0.0,1.0,0.0,1.0
SF-Q22-1,SF-C20,4,2,0,1,4,1,0.0,1.0,0.5,0.5
SF-Q22-1,SF-A20,1,2,0,0,1,2,0.0,1.0,0.0,1.0
SF-Q22-1,SF-C25,3,4,0,1,3,3,0.0,1.0,0.25,0.75
SF-Q22-1,SF-B25,2,4,0,0,2,4,0.0,1.0,0.0,1.0
SF-Q22-1,SF-E27,5,3,0,0,5,3,0.0,1.0,0.0,1.0
SF-Q22-1,SF-D27,3,3,1,0,2,3,0.3333333333333333,0.6666666666666666,0.0,1.0
SF-Q22-1,SF-C28-2,1,2,0,1,1,1,0.0,1.0,0.5,0.5
SF-Q22-1,SF-J1,5,6,2,2,3,4,0.4,0.6,0.3333333333333333,0.6666666666666666
SF-Q22-1,SF-H0,3,2,0,0,3,2,0.0,1.0,0.0,1.0
SF-Q22-1,SF-G7,2,4,1,0,1,4,0.5,0.5,0.0,1.0
SF-Q22-1,SF-H25,13,6,5,2,8,4,0.38461538461538464,0.6153846153846154,0.3333333333333333,0.6666666666666666
SF-Q22-1,SF-G26,12,14,4,1,8,13,0.3333333333333333,0.6666666666666666,0.07142857142857142,0.9285714285714286
SF-Q22-1,SF-K21,7,13,5,0,2,13,0.7142857142857143,0.2857142857142857,0.0,1.0
SF-Q22-1,SF-K22-1,14,7,7,4,7,3,0.5,0.5,0.5714285714285714,0.42857142857142855
SF-Q22-1,SF-J23-1,40,36,24,23,16,13,0.6,0.4,0.6388888888888888,0.3611111111111111
SF-Q22-1,SF-J22-1,40,28,11,4,29,24,0.275,0.725,0.14285714285714285,0.8571428571428571
SF-Q22-1,SF-J22-2,9,7,1,1,8,6,0.1111111111111111,0.8888888888888888,0.14285714285714285,0.8571428571428571
SF-Q22-1,SF-J21,16,16,6,6,10,10,0.375,0.625,0.375,0.625
SF-Q22-1,SF-I21,4,1,2,0,2,1,0.5,0.5,0.0,1.0
SF-Q22-1,SF-I22,3,3,1,0,2,3,0.3333333333333333,0.6666666666666666,0.0,1.0
SF-Q22-1,SF-I23-2,10,5,6,2,4,3,0.6,0.4,0.4,0.6
SF-Q22-1,SF-I24,3,1,1,0,2,1,0.3333333333333333,0.6666666666666666,0.0,1.0
SF-Q22-1,SF-I23-1,10,5,0,3,10,2,0.0,1.0,0.6,0.4
SF-Q22-1,SF-F26,20,12,8,1,12,11,0.4,0.6,0.08333333333333333,0.9166666666666666
SF-Q22-1,SF-M13,24,12,1,1,23,11,0.041666666666666664,0.9583333333333334,0.08333333333333333,0.9166666666666666
SF-Q22-1,SF-M15,20,13,5,1,15,12,0.25,0.75,0.07692307692307693,0.9230769230769231
SF-Q22-1,SF-L19,8,16,3,2,5,14,0.375,0.625,0.125,0.875
SF-Q22-1,SF-L20,19,15,9,3,10,12,0.47368421052631576,0.5263157894736842,0.2,0.8
SF-Q22-1,SF-N20-1,71,100,46,8,25,92,0.647887323943662,0.352112676056338,0.08,0.92
SF-Q22-1,SF-M20,48,36,16,12,32,24,0.3333333333333333,0.6666666666666666,0.3333333333333333,0.6666666666666666
SF-Q22-1,SF-K17-2,8,4,2,2,6,2,0.25,0.75,0.5,0.5
SF-Q22-1,SF-K20,55,64,10,5,45,59,0.18181818181818182,0.8181818181818182,0.078125,0.921875
SF-Q22-1,SF-K15-,19,22,4,0,15,22,0.21052631578947367,0.7894736842105263,0.0,1.0
SF-Q22-1,SF-K19,31,15,3,3,28,12,0.0967741935483871,0.9032258064516129,0.2,0.8
SF-Q22-1,SF-K18,19,12,9,5,10,7,0.47368421052631576,0.5263157894736842,0.4166666666666667,0.5833333333333334
SF-Q22-1,SF-K17,9,11,3,1,6,10,0.3333333333333333,0.6666666666666666,0.09090909090909091,0.9090909090909091
SF-Q22-1,SF-J16,5,5,1,0,4,5,0.2,0.8,0.0,1.0
SF-Q22-1,SF-J18,16,14,8,1,8,13,0.5,0.5,0.07142857142857142,0.9285714285714286
SF-Q22-1,SF-J20,6,3,3,0,3,3,0.5,0.5,0.0,1.0
SF-Q22-1,SF-J19,7,6,3,2,4,4,0.42857142857142855,0.5714285714285714,0.3333333333333333,0.6666666666666666
SF-Q22-1,SF-M12,8,2,0,0,8,2,0.0,1.0,0.0,1.0
SF-Q22-1,SF-M10,5,1,5,0,0,1,1.0,0.0,0.0,1.0
SF-Q22-1,SF-M11,5,6,3,3,2,3,0.6,0.4,0.5,0.5
SF-Q22-1,SF-R19,7,26,6,7,1,19,0.8571428571428571,0.14285714285714285,0.2692307692307692,0.7307692307692307
SF-Q22-1,SF-R20,15,9,8,3,7,6,0.5333333333333333,0.4666666666666667,0.3333333333333333,0.6666666666666666
SF-Q22-1,SF-Q21-2,37,18,18,2,19,16,0.4864864864864865,0.5135135135135135,0.1111111111111111,0.8888888888888888
SF-Q22-1,SF-Q21-1,37,12,20,5,17,7,0.5405405405405406,0.4594594594594595,0.4166666666666667,0.5833333333333334
SF-Q22-1,SF-P21,26,18,19,11,7,7,0.7307692307692307,0.2692307692307692,0.6111111111111112,0.3888888888888889
SF-Q22-1,SF-O18,18,11,4,3,14,8,0.2222222222222222,0.7777777777777778,0.2727272727272727,0.7272727272727273
SF-Q22-1,SF-O19,27,30,14,10,13,20,0.5185185185185185,0.48148148148148145,0.3333333333333333,0.6666666666666666
SF-Q22-1,SF-O21,41,30,24,19,17,11,0.5853658536585366,0.4146341463414634,0.6333333333333333,0.36666666666666664
SF-Q22-1,SF-O22,55,55,38,43,17,12,0.6909090909090909,0.3090909090909091,0.7818181818181819,0.21818181818181817
SF-Q22-1,SF-N21,23,8,17,4,6,4,0.7391304347826086,0.2608695652173913,0.5,0.5
SF-Q22-1,SF-N20-2,40,17,24,10,16,7,0.6,0.4,0.5882352941176471,0.4117647058823529
SF-Q22-1,SF-M21,30,19,19,8,11,11,0.6333333333333333,0.36666666666666664,0.42105263157894735,0.5789473684210527
SF-Q22-1,SF-L21,52,31,26,13,26,18,0.5,0.5,0.41935483870967744,0.5806451612903226
SF-Q22-1,SF-Q30,7,6,2,0,5,6,0.2857142857142857,0.7142857142857143,0.0,1.0
SF-Q22-1,SF-P30,4,5,0,2,4,3,0.0,1.0,0.4,0.6
SF-Q22-1,SF-O30-2,16,6,0,1,16,5,0.0,1.0,0.16666666666666666,0.8333333333333334
SF-Q22-1,SF-O30,9,7,2,1,7,6,0.2222222222222222,0.7777777777777778,0.14285714285714285,0.8571428571428571
SF-Q22-1,SF-N27,14,6,4,3,10,3,0.2857142857142857,0.7142857142857143,0.5,0.5
SF-Q22-1,SF-N29,14,4,4,4,10,0,0.2857142857142857,0.7142857142857143,1.0,0.0
SF-Q22-1,SF-N28,18,11,4,3,14,8,0.2222222222222222,0.7777777777777778,0.2727272727272727,0.7272727272727273
SF-Q22-1,SF-L30-1,10,11,2,3,8,8,0.2,0.8,0.2727272727272727,0.7272727272727273
SF-Q22-1,SF-L31-1,2,2,1,0,1,2,0.5,0.5,0.0,1.0
SF-Q22-1,SF-K30-2,6,2,5,0,1,2,0.8333333333333334,0.16666666666666666,0.0,1.0
SF-Q22-1,SF-L29,6,3,3,1,3,2,0.5,0.5,0.3333333333333333,0.6666666666666666
SF-Q22-1,SF-J29-1,7,7,0,1,7,6,0.0,1.0,0.14285714285714285,0.8571428571428571
SF-Q22-1,SF-I30,5,3,1,2,4,1,0.2,0.8,0.6666666666666666,0.3333333333333333
SF-Q22-1,SF-I29-2,4,2,3,1,1,1,0.75,0.25,0.5,0.5
SF-Q22-1,SF-I27,3,5,1,2,2,3,0.3333333333333333,0.6666666666666666,0.4,0.6
SF-Q22-1,SF-I28,12,5,2,0,10,5,0.16666666666666666,0.8333333333333334,0.0,1.0
SF-Q22-1,SF-I30-2,3,5,0,0,3,5,0.0,1.0,0.0,1.0
SF-Q22-1,SF I29-1,4,14,0,1,4,13,0.0,1.0,0.07142857142857142,0.9285714285714286
SF-Q22-1,SF-H28,2,4,1,3,1,1,0.5,0.5,0.75,0.25
SF-Q22-1,SF-S24,34,36,15,16,19,20,0.4411764705882353,0.5588235294117647,0.4444444444444444,0.5555555555555556
SF-Q22-1,SF-R24,26,21,18,18,8,3,0.6923076923076923,0.3076923076923077,0.8571428571428571,0.14285714285714285
SF-Q22-1,SF-R26,5,3,3,1,2,2,0.6,0.4,0.3333333333333333,0.6666666666666666
SF-Q22-1,SF-Q26,15,5,10,2,5,3,0.6666666666666666,0.3333333333333333,0.4,0.6
SF-Q22-1,SF-P26,10,8,5,5,5,3,0.5,0.5,0.625,0.375
SF-Q22-1,SF-O25-2,21,14,9,6,12,8,0.42857142857142855,0.5714285714285714,0.42857142857142855,0.5714285714285714
SF-Q22-1,SF-N22-1B,4,7,3,3,1,4,0.75,0.25,0.42857142857142855,0.5714285714285714
SF-Q22-1,SF-N26,5,3,1,1,4,2,0.2,0.8,0.3333333333333333,0.6666666666666666
SF-Q22-1,SF-N25,24,26,8,20,16,6,0.3333333333333333,0.6666666666666666,0.7692307692307693,0.23076923076923078
SF-Q22-1,SF-T21,9,12,4,5,5,7,0.4444444444444444,0.5555555555555556,0.4166666666666667,0.5833333333333334
SF-Q22-1,SF-T22,25,55,16,27,9,28,0.64,0.36,0.4909090909090909,0.509090909090909
SF-Q22-1,SF-S22-2,13,14,7,5,6,9,0.5384615384615384,0.46153846153846156,0.35714285714285715,0.6428571428571429
SF-Q22-1,SF-S22-1,20,21,11,15,9,6,0.55,0.45,0.7142857142857143,0.2857142857142857
SF-Q22-1,SF-Q23-3,20,22,11,6,9,16,0.55,0.45,0.2727272727272727,0.7272727272727273
SF-Q22-1,SF-Q22-2,56,37,41,26,15,11,0.7321428571428571,0.26785714285714285,0.7027027027027027,0.2972972972972973
SF-Q22-1,SF-P22,28,45,22,23,6,22,0.7857142857142857,0.21428571428571427,0.5111111111111111,0.4888888888888889
SF-Q22-1,SF-W19,3,10,0,4,3,6,0.0,1.0,0.4,0.6
SF-Q22-1,SF-U21,11,9,7,3,4,6,0.6363636363636364,0.36363636363636365,0.3333333333333333,0.6666666666666666
SF-Q22-1,SF-T20,12,45,5,13,7,32,0.4166666666666667,0.5833333333333334,0.28888888888888886,0.7111111111111111
SF-Q22-1,SF-S21,3,6,0,1,3,5,0.0,1.0,0.16666666666666666,0.8333333333333334
SF-Q22-1,SF-Y27,3,3,0,0,3,3,0.0,1.0,0.0,1.0
SF-Q22-1,SF-X29,1,1,1,0,0,1,1.0,0.0,0.0,1.0
SF-Q22-1,SF-W29,2,1,1,0,1,1,0.5,0.5,0.0,1.0
SF-Q22-1,SF-V29,4,3,2,2,2,1,0.5,0.5,0.6666666666666666,0.3333333333333333
SF-Q22-1,SF-V30,2,2,0,1,2,1,0.0,1.0,0.5,0.5
SF-Q22-1,SF-W14,1,12,0,0,1,12,0.0,1.0,0.0,1.0
SF-Q22-1,SF-X19,1,1,1,0,0,1,1.0,0.0,0.0,1.0
SF-Q22-2,SF-M25,17,12,9,5,8,7,0.5294117647058824,0.47058823529411764,0.4166666666666667,0.5833333333333334
SF-Q22-2,SF-M26-2,7,7,0,3,7,4,0.0,1.0,0.42857142857142855,0.5714285714285714
SF-Q22-2,SF-L27,2,1,0,0,2,1,0.0,1.0,0.0,1.0
SF-Q22-2,SF-K26,11,11,4,2,7,9,0.36363636363636365,0.6363636363636364,0.18181818181818182,0.8181818181818182
SF-Q22-2,SF-J27,5,3,3,1,2,2,0.6,0.4,0.3333333333333333,0.6666666666666666
SF-Q22-2,SF-M30,71,69,2,3,69,66,0.028169014084507043,0.971830985915493,0.043478260869565216,0.9565217391304348
SF-Q22-2,SF-L27-2,1,1,0,0,1,1,0.0,1.0,0.0,1.0
SF-Q22-2,SF-J29-3,2,1,1,0,1,1,0.5,0.5,0.0,1.0
SF-Q22-2,SF-J29,4,3,1,0,3,3,0.25,0.75,0.0,1.0
SF-Q22-2,SF-L26,36,54,10,27,26,27,0.2777777777777778,0.7222222222222222,0.5,0.5
SF-Q22-2,SF-M28,7,19,1,0,6,19,0.14285714285714285,0.8571428571428571,0.0,1.0
SF-Q22-2,SF-L25,9,15,3,8,6,7,0.3333333333333333,0.6666666666666666,0.5333333333333333,0.4666666666666667
SF-Q22-2,SF-M24,13,21,10,14,3,7,0.7692307692307693,0.23076923076923078,0.6666666666666666,0.3333333333333333
SF-Q22-2,SF-L24,19,17,11,13,8,4,0.5789473684210527,0.42105263157894735,0.7647058823529411,0.23529411764705882
SF-Q22-2,SF-N23,10,11,6,5,4,6,0.6,0.4,0.45454545454545453,0.5454545454545454
SF-Q22-2,SF-N24-2,42,43,39,38,3,5,0.9285714285714286,0.07142857142857142,0.8837209302325582,0.11627906976744186
SF-Q22-2,SF-K27-2,13,15,9,8,4,7,0.6923076923076923,0.3076923076923077,0.5333333333333333,0.4666666666666667
SF-Q22-2,SF-J26-2,7,17,6,4,1,13,0.8571428571428571,0.14285714285714285,0.23529411764705882,0.7647058823529411
SF-Q22-2,SF-K28,3,5,0,4,3,1,0.0,1.0,0.8,0.2
SF-Q22-2,SF-K29-1,8,7,1,1,7,6,0.125,0.875,0.14285714285714285,0.8571428571428571
SF-Q22-2,SF-J28-2,4,1,4,1,0,0,1.0,0.0,1.0,0.0
SF-Q22-2,SF-K27,1,1,1,1,0,0,1.0,0.0,1.0,0.0
SF-Q22-2,SF-K25,16,24,7,6,9,18,0.4375,0.5625,0.25,0.75
SF-Q22-2,SF-J25,25,6,11,3,14,3,0.44,0.56,0.5,0.5
SF-Q22-2,SF-H26-2,2,4,0,2,2,2,0.0,1.0,0.5,0.5
SF-Q22-2,SF-P24,34,24,26,23,8,1,0.7647058823529411,0.23529411764705882,0.9583333333333334,0.041666666666666664
SF-Q22-2,SF-J24,8,6,4,1,4,5,0.5,0.5,0.16666666666666666,0.8333333333333334
SF-Q22-2,SF-O24,16,16,12,14,4,2,0.75,0.25,0.875,0.125
SF-Q22-2,SF-J26,2,6,0,3,2,3,0.0,1.0,0.5,0.5
SF-Q22-2,SF-I25,53,45,42,35,11,10,0.7924528301886793,0.20754716981132076,0.7777777777777778,0.2222222222222222
SF-Q22-2,SF-K23,8,12,5,9,3,3,0.625,0.375,0.75,0.25
SF-Q22-2,SF-H26,18,29,10,22,8,7,0.5555555555555556,0.4444444444444444,0.7586206896551724,0.2413793103448276
SF-Q22-2,SF-O23,17,24,11,16,6,8,0.6470588235294118,0.35294117647058826,0.6666666666666666,0.3333333333333333
SF-Q22-2,SF-H27-1,6,3,0,1,6,2,0.0,1.0,0.3333333333333333,0.6666666666666666
SF-Q22-2,SF-F28-2,14,36,10,25,4,11,0.7142857142857143,0.2857142857142857,0.6944444444444444,0.3055555555555556
SF-Q22-2,SF-G27,32,29,15,19,17,10,0.46875,0.53125,0.6551724137931034,0.3448275862068966
SF-Q22-2,SF-M22-2,42,76,19,52,23,24,0.4523809523809524,0.5476190476190477,0.6842105263157895,0.3157894736842105
SF-Q22-2,SF-L22,70,100,29,38,41,62,0.4142857142857143,0.5857142857142857,0.38,0.62
SF-Q22-2,SF-F27,12,13,6,3,6,10,0.5,0.5,0.23076923076923078,0.7692307692307693
SF-Q22-2,SF-N22-2,69,97,41,67,28,30,0.5942028985507246,0.4057971014492754,0.6907216494845361,0.30927835051546393
SF-Q22-2,SF-M22-1,27,22,9,8,18,14,0.3333333333333333,0.6666666666666666,0.36363636363636365,0.6363636363636364
SF-Q22-2,SF-O25-1,8,3,4,2,4,1,0.5,0.5,0.6666666666666666,0.3333333333333333
SF-Q22-2,SF-K22-2,35,51,15,36,20,15,0.42857142857142855,0.5714285714285714,0.7058823529411765,0.29411764705882354
SF-Q22-2,SF-K24,7,5,3,4,4,1,0.42857142857142855,0.5714285714285714,0.8,0.2
SF-Q22-2,SF-J23-2,18,18,8,9,10,9,0.4444444444444444,0.5555555555555556,0.5,0.5
SF-Q22-2,SF-G23,8,4,4,3,4,1,0.5,0.5,0.75,0.25
SF-Q22-2,SF-G24,45,38,5,1,40,37,0.1111111111111111,0.8888888888888888,0.02631578947368421,0.9736842105263158
SF-Q22-2,SF-G25,13,4,4,1,9,3,0.3076923076923077,0.6923076923076923,0.25,0.75
SF-Q22-2,SF-F23,52,6,4,1,48,5,0.07692307692307693,0.9230769230769231,0.16666666666666666,0.8333333333333334
SF-Q22-2,SF-E23,49,38,4,3,45,35,0.08163265306122448,0.9183673469387755,0.07894736842105263,0.9210526315789473
SF-Q22-2,SF-D24,1,2,0,0,1,2,0.0,1.0,0.0,1.0
SF-Q22-2,SF-C22,18,17,0,1,18,16,0.0,1.0,0.058823529411764705,0.9411764705882353
SF-Q22-2,SF-B22,2,5,0,2,2,3,0.0,1.0,0.4,0.6
SF-Q22-2,SF-J17,28,42,8,4,20,38,0.2857142857142857,0.7142857142857143,0.09523809523809523,0.9047619047619048
SF-Q22-2,SF-I19,10,1,3,0,7,1,0.3,0.7,0.0,1.0
SF-Q22-2,SF-I20,2,2,0,0,2,2,0.0,1.0,0.0,1.0
SF-Q22-2,SF-H16,2,2,2,0,0,2,1.0,0.0,0.0,1.0
SF-Q22-2,SF-H20,7,8,5,1,2,7,0.7142857142857143,0.2857142857142857,0.125,0.875
SF-Q22-2,SF-H18,6,2,1,1,5,1,0.16666666666666666,0.8333333333333334,0.5,0.5
SF-Q22-2,SF-G19,4,3,2,1,2,2,0.5,0.5,0.3333333333333333,0.6666666666666666
SF-Q22-2,SF-G17,1,1,0,0,1,1,0.0,1.0,0.0,1.0
SF-Q22-2,SF-G18,14,7,6,2,8,5,0.42857142857142855,0.5714285714285714,0.2857142857142857,0.7142857142857143
SF-Q22-2,SF-G20,6,3,0,0,6,3,0.0,1.0,0.0,1.0
SF-Q22-2,SF-F19,6,8,3,2,3,6,0.5,0.5,0.25,0.75
SF-Q22-2,SF-E18,2,8,0,5,2,3,0.0,1.0,0.625,0.375
SF-Q22-2,SF-E20,11,15,10,10,1,5,0.9090909090909091,0.09090909090909091,0.6666666666666666,0.3333333333333333
SF-Q22-2,SF-H30,4,6,4,5,0,1,1.0,0.0,0.8333333333333334,0.16666666666666666
SF-Q22-2,SF-G30-2,8,2,3,0,5,2,0.375,0.625,0.0,1.0
SF-Q22-2,SF-F30-1,2,2,0,1,2,1,0.0,1.0,0.5,0.5
SF-Q22-2,SF-E29-2,21,48,15,32,6,16,0.7142857142857143,0.2857142857142857,0.6666666666666666,0.3333333333333333
SF-Q22-2,SF-E29-1,8,5,2,2,6,3,0.25,0.75,0.4,0.6
SF-Q22-2,SF-D29,5,2,0,2,5,0,0.0,1.0,1.0,0.0
SF-Q22-2,SF-G29-2,3,5,2,2,1,3,0.6666666666666666,0.3333333333333333,0.4,0.6
SF-Q22-2,SF-G29-1,1,1,0,0,1,1,0.0,1.0,0.0,1.0
SF-Q22-2,SF-G30-1,1,2,1,2,0,0,1.0,0.0,1.0,0.0
SF-Q22-2,SF-E29-3,12,9,2,7,10,2,0.16666666666666666,0.8333333333333334,0.7777777777777778,0.2222222222222222
SF-Q22-2,SF-F28-1,6,7,4,5,2,2,0.6666666666666666,0.3333333333333333,0.7142857142857143,0.2857142857142857
SF-Q22-2,SF-E28-2,2,5,1,2,1,3,0.5,0.5,0.4,0.6
SF-Q22-2,SF-E28,2,1,2,1,0,0,1.0,0.0,1.0,0.0
SF-Q22-2,SF-J10,3,8,0,0,3,8,0.0,1.0,0.0,1.0
SF-Q22-2,SF-J12,7,2,1,0,6,2,0.14285714285714285,0.8571428571428571,0.0,1.0
SF-Q22-2,SF-J13,1,5,0,2,1,3,0.0,1.0,0.4,0.6
SF-Q22-2,SF-J15,2,2,0,0,2,2,0.0,1.0,0.0,1.0
SF-Q22-2,SF-H13,3,1,0,0,3,1,0.0,1.0,0.0,1.0
SF-Q22-2,SF-I16,1,3,0,0,1,3,0.0,1.0,0.0,1.0
SF-Q22-2,SF-H12,10,9,0,0,10,9,0.0,1.0,0.0,1.0
SF-Q22-2,SF-G10-2,10,3,2,0,8,3,0.2,0.8,0.0,1.0
SF-Q22-2,SF-H15,1,2,1,0,0,2,1.0,0.0,0.0,1.0
SF-Q22-2,SF-G9,1,4,0,0,1,4,0.0,1.0,0.0,1.0
SF-Q22-2,SF-G13,2,1,1,0,1,1,0.5,0.5,0.0,1.0
SF-Q22-2,SF-G12,6,4,2,0,4,4,0.3333333333333333,0.6666666666666666,0.0,1.0
SF-Q22-2,SF-F15,4,3,2,2,2,1,0.5,0.5,0.6666666666666666,0.3333333333333333
SF-Q22-2,SF-C20,3,10,0,2,3,8,0.0,1.0,0.2,0.8
SF-Q22-2,SF-B21,3,1,0,1,3,0,0.0,1.0,1.0,0.0
SF-Q22-2,SF-B19,3,5,0,2,3,3,0.0,1.0,0.4,0.6
SF-Q22-2,SF-A20,5,4,1,1,4,3,0.2,0.8,0.25,0.75
SF-Q22-2,SF-C26,1,4,0,0,1,4,0.0,1.0,0.0,1.0
SF-Q22-2,SF-C25,20,11,2,1,18,10,0.1,0.9,0.09090909090909091,0.9090909090909091
SF-Q22-2,SF-E27,2,6,0,0,2,6,0.0,1.0,0.0,1.0
SF-Q22-2,SF-D27,4,11,2,3,2,8,0.5,0.5,0.2727272727272727,0.7272727272727273
SF-Q22-2,SF-C28-2,2,1,1,0,1,1,0.5,0.5,0.0,1.0
SF-Q22-2,SF-B28,4,6,0,0,4,6,0.0,1.0,0.0,1.0
SF-Q22-2,SF-J1,2,10,0,6,2,4,0.0,1.0,0.6,0.4
SF-Q22-2,SF-J3,1,2,0,1,1,1,0.0,1.0,0.5,0.5
SF-Q22-2,SF-G8,5,2,0,0,5,2,0.0,1.0,0.0,1.0
SF-Q22-2,SF-G5,2,2,0,0,2,2,0.0,1.0,0.0,1.0
SF-Q22-2,SF-G7,2,1,2,0,0,1,1.0,0.0,0.0,1.0
SF-Q22-2,SF-H25,4,4,1,1,3,3,0.25,0.75,0.25,0.75
SF-Q22-2,SF-G26,6,7,1,3,5,4,0.16666666666666666,0.8333333333333334,0.42857142857142855,0.5714285714285714
SF-Q22-2,SF-K21,13,14,7,2,6,12,0.5384615384615384,0.46153846153846156,0.14285714285714285,0.8571428571428571
SF-Q22-2,SF-K22-1,18,10,12,8,6,2,0.6666666666666666,0.3333333333333333,0.8,0.2
SF-Q22-2,SF-J23-1,71,74,21,26,50,48,0.29577464788732394,0.704225352112676,0.35135135135135137,0.6486486486486487
SF-Q22-2,SF-J22-1,20,36,5,13,15,23,0.25,0.75,0.3611111111111111,0.6388888888888888
SF-Q22-2,SF-J22-2,15,8,6,3,9,5,0.4,0.6,0.375,0.625
SF-Q22-2,SF-J21,25,16,11,4,14,12,0.44,0.56,0.25,0.75
SF-Q22-2,SF-I21,1,1,1,1,0,0,1.0,0.0,1.0,0.0
SF-Q22-2,SF-I22,5,7,3,3,2,4,0.6,0.4,0.42857142857142855,0.5714285714285714
SF-Q22-2,SF-I23-2,17,40,10,38,7,2,0.5882352941176471,0.4117647058823529,0.95,0.05
SF-Q22-2,SF-I24,3,6,2,6,1,0,0.6666666666666666,0.3333333333333333,1.0,0.0
SF-Q22-2,SF-I23-1,8,14,2,2,6,12,0.25,0.75,0.14285714285714285,0.8571428571428571
SF-Q22-2,SF-F26,18,7,8,4,10,3,0.4444444444444444,0.5555555555555556,0.5714285714285714,0.42857142857142855
SF-Q22-2,SF-M13,37,50,3,2,34,48,0.08108108108108109,0.918918918918919,0.04,0.96
SF-Q22-2,SF-M15,26,10,6,4,20,6,0.23076923076923078,0.7692307692307693,0.4,0.6
SF-Q22-2,SF-L19,22,14,4,5,18,9,0.18181818181818182,0.8181818181818182,0.35714285714285715,0.6428571428571429
SF-Q22-2,SF-L20,13,19,6,9,7,10,0.46153846153846156,0.5384615384615384,0.47368421052631576,0.5263157894736842
SF-Q22-2,SF-N20-1,16,24,2,0,14,24,0.125,0.875,0.0,1.0
SF-Q22-2,SF-M20,25,28,6,10,19,18,0.24,0.76,0.35714285714285715,0.6428571428571429
SF-Q22-2,SF-K17-2,14,4,3,1,11,3,0.21428571428571427,0.7857142857142857,0.25,0.75
SF-Q22-2,SF-K20,14,25,5,9,9,16,0.35714285714285715,0.6428571428571429,0.36,0.64
SF-Q22-2,SF-K15-,23,36,5,7,18,29,0.21739130434782608,0.782608695652174,0.19444444444444445,0.8055555555555556
SF-Q22-2,SF-K19,24,30,3,4,21,26,0.125,0.875,0.13333333333333333,0.8666666666666667
SF-Q22-2,SF-K18,22,12,9,2,13,10,0.4090909090909091,0.5909090909090909,0.16666666666666666,0.8333333333333334
SF-Q22-2,SF-K17,28,15,12,4,16,11,0.42857142857142855,0.5714285714285714,0.26666666666666666,0.7333333333333333
SF-Q22-2,SF-J16,15,14,0,0,15,14,0.0,1.0,0.0,1.0
SF-Q22-2,SF-J18,19,6,3,0,16,6,0.15789473684210525,0.8421052631578947,0.0,1.0
SF-Q22-2,SF-J20,9,10,6,5,3,5,0.6666666666666666,0.3333333333333333,0.5,0.5
SF-Q22-2,SF-J19,6,12,2,3,4,9,0.3333333333333333,0.6666666666666666,0.25,0.75
SF-Q22-2,SF-M12,3,9,0,0,3,9,0.0,1.0,0.0,1.0
SF-Q22-2,SF-M10,2,2,0,1,2,1,0.0,1.0,0.5,0.5
SF-Q22-2,SF-M11,3,8,3,2,0,6,1.0,0.0,0.25,0.75
SF-Q22-2,SF-R19,14,23,8,5,6,18,0.5714285714285714,0.42857142857142855,0.21739130434782608,0.782608695652174
SF-Q22-2,SF-R20,10,5,8,1,2,4,0.8,0.2,0.2,0.8
SF-Q22-2,SF-Q21-2,43,30,32,3,11,27,0.7441860465116279,0.2558139534883721,0.1,0.9
SF-Q22-2,SF-Q21-1,10,3,4,1,6,2,0.4,0.6,0.3333333333333333,0.6666666666666666
SF-Q22-2,SF-P21,22,23,14,8,8,15,0.6363636363636364,0.36363636363636365,0.34782608695652173,0.6521739130434783
SF-Q22-2,SF-O18,7,11,1,3,6,8,0.14285714285714285,0.8571428571428571,0.2727272727272727,0.7272727272727273
SF-Q22-2,SF-O19,38,49,11,21,27,28,0.2894736842105263,0.7105263157894737,0.42857142857142855,0.5714285714285714
SF-Q22-2,SF-O21,36,74,14,48,22,26,0.3888888888888889,0.6111111111111112,0.6486486486486487,0.35135135135135137
SF-Q22-2,SF-O22,120,96,91,71,29,25,0.7583333333333333,0.24166666666666667,0.7395833333333334,0.2604166666666667
SF-Q22-2,SF-N21,23,29,19,25,4,4,0.8260869565217391,0.17391304347826086,0.8620689655172413,0.13793103448275862
SF-Q22-2,SF-N20-2,10,21,7,9,3,12,0.7,0.3,0.42857142857142855,0.5714285714285714
SF-Q22-2,SF-M21,28,22,18,10,10,12,0.6428571428571429,0.35714285714285715,0.45454545454545453,0.5454545454545454
SF-Q22-2,SF-L21,27,39,9,12,18,27,0.3333333333333333,0.6666666666666666,0.3076923076923077,0.6923076923076923
SF-Q22-2,SF-S29,2,2,0,2,2,0,0.0,1.0,1.0,0.0
SF-Q22-2,SF-S30,4,2,2,0,2,2,0.5,0.5,0.0,1.0
SF-Q22-2,SF-Q30,13,9,0,1,13,8,0.0,1.0,0.1111111111111111,0.8888888888888888
SF-Q22-2,SF-P30,4,7,2,3,2,4,0.5,0.5,0.42857142857142855,0.5714285714285714
SF-Q22-2,SF-O30-2,5,4,2,1,3,3,0.4,0.6,0.25,0.75
SF-Q22-2,SF-O30,10,12,2,1,8,11,0.2,0.8,0.08333333333333333,0.9166666666666666
SF-Q22-2,SF-N27,8,10,4,4,4,6,0.5,0.5,0.4,0.6
SF-Q22-2,SF-N29,6,9,3,5,3,4,0.5,0.5,0.5555555555555556,0.4444444444444444
SF-Q22-2,SF-N28,12,16,5,8,7,8,0.4166666666666667,0.5833333333333334,0.5,0.5
SF-Q22-2,SF-L30-1,6,15,4,9,2,6,0.6666666666666666,0.3333333333333333,0.6,0.4
SF-Q22-2,SF-L31-1,6,2,1,0,5,2,0.16666666666666666,0.8333333333333334,0.0,1.0
SF-Q22-2,SF-K30-2,2,3,0,3,2,0,0.0,1.0,1.0,0.0
SF-Q22-2,SF-J29-1,1,2,0,1,1,1,0.0,1.0,0.5,0.5
SF-Q22-2,SF-I30,10,9,0,3,10,6,0.0,1.0,0.3333333333333333,0.6666666666666666
SF-Q22-2,SF-I29-2,2,1,0,0,2,1,0.0,1.0,0.0,1.0
SF-Q22-2,SF-I27,5,2,1,1,4,1,0.2,0.8,0.5,0.5
SF-Q22-2,SF-I28,2,2,0,1,2,1,0.0,1.0,0.5,0.5
SF-Q22-2,SF I29-1,3,3,1,0,2,3,0.3333333333333333,0.6666666666666666,0.0,1.0
SF-Q22-2,SF-H28,3,8,3,0,0,8,1.0,0.0,0.0,1.0
SF-Q22-2,SF-S24,35,46,21,31,14,15,0.6,0.4,0.6739130434782609,0.32608695652173914
SF-Q22-2,SF-R24,29,37,17,29,12,8,0.5862068965517241,0.41379310344827586,0.7837837837837838,0.21621621621621623
SF-Q22-2,SF-R26,3,4,2,2,1,2,0.6666666666666666,0.3333333333333333,0.5,0.5
SF-Q22-2,SF-Q26,13,7,7,2,6,5,0.5384615384615384,0.46153846153846156,0.2857142857142857,0.7142857142857143
SF-Q22-2,SF-P26,19,18,10,8,9,10,0.5263157894736842,0.47368421052631576,0.4444444444444444,0.5555555555555556
SF-Q22-2,SF-O25-2,6,14,4,9,2,5,0.6666666666666666,0.3333333333333333,0.6428571428571429,0.35714285714285715
SF-Q22-2,SF-N22-1B,2,9,2,8,0,1,1.0,0.0,0.8888888888888888,0.1111111111111111
SF-Q22-2,SF-N26,5,3,3,0,2,3,0.6,0.4,0.0,1.0
SF-Q22-2,SF-N25,4,9,3,5,1,4,0.75,0.25,0.5555555555555556,0.4444444444444444
SF-Q22-2,SF-T21,8,11,5,9,3,2,0.625,0.375,0.8181818181818182,0.18181818181818182
SF-Q22-2,SF-T22,77,46,47,30,30,16,0.6103896103896104,0.38961038961038963,0.6521739130434783,0.34782608695652173
SF-Q22-2,SF-S22-2,30,32,22,2,8,30,0.7333333333333333,0.26666666666666666,0.0625,0.9375
SF-Q22-2,SF-S22-1,87,19,68,12,19,7,0.7816091954022989,0.21839080459770116,0.631578947368421,0.3684210526315789
SF-Q22-2,SF-Q23-3,26,26,19,10,7,16,0.7307692307692307,0.2692307692307692,0.38461538461538464,0.6153846153846154
SF-Q22-2,SF-Q22-1,37,56,26,41,11,15,0.7027027027027027,0.2972972972972973,0.7321428571428571,0.26785714285714285
SF-Q22-2,SF-P22,30,74,24,57,6,17,0.8,0.2,0.7702702702702703,0.22972972972972974
SF-Q22-2,SF-W19,15,12,4,2,11,10,0.26666666666666666,0.7333333333333333,0.16666666666666666,0.8333333333333334
SF-Q22-2,SF-U21,33,13,12,3,21,10,0.36363636363636365,0.6363636363636364,0.23076923076923078,0.7692307692307693
SF-Q22-2,SF-T20,28,33,21,5,7,28,0.75,0.25,0.15151515151515152,0.8484848484848485
SF-Q22-2,SF-S21,22,16,16,3,6,13,0.7272727272727273,0.2727272727272727,0.1875,0.8125
SF-Q22-2,SF-X29,2,5,0,0,2,5,0.0,1.0,0.0,1.0
SF-Q22-2,SF-V28,4,6,0,0,4,6,0.0,1.0,0.0,1.0
SF-Q22-2,SF-V29,7,3,4,2,3,1,0.5714285714285714,0.42857142857142855,0.6666666666666666,0.3333333333333333
SF-Q22-2,SF-U30,15,3,0,0,15,3,0.0,1.0,0.0,1.0
SF-Q22-2,SF-W14,23,7,20,0,3,7,0.8695652173913043,0.13043478260869565,0.0,1.0
SF-Q22-2,SF-AA15,1,2,0,1,1,1,0.0,1.0,0.5,0.5
SF-Q22-2,SF-Y14,4,4,1,0,3,4,0.25,0.75,0.0,1.0
SF-Q22-2,SF-X19,2,1,2,1,0,0,1.0,0.0,1.0,0.0
SF-P22,SF-M26,3,2,2,0,1,2,0.6666666666666666,0.3333333333333333,0.0,1.0
SF-P22,SF-M25,11,11,5,4,6,7,0.45454545454545453,0.5454545454545454,0.36363636363636365,0.6363636363636364
SF-P22,SF-M26-2,24,4,13,1,11,3,0.5416666666666666,0.4583333333333333,0.25,0.75
SF-P22,SF-L27,3,1,1,0,2,1,0.3333333333333333,0.6666666666666666,0.0,1.0
SF-P22,SF-K26,19,14,11,5,8,9,0.5789473684210527,0.42105263157894735,0.35714285714285715,0.6428571428571429
SF-P22,SF-J27,28,33,6,6,22,27,0.21428571428571427,0.7857142857142857,0.18181818181818182,0.8181818181818182
SF-P22,SF-M30,39,28,5,13,34,15,0.1282051282051282,0.8717948717948718,0.4642857142857143,0.5357142857142857
SF-P22,SF-J29-3,2,2,0,1,2,1,0.0,1.0,0.5,0.5
SF-P22,SF-J29,6,7,0,0,6,7,0.0,1.0,0.0,1.0
SF-P22,SF-L26,42,82,18,31,24,51,0.42857142857142855,0.5714285714285714,0.3780487804878049,0.6219512195121951
SF-P22,SF-M28,19,15,2,1,17,14,0.10526315789473684,0.8947368421052632,0.06666666666666667,0.9333333333333333
SF-P22,SF-M27,2,2,1,1,1,1,0.5,0.5,0.5,0.5
SF-P22,SF-L25,11,7,3,3,8,4,0.2727272727272727,0.7272727272727273,0.42857142857142855,0.5714285714285714
SF-P22,SF-M24,17,10,13,6,4,4,0.7647058823529411,0.23529411764705882,0.6,0.4
SF-P22,SF-L24,17,18,10,11,7,7,0.5882352941176471,0.4117647058823529,0.6111111111111112,0.3888888888888889
SF-P22,SF-N23,7,12,3,8,4,4,0.42857142857142855,0.5714285714285714,0.6666666666666666,0.3333333333333333
SF-P22,SF-N24-2,14,16,9,12,5,4,0.6428571428571429,0.35714285714285715,0.75,0.25
SF-P22,SF-K27-2,37,30,29,4,8,26,0.7837837837837838,0.21621621621621623,0.13333333333333333,0.8666666666666667
SF-P22,SF-J26-2,31,30,1,3,30,27,0.03225806451612903,0.967741935483871,0.1,0.9
SF-P22,SF-K28-3,1,3,1,2,0,1,1.0,0.0,0.6666666666666666,0.3333333333333333
SF-P22,SF-L28,1,2,0,0,1,2,0.0,1.0,0.0,1.0
SF-P22,SF-K28,5,8,1,5,4,3,0.2,0.8,0.625,0.375
SF-P22,SF-K29-1,7,9,5,3,2,6,0.7142857142857143,0.2857142857142857,0.3333333333333333,0.6666666666666666
SF-P22,SF-J28-2,1,5,1,4,0,1,1.0,0.0,0.8,0.2
SF-P22,SF-K27,3,2,2,0,1,2,0.6666666666666666,0.3333333333333333,0.0,1.0
SF-P22,SF-K25,16,13,6,3,10,10,0.375,0.625,0.23076923076923078,0.7692307692307693
SF-P22,SF-J25,22,11,7,2,15,9,0.3181818181818182,0.6818181818181818,0.18181818181818182,0.8181818181818182
SF-P22,SF-H26-2,2,2,1,1,1,1,0.5,0.5,0.5,0.5
SF-P22,SF-P24,18,15,13,10,5,5,0.7222222222222222,0.2777777777777778,0.6666666666666666,0.3333333333333333
SF-P22,SF-N22-1A,3,1,1,0,2,1,0.3333333333333333,0.6666666666666666,0.0,1.0
SF-P22,SF-J24,17,24,9,18,8,6,0.5294117647058824,0.47058823529411764,0.75,0.25
SF-P22,SF-O24,6,2,4,2,2,0,0.6666666666666666,0.3333333333333333,1.0,0.0
SF-P22,SF-J26,5,4,3,3,2,1,0.6,0.4,0.75,0.25
SF-P22,SF-I25,13,12,9,5,4,7,0.6923076923076923,0.3076923076923077,0.4166666666666667,0.5833333333333334
SF-P22,SF-K23,4,7,1,3,3,4,0.25,0.75,0.42857142857142855,0.5714285714285714
SF-P22,SF-H26,28,18,10,9,18,9,0.35714285714285715,0.6428571428571429,0.5,0.5
SF-P22,SF-O23,12,12,8,6,4,6,0.6666666666666666,0.3333333333333333,0.5,0.5
SF-P22,SF-H27-1,4,6,1,1,3,5,0.25,0.75,0.16666666666666666,0.8333333333333334
SF-P22,SF-F28-2,14,11,5,6,9,5,0.35714285714285715,0.6428571428571429,0.5454545454545454,0.45454545454545453
SF-P22,SF-G27,18,21,9,9,9,12,0.5,0.5,0.42857142857142855,0.5714285714285714
SF-P22,SF-M22-2,48,79,28,52,20,27,0.5833333333333334,0.4166666666666667,0.6582278481012658,0.34177215189873417
SF-P22,SF-L22,75,57,35,28,40,29,0.4666666666666667,0.5333333333333333,0.49122807017543857,0.5087719298245614
SF-P22,SF-F27,9,11,4,3,5,8,0.4444444444444444,0.5555555555555556,0.2727272727272727,0.7272727272727273
SF-P22,SF-N22-2,79,86,40,63,39,23,0.5063291139240507,0.4936708860759494,0.7325581395348837,0.26744186046511625
SF-P22,SF-G28-2,1,2,0,0,1,2,0.0,1.0,0.0,1.0
SF-P22,SF-G28-1,1,1,0,0,1,1,0.0,1.0,0.0,1.0
SF-P22,SF-M22-1,30,54,7,16,23,38,0.23333333333333334,0.7666666666666667,0.2962962962962963,0.7037037037037037
SF-P22,SF-O25-1,15,9,7,5,8,4,0.4666666666666667,0.5333333333333333,0.5555555555555556,0.4444444444444444
SF-P22,SF-K22-2,44,51,21,23,23,28,0.4772727272727273,0.5227272727272727,0.45098039215686275,0.5490196078431373
SF-P22,SF-K24,6,6,5,4,1,2,0.8333333333333334,0.16666666666666666,0.6666666666666666,0.3333333333333333
SF-P22,SF-J23-2,18,11,9,10,9,1,0.5,0.5,0.9090909090909091,0.09090909090909091
SF-P22,SF-G23,5,5,4,4,1,1,0.8,0.2,0.8,0.2
SF-P22,SF-G24,17,18,3,2,14,16,0.17647058823529413,0.8235294117647058,0.1111111111111111,0.8888888888888888
SF-P22,SF-G25,19,11,1,1,18,10,0.05263157894736842,0.9473684210526315,0.09090909090909091,0.9090909090909091
SF-P22,SF-F23,6,7,2,3,4,4,0.3333333333333333,0.6666666666666666,0.42857142857142855,0.5714285714285714
SF-P22,SF-E23,18,17,9,3,9,14,0.5,0.5,0.17647058823529413,0.8235294117647058
SF-P22,SF-D24,1,1,0,0,1,1,0.0,1.0,0.0,1.0
SF-P22,SF-C22,10,7,3,3,7,4,0.3,0.7,0.42857142857142855,0.5714285714285714
SF-P22,SF-J17,8,14,0,0,8,14,0.0,1.0,0.0,1.0
SF-P22,SF-I19,15,8,9,0,6,8,0.6,0.4,0.0,1.0
SF-P22,SF-I20,1,2,0,1,1,1,0.0,1.0,0.5,0.5
SF-P22,SF-H20,5,5,4,2,1,3,0.8,0.2,0.4,0.6
SF-P22,SF-H18,2,3,0,0,2,3,0.0,1.0,0.0,1.0
SF-P22,SF-G19,5,4,2,2,3,2,0.4,0.6,0.5,0.5
SF-P22,SF-G17,1,2,0,0,1,2,0.0,1.0,0.0,1.0
SF-P22,SF-G18,8,9,4,2,4,7,0.5,0.5,0.2222222222222222,0.7777777777777778
SF-P22,SF-G20,22,29,12,7,10,22,0.5454545454545454,0.45454545454545453,0.2413793103448276,0.7586206896551724
SF-P22,SF-F19,3,7,1,0,2,7,0.3333333333333333,0.6666666666666666,0.0,1.0
SF-P22,SF-E18,2,7,1,2,1,5,0.5,0.5,0.2857142857142857,0.7142857142857143
SF-P22,SF-E20,5,5,2,0,3,5,0.4,0.6,0.0,1.0
SF-P22,SF-G30-2,1,4,1,3,0,1,1.0,0.0,0.75,0.25
SF-P22,SF-F30-1,3,2,1,2,2,0,0.3333333333333333,0.6666666666666666,1.0,0.0
SF-P22,SF-E29-2,12,22,3,9,9,13,0.25,0.75,0.4090909090909091,0.5909090909090909
SF-P22,SF-E29-1,9,8,3,7,6,1,0.3333333333333333,0.6666666666666666,0.875,0.125
SF-P22,SF-D29,4,5,0,0,4,5,0.0,1.0,0.0,1.0
SF-P22,SF-D28,14,17,3,6,11,11,0.21428571428571427,0.7857142857142857,0.35294117647058826,0.6470588235294118
SF-P22,SF-A27,1,2,0,1,1,1,0.0,1.0,0.5,0.5
SF-P22,SF-G29-2,14,6,5,1,9,5,0.35714285714285715,0.6428571428571429,0.16666666666666666,0.8333333333333334
SF-P22,SF-G29-1,7,7,5,3,2,4,0.7142857142857143,0.2857142857142857,0.42857142857142855,0.5714285714285714
SF-P22,SF-G30-1,3,3,0,2,3,1,0.0,1.0,0.6666666666666666,0.3333333333333333
SF-P22,SF-F30-2,1,1,0,0,1,1,0.0,1.0,0.0,1.0
SF-P22,SF-F29,1,1,1,1,0,0,1.0,0.0,1.0,0.0
SF-P22,SF-E29-3,3,4,0,2,3,2,0.0,1.0,0.5,0.5
SF-P22,SF-F28-1,3,2,2,1,1,1,0.6666666666666666,0.3333333333333333,0.5,0.5
SF-P22,SF-E28-2,2,1,0,0,2,1,0.0,1.0,0.0,1.0
SF-P22,SF-E28,7,3,1,1,6,2,0.14285714285714285,0.8571428571428571,0.3333333333333333,0.6666666666666666
SF-P22,SF-J10,6,8,2,2,4,6,0.3333333333333333,0.6666666666666666,0.25,0.75
SF-P22,SF-J12,5,6,1,1,4,5,0.2,0.8,0.16666666666666666,0.8333333333333334
SF-P22,SF-H13,2,1,1,1,1,0,0.5,0.5,1.0,0.0
SF-P22,SF-I16,1,3,0,1,1,2,0.0,1.0,0.3333333333333333,0.6666666666666666
SF-P22,SF-H12,4,1,0,0,4,1,0.0,1.0,0.0,1.0
SF-P22,SF-G10-2,4,9,0,2,4,7,0.0,1.0,0.2222222222222222,0.7777777777777778
SF-P22,SF-G9,4,7,0,0,4,7,0.0,1.0,0.0,1.0
SF-P22,SF-G13,3,3,2,0,1,3,0.6666666666666666,0.3333333333333333,0.0,1.0
SF-P22,SF-G11,1,6,1,2,0,4,1.0,0.0,0.3333333333333333,0.6666666666666666
SF-P22,SF-G12,2,5,1,0,1,5,0.5,0.5,0.0,1.0
SF-P22,SF-F15,1,2,1,2,0,0,1.0,0.0,1.0,0.0
SF-P22,SF-C21,2,1,1,0,1,1,0.5,0.5,0.0,1.0
SF-P22,SF-C20,1,3,1,2,0,1,1.0,0.0,0.6666666666666666,0.3333333333333333
SF-P22,SF-B21,2,1,0,0,2,1,0.0,1.0,0.0,1.0
SF-P22,SF-B19,3,6,2,1,1,5,0.6666666666666666,0.3333333333333333,0.16666666666666666,0.8333333333333334
SF-P22,SF-A20,6,7,3,5,3,2,0.5,0.5,0.7142857142857143,0.2857142857142857
SF-P22,SF-C25,14,9,6,3,8,6,0.42857142857142855,0.5714285714285714,0.3333333333333333,0.6666666666666666
SF-P22,SF-B25,1,5,0,0,1,5,0.0,1.0,0.0,1.0
SF-P22,SF-E27,6,5,0,1,6,4,0.0,1.0,0.2,0.8
SF-P22,SF-B28-2,2,1,0,0,2,1,0.0,1.0,0.0,1.0
SF-P22,SF-D27,4,4,2,2,2,2,0.5,0.5,0.5,0.5
SF-P22,SF-B28,3,3,2,1,1,2,0.6666666666666666,0.3333333333333333,0.3333333333333333,0.6666666666666666
SF-P22,SF-J1,2,10,0,4,2,6,0.0,1.0,0.4,0.6
SF-P22,SF-H0,4,4,1,0,3,4,0.25,0.75,0.0,1.0
SF-P22,SF-G8,2,3,0,0,2,3,0.0,1.0,0.0,1.0
SF-P22,SF-H25,11,20,2,2,9,18,0.18181818181818182,0.8181818181818182,0.1,0.9
SF-P22,SF-G26,11,11,7,1,4,10,0.6363636363636364,0.36363636363636365,0.09090909090909091,0.9090909090909091
SF-P22,SF-K21,12,8,3,1,9,7,0.25,0.75,0.125,0.875
SF-P22,SF-K22-1,25,24,8,17,17,7,0.32,0.68,0.7083333333333334,0.2916666666666667
SF-P22,SF-J23-1,38,49,22,16,16,33,0.5789473684210527,0.42105263157894735,0.32653061224489793,0.673469387755102
SF-P22,SF-J22-1,47,37,17,11,30,26,0.3617021276595745,0.6382978723404256,0.2972972972972973,0.7027027027027027
SF-P22,SF-J22-2,18,6,4,1,14,5,0.2222222222222222,0.7777777777777778,0.16666666666666666,0.8333333333333334
SF-P22,SF-J21,16,15,4,4,12,11,0.25,0.75,0.26666666666666666,0.7333333333333333
SF-P22,SF-I21,2,1,1,1,1,0,0.5,0.5,1.0,0.0
SF-P22,SF-I22,4,6,0,2,4,4,0.0,1.0,0.3333333333333333,0.6666666666666666
SF-P22,SF-I23-2,10,7,3,6,7,1,0.3,0.7,0.8571428571428571,0.14285714285714285
SF-P22,SF-I24,6,4,3,3,3,1,0.5,0.5,0.75,0.25
SF-P22,SF-I23-1,9,18,4,8,5,10,0.4444444444444444,0.5555555555555556,0.4444444444444444,0.5555555555555556
SF-P22,SF-F26,17,12,11,9,6,3,0.6470588235294118,0.35294117647058826,0.75,0.25
SF-P22,SF-M13,8,10,4,6,4,4,0.5,0.5,0.6,0.4
SF-P22,SF-M15,18,7,6,1,12,6,0.3333333333333333,0.6666666666666666,0.14285714285714285,0.8571428571428571
SF-P22,SF-L19,22,14,7,4,15,10,0.3181818181818182,0.6818181818181818,0.2857142857142857,0.7142857142857143
SF-P22,SF-L20,16,18,6,6,10,12,0.375,0.625,0.3333333333333333,0.6666666666666666
SF-P22,SF-N20-1,27,42,7,11,20,31,0.25925925925925924,0.7407407407407407,0.2619047619047619,0.7380952380952381
SF-P22,SF-M20,61,37,12,6,49,31,0.19672131147540983,0.8032786885245902,0.16216216216216217,0.8378378378378378
SF-P22,SF-K17-2,9,10,3,3,6,7,0.3333333333333333,0.6666666666666666,0.3,0.7
SF-P22,SF-K20,30,44,11,7,19,37,0.36666666666666664,0.6333333333333333,0.1590909090909091,0.8409090909090909
SF-P22,SF-K15-,27,24,12,5,15,19,0.4444444444444444,0.5555555555555556,0.20833333333333334,0.7916666666666666
SF-P22,SF-K19,18,16,8,3,10,13,0.4444444444444444,0.5555555555555556,0.1875,0.8125
SF-P22,SF-K18,18,22,6,4,12,18,0.3333333333333333,0.6666666666666666,0.18181818181818182,0.8181818181818182
SF-P22,SF-K17,16,9,4,4,12,5,0.25,0.75,0.4444444444444444,0.5555555555555556
SF-P22,SF-J16,9,4,0,1,9,3,0.0,1.0,0.25,0.75
SF-P22,SF-J18,10,14,7,3,3,11,0.7,0.3,0.21428571428571427,0.7857142857142857
SF-P22,SF-J20,4,6,1,4,3,2,0.25,0.75,0.6666666666666666,0.3333333333333333
SF-P22,SF-J19,15,11,8,3,7,8,0.5333333333333333,0.4666666666666667,0.2727272727272727,0.7272727272727273
SF-P22,SF-M12,11,1,0,1,11,0,0.0,1.0,1.0,0.0
SF-P22,SF-M10,9,4,5,1,4,3,0.5555555555555556,0.4444444444444444,0.25,0.75
SF-P22,SF-M11,3,1,2,0,1,1,0.6666666666666666,0.3333333333333333,0.0,1.0
SF-P22,SF-R19,33,28,10,8,23,20,0.30303030303030304,0.696969696969697,0.2857142857142857,0.7142857142857143
SF-P22,SF-R20,26,5,13,0,13,5,0.5,0.5,0.0,1.0
SF-P22,SF-Q21-2,55,23,38,2,17,21,0.6909090909090909,0.3090909090909091,0.08695652173913043,0.9130434782608695
SF-P22,SF-Q21-1,39,21,21,15,18,6,0.5384615384615384,0.46153846153846156,0.7142857142857143,0.2857142857142857
SF-P22,SF-P21,35,20,15,6,20,14,0.42857142857142855,0.5714285714285714,0.3,0.7
SF-P22,SF-O18,25,14,10,7,15,7,0.4,0.6,0.5,0.5
SF-P22,SF-O19,40,18,17,10,23,8,0.425,0.575,0.5555555555555556,0.4444444444444444
SF-P22,SF-O21,56,67,38,53,18,14,0.6785714285714286,0.32142857142857145,0.7910447761194029,0.208955223880597
SF-P22,SF-O22,70,76,42,45,28,31,0.6,0.4,0.5921052631578947,0.40789473684210525
SF-P22,SF-N21,26,31,16,21,10,10,0.6153846153846154,0.38461538461538464,0.6774193548387096,0.3225806451612903
SF-P22,SF-N20-2,12,13,6,5,6,8,0.5,0.5,0.38461538461538464,0.6153846153846154
SF-P22,SF-M21,40,33,21,15,19,18,0.525,0.475,0.45454545454545453,0.5454545454545454
SF-P22,SF-L21,76,52,49,30,27,22,0.6447368421052632,0.35526315789473684,0.5769230769230769,0.4230769230769231
SF-P22,SF-S30,1,2,0,1,1,1,0.0,1.0,0.5,0.5
SF-P22,SF-Q30,2,7,0,2,2,5,0.0,1.0,0.2857142857142857,0.7142857142857143
SF-P22,SF-P30,4,5,1,2,3,3,0.25,0.75,0.4,0.6
SF-P22,SF-O30-2,5,10,0,2,5,8,0.0,1.0,0.2,0.8
SF-P22,SF-O30,16,7,6,1,10,6,0.375,0.625,0.14285714285714285,0.8571428571428571
SF-P22,SF-N27,22,16,6,11,16,5,0.2727272727272727,0.7272727272727273,0.6875,0.3125
SF-P22,SF-N29,12,11,7,5,5,6,0.5833333333333334,0.4166666666666667,0.45454545454545453,0.5454545454545454
SF-P22,SF-N28,17,19,3,7,14,12,0.17647058823529413,0.8235294117647058,0.3684210526315789,0.631578947368421
SF-P22,SF-L30-1,4,8,1,4,3,4,0.25,0.75,0.5,0.5
SF-P22,SF-L31-1,2,4,1,2,1,2,0.5,0.5,0.5,0.5
SF-P22,SF-K30-2,1,2,0,1,1,1,0.0,1.0,0.5,0.5
SF-P22,SF-L29,4,5,0,0,4,5,0.0,1.0,0.0,1.0
SF-P22,SF-J29-1,3,3,0,1,3,2,0.0,1.0,0.3333333333333333,0.6666666666666666
SF-P22,SF-I30,3,2,3,0,0,2,1.0,0.0,0.0,1.0
SF-P22,SF-I27,6,10,1,7,5,3,0.16666666666666666,0.8333333333333334,0.7,0.3
SF-P22,SF-I28,5,3,4,1,1,2,0.8,0.2,0.3333333333333333,0.6666666666666666
SF-P22,SF-I30-2,4,3,1,1,3,2,0.25,0.75,0.3333333333333333,0.6666666666666666
SF-P22,SF I29-1,17,55,1,11,16,44,0.058823529411764705,0.9411764705882353,0.2,0.8
SF-P22,SF-H28,4,4,3,1,1,3,0.75,0.25,0.25,0.75
SF-P22,SF-S24,34,25,13,7,21,18,0.38235294117647056,0.6176470588235294,0.28,0.72
SF-P22,SF-R24,33,39,22,21,11,18,0.6666666666666666,0.3333333333333333,0.5384615384615384,0.46153846153846156
SF-P22,SF-R26,8,7,4,5,4,2,0.5,0.5,0.7142857142857143,0.2857142857142857
SF-P22,SF-Q26,20,30,8,5,12,25,0.4,0.6,0.16666666666666666,0.8333333333333334
SF-P22,SF-P26,37,50,26,34,11,16,0.7027027027027027,0.2972972972972973,0.68,0.32
SF-P22,SF-O25-2,14,20,7,12,7,8,0.5,0.5,0.6,0.4
SF-P22,SF-N22-1B,9,13,6,7,3,6,0.6666666666666666,0.3333333333333333,0.5384615384615384,0.46153846153846156
SF-P22,SF-N26,17,8,5,2,12,6,0.29411764705882354,0.7058823529411765,0.25,0.75
SF-P22,SF-N25,15,18,5,4,10,14,0.3333333333333333,0.6666666666666666,0.2222222222222222,0.7777777777777778
SF-P22,SF-T21,27,8,16,4,11,4,0.5925925925925926,0.4074074074074074,0.5,0.5
SF-P22,SF-T22,65,52,31,21,34,31,0.47692307692307695,0.5230769230769231,0.40384615384615385,0.5961538461538461
SF-P22,SF-S22-2,34,27,16,9,18,18,0.47058823529411764,0.5294117647058824,0.3333333333333333,0.6666666666666666
SF-P22,SF-S22-1,70,44,40,32,30,12,0.5714285714285714,0.42857142857142855,0.7272727272727273,0.2727272727272727
SF-P22,SF-Q23-3,15,24,10,11,5,13,0.6666666666666666,0.3333333333333333,0.4583333333333333,0.5416666666666666
SF-P22,SF-Q22-1,45,28,23,22,22,6,0.5111111111111111,0.4888888888888889,0.7857142857142857,0.21428571428571427
SF-P22,SF-Q22-2,74,30,57,24,17,6,0.7702702702702703,0.22972972972972974,0.8,0.2
SF-P22,SF-W19,1,7,0,2,1,5,0.0,1.0,0.2857142857142857,0.7142857142857143
SF-P22,SF-W19-2,5,6,1,0,4,6,0.2,0.8,0.0,1.0
SF-P22,SF-U21,13,14,8,5,5,9,0.6153846153846154,0.38461538461538464,0.35714285714285715,0.6428571428571429
SF-P22,SF-T20,77,32,32,8,45,24,0.4155844155844156,0.5844155844155844,0.25,0.75
SF-P22,SF-S21,12,9,6,2,6,7,0.5,0.5,0.2222222222222222,0.7777777777777778
SF-P22,SF-V28,3,1,2,1,1,0,0.6666666666666666,0.3333333333333333,1.0,0.0
SF-P22,SF-W14,3,2,0,0,3,2,0.0,1.0,0.0,1.0
SF-P22,SF-Y14,2,5,0,0,2,5,0.0,1.0,0.0,1.0
SF-P22,SF-X19,4,4,3,1,1,3,0.75,0.25,0.25,0.75
SF-W19,SF-K26,6,5,0,0,6,5,0.0,1.0,0.0,1.0
SF-W19,SF-J27,1,1,1,1,0,0,1.0,0.0,1.0,0.0
SF-W19,SF-L26,4,5,0,0,4,5,0.0,1.0,0.0,1.0
SF-W19,SF-L25,3,4,0,1,3,3,0.0,1.0,0.25,0.75
SF-W19,SF-L24,1,3,0,1,1,2,0.0,1.0,0.3333333333333333,0.6666666666666666
SF-W19,SF-N23,2,1,1,0,1,1,0.5,0.5,0.0,1.0
SF-W19,SF-N24-2,3,1,2,0,1,1,0.6666666666666666,0.3333333333333333,0.0,1.0
SF-W19,SF-J28-2,2,1,0,0,2,1,0.0,1.0,0.0,1.0
SF-W19,SF-J24,2,1,1,1,1,0,0.5,0.5,1.0,0.0
SF-W19,SF-I25,1,2,0,1,1,1,0.0,1.0,0.5,0.5
SF-W19,SF-H26,1,1,1,1,0,0,1.0,0.0,1.0,0.0
SF-W19,SF-H27-1,2,10,0,0,2,10,0.0,1.0,0.0,1.0
SF-W19,SF-F28-2,64,68,39,61,25,7,0.609375,0.390625,0.8970588235294118,0.10294117647058823
SF-W19,SF-G27,2,4,1,1,1,3,0.5,0.5,0.25,0.75
SF-W19,SF-M22-2,6,6,4,2,2,4,0.6666666666666666,0.3333333333333333,0.3333333333333333,0.6666666666666666
SF-W19,SF-L22,2,4,0,0,2,4,0.0,1.0,0.0,1.0
SF-W19,SF-F27,14,3,2,0,12,3,0.14285714285714285,0.8571428571428571,0.0,1.0
SF-W19,SF-N22-2,5,11,2,4,3,7,0.4,0.6,0.36363636363636365,0.6363636363636364
SF-W19,SF-M22-1,2,8,1,6,1,2,0.5,0.5,0.75,0.25
SF-W19,SF-K22-2,2,1,1,1,1,0,0.5,0.5,1.0,0.0
SF-W19,SF-G23,2,5,0,5,2,0,0.0,1.0,1.0,0.0
SF-W19,SF-G24,2,1,1,0,1,1,0.5,0.5,0.0,1.0
SF-W19,SF-G25,2,2,0,1,2,1,0.0,1.0,0.5,0.5
SF-W19,SF-F23,5,2,5,2,0,0,1.0,0.0,1.0,0.0
SF-W19,SF-C22,3,2,2,0,1,2,0.6666666666666666,0.3333333333333333,0.0,1.0
SF-W19,SF-B22,2,3,2,3,0,0,1.0,0.0,1.0,0.0
SF-W19,SF-H18,2,2,0,0,2,2,0.0,1.0,0.0,1.0
SF-W19,SF-H17,1,1,0,0,1,1,0.0,1.0,0.0,1.0
SF-W19,SF-G18,4,1,0,0,4,1,0.0,1.0,0.0,1.0
SF-W19,SF-G20,1,1,0,0,1,1,0.0,1.0,0.0,1.0
SF-W19,SF-H30,2,8,0,6,2,2,0.0,1.0,0.75,0.25
SF-W19,SF-E29-2,5,3,1,0,4,3,0.2,0.8,0.0,1.0
SF-W19,SF-E29-1,2,2,0,2,2,0,0.0,1.0,1.0,0.0
SF-W19,SF-G29-1,1,1,0,1,1,0,0.0,1.0,1.0,0.0
SF-W19,SF-F30-2,1,1,0,0,1,1,0.0,1.0,0.0,1.0
SF-W19,SF-E28-2,4,15,4,15,0,0,1.0,0.0,1.0,0.0
SF-W19,SF-J12,4,1,0,0,4,1,0.0,1.0,0.0,1.0
SF-W19,SF-A20,1,1,0,0,1,1,0.0,1.0,0.0,1.0
SF-W19,SF-B25,2,2,0,0,2,2,0.0,1.0,0.0,1.0
SF-W19,SF-J23-1,2,4,1,1,1,3,0.5,0.5,0.25,0.75
SF-W19,SF-M13,1,2,0,1,1,1,0.0,1.0,0.5,0.5
SF-W19,SF-L19,3,3,0,0,3,3,0.0,1.0,0.0,1.0
SF-W19,SF-N20-1,13,11,0,0,13,11,0.0,1.0,0.0,1.0
SF-W19,SF-M20,3,3,1,0,2,3,0.3333333333333333,0.6666666666666666,0.0,1.0
SF-W19,SF-K17-2,2,1,0,0,2,1,0.0,1.0,0.0,1.0
SF-W19,SF-K20,1,2,1,0,0,2,1.0,0.0,0.0,1.0
SF-W19,SF-K15-,2,1,0,0,2,1,0.0,1.0,0.0,1.0
SF-W19,SF-K19,2,4,1,0,1,4,0.5,0.5,0.0,1.0
SF-W19,SF-K18,3,3,2,0,1,3,0.6666666666666666,0.3333333333333333,0.0,1.0
SF-W19,SF-J16,1,1,0,0,1,1,0.0,1.0,0.0,1.0
SF-W19,SF-M12,8,8,0,0,8,8,0.0,1.0,0.0,1.0
SF-W19,SF-M10,1,3,0,0,1,3,0.0,1.0,0.0,1.0
SF-W19,SF-M11,1,3,1,0,0,3,1.0,0.0,0.0,1.0
SF-W19,SF-R19,11,13,2,0,9,13,0.18181818181818182,0.8181818181818182,0.0,1.0
SF-W19,SF-R20,5,7,1,0,4,7,0.2,0.8,0.0,1.0
SF-W19,SF-Q21-2,3,2,0,0,3,2,0.0,1.0,0.0,1.0
SF-W19,SF-P21,5,11,4,9,1,2,0.8,0.2,0.8181818181818182,0.18181818181818182
SF-W19,SF-O18,4,5,0,0,4,5,0.0,1.0,0.0,1.0
SF-W19,SF-O19,6,5,0,2,6,3,0.0,1.0,0.4,0.6
SF-W19,SF-O21,11,5,0,3,11,2,0.0,1.0,0.6,0.4
SF-W19,SF-O22,14,5,8,2,6,3,0.5714285714285714,0.42857142857142855,0.4,0.6
SF-W19,SF-L21,4,2,2,0,2,2,0.5,0.5,0.0,1.0
SF-W19,SF-Q30,1,2,0,2,1,0,0.0,1.0,1.0,0.0
SF-W19,SF-O30-2,3,2,0,0,3,2,0.0,1.0,0.0,1.0
SF-W19,SF-N27,5,9,0,0,5,9,0.0,1.0,0.0,1.0
SF-W19,SF-N28,5,15,0,0,5,15,0.0,1.0,0.0,1.0
SF-W19,SF-J29-1,3,2,0,0,3,2,0.0,1.0,0.0,1.0
SF-W19,SF-I30,3,3,1,2,2,1,0.3333333333333333,0.6666666666666666,0.6666666666666666,0.3333333333333333
SF-W19,SF-I30-2,1,2,0,1,1,1,0.0,1.0,0.5,0.5
SF-W19,SF-S24,15,10,3,2,12,8,0.2,0.8,0.2,0.8
SF-W19,SF-R24,2,4,0,2,2,2,0.0,1.0,0.5,0.5
SF-W19,SF-R26,27,2,24,0,3,2,0.8888888888888888,0.1111111111111111,0.0,1.0
SF-W19,SF-Q26,5,2,2,0,3,2,0.4,0.6,0.0,1.0
SF-W19,SF-P26,6,1,1,0,5,1,0.16666666666666666,0.8333333333333334,0.0,1.0
SF-W19,SF-N25,1,2,0,0,1,2,0.0,1.0,0.0,1.0
SF-W19,SF-T21,9,9,2,2,7,7,0.2222222222222222,0.7777777777777778,0.2222222222222222,0.7777777777777778
SF-W19,SF-T22,21,13,4,2,17,11,0.19047619047619047,0.8095238095238095,0.15384615384615385,0.8461538461538461
SF-W19,SF-S22-2,8,4,1,1,7,3,0.125,0.875,0.25,0.75
SF-W19,SF-S22-1,12,12,6,7,6,5,0.5,0.5,0.5833333333333334,0.4166666666666667
SF-W19,SF-Q23-3,3,8,2,2,1,6,0.6666666666666666,0.3333333333333333,0.25,0.75
SF-W19,SF-Q22-1,10,3,4,0,6,3,0.4,0.6,0.0,1.0
SF-W19,SF-Q22-2,12,15,2,4,10,11,0.16666666666666666,0.8333333333333334,0.26666666666666666,0.7333333333333333
SF-W19,SF-P22,7,1,2,0,5,1,0.2857142857142857,0.7142857142857143,0.0,1.0
SF-W19,SF-W19-2,16,13,8,4,8,9,0.5,0.5,0.3076923076923077,0.6923076923076923
SF-W19,SF-U21,61,37,12,2,49,35,0.19672131147540983,0.8032786885245902,0.05405405405405406,0.9459459459459459
SF-W19,SF-T20,12,18,3,2,9,16,0.25,0.75,0.1111111111111111,0.8888888888888888
SF-W19,SF-S21,4,7,1,3,3,4,0.25,0.75,0.42857142857142855,0.5714285714285714
SF-W19,SF-Y27,1,1,0,0,1,1,0.0,1.0,0.0,1.0
SF-W19,SF-V28,1,3,0,1,1,2,0.0,1.0,0.3333333333333333,0.6666666666666666
SF-W19,SF-V32,1,2,0,2,1,0,0.0,1.0,1.0,0.0
SF-W19,SF-W14,149,90,68,12,81,78,0.4563758389261745,0.5436241610738255,0.13333333333333333,0.8666666666666667
SF-W19,SF-Z7,3,5,0,4,3,1,0.0,1.0,0.8,0.2
SF-W19,SF-AA15,7,9,1,4,6,5,0.14285714285714285,0.8571428571428571,0.4444444444444444,0.5555555555555556
SF-W19,SF-Z16,7,8,2,3,5,5,0.2857142857142857,0.7142857142857143,0.375,0.625
SF-W19,SF-Y14,20,26,6,3,14,23,0.3,0.7,0.11538461538461539,0.8846153846153846
SF-W19,SF-X14,9,6,6,3,3,3,0.6666666666666666,0.3333333333333333,0.5,0.5
SF-W19,SF-X19,12,5,5,4,7,1,0.4166666666666667,0.5833333333333334,0.8,0.2
SF-W19,SF-Y25,4,2,2,2,2,0,0.5,0.5,1.0,0.0
SF-W19-2,SF-J27,1,2,0,0,1,2,0.0,1.0,0.0,1.0
SF-W19-2,SF-J26-2,1,1,0,0,1,1,0.0,1.0,0.0,1.0
SF-W19-2,SF-P24,1,3,1,2,0,1,1.0,0.0,0.6666666666666666,0.3333333333333333
SF-W19-2,SF-J24,2,1,0,0,2,1,0.0,1.0,0.0,1.0
SF-W19-2,SF-J26,7,18,4,4,3,14,0.5714285714285714,0.42857142857142855,0.2222222222222222,0.7777777777777778
SF-W19-2,SF-M22-2,3,4,0,2,3,2,0.0,1.0,0.5,0.5
SF-W19-2,SF-N22-2,1,1,0,1,1,0,0.0,1.0,1.0,0.0
SF-W19-2,SF-K24,1,1,1,0,0,1,1.0,0.0,0.0,1.0
SF-W19-2,SF-H18,1,1,0,0,1,1,0.0,1.0,0.0,1.0
SF-W19-2,SF-G19,1,1,0,0,1,1,0.0,1.0,0.0,1.0
SF-W19-2,SF-F28-1,1,1,0,0,1,1,0.0,1.0,0.0,1.0
SF-W19-2,SF-C20,3,2,0,0,3,2,0.0,1.0,0.0,1.0
SF-W19-2,SF-J23-1,3,2,1,0,2,2,0.3333333333333333,0.6666666666666666,0.0,1.0
SF-W19-2,SF-J22-1,1,2,0,0,1,2,0.0,1.0,0.0,1.0
SF-W19-2,SF-M13,12,1,0,0,12,1,0.0,1.0,0.0,1.0
SF-W19-2,SF-L19,4,1,0,0,4,1,0.0,1.0,0.0,1.0
SF-W19-2,SF-L20,1,1,0,1,1,0,0.0,1.0,1.0,0.0
SF-W19-2,SF-K19,1,1,0,0,1,1,0.0,1.0,0.0,1.0
SF-W19-2,SF-K18,3,2,1,0,2,2,0.3333333333333333,0.6666666666666666,0.0,1.0
SF-W19-2,SF-M12,19,25,0,0,19,25,0.0,1.0,0.0,1.0
SF-W19-2,SF-R19,2,6,0,2,2,4,0.0,1.0,0.3333333333333333,0.6666666666666666
SF-W19-2,SF-R20,5,4,1,0,4,4,0.2,0.8,0.0,1.0
SF-W19-2,SF-Q21-1,3,2,0,0,3,2,0.0,1.0,0.0,1.0
SF-W19-2,SF-P21,1,4,0,1,1,3,0.0,1.0,0.25,0.75
SF-W19-2,SF-O19,1,1,0,0,1,1,0.0,1.0,0.0,1.0
SF-W19-2,SF-O21,6,2,0,0,6,2,0.0,1.0,0.0,1.0
SF-W19-2,SF-O22,6,3,0,0,6,3,0.0,1.0,0.0,1.0
SF-W19-2,SF-L21,2,1,0,0,2,1,0.0,1.0,0.0,1.0
SF-W19-2,SF-N27,2,1,0,0,2,1,0.0,1.0,0.0,1.0
SF-W19-2,SF-N28,2,3,0,0,2,3,0.0,1.0,0.0,1.0
SF-W19-2,SF-S24,3,14,0,2,3,12,0.0,1.0,0.14285714285714285,0.8571428571428571
SF-W19-2,SF-R24,2,4,1,1,1,3,0.5,0.5,0.25,0.75
SF-W19-2,SF-Q26,2,4,1,1,1,3,0.5,0.5,0.25,0.75
SF-W19-2,SF-P26,1,1,0,0,1,1,0.0,1.0,0.0,1.0
SF-W19-2,SF-T21,6,12,0,6,6,6,0.0,1.0,0.5,0.5
SF-W19-2,SF-T22,7,13,3,4,4,9,0.42857142857142855,0.5714285714285714,0.3076923076923077,0.6923076923076923
SF-W19-2,SF-S22-2,3,1,1,1,2,0,0.3333333333333333,0.6666666666666666,1.0,0.0
SF-W19-2,SF-S22-1,3,1,0,0,3,1,0.0,1.0,0.0,1.0
SF-W19-2,SF-P22,6,5,0,1,6,4,0.0,1.0,0.2,0.8
SF-W19-2,SF-W19,13,16,4,8,9,8,0.3076923076923077,0.6923076923076923,0.5,0.5
SF-W19-2,SF-U21,7,22,2,2,5,20,0.2857142857142857,0.7142857142857143,0.09090909090909091,0.9090909090909091
SF-W19-2,SF-T20,17,13,1,4,16,9,0.058823529411764705,0.9411764705882353,0.3076923076923077,0.6923076923076923
SF-W19-2,SF-W14,2,1,0,0,2,1,0.0,1.0,0.0,1.0
SF-W19-2,SF-AA15,11,10,2,1,9,9,0.18181818181818182,0.8181818181818182,0.1,0.9
SF-W19-2,SF-Y14,3,2,0,0,3,2,0.0,1.0,0.0,1.0
SF-W19-2,SF-X14,2,2,0,0,2,2,0.0,1.0,0.0,1.0
SF-U21,SF-M25,1,3,0,2,1,1,0.0,1.0,0.6666666666666666,0.3333333333333333
SF-U21,SF-M26-2,1,3,1,2,0,1,1.0,0.0,0.6666666666666666,0.3333333333333333
SF-U21,SF-M30,5,9,1,6,4,3,0.2,0.8,0.6666666666666666,0.3333333333333333
SF-U21,SF-L26,16,10,3,3,13,7,0.1875,0.8125,0.3,0.7
SF-U21,SF-L25,1,2,0,0,1,2,0.0,1.0,0.0,1.0
SF-U21,SF-M24,2,7,0,2,2,5,0.0,1.0,0.2857142857142857,0.7142857142857143
SF-U21,SF-L24,1,2,1,0,0,2,1.0,0.0,0.0,1.0
SF-U21,SF-N23,5,1,1,1,4,0,0.2,0.8,1.0,0.0
SF-U21,SF-N24-2,1,1,0,1,1,0,0.0,1.0,1.0,0.0
SF-U21,SF-K27,1,1,0,0,1,1,0.0,1.0,0.0,1.0
SF-U21,SF-P24,3,2,0,1,3,1,0.0,1.0,0.5,0.5
SF-U21,SF-O24,3,1,0,0,3,1,0.0,1.0,0.0,1.0
SF-U21,SF-H26,5,3,2,1,3,2,0.4,0.6,0.3333333333333333,0.6666666666666666
SF-U21,SF-O23,5,3,0,0,5,3,0.0,1.0,0.0,1.0
SF-U21,SF-G27,5,1,0,0,5,1,0.0,1.0,0.0,1.0
SF-U21,SF-M22-2,5,27,0,6,5,21,0.0,1.0,0.2222222222222222,0.7777777777777778
SF-U21,SF-L22,2,4,1,1,1,3,0.5,0.5,0.25,0.75
SF-U21,SF-N22-2,16,15,2,6,14,9,0.125,0.875,0.4,0.6
SF-U21,SF-G28-2,1,1,0,1,1,0,0.0,1.0,1.0,0.0
SF-U21,SF-M22-1,1,2,0,0,1,2,0.0,1.0,0.0,1.0
SF-U21,SF-K22-2,3,10,0,4,3,6,0.0,1.0,0.4,0.6
SF-U21,SF-J23-2,5,19,0,14,5,5,0.0,1.0,0.7368421052631579,0.2631578947368421
SF-U21,SF-G24,6,4,1,0,5,4,0.16666666666666666,0.8333333333333334,0.0,1.0
SF-U21,SF-C22,1,1,1,0,0,1,1.0,0.0,0.0,1.0
SF-U21,SF-I19,2,1,1,1,1,0,0.5,0.5,1.0,0.0
SF-U21,SF-G19,1,1,1,0,0,1,1.0,0.0,0.0,1.0
SF-U21,SF-G18,1,3,0,0,1,3,0.0,1.0,0.0,1.0
SF-U21,SF-E29-1,1,1,0,0,1,1,0.0,1.0,0.0,1.0
SF-U21,SF-D29,1,1,1,1,0,0,1.0,0.0,1.0,0.0
SF-U21,SF-F30-2,3,3,1,0,2,3,0.3333333333333333,0.6666666666666666,0.0,1.0
SF-U21,SF-C26,2,2,0,1,2,1,0.0,1.0,0.5,0.5
SF-U21,SF-E27,1,2,0,0,1,2,0.0,1.0,0.0,1.0
SF-U21,SF-D27,2,6,0,6,2,0,0.0,1.0,1.0,0.0
SF-U21,SF-K21,1,2,0,0,1,2,0.0,1.0,0.0,1.0
SF-U21,SF-K22-1,1,2,0,2,1,0,0.0,1.0,1.0,0.0
SF-U21,SF-J23-1,19,22,3,4,16,18,0.15789473684210525,0.8421052631578947,0.18181818181818182,0.8181818181818182
SF-U21,SF-J22-1,2,10,1,0,1,10,0.5,0.5,0.0,1.0
SF-U21,SF-I23-1,1,3,0,0,1,3,0.0,1.0,0.0,1.0
SF-U21,SF-F26,1,3,0,0,1,3,0.0,1.0,0.0,1.0
SF-U21,SF-M15,1,2,0,0,1,2,0.0,1.0,0.0,1.0
SF-U21,SF-L19,3,4,2,1,1,3,0.6666666666666666,0.3333333333333333,0.25,0.75
SF-U21,SF-L20,4,2,0,0,4,2,0.0,1.0,0.0,1.0
SF-U21,SF-N20-1,2,5,0,0,2,5,0.0,1.0,0.0,1.0
SF-U21,SF-M20,1,5,0,1,1,4,0.0,1.0,0.2,0.8
SF-U21,SF-K17-2,2,1,0,1,2,0,0.0,1.0,1.0,0.0
SF-U21,SF-K20,3,11,1,0,2,11,0.3333333333333333,0.6666666666666666,0.0,1.0
SF-U21,SF-K15-,1,4,0,3,1,1,0.0,1.0,0.75,0.25
SF-U21,SF-K19,6,3,2,0,4,3,0.3333333333333333,0.6666666666666666,0.0,1.0
SF-U21,SF-K18,5,5,0,0,5,5,0.0,1.0,0.0,1.0
SF-U21,SF-K17,1,1,0,0,1,1,0.0,1.0,0.0,1.0
SF-U21,SF-J20,2,1,1,1,1,0,0.5,0.5,1.0,0.0
SF-U21,SF-M12,2,4,0,0,2,4,0.0,1.0,0.0,1.0
SF-U21,SF-R19,13,13,2,4,11,9,0.15384615384615385,0.8461538461538461,0.3076923076923077,0.6923076923076923
SF-U21,SF-R20,13,7,2,3,11,4,0.15384615384615385,0.8461538461538461,0.42857142857142855,0.5714285714285714
SF-U21,SF-Q21-2,4,7,0,3,4,4,0.0,1.0,0.42857142857142855,0.5714285714285714
SF-U21,SF-Q21-1,6,10,1,2,5,8,0.16666666666666666,0.8333333333333334,0.2,0.8
SF-U21,SF-P21,11,19,1,1,10,18,0.09090909090909091,0.9090909090909091,0.05263157894736842,0.9473684210526315
SF-U21,SF-O18,2,1,1,0,1,1,0.5,0.5,0.0,1.0
SF-U21,SF-O19,3,5,1,2,2,3,0.3333333333333333,0.6666666666666666,0.4,0.6
SF-U21,SF-O21,5,3,0,0,5,3,0.0,1.0,0.0,1.0
SF-U21,SF-O22,20,9,3,4,17,5,0.15,0.85,0.4444444444444444,0.5555555555555556
SF-U21,SF-N21,1,1,0,1,1,0,0.0,1.0,1.0,0.0
SF-U21,SF-N20-2,3,3,1,0,2,3,0.3333333333333333,0.6666666666666666,0.0,1.0
SF-U21,SF-M21,1,3,0,1,1,2,0.0,1.0,0.3333333333333333,0.6666666666666666
SF-U21,SF-L21,2,4,0,0,2,4,0.0,1.0,0.0,1.0
SF-U21,SF-Q30,2,1,0,0,2,1,0.0,1.0,0.0,1.0
SF-U21,SF-I30,1,6,0,4,1,2,0.0,1.0,0.6666666666666666,0.3333333333333333
SF-U21,SF-S24,5,13,0,4,5,9,0.0,1.0,0.3076923076923077,0.6923076923076923
SF-U21,SF-R24,2,4,0,2,2,2,0.0,1.0,0.5,0.5
SF-U21,SF-Q26,3,4,2,0,1,4,0.6666666666666666,0.3333333333333333,0.0,1.0
SF-U21,SF-O25-2,1,2,0,0,1,2,0.0,1.0,0.0,1.0
SF-U21,SF-T21,47,54,5,19,42,35,0.10638297872340426,0.8936170212765957,0.35185185185185186,0.6481481481481481
SF-U21,SF-T22,11,30,4,16,7,14,0.36363636363636365,0.6363636363636364,0.5333333333333333,0.4666666666666667
SF-U21,SF-S22-2,7,8,2,7,5,1,0.2857142857142857,0.7142857142857143,0.875,0.125
SF-U21,SF-S22-1,8,14,3,8,5,6,0.375,0.625,0.5714285714285714,0.42857142857142855
SF-U21,SF-Q23-3,4,13,1,4,3,9,0.25,0.75,0.3076923076923077,0.6923076923076923
SF-U21,SF-Q22-1,9,11,3,7,6,4,0.3333333333333333,0.6666666666666666,0.6363636363636364,0.36363636363636365
SF-U21,SF-Q22-2,13,33,3,12,10,21,0.23076923076923078,0.7692307692307693,0.36363636363636365,0.6363636363636364
SF-U21,SF-P22,14,13,5,8,9,5,0.35714285714285715,0.6428571428571429,0.6153846153846154,0.38461538461538464
SF-U21,SF-W19,37,61,2,12,35,49,0.05405405405405406,0.9459459459459459,0.19672131147540983,0.8032786885245902
SF-U21,SF-W19-2,22,7,2,2,20,5,0.09090909090909091,0.9090909090909091,0.2857142857142857,0.7142857142857143
SF-U21,SF-T20,11,41,6,35,5,6,0.5454545454545454,0.45454545454545453,0.8536585365853658,0.14634146341463414
SF-U21,SF-W14,32,9,7,1,25,8,0.21875,0.78125,0.1111111111111111,0.8888888888888888
SF-U21,SF-AA15,2,16,0,1,2,15,0.0,1.0,0.0625,0.9375
SF-U21,SF-Z16,7,10,0,2,7,8,0.0,1.0,0.2,0.8
SF-U21,SF-Y14,66,54,0,0,66,54,0.0,1.0,0.0,1.0
SF-U21,SF-X14,11,2,1,0,10,2,0.09090909090909091,0.9090909090909091,0.0,1.0
SF-U21,SF-X19,2,2,2,1,0,1,1.0,0.0,0.5,0.5
SF-T20,SF-M26,1,1,0,0,1,1,0.0,1.0,0.0,1.0
SF-T20,SF-M25,10,11,0,0,10,11,0.0,1.0,0.0,1.0
SF-T20,SF-M26-2,1,1,1,0,0,1,1.0,0.0,0.0,1.0
SF-T20,SF-M30,2,10,0,4,2,6,0.0,1.0,0.4,0.6
SF-T20,SF-L26,10,9,0,0,10,9,0.0,1.0,0.0,1.0
SF-T20,SF-L25,6,7,0,1,6,6,0.0,1.0,0.14285714285714285,0.8571428571428571
SF-T20,SF-M24,6,5,1,3,5,2,0.16666666666666666,0.8333333333333334,0.6,0.4
SF-T20,SF-L24,4,2,3,0,1,2,0.75,0.25,0.0,1.0
SF-T20,SF-N23,5,6,1,2,4,4,0.2,0.8,0.3333333333333333,0.6666666666666666
SF-T20,SF-N24-2,4,5,2,1,2,4,0.5,0.5,0.2,0.8
SF-T20,SF-K27-2,1,1,0,0,1,1,0.0,1.0,0.0,1.0
SF-T20,SF-J26-2,3,12,0,1,3,11,0.0,1.0,0.08333333333333333,0.9166666666666666
SF-T20,SF-K29-1,3,2,0,0,3,2,0.0,1.0,0.0,1.0
SF-T20,SF-K27,2,2,2,0,0,2,1.0,0.0,0.0,1.0
SF-T20,SF-K25,1,4,0,1,1,3,0.0,1.0,0.25,0.75
SF-T20,SF-J25,8,10,1,3,7,7,0.125,0.875,0.3,0.7
SF-T20,SF-H26-2,4,2,0,1,4,1,0.0,1.0,0.5,0.5
SF-T20,SF-P24,8,11,2,4,6,7,0.25,0.75,0.36363636363636365,0.6363636363636364
SF-T20,SF-J24,3,2,2,1,1,1,0.6666666666666666,0.3333333333333333,0.5,0.5
SF-T20,SF-O24,2,9,1,1,1,8,0.5,0.5,0.1111111111111111,0.8888888888888888
SF-T20,SF-J26,8,13,0,0,8,13,0.0,1.0,0.0,1.0
SF-T20,SF-I26-,11,28,0,0,11,28,0.0,1.0,0.0,1.0
SF-T20,SF-I25,21,8,0,2,21,6,0.0,1.0,0.25,0.75
SF-T20,SF-K23,53,3,46,2,7,1,0.8679245283018868,0.1320754716981132,0.6666666666666666,0.3333333333333333
SF-T20,SF-H26,5,9,3,2,2,7,0.6,0.4,0.2222222222222222,0.7777777777777778
SF-T20,SF-O23,8,14,2,5,6,9,0.25,0.75,0.35714285714285715,0.6428571428571429
SF-T20,SF-F28-2,9,13,3,2,6,11,0.3333333333333333,0.6666666666666666,0.15384615384615385,0.8461538461538461
SF-T20,SF-G27,20,13,3,2,17,11,0.15,0.85,0.15384615384615385,0.8461538461538461
SF-T20,SF-M22-2,15,22,4,9,11,13,0.26666666666666666,0.7333333333333333,0.4090909090909091,0.5909090909090909
SF-T20,SF-L22,44,22,11,17,33,5,0.25,0.75,0.7727272727272727,0.22727272727272727
SF-T20,SF-F27,3,11,0,2,3,9,0.0,1.0,0.18181818181818182,0.8181818181818182
SF-T20,SF-N22-2,36,36,11,12,25,24,0.3055555555555556,0.6944444444444444,0.3333333333333333,0.6666666666666666
SF-T20,SF-G28-2,4,4,2,2,2,2,0.5,0.5,0.5,0.5
SF-T20,SF-M22-1,13,30,1,2,12,28,0.07692307692307693,0.9230769230769231,0.06666666666666667,0.9333333333333333
SF-T20,SF-O25-1,5,3,0,1,5,2,0.0,1.0,0.3333333333333333,0.6666666666666666
SF-T20,SF-K22-2,35,9,22,4,13,5,0.6285714285714286,0.37142857142857144,0.4444444444444444,0.5555555555555556
SF-T20,SF-K24,7,9,1,1,6,8,0.14285714285714285,0.8571428571428571,0.1111111111111111,0.8888888888888888
SF-T20,SF-J23-2,12,46,0,6,12,40,0.0,1.0,0.13043478260869565,0.8695652173913043
SF-T20,SF-G23,1,3,0,1,1,2,0.0,1.0,0.3333333333333333,0.6666666666666666
SF-T20,SF-F23,1,3,0,0,1,3,0.0,1.0,0.0,1.0
SF-T20,SF-E23,1,2,0,0,1,2,0.0,1.0,0.0,1.0
SF-T20,SF-B22,2,2,1,0,1,2,0.5,0.5,0.0,1.0
SF-T20,SF-J17,8,6,1,1,7,5,0.125,0.875,0.16666666666666666,0.8333333333333334
SF-T20,SF-I20,1,1,1,0,0,1,1.0,0.0,0.0,1.0
SF-T20,SF-H16,1,1,0,0,1,1,0.0,1.0,0.0,1.0
SF-T20,SF-H20,7,22,5,20,2,2,0.7142857142857143,0.2857142857142857,0.9090909090909091,0.09090909090909091
SF-T20,SF-G19,2,2,0,0,2,2,0.0,1.0,0.0,1.0
SF-T20,SF-G18,3,1,0,0,3,1,0.0,1.0,0.0,1.0
SF-T20,SF-G20,2,1,0,0,2,1,0.0,1.0,0.0,1.0
SF-T20,SF-F19,3,1,0,0,3,1,0.0,1.0,0.0,1.0
SF-T20,SF-E20,3,7,0,0,3,7,0.0,1.0,0.0,1.0
SF-T20,SF-G30-2,2,1,1,1,1,0,0.5,0.5,1.0,0.0
SF-T20,SF-E29-2,7,4,1,1,6,3,0.14285714285714285,0.8571428571428571,0.25,0.75
SF-T20,SF-E29-1,2,2,1,1,1,1,0.5,0.5,0.5,0.5
SF-T20,SF-G29-2,1,2,0,1,1,1,0.0,1.0,0.5,0.5
SF-T20,SF-G29-3,4,6,3,2,1,4,0.75,0.25,0.3333333333333333,0.6666666666666666
SF-T20,SF-E29-3,2,3,1,0,1,3,0.5,0.5,0.0,1.0
SF-T20,SF-F28-1,1,3,1,1,0,2,1.0,0.0,0.3333333333333333,0.6666666666666666
SF-T20,SF-J10,2,2,1,0,1,2,0.5,0.5,0.0,1.0
SF-T20,SF-J12,1,1,0,1,1,0,0.0,1.0,1.0,0.0
SF-T20,SF-J13,2,1,0,0,2,1,0.0,1.0,0.0,1.0
SF-T20,SF-G12,1,3,0,0,1,3,0.0,1.0,0.0,1.0
SF-T20,SF-F16,1,1,0,0,1,1,0.0,1.0,0.0,1.0
SF-T20,SF-C20,7,4,0,0,7,4,0.0,1.0,0.0,1.0
SF-T20,SF-B19,1,1,0,0,1,1,0.0,1.0,0.0,1.0
SF-T20,SF-A19,2,1,0,0,2,1,0.0,1.0,0.0,1.0
SF-T20,SF-C26,3,2,0,0,3,2,0.0,1.0,0.0,1.0
SF-T20,SF-B25,1,1,0,0,1,1,0.0,1.0,0.0,1.0
SF-T20,SF-E27,8,2,0,0,8,2,0.0,1.0,0.0,1.0
SF-T20,SF-D27,1,1,0,0,1,1,0.0,1.0,0.0,1.0
SF-T20,SF-J1,1,6,0,1,1,5,0.0,1.0,0.16666666666666666,0.8333333333333334
SF-T20,SF-G7,1,2,0,0,1,2,0.0,1.0,0.0,1.0
SF-T20,SF-H25,3,14,0,0,3,14,0.0,1.0,0.0,1.0
SF-T20,SF-G26,13,9,4,3,9,6,0.3076923076923077,0.6923076923076923,0.3333333333333333,0.6666666666666666
SF-T20,SF-K21,6,1,0,0,6,1,0.0,1.0,0.0,1.0
SF-T20,SF-K22-1,21,11,5,10,16,1,0.23809523809523808,0.7619047619047619,0.9090909090909091,0.09090909090909091
SF-T20,SF-J23-1,12,14,1,5,11,9,0.08333333333333333,0.9166666666666666,0.35714285714285715,0.6428571428571429
SF-T20,SF-J22-1,70,152,62,130,8,22,0.8857142857142857,0.11428571428571428,0.8552631578947368,0.14473684210526316
SF-T20,SF-J22-2,2,3,1,1,1,2,0.5,0.5,0.3333333333333333,0.6666666666666666
SF-T20,SF-J21,4,10,0,1,4,9,0.0,1.0,0.1,0.9
SF-T20,SF-I22,1,1,1,0,0,1,1.0,0.0,0.0,1.0
SF-T20,SF-I23-2,6,8,2,2,4,6,0.3333333333333333,0.6666666666666666,0.25,0.75
SF-T20,SF-I24,11,3,1,1,10,2,0.09090909090909091,0.9090909090909091,0.3333333333333333,0.6666666666666666
SF-T20,SF-I23-1,14,15,0,2,14,13,0.0,1.0,0.13333333333333333,0.8666666666666667
SF-T20,SF-F26,6,5,3,1,3,4,0.5,0.5,0.2,0.8
SF-T20,SF-M13,1,3,0,0,1,3,0.0,1.0,0.0,1.0
SF-T20,SF-M15,8,6,0,0,8,6,0.0,1.0,0.0,1.0
SF-T20,SF-L19,4,12,0,0,4,12,0.0,1.0,0.0,1.0
SF-T20,SF-L20,23,21,0,11,23,10,0.0,1.0,0.5238095238095238,0.47619047619047616
SF-T20,SF-N20-1,11,9,0,1,11,8,0.0,1.0,0.1111111111111111,0.8888888888888888
SF-T20,SF-M20,21,13,0,2,21,11,0.0,1.0,0.15384615384615385,0.8461538461538461
SF-T20,SF-K17-2,1,3,0,0,1,3,0.0,1.0,0.0,1.0
SF-T20,SF-K20,7,6,1,1,6,5,0.14285714285714285,0.8571428571428571,0.16666666666666666,0.8333333333333334
SF-T20,SF-K15-,7,16,0,1,7,15,0.0,1.0,0.0625,0.9375
SF-T20,SF-K19,12,8,3,1,9,7,0.25,0.75,0.125,0.875
SF-T20,SF-K18,4,1,1,0,3,1,0.25,0.75,0.0,1.0
SF-T20,SF-K17,3,3,1,2,2,1,0.3333333333333333,0.6666666666666666,0.6666666666666666,0.3333333333333333
SF-T20,SF-J18,9,7,0,1,9,6,0.0,1.0,0.14285714285714285,0.8571428571428571
SF-T20,SF-J19,1,9,1,0,0,9,1.0,0.0,0.0,1.0
SF-T20,SF-M12,3,1,0,0,3,1,0.0,1.0,0.0,1.0
SF-T20,SF-M10,1,2,0,0,1,2,0.0,1.0,0.0,1.0
SF-T20,SF-R19,26,39,13,10,13,29,0.5,0.5,0.2564102564102564,0.7435897435897436
SF-T20,SF-R20,43,36,27,20,16,16,0.627906976744186,0.37209302325581395,0.5555555555555556,0.4444444444444444
SF-T20,SF-Q21-2,14,22,10,3,4,19,0.7142857142857143,0.2857142857142857,0.13636363636363635,0.8636363636363636
SF-T20,SF-Q21-1,12,11,3,7,9,4,0.25,0.75,0.6363636363636364,0.36363636363636365
SF-T20,SF-P21,23,22,4,7,19,15,0.17391304347826086,0.8260869565217391,0.3181818181818182,0.6818181818181818
SF-T20,SF-O18,19,15,2,0,17,15,0.10526315789473684,0.8947368421052632,0.0,1.0
SF-T20,SF-O19,9,9,2,4,7,5,0.2222222222222222,0.7777777777777778,0.4444444444444444,0.5555555555555556
SF-T20,SF-O21,41,58,13,30,28,28,0.3170731707317073,0.6829268292682927,0.5172413793103449,0.4827586206896552
SF-T20,SF-O22,71,40,23,7,48,33,0.323943661971831,0.676056338028169,0.175,0.825
SF-T20,SF-N21,11,7,4,0,7,7,0.36363636363636365,0.6363636363636364,0.0,1.0
SF-T20,SF-M21,10,7,3,3,7,4,0.3,0.7,0.42857142857142855,0.5714285714285714
SF-T20,SF-L21,30,38,1,26,29,12,0.03333333333333333,0.9666666666666667,0.6842105263157895,0.3157894736842105
SF-T20,SF-S29,1,1,0,0,1,1,0.0,1.0,0.0,1.0
SF-T20,SF-O30,6,5,1,1,5,4,0.16666666666666666,0.8333333333333334,0.2,0.8
SF-T20,SF-N29,1,1,0,0,1,1,0.0,1.0,0.0,1.0
SF-T20,SF-N28,2,3,0,1,2,2,0.0,1.0,0.3333333333333333,0.6666666666666666
SF-T20,SF-L30-1,6,10,0,2,6,8,0.0,1.0,0.2,0.8
SF-T20,SF-L31-1,6,6,0,0,6,6,0.0,1.0,0.0,1.0
SF-T20,SF-I30,8,3,8,3,0,0,1.0,0.0,1.0,0.0
SF-T20,SF-I27,10,15,0,3,10,12,0.0,1.0,0.2,0.8
SF-T20,SF I29-1,4,1,3,0,1,1,0.75,0.25,0.0,1.0
SF-T20,SF-H28,2,1,1,1,1,0,0.5,0.5,1.0,0.0
SF-T20,SF-S24,17,19,5,9,12,10,0.29411764705882354,0.7058823529411765,0.47368421052631576,0.5263157894736842
SF-T20,SF-R24,28,23,5,5,23,18,0.17857142857142858,0.8214285714285714,0.21739130434782608,0.782608695652174
SF-T20,SF-Q26,9,6,0,0,9,6,0.0,1.0,0.0,1.0
SF-T20,SF-P26,21,25,4,1,17,24,0.19047619047619047,0.8095238095238095,0.04,0.96
SF-T20,SF-N22-1B,2,2,1,0,1,2,0.5,0.5,0.0,1.0
SF-T20,SF-T21,12,5,6,4,6,1,0.5,0.5,0.8,0.2
SF-T20,SF-T22,49,79,23,54,26,25,0.46938775510204084,0.5306122448979592,0.6835443037974683,0.31645569620253167
SF-T20,SF-S22-2,5,9,2,5,3,4,0.4,0.6,0.5555555555555556,0.4444444444444444
SF-T20,SF-S22-1,28,50,11,36,17,14,0.39285714285714285,0.6071428571428571,0.72,0.28
SF-T20,SF-Q23-3,27,37,4,18,23,19,0.14814814814814814,0.8518518518518519,0.4864864864864865,0.5135135135135135
SF-T20,SF-Q22-1,45,12,13,5,32,7,0.28888888888888886,0.7111111111111111,0.4166666666666667,0.5833333333333334
SF-T20,SF-Q22-2,33,28,5,21,28,7,0.15151515151515152,0.8484848484848485,0.75,0.25
SF-T20,SF-P22,32,77,8,32,24,45,0.25,0.75,0.4155844155844156,0.5844155844155844
SF-T20,SF-W19,18,12,2,3,16,9,0.1111111111111111,0.8888888888888888,0.25,0.75
SF-T20,SF-W19-2,13,17,4,1,9,16,0.3076923076923077,0.6923076923076923,0.058823529411764705,0.9411764705882353
SF-T20,SF-U21,41,11,35,6,6,5,0.8536585365853658,0.14634146341463414,0.5454545454545454,0.45454545454545453
SF-T20,SF-S21,5,3,4,3,1,0,0.8,0.2,1.0,0.0
SF-T20,SF-W14,1,5,0,0,1,5,0.0,1.0,0.0,1.0
SF-T20,SF-Y14,1,2,0,0,1,2,0.0,1.0,0.0,1.0
SF-T20,SF-X19,1,1,0,1,1,0,0.0,1.0,1.0,0.0
SF-T20,SF-Y25,1,1,0,0,1,1,0.0,1.0,0.0,1.0
SF-S21,SF-M26,1,1,1,1,0,0,1.0,0.0,1.0,0.0
SF-S21,SF-M25,1,2,0,0,1,2,0.0,1.0,0.0,1.0
SF-S21,SF-K26,3,2,0,0,3,2,0.0,1.0,0.0,1.0
SF-S21,SF-J27,1,2,0,0,1,2,0.0,1.0,0.0,1.0
SF-S21,SF-M30,2,7,0,1,2,6,0.0,1.0,0.14285714285714285,0.8571428571428571
SF-S21,SF-J29,2,1,0,0,2,1,0.0,1.0,0.0,1.0
SF-S21,SF-L26,16,20,0,1,16,19,0.0,1.0,0.05,0.95
SF-S21,SF-L25,1,3,0,2,1,1,0.0,1.0,0.6666666666666666,0.3333333333333333
SF-S21,SF-M24,1,1,0,1,1,0,0.0,1.0,1.0,0.0
SF-S21,SF-N23,2,5,0,0,2,5,0.0,1.0,0.0,1.0
SF-S21,SF-N24-2,1,4,1,3,0,1,1.0,0.0,0.75,0.25
SF-S21,SF-K27-2,4,3,1,0,3,3,0.25,0.75,0.0,1.0
SF-S21,SF-J26-2,2,2,1,1,1,1,0.5,0.5,0.5,0.5
SF-S21,SF-K29-1,3,1,0,1,3,0,0.0,1.0,1.0,0.0
SF-S21,SF-J25,2,1,0,0,2,1,0.0,1.0,0.0,1.0
SF-S21,SF-P24,2,1,0,1,2,0,0.0,1.0,1.0,0.0
SF-S21,SF-J24,1,1,0,0,1,1,0.0,1.0,0.0,1.0
SF-S21,SF-O24,4,8,0,4,4,4,0.0,1.0,0.5,0.5
SF-S21,SF-I25,3,1,1,1,2,0,0.3333333333333333,0.6666666666666666,1.0,0.0
SF-S21,SF-H26,2,1,2,1,0,0,1.0,0.0,1.0,0.0
SF-S21,SF-O23,4,2,0,1,4,1,0.0,1.0,0.5,0.5
SF-S21,SF-G27,5,4,0,3,5,1,0.0,1.0,0.75,0.25
SF-S21,SF-M22-2,9,1,5,0,4,1,0.5555555555555556,0.4444444444444444,0.0,1.0
SF-S21,SF-L22,4,4,0,1,4,3,0.0,1.0,0.25,0.75
SF-S21,SF-F27,3,3,0,0,3,3,0.0,1.0,0.0,1.0
SF-S21,SF-N22-2,10,13,1,6,9,7,0.1,0.9,0.46153846153846156,0.5384615384615384
SF-S21,SF-M22-1,2,1,0,1,2,0,0.0,1.0,1.0,0.0
SF-S21,SF-K22-2,4,11,3,5,1,6,0.75,0.25,0.45454545454545453,0.5454545454545454
SF-S21,SF-K24,1,2,0,1,1,1,0.0,1.0,0.5,0.5
SF-S21,SF-G24,6,3,1,0,5,3,0.16666666666666666,0.8333333333333334,0.0,1.0
SF-S21,SF-G25,1,5,0,3,1,2,0.0,1.0,0.6,0.4
SF-S21,SF-E23,38,33,0,1,38,32,0.0,1.0,0.030303030303030304,0.9696969696969697
SF-S21,SF-I20,2,2,1,2,1,0,0.5,0.5,1.0,0.0
SF-S21,SF-H20,1,1,0,0,1,1,0.0,1.0,0.0,1.0
SF-S21,SF-H30,4,2,1,1,3,1,0.25,0.75,0.5,0.5
SF-S21,SF-G30-2,2,1,0,1,2,0,0.0,1.0,1.0,0.0
SF-S21,SF-E29-1,1,3,0,0,1,3,0.0,1.0,0.0,1.0
SF-S21,SF-A27,6,1,0,1,6,0,0.0,1.0,1.0,0.0
SF-S21,SF-G29-2,4,5,1,0,3,5,0.25,0.75,0.0,1.0
SF-S21,SF-G29-1,3,2,0,0,3,2,0.0,1.0,0.0,1.0
SF-S21,SF-F30-2,3,1,0,0,3,1,0.0,1.0,0.0,1.0
SF-S21,SF-E29-3,1,2,0,0,1,2,0.0,1.0,0.0,1.0
SF-S21,SF-F28-1,2,4,0,2,2,2,0.0,1.0,0.5,0.5
SF-S21,SF-J12,2,1,0,0,2,1,0.0,1.0,0.0,1.0
SF-S21,SF-J13,1,3,0,2,1,1,0.0,1.0,0.6666666666666666,0.3333333333333333
SF-S21,SF-G12,2,1,0,0,2,1,0.0,1.0,0.0,1.0
SF-S21,SF-C26,2,3,0,0,2,3,0.0,1.0,0.0,1.0
SF-S21,SF-C25,7,2,0,0,7,2,0.0,1.0,0.0,1.0
SF-S21,SF-B28-2,4,1,0,0,4,1,0.0,1.0,0.0,1.0
SF-S21,SF-C28-2,2,6,2,6,0,0,1.0,0.0,1.0,0.0
SF-S21,SF-B28,10,24,0,0,10,24,0.0,1.0,0.0,1.0
SF-S21,SF-K21,2,2,0,0,2,2,0.0,1.0,0.0,1.0
SF-S21,SF-K22-1,5,5,4,3,1,2,0.8,0.2,0.6,0.4
SF-S21,SF-J23-1,85,59,75,52,10,7,0.8823529411764706,0.11764705882352941,0.8813559322033898,0.11864406779661017
SF-S21,SF-J22-1,7,6,2,3,5,3,0.2857142857142857,0.7142857142857143,0.5,0.5
SF-S21,SF-J22-2,2,3,1,1,1,2,0.5,0.5,0.3333333333333333,0.6666666666666666
SF-S21,SF-J21,19,9,3,1,16,8,0.15789473684210525,0.8421052631578947,0.1111111111111111,0.8888888888888888
SF-S21,SF-I24,2,4,1,1,1,3,0.5,0.5,0.25,0.75
SF-S21,SF-I23-1,2,28,0,0,2,28,0.0,1.0,0.0,1.0
SF-S21,SF-F26,6,4,1,1,5,3,0.16666666666666666,0.8333333333333334,0.25,0.75
SF-S21,SF-M13,3,5,3,0,0,5,1.0,0.0,0.0,1.0
SF-S21,SF-M15,2,2,0,0,2,2,0.0,1.0,0.0,1.0
SF-S21,SF-L19,3,7,0,2,3,5,0.0,1.0,0.2857142857142857,0.7142857142857143
SF-S21,SF-L20,4,3,0,0,4,3,0.0,1.0,0.0,1.0
SF-S21,SF-N20-1,13,10,0,0,13,10,0.0,1.0,0.0,1.0
SF-S21,SF-M20,5,5,2,3,3,2,0.4,0.6,0.6,0.4
SF-S21,SF-K15-,5,10,2,6,3,4,0.4,0.6,0.6,0.4
SF-S21,SF-K17,1,1,0,0,1,1,0.0,1.0,0.0,1.0
SF-S21,SF-J16,1,1,0,0,1,1,0.0,1.0,0.0,1.0
SF-S21,SF-J18,3,5,1,0,2,5,0.3333333333333333,0.6666666666666666,0.0,1.0
SF-S21,SF-J19,2,3,1,0,1,3,0.5,0.5,0.0,1.0
SF-S21,SF-M10,1,1,1,0,0,1,1.0,0.0,0.0,1.0
SF-S21,SF-R19,6,7,3,3,3,4,0.5,0.5,0.42857142857142855,0.5714285714285714
SF-S21,SF-R20,10,6,8,3,2,3,0.8,0.2,0.5,0.5
SF-S21,SF-Q21-2,2,7,1,4,1,3,0.5,0.5,0.5714285714285714,0.42857142857142855
SF-S21,SF-Q21-1,2,3,0,3,2,0,0.0,1.0,1.0,0.0
SF-S21,SF-P21,5,5,3,0,2,5,0.6,0.4,0.0,1.0
SF-S21,SF-O18,4,2,0,0,4,2,0.0,1.0,0.0,1.0
SF-S21,SF-O19,10,9,0,0,10,9,0.0,1.0,0.0,1.0
SF-S21,SF-O21,9,12,2,5,7,7,0.2222222222222222,0.7777777777777778,0.4166666666666667,0.5833333333333334
SF-S21,SF-O22,19,16,3,10,16,6,0.15789473684210525,0.8421052631578947,0.625,0.375
SF-S21,SF-N21,9,6,4,3,5,3,0.4444444444444444,0.5555555555555556,0.5,0.5
SF-S21,SF-M21,10,13,4,2,6,11,0.4,0.6,0.15384615384615385,0.8461538461538461
SF-S21,SF-L21,4,5,1,2,3,3,0.25,0.75,0.4,0.6
SF-S21,SF-S29,1,2,1,2,0,0,1.0,0.0,1.0,0.0
SF-S21,SF-P30,4,2,2,0,2,2,0.5,0.5,0.0,1.0
SF-S21,SF-O30,3,5,0,0,3,5,0.0,1.0,0.0,1.0
SF-S21,SF-N28,8,5,1,0,7,5,0.125,0.875,0.0,1.0
SF-S21,SF-I27,1,5,0,1,1,4,0.0,1.0,0.2,0.8
SF-S21,SF-S24,8,17,0,10,8,7,0.0,1.0,0.5882352941176471,0.4117647058823529
SF-S21,SF-R24,10,6,3,1,7,5,0.3,0.7,0.16666666666666666,0.8333333333333334
SF-S21,SF-R26,7,11,1,1,6,10,0.14285714285714285,0.8571428571428571,0.09090909090909091,0.9090909090909091
SF-S21,SF-P26,5,10,0,1,5,9,0.0,1.0,0.1,0.9
SF-S21,SF-O25-2,2,1,0,0,2,1,0.0,1.0,0.0,1.0
SF-S21,SF-N26,4,1,0,0,4,1,0.0,1.0,0.0,1.0
SF-S21,SF-N25,1,3,0,0,1,3,0.0,1.0,0.0,1.0
SF-S21,SF-T21,2,2,1,1,1,1,0.5,0.5,0.5,0.5
SF-S21,SF-T22,2,2,0,1,2,1,0.0,1.0,0.5,0.5
SF-S21,SF-S22-2,4,1,4,1,0,0,1.0,0.0,1.0,0.0
SF-S21,SF-S22-1,4,19,4,17,0,2,1.0,0.0,0.8947368421052632,0.10526315789473684
SF-S21,SF-Q23-3,8,5,2,2,6,3,0.25,0.75,0.4,0.6
SF-S21,SF-Q22-1,6,3,1,0,5,3,0.16666666666666666,0.8333333333333334,0.0,1.0
SF-S21,SF-Q22-2,16,22,3,16,13,6,0.1875,0.8125,0.7272727272727273,0.2727272727272727
SF-S21,SF-P22,9,12,2,6,7,6,0.2222222222222222,0.7777777777777778,0.5,0.5
SF-S21,SF-W19,7,4,3,1,4,3,0.42857142857142855,0.5714285714285714,0.25,0.75
SF-S21,SF-T20,3,5,3,4,0,1,1.0,0.0,0.8,0.2
SF-S21,SF-Y29,4,1,0,1,4,0,0.0,1.0,1.0,0.0
SF-S21,SF-W14,1,5,0,0,1,5,0.0,1.0,0.0,1.0
SF-AA28,SF-J26-2,11,12,1,0,10,12,0.09090909090909091,0.9090909090909091,0.0,1.0
SF-AA28,SF-J25,1,1,1,1,0,0,1.0,0.0,1.0,0.0
SF-AA28,SF-N22-2,1,1,1,0,0,1,1.0,0.0,0.0,1.0
SF-AA28,SF-K20,1,12,0,0,1,12,0.0,1.0,0.0,1.0
SF-AA28,SF-L21,1,1,0,0,1,1,0.0,1.0,0.0,1.0
SF-AA28,SF-Q30,2,2,2,2,0,0,1.0,0.0,1.0,0.0
SF-AA28,SF-O30-2,1,1,1,1,0,0,1.0,0.0,1.0,0.0
SF-AA28,SF-Z28,8,7,1,1,7,6,0.125,0.875,0.14285714285714285,0.8571428571428571
SF-AA28,SF-Y29,6,12,1,8,5,4,0.16666666666666666,0.8333333333333334,0.6666666666666666,0.3333333333333333
SF-AA28,SF-Y30,6,7,5,5,1,2,0.8333333333333334,0.16666666666666666,0.7142857142857143,0.2857142857142857
SF-AA28,SF-Y27,5,7,5,5,0,2,1.0,0.0,0.7142857142857143,0.2857142857142857
SF-AA28,SF-V31,38,102,33,35,5,67,0.868421052631579,0.13157894736842105,0.3431372549019608,0.6568627450980392
SF-Z28,SF-M28,1,1,1,0,0,1,1.0,0.0,0.0,1.0
SF-Z28,SF-G27,4,9,1,1,3,8,0.25,0.75,0.1111111111111111,0.8888888888888888
SF-Z28,SF-H30,4,4,3,4,1,0,0.75,0.25,1.0,0.0
SF-Z28,SF-B25,1,3,0,2,1,1,0.0,1.0,0.6666666666666666,0.3333333333333333
SF-Z28,SF-C28-1,1,1,1,0,0,1,1.0,0.0,0.0,1.0
SF-Z28,SF-L20,4,2,0,0,4,2,0.0,1.0,0.0,1.0
SF-Z28,SF-K20,3,1,0,0,3,1,0.0,1.0,0.0,1.0
SF-Z28,SF-P30,1,4,0,1,1,3,0.0,1.0,0.25,0.75
SF-Z28,SF-O30,4,2,0,1,4,1,0.0,1.0,0.5,0.5
SF-Z28,SF-L29,12,10,12,10,0,0,1.0,0.0,1.0,0.0
SF-Z28,SF-J29-1,3,1,0,0,3,1,0.0,1.0,0.0,1.0
SF-Z28,SF-I30,5,7,4,7,1,0,0.8,0.2,1.0,0.0
SF-Z28,SF-I29-2,27,29,0,0,27,29,0.0,1.0,0.0,1.0
SF-Z28,SF-R26,1,1,0,0,1,1,0.0,1.0,0.0,1.0
SF-Z28,SF-S22-1,2,2,0,0,2,2,0.0,1.0,0.0,1.0
SF-Z28,SF-AA28,7,8,1,1,6,7,0.14285714285714285,0.8571428571428571,0.125,0.875
SF-Z28,SF-Y29,4,5,3,5,1,0,0.75,0.25,1.0,0.0
SF-Z28,SF-Y30,2,3,2,3,0,0,1.0,0.0,1.0,0.0
SF-Z28,SF-Y27,7,4,3,0,4,4,0.42857142857142855,0.5714285714285714,0.0,1.0
SF-Z28,SF-X30,4,1,2,1,2,0,0.5,0.5,1.0,0.0
SF-Z28,SF-X29,2,4,2,1,0,3,1.0,0.0,0.25,0.75
SF-Z28,SF-W29,4,4,4,4,0,0,1.0,0.0,1.0,0.0
SF-Z28,SF-V31,25,5,24,0,1,5,0.96,0.04,0.0,1.0
SF-Z28,SF-V32,1,2,0,0,1,2,0.0,1.0,0.0,1.0
SF-Z28,SF-Y25,1,3,1,2,0,1,1.0,0.0,0.6666666666666666,0.3333333333333333
SF-Y29,SF-J25,1,1,0,0,1,1,0.0,1.0,0.0,1.0
SF-Y29,SF-H27-1,1,1,1,1,0,0,1.0,0.0,1.0,0.0
SF-Y29,SF-E29-2,1,1,0,0,1,1,0.0,1.0,0.0,1.0
SF-Y29,SF-N29,2,3,0,0,2,3,0.0,1.0,0.0,1.0
SF-Y29,SF-N28,3,3,3,3,0,0,1.0,0.0,1.0,0.0
SF-Y29,SF-R24,8,6,5,1,3,5,0.625,0.375,0.16666666666666666,0.8333333333333334
SF-Y29,SF-S21,1,4,1,0,0,4,1.0,0.0,0.0,1.0
SF-Y29,SF-AA28,12,6,8,1,4,5,0.6666666666666666,0.3333333333333333,0.16666666666666666,0.8333333333333334
SF-Y29,SF-Z28,5,4,5,3,0,1,1.0,0.0,0.75,0.25
SF-Y29,SF-Y30,5,3,3,0,2,3,0.6,0.4,0.0,1.0
SF-Y29,SF-Y27,14,11,5,6,9,5,0.35714285714285715,0.6428571428571429,0.5454545454545454,0.45454545454545453
SF-Y29,SF-X30,2,1,2,1,0,0,1.0,0.0,1.0,0.0
SF-Y29,SF-X29,5,13,5,4,0,9,1.0,0.0,0.3076923076923077,0.6923076923076923
SF-Y29,SF-V28,2,4,0,4,2,0,0.0,1.0,1.0,0.0
SF-Y29,SF-V29,1,1,0,1,1,0,0.0,1.0,1.0,0.0
SF-Y29,SF-V30,4,5,2,5,2,0,0.5,0.5,1.0,0.0
SF-Y29,SF-V31,8,5,5,0,3,5,0.625,0.375,0.0,1.0
SF-Y29,SF-Y25,1,1,1,1,0,0,1.0,0.0,1.0,0.0
SF-Y30,SF-J26-2,2,2,1,2,1,0,0.5,0.5,1.0,0.0
SF-Y30,SF-G27,2,1,1,1,1,0,0.5,0.5,1.0,0.0
SF-Y30,SF-M22-2,2,5,0,0,2,5,0.0,1.0,0.0,1.0
SF-Y30,SF-L22,12,9,2,0,10,9,0.16666666666666666,0.8333333333333334,0.0,1.0
SF-Y30,SF-M20,1,1,0,0,1,1,0.0,1.0,0.0,1.0
SF-Y30,SF-P21,5,4,0,0,5,4,0.0,1.0,0.0,1.0
SF-Y30,SF-O21,6,4,0,0,6,4,0.0,1.0,0.0,1.0
SF-Y30,SF-L21,2,5,0,0,2,5,0.0,1.0,0.0,1.0
SF-Y30,SF-AA28,7,6,5,5,2,1,0.7142857142857143,0.2857142857142857,0.8333333333333334,0.16666666666666666
SF-Y30,SF-Z28,3,2,3,2,0,0,1.0,0.0,1.0,0.0
SF-Y30,SF-Y29,3,5,0,3,3,2,0.0,1.0,0.6,0.4
SF-Y30,SF-X30,3,5,2,2,1,3,0.6666666666666666,0.3333333333333333,0.4,0.6
SF-Y30,SF-X29,2,3,2,1,0,2,1.0,0.0,0.3333333333333333,0.6666666666666666
SF-Y30,SF-V29,4,6,2,4,2,2,0.5,0.5,0.6666666666666666,0.3333333333333333
SF-Y30,SF-V31,2,3,1,2,1,1,0.5,0.5,0.6666666666666666,0.3333333333333333
SF-Y27,SF-M30,2,5,1,3,1,2,0.5,0.5,0.6,0.4
SF-Y27,SF-M24,2,3,0,0,2,3,0.0,1.0,0.0,1.0
SF-Y27,SF-I25,1,1,0,0,1,1,0.0,1.0,0.0,1.0
SF-Y27,SF-G27,2,2,0,0,2,2,0.0,1.0,0.0,1.0
SF-Y27,SF-M22-2,1,1,0,0,1,1,0.0,1.0,0.0,1.0
SF-Y27,SF-J23-2,1,1,0,0,1,1,0.0,1.0,0.0,1.0
SF-Y27,SF-G18,6,2,0,0,6,2,0.0,1.0,0.0,1.0
SF-Y27,SF-J19,1,1,0,0,1,1,0.0,1.0,0.0,1.0
SF-Y27,SF-L21,2,1,0,0,2,1,0.0,1.0,0.0,1.0
SF-Y27,SF-O30,1,1,0,1,1,0,0.0,1.0,1.0,0.0
SF-Y27,SF-N29,2,8,0,0,2,8,0.0,1.0,0.0,1.0
SF-Y27,SF-L30-1,1,4,0,4,1,0,0.0,1.0,1.0,0.0
SF-Y27,SF-K30-2,1,1,0,0,1,1,0.0,1.0,0.0,1.0
SF-Y27,SF-Q22-1,3,3,0,0,3,3,0.0,1.0,0.0,1.0
SF-Y27,SF-W19,1,1,0,0,1,1,0.0,1.0,0.0,1.0
SF-Y27,SF-AA28,7,5,5,5,2,0,0.7142857142857143,0.2857142857142857,1.0,0.0
SF-Y27,SF-Z28,4,7,0,3,4,4,0.0,1.0,0.42857142857142855,0.5714285714285714
SF-Y27,SF-Y29,11,14,6,5,5,9,0.5454545454545454,0.45454545454545453,0.35714285714285715,0.6428571428571429
SF-Y27,SF-X29,1,4,0,3,1,1,0.0,1.0,0.75,0.25
SF-Y27,SF-W29,3,1,0,0,3,1,0.0,1.0,0.0,1.0
SF-Y27,SF-V31,14,3,5,1,9,2,0.35714285714285715,0.6428571428571429,0.3333333333333333,0.6666666666666666
SF-Y27,SF-U30,2,1,0,0,2,1,0.0,1.0,0.0,1.0
SF-Y27,SF-Y25,13,1,9,0,4,1,0.6923076923076923,0.3076923076923077,0.0,1.0
SF-X30,SF-K27,3,3,0,0,3,3,0.0,1.0,0.0,1.0
SF-X30,SF-H27-1,1,1,1,1,0,0,1.0,0.0,1.0,0.0
SF-X30,SF-C25,2,2,0,0,2,2,0.0,1.0,0.0,1.0
SF-X30,SF-F26,2,1,1,0,1,1,0.5,0.5,0.0,1.0
SF-X30,SF-S30,1,2,0,2,1,0,0.0,1.0,1.0,0.0
SF-X30,SF-Z28,1,4,1,2,0,2,1.0,0.0,0.5,0.5
SF-X30,SF-Y29,1,2,1,2,0,0,1.0,0.0,1.0,0.0
SF-X30,SF-Y30,5,3,2,2,3,1,0.4,0.6,0.6666666666666666,0.3333333333333333
SF-X30,SF-X29,7,5,0,3,7,2,0.0,1.0,0.6,0.4
SF-X30,SF-W29,1,2,0,1,1,1,0.0,1.0,0.5,0.5
SF-X30,SF-V30,1,2,0,2,1,0,0.0,1.0,1.0,0.0
SF-X30,SF-V31,2,2,1,0,1,2,0.5,0.5,0.0,1.0
SF-X29,SF-J26-2,2,3,2,0,0,3,1.0,0.0,0.0,1.0
SF-X29,SF-P24,2,4,2,4,0,0,1.0,0.0,1.0,0.0
SF-X29,SF-B22,2,2,1,1,1,1,0.5,0.5,0.5,0.5
SF-X29,SF-D29,1,4,0,0,1,4,0.0,1.0,0.0,1.0
SF-X29,SF-C25,1,1,0,0,1,1,0.0,1.0,0.0,1.0
SF-X29,SF-B25,2,2,0,0,2,2,0.0,1.0,0.0,1.0
SF-X29,SF-Q21-1,2,1,2,1,0,0,1.0,0.0,1.0,0.0
SF-X29,SF-P21,2,4,0,0,2,4,0.0,1.0,0.0,1.0
SF-X29,SF-S30,1,2,1,1,0,1,1.0,0.0,0.5,0.5
SF-X29,SF-Q30,1,1,0,0,1,1,0.0,1.0,0.0,1.0
SF-X29,SF-L30-1,1,1,0,0,1,1,0.0,1.0,0.0,1.0
SF-X29,SF-R24,3,5,0,1,3,4,0.0,1.0,0.2,0.8
SF-X29,SF-T22,3,1,0,0,3,1,0.0,1.0,0.0,1.0
SF-X29,SF-S22-1,19,11,0,0,19,11,0.0,1.0,0.0,1.0
SF-X29,SF-Q23-3,4,7,1,0,3,7,0.25,0.75,0.0,1.0
SF-X29,SF-Q22-1,1,1,0,1,1,0,0.0,1.0,1.0,0.0
SF-X29,SF-Q22-2,5,2,0,0,5,2,0.0,1.0,0.0,1.0
SF-X29,SF-Z28,4,2,1,2,3,0,0.25,0.75,1.0,0.0
SF-X29,SF-Y29,13,5,4,5,9,0,0.3076923076923077,0.6923076923076923,1.0,0.0
SF-X29,SF-Y30,3,2,1,2,2,0,0.3333333333333333,0.6666666666666666,1.0,0.0
SF-X29,SF-Y27,4,1,3,0,1,1,0.75,0.25,0.0,1.0
SF-X29,SF-X30,5,7,3,0,2,7,0.6,0.4,0.0,1.0
SF-X29,SF-W29,5,1,2,1,3,0,0.4,0.6,1.0,0.0
SF-X29,SF-V28,1,6,0,3,1,3,0.0,1.0,0.5,0.5
SF-X29,SF-V29,1,1,0,0,1,1,0.0,1.0,0.0,1.0
SF-X29,SF-V30,8,6,0,5,8,1,0.0,1.0,0.8333333333333334,0.16666666666666666
SF-X29,SF-V31,6,19,3,8,3,11,0.5,0.5,0.42105263157894735,0.5789473684210527
SF-W29,SF-M30,4,1,0,1,4,0,0.0,1.0,1.0,0.0
SF-W29,SF-I25,1,1,1,1,0,0,1.0,0.0,1.0,0.0
SF-W29,SF-M22-2,2,2,0,0,2,2,0.0,1.0,0.0,1.0
SF-W29,SF-J17,1,1,0,0,1,1,0.0,1.0,0.0,1.0
SF-W29,SF-P21,1,1,0,0,1,1,0.0,1.0,0.0,1.0
SF-W29,SF-S29,2,1,2,1,0,0,1.0,0.0,1.0,0.0
SF-W29,SF-Q30,35,42,1,1,34,41,0.02857142857142857,0.9714285714285714,0.023809523809523808,0.9761904761904762
SF-W29,SF-O30,3,1,0,1,3,0,0.0,1.0,1.0,0.0
SF-W29,SF-N29,4,7,0,0,4,7,0.0,1.0,0.0,1.0
SF-W29,SF-L30-1,1,1,1,0,0,1,1.0,0.0,0.0,1.0
SF-W29,SF-Q26,2,1,1,0,1,1,0.5,0.5,0.0,1.0
SF-W29,SF-P26,2,2,0,1,2,1,0.0,1.0,0.5,0.5
SF-W29,SF-Q22-1,1,2,0,1,1,1,0.0,1.0,0.5,0.5
SF-W29,SF-Z28,4,4,4,4,0,0,1.0,0.0,1.0,0.0
SF-W29,SF-Y27,1,3,0,0,1,3,0.0,1.0,0.0,1.0
SF-W29,SF-X30,2,1,1,0,1,1,0.5,0.5,0.0,1.0
SF-W29,SF-X29,1,5,1,2,0,3,1.0,0.0,0.4,0.6
SF-W29,SF-V28,2,1,0,1,2,0,0.0,1.0,1.0,0.0
SF-W29,SF-V30,24,28,2,5,22,23,0.08333333333333333,0.9166666666666666,0.17857142857142858,0.8214285714285714
SF-W29,SF-V31,24,6,8,0,16,6,0.3333333333333333,0.6666666666666666,0.0,1.0
SF-W29,SF-V32,4,3,1,0,3,3,0.25,0.75,0.0,1.0
SF-V28,SF-M30,4,5,2,0,2,5,0.5,0.5,0.0,1.0
SF-V28,SF-P24,1,4,0,3,1,1,0.0,1.0,0.75,0.25
SF-V28,SF-J26,2,17,0,0,2,17,0.0,1.0,0.0,1.0
SF-V28,SF-O23,3,1,2,0,1,1,0.6666666666666666,0.3333333333333333,0.0,1.0
SF-V28,SF-G27,1,2,0,0,1,2,0.0,1.0,0.0,1.0
SF-V28,SF-F27,3,3,0,0,3,3,0.0,1.0,0.0,1.0
SF-V28,SF-M22-1,2,1,0,0,2,1,0.0,1.0,0.0,1.0
SF-V28,SF-G23,9,15,9,14,0,1,1.0,0.0,0.9333333333333333,0.06666666666666667
SF-V28,SF-G25,1,1,0,0,1,1,0.0,1.0,0.0,1.0
SF-V28,SF-F23,9,6,9,4,0,2,1.0,0.0,0.6666666666666666,0.3333333333333333
SF-V28,SF-G30-2,5,12,0,0,5,12,0.0,1.0,0.0,1.0
SF-V28,SF-H25,3,8,0,0,3,8,0.0,1.0,0.0,1.0
SF-V28,SF-G26,1,1,1,0,0,1,1.0,0.0,0.0,1.0
SF-V28,SF-J23-1,2,2,0,0,2,2,0.0,1.0,0.0,1.0
SF-V28,SF-P21,4,3,2,0,2,3,0.5,0.5,0.0,1.0
SF-V28,SF-O19,1,5,0,2,1,3,0.0,1.0,0.4,0.6
SF-V28,SF-O21,1,3,0,0,1,3,0.0,1.0,0.0,1.0
SF-V28,SF-S30,3,4,1,0,2,4,0.3333333333333333,0.6666666666666666,0.0,1.0
SF-V28,SF-Q30,5,4,0,0,5,4,0.0,1.0,0.0,1.0
SF-V28,SF-P30,1,1,1,0,0,1,1.0,0.0,0.0,1.0
SF-V28,SF-O30-2,2,1,0,0,2,1,0.0,1.0,0.0,1.0
SF-V28,SF-L30-1,4,1,1,0,3,1,0.25,0.75,0.0,1.0
SF-V28,SF-K30-2,8,12,0,0,8,12,0.0,1.0,0.0,1.0
SF-V28,SF-I27,8,17,0,0,8,17,0.0,1.0,0.0,1.0
SF-V28,SF-I28,4,1,0,0,4,1,0.0,1.0,0.0,1.0
SF-V28,SF I29-1,8,7,0,0,8,7,0.0,1.0,0.0,1.0
SF-V28,SF-R24,10,11,4,1,6,10,0.4,0.6,0.09090909090909091,0.9090909090909091
SF-V28,SF-R26,2,10,1,0,1,10,0.5,0.5,0.0,1.0
SF-V28,SF-N25,2,1,2,0,0,1,1.0,0.0,0.0,1.0
SF-V28,SF-S22-1,5,8,1,1,4,7,0.2,0.8,0.125,0.875
SF-V28,SF-Q23-3,54,4,0,2,54,2,0.0,1.0,0.5,0.5
SF-V28,SF-Q22-2,6,4,0,0,6,4,0.0,1.0,0.0,1.0
SF-V28,SF-P22,1,3,1,2,0,1,1.0,0.0,0.6666666666666666,0.3333333333333333
SF-V28,SF-W19,3,1,1,0,2,1,0.3333333333333333,0.6666666666666666,0.0,1.0
SF-V28,SF-Y29,4,2,4,0,0,2,1.0,0.0,0.0,1.0
SF-V28,SF-X29,6,1,3,0,3,1,0.5,0.5,0.0,1.0
SF-V28,SF-W29,1,2,1,0,0,2,1.0,0.0,0.0,1.0
SF-V28,SF-V29,2,5,0,4,2,1,0.0,1.0,0.8,0.2
SF-V28,SF-V31,6,3,1,0,5,3,0.16666666666666666,0.8333333333333334,0.0,1.0
SF-V28,SF-Y25,3,3,0,0,3,3,0.0,1.0,0.0,1.0
SF-V29,SF-M30,16,7,10,3,6,4,0.625,0.375,0.42857142857142855,0.5714285714285714
SF-V29,SF-M28,4,3,3,1,1,2,0.75,0.25,0.3333333333333333,0.6666666666666666
SF-V29,SF-L28,7,3,0,0,7,3,0.0,1.0,0.0,1.0
SF-V29,SF-K29-1,3,2,1,0,2,2,0.3333333333333333,0.6666666666666666,0.0,1.0
SF-V29,SF-G27,1,7,0,0,1,7,0.0,1.0,0.0,1.0
SF-V29,SF-N22-2,2,2,0,0,2,2,0.0,1.0,0.0,1.0
SF-V29,SF-E23,5,1,0,0,5,1,0.0,1.0,0.0,1.0
SF-V29,SF-D24,10,1,0,0,10,1,0.0,1.0,0.0,1.0
SF-V29,SF-B22,4,13,0,0,4,13,0.0,1.0,0.0,1.0
SF-V29,SF-J17,9,6,0,0,9,6,0.0,1.0,0.0,1.0
SF-V29,SF-I19,1,2,0,0,1,2,0.0,1.0,0.0,1.0
SF-V29,SF-H30,6,1,4,0,2,1,0.6666666666666666,0.3333333333333333,0.0,1.0
SF-V29,SF-E29-1,2,3,0,2,2,1,0.0,1.0,0.6666666666666666,0.3333333333333333
SF-V29,SF-A27,3,2,1,1,2,1,0.3333333333333333,0.6666666666666666,0.5,0.5
SF-V29,SF-B28,2,7,0,0,2,7,0.0,1.0,0.0,1.0
SF-V29,SF-Q21-1,1,1,1,1,0,0,1.0,0.0,1.0,0.0
SF-V29,SF-O21,3,2,0,0,3,2,0.0,1.0,0.0,1.0
SF-V29,SF-L21,1,1,0,1,1,0,0.0,1.0,1.0,0.0
SF-V29,SF-S29,4,1,2,0,2,1,0.5,0.5,0.0,1.0
SF-V29,SF-S30,1,4,1,2,0,2,1.0,0.0,0.5,0.5
SF-V29,SF-Q30,24,17,6,6,18,11,0.25,0.75,0.35294117647058826,0.6470588235294118
SF-V29,SF-P30,14,8,10,8,4,0,0.7142857142857143,0.2857142857142857,1.0,0.0
SF-V29,SF-O30-2,6,6,4,2,2,4,0.6666666666666666,0.3333333333333333,0.3333333333333333,0.6666666666666666
SF-V29,SF-O30,10,1,6,0,4,1,0.6,0.4,0.0,1.0
SF-V29,SF-N28,2,1,2,0,0,1,1.0,0.0,0.0,1.0
SF-V29,SF-L30-1,6,3,4,2,2,1,0.6666666666666666,0.3333333333333333,0.6666666666666666,0.3333333333333333
SF-V29,SF-L31-1,3,1,1,0,2,1,0.3333333333333333,0.6666666666666666,0.0,1.0
SF-V29,SF-K30-2,1,2,1,1,0,1,1.0,0.0,0.5,0.5
SF-V29,SF-L29,3,2,3,1,0,1,1.0,0.0,0.5,0.5
SF-V29,SF-I30,2,1,2,1,0,0,1.0,0.0,1.0,0.0
SF-V29,SF I29-1,4,4,0,0,4,4,0.0,1.0,0.0,1.0
SF-V29,SF-S24,3,1,2,1,1,0,0.6666666666666666,0.3333333333333333,1.0,0.0
SF-V29,SF-R24,1,2,0,0,1,2,0.0,1.0,0.0,1.0
SF-V29,SF-R26,1,1,1,1,0,0,1.0,0.0,1.0,0.0
SF-V29,SF-P26,4,2,0,1,4,1,0.0,1.0,0.5,0.5
SF-V29,SF-O25-2,5,1,2,0,3,1,0.4,0.6,0.0,1.0
SF-V29,SF-S22-1,1,2,1,0,0,2,1.0,0.0,0.0,1.0
SF-V29,SF-Q23-3,1,1,0,0,1,1,0.0,1.0,0.0,1.0
SF-V29,SF-Q22-1,3,4,2,2,1,2,0.6666666666666666,0.3333333333333333,0.5,0.5
SF-V29,SF-Q22-2,3,7,2,4,1,3,0.6666666666666666,0.3333333333333333,0.5714285714285714,0.42857142857142855
SF-V29,SF-Y29,1,1,1,0,0,1,1.0,0.0,0.0,1.0
SF-V29,SF-Y30,6,4,4,2,2,2,0.6666666666666666,0.3333333333333333,0.5,0.5
SF-V29,SF-X29,1,1,0,0,1,1,0.0,1.0,0.0,1.0
SF-V29,SF-V28,5,2,4,0,1,2,0.8,0.2,0.0,1.0
SF-V29,SF-V30,12,18,8,7,4,11,0.6666666666666666,0.3333333333333333,0.3888888888888889,0.6111111111111112
SF-V29,SF-V31,4,8,2,4,2,4,0.5,0.5,0.5,0.5
SF-V29,SF-V32,15,5,14,1,1,4,0.9333333333333333,0.06666666666666667,0.2,0.8
SF-V29,SF-U30,1,1,1,0,0,1,1.0,0.0,0.0,1.0
SF-V29,SF-X19,1,1,1,1,0,0,1.0,0.0,1.0,0.0
SF-V29,SF-Y25,3,14,0,1,3,13,0.0,1.0,0.07142857142857142,0.9285714285714286
SF-V30,SF-M30,7,6,3,2,4,4,0.42857142857142855,0.5714285714285714,0.3333333333333333,0.6666666666666666
SF-V30,SF-M28,5,4,1,1,4,3,0.2,0.8,0.25,0.75
SF-V30,SF-N23,2,2,0,0,2,2,0.0,1.0,0.0,1.0
SF-V30,SF-L28,1,1,1,0,0,1,1.0,0.0,0.0,1.0
SF-V30,SF-H27-1,3,1,0,1,3,0,0.0,1.0,1.0,0.0
SF-V30,SF-F27,5,2,2,1,3,1,0.4,0.6,0.5,0.5
SF-V30,SF-N22-2,2,1,0,0,2,1,0.0,1.0,0.0,1.0
SF-V30,SF-H30,1,1,1,1,0,0,1.0,0.0,1.0,0.0
SF-V30,SF-G30-2,2,1,1,1,1,0,0.5,0.5,1.0,0.0
SF-V30,SF-E29-2,1,10,0,4,1,6,0.0,1.0,0.4,0.6
SF-V30,SF-E29-1,7,8,3,3,4,5,0.42857142857142855,0.5714285714285714,0.375,0.625
SF-V30,SF-D29,1,1,0,0,1,1,0.0,1.0,0.0,1.0
SF-V30,SF-G30-1,44,43,41,43,3,0,0.9318181818181818,0.06818181818181818,1.0,0.0
SF-V30,SF-E29-3,7,6,0,2,7,4,0.0,1.0,0.3333333333333333,0.6666666666666666
SF-V30,SF-F28-1,1,8,0,5,1,3,0.0,1.0,0.625,0.375
SF-V30,SF-B25,1,1,1,0,0,1,1.0,0.0,0.0,1.0
SF-V30,SF-G26,2,5,0,0,2,5,0.0,1.0,0.0,1.0
SF-V30,SF-K21,1,1,0,0,1,1,0.0,1.0,0.0,1.0
SF-V30,SF-S30,1,7,1,7,0,0,1.0,0.0,1.0,0.0
SF-V30,SF-Q30,16,10,9,8,7,2,0.5625,0.4375,0.8,0.2
SF-V30,SF-P30,4,4,2,2,2,2,0.5,0.5,0.5,0.5
SF-V30,SF-O30-2,4,3,0,2,4,1,0.0,1.0,0.6666666666666666,0.3333333333333333
SF-V30,SF-O30,3,1,0,1,3,0,0.0,1.0,1.0,0.0
SF-V30,SF-N27,4,5,1,1,3,4,0.25,0.75,0.2,0.8
SF-V30,SF-N29,2,2,0,0,2,2,0.0,1.0,0.0,1.0
SF-V30,SF-N28,4,1,3,1,1,0,0.75,0.25,1.0,0.0
SF-V30,SF-L30-1,1,1,0,0,1,1,0.0,1.0,0.0,1.0
SF-V30,SF-L31-1,9,7,4,5,5,2,0.4444444444444444,0.5555555555555556,0.7142857142857143,0.2857142857142857
SF-V30,SF-L29,7,5,5,3,2,2,0.7142857142857143,0.2857142857142857,0.6,0.4
SF-V30,SF-I27,4,3,0,0,4,3,0.0,1.0,0.0,1.0
SF-V30,SF-H28,5,5,1,1,4,4,0.2,0.8,0.2,0.8
SF-V30,SF-T22,1,1,1,0,0,1,1.0,0.0,0.0,1.0
SF-V30,SF-Q23-3,4,2,0,0,4,2,0.0,1.0,0.0,1.0
SF-V30,SF-Q22-1,2,2,1,0,1,2,0.5,0.5,0.0,1.0
SF-V30,SF-Y29,5,4,5,2,0,2,1.0,0.0,0.5,0.5
SF-V30,SF-X30,2,1,2,0,0,1,1.0,0.0,0.0,1.0
SF-V30,SF-X29,6,8,5,0,1,8,0.8333333333333334,0.16666666666666666,0.0,1.0
SF-V30,SF-W29,28,24,5,2,23,22,0.17857142857142858,0.8214285714285714,0.08333333333333333,0.9166666666666666
SF-V30,SF-V29,18,12,7,8,11,4,0.3888888888888889,0.6111111111111112,0.6666666666666666,0.3333333333333333
SF-V30,SF-V31,39,49,30,7,9,42,0.7692307692307693,0.23076923076923078,0.14285714285714285,0.8571428571428571
SF-V30,SF-V32,6,3,6,1,0,2,1.0,0.0,0.3333333333333333,0.6666666666666666
SF-V30,SF-U30,3,3,0,3,3,0,0.0,1.0,1.0,0.0
SF-V31,SF-K29-1,1,1,0,0,1,1,0.0,1.0,0.0,1.0
SF-V31,SF-J25,30,3,30,3,0,0,1.0,0.0,1.0,0.0
SF-V31,SF-F27,7,2,5,1,2,1,0.7142857142857143,0.2857142857142857,0.5,0.5
SF-V31,SF-H30,1,1,1,1,0,0,1.0,0.0,1.0,0.0
SF-V31,SF-E29-2,1,2,1,0,0,2,1.0,0.0,0.0,1.0
SF-V31,SF-E29-1,1,2,0,0,1,2,0.0,1.0,0.0,1.0
SF-V31,SF-G30-1,1,2,1,2,0,0,1.0,0.0,1.0,0.0
SF-V31,SF-F26,2,3,0,0,2,3,0.0,1.0,0.0,1.0
SF-V31,SF-S30,8,10,8,1,0,9,1.0,0.0,0.1,0.9
SF-V31,SF-Q30,5,8,1,1,4,7,0.2,0.8,0.125,0.875
SF-V31,SF-P30,6,2,5,2,1,0,0.8333333333333334,0.16666666666666666,1.0,0.0
SF-V31,SF-O30-2,9,4,7,1,2,3,0.7777777777777778,0.2222222222222222,0.25,0.75
SF-V31,SF-O30,2,2,0,0,2,2,0.0,1.0,0.0,1.0
SF-V31,SF-N27,4,1,1,0,3,1,0.25,0.75,0.0,1.0
SF-V31,SF-L31-1,1,2,0,0,1,2,0.0,1.0,0.0,1.0
SF-V31,SF-H28,1,2,1,0,0,2,1.0,0.0,0.0,1.0
SF-V31,SF-S24,3,1,2,1,1,0,0.6666666666666666,0.3333333333333333,1.0,0.0
SF-V31,SF-R24,3,2,0,0,3,2,0.0,1.0,0.0,1.0
SF-V31,SF-O25-2,2,1,1,0,1,1,0.5,0.5,0.0,1.0
SF-V31,SF-AA28,102,38,35,33,67,5,0.3431372549019608,0.6568627450980392,0.868421052631579,0.13157894736842105
SF-V31,SF-Z28,5,25,0,24,5,1,0.0,1.0,0.96,0.04
SF-V31,SF-Y29,5,8,0,5,5,3,0.0,1.0,0.625,0.375
SF-V31,SF-Y30,3,2,2,1,1,1,0.6666666666666666,0.3333333333333333,0.5,0.5
SF-V31,SF-Y27,3,14,1,5,2,9,0.3333333333333333,0.6666666666666666,0.35714285714285715,0.6428571428571429
SF-V31,SF-X30,2,2,0,1,2,1,0.0,1.0,0.5,0.5
SF-V31,SF-X29,19,6,8,3,11,3,0.42105263157894735,0.5789473684210527,0.5,0.5
SF-V31,SF-W29,6,24,0,8,6,16,0.0,1.0,0.3333333333333333,0.6666666666666666
SF-V31,SF-V28,3,6,0,1,3,5,0.0,1.0,0.16666666666666666,0.8333333333333334
SF-V31,SF-V29,8,4,4,2,4,2,0.5,0.5,0.5,0.5
SF-V31,SF-V30,49,39,7,30,42,9,0.14285714285714285,0.8571428571428571,0.7692307692307693,0.23076923076923078
SF-V31,SF-V32,7,5,6,3,1,2,0.8571428571428571,0.14285714285714285,0.6,0.4
SF-V31,SF-U30,4,5,3,0,1,5,0.75,0.25,0.0,1.0
SF-V32,SF-K26,1,3,1,2,0,1,1.0,0.0,0.6666666666666666,0.3333333333333333
SF-V32,SF-M30,16,10,3,5,13,5,0.1875,0.8125,0.5,0.5
SF-V32,SF-M28,4,4,3,3,1,1,0.75,0.25,0.75,0.25
SF-V32,SF-K27-2,4,6,4,5,0,1,1.0,0.0,0.8333333333333334,0.16666666666666666
SF-V32,SF-K29-1,6,3,5,2,1,1,0.8333333333333334,0.16666666666666666,0.6666666666666666,0.3333333333333333
SF-V32,SF-K25,3,1,0,0,3,1,0.0,1.0,0.0,1.0
SF-V32,SF-J25,22,26,17,8,5,18,0.7727272727272727,0.22727272727272727,0.3076923076923077,0.6923076923076923
SF-V32,SF-O24,1,1,0,0,1,1,0.0,1.0,0.0,1.0
SF-V32,SF-F27,2,2,2,2,0,0,1.0,0.0,1.0,0.0
SF-V32,SF-K22-2,2,1,0,0,2,1,0.0,1.0,0.0,1.0
SF-V32,SF-F23,1,12,1,10,0,2,1.0,0.0,0.8333333333333334,0.16666666666666666
SF-V32,SF-E23,7,13,5,13,2,0,0.7142857142857143,0.2857142857142857,1.0,0.0
SF-V32,SF-G30-2,6,3,6,3,0,0,1.0,0.0,1.0,0.0
SF-V32,SF-E29-2,2,1,0,1,2,0,0.0,1.0,1.0,0.0
SF-V32,SF-E29-1,1,2,1,1,0,1,1.0,0.0,0.5,0.5
SF-V32,SF-D29,1,1,1,1,0,0,1.0,0.0,1.0,0.0
SF-V32,SF-G29-2,7,2,7,2,0,0,1.0,0.0,1.0,0.0
SF-V32,SF-G30-1,1,4,0,2,1,2,0.0,1.0,0.5,0.5
SF-V32,SF-B28,1,9,1,9,0,0,1.0,0.0,1.0,0.0
SF-V32,SF-L19,2,1,2,1,0,0,1.0,0.0,1.0,0.0
SF-V32,SF-K18,4,1,4,1,0,0,1.0,0.0,1.0,0.0
SF-V32,SF-J19,1,2,1,0,0,2,1.0,0.0,0.0,1.0
SF-V32,SF-O19,20,1,18,0,2,1,0.9,0.1,0.0,1.0
SF-V32,SF-O22,4,1,4,1,0,0,1.0,0.0,1.0,0.0
SF-V32,SF-S29,1,5,1,3,0,2,1.0,0.0,0.6,0.4
SF-V32,SF-S30,18,10,16,10,2,0,0.8888888888888888,0.1111111111111111,1.0,0.0
SF-V32,SF-Q30,47,54,47,46,0,8,1.0,0.0,0.8518518518518519,0.14814814814814814
SF-V32,SF-P30,8,11,7,8,1,3,0.875,0.125,0.7272727272727273,0.2727272727272727
SF-V32,SF-O30-2,24,30,22,20,2,10,0.9166666666666666,0.08333333333333333,0.6666666666666666,0.3333333333333333
SF-V32,SF-O30,12,16,8,10,4,6,0.6666666666666666,0.3333333333333333,0.625,0.375
SF-V32,SF-N27,4,2,4,2,0,0,1.0,0.0,1.0,0.0
SF-V32,SF-N28,1,3,0,2,1,1,0.0,1.0,0.6666666666666666,0.3333333333333333
SF-V32,SF-L30-1,7,32,5,16,2,16,0.7142857142857143,0.2857142857142857,0.5,0.5
SF-V32,SF-L31-1,13,14,13,11,0,3,1.0,0.0,0.7857142857142857,0.21428571428571427
SF-V32,SF-L29,1,1,1,0,0,1,1.0,0.0,0.0,1.0
SF-V32,SF-J29-1,1,4,1,4,0,0,1.0,0.0,1.0,0.0
SF-V32,SF-I30,11,12,11,12,0,0,1.0,0.0,1.0,0.0
SF-V32,SF-I27,1,4,0,3,1,1,0.0,1.0,0.75,0.25
SF-V32,SF-H28,19,10,14,1,5,9,0.7368421052631579,0.2631578947368421,0.1,0.9
SF-V32,SF-S24,2,7,1,1,1,6,0.5,0.5,0.14285714285714285,0.8571428571428571
SF-V32,SF-R24,4,5,0,1,4,4,0.0,1.0,0.2,0.8
SF-V32,SF-T22,1,1,0,0,1,1,0.0,1.0,0.0,1.0
SF-V32,SF-S22-1,2,4,0,0,2,4,0.0,1.0,0.0,1.0
SF-V32,SF-W19,2,1,2,0,0,1,1.0,0.0,0.0,1.0
SF-V32,SF-Z28,2,1,0,0,2,1,0.0,1.0,0.0,1.0
SF-V32,SF-W29,3,4,0,1,3,3,0.0,1.0,0.25,0.75
SF-V32,SF-V29,5,15,1,14,4,1,0.2,0.8,0.9333333333333333,0.06666666666666667
SF-V32,SF-V30,3,6,1,6,2,0,0.3333333333333333,0.6666666666666666,1.0,0.0
SF-V32,SF-V31,5,7,3,6,2,1,0.6,0.4,0.8571428571428571,0.14285714285714285
SF-V32,SF-U30,2,7,2,6,0,1,1.0,0.0,0.8571428571428571,0.14285714285714285
SF-U30,SF-M30,1,5,0,1,1,4,0.0,1.0,0.2,0.8
SF-U30,SF-J26-2,2,2,0,0,2,2,0.0,1.0,0.0,1.0
SF-U30,SF-L28,6,1,1,0,5,1,0.16666666666666666,0.8333333333333334,0.0,1.0
SF-U30,SF-K29-1,1,2,1,1,0,1,1.0,0.0,0.5,0.5
SF-U30,SF-K25,1,1,1,1,0,0,1.0,0.0,1.0,0.0
SF-U30,SF-H26,29,24,0,0,29,24,0.0,1.0,0.0,1.0
SF-U30,SF-K22-2,1,3,0,0,1,3,0.0,1.0,0.0,1.0
SF-U30,SF-G24,16,8,0,0,16,8,0.0,1.0,0.0,1.0
SF-U30,SF-F23,10,4,0,0,10,4,0.0,1.0,0.0,1.0
SF-U30,SF-E18,8,3,0,0,8,3,0.0,1.0,0.0,1.0
SF-U30,SF-H30,1,3,0,0,1,3,0.0,1.0,0.0,1.0
SF-U30,SF-G30-2,3,2,1,1,2,1,0.3333333333333333,0.6666666666666666,0.5,0.5
SF-U30,SF-E29-2,2,1,1,1,1,0,0.5,0.5,1.0,0.0
SF-U30,SF-H12,1,1,0,0,1,1,0.0,1.0,0.0,1.0
SF-U30,SF-I23-1,7,2,6,0,1,2,0.8571428571428571,0.14285714285714285,0.0,1.0
SF-U30,SF-M20,33,16,0,0,33,16,0.0,1.0,0.0,1.0
SF-U30,SF-L21,4,16,0,0,4,16,0.0,1.0,0.0,1.0
SF-U30,SF-S30,1,7,1,3,0,4,1.0,0.0,0.42857142857142855,0.5714285714285714
SF-U30,SF-Q30,10,17,6,7,4,10,0.6,0.4,0.4117647058823529,0.5882352941176471
SF-U30,SF-O30-2,4,5,2,0,2,5,0.5,0.5,0.0,1.0
SF-U30,SF-O30,4,8,2,4,2,4,0.5,0.5,0.5,0.5
SF-U30,SF-N27,15,17,0,0,15,17,0.0,1.0,0.0,1.0
SF-U30,SF-N28,1,1,0,0,1,1,0.0,1.0,0.0,1.0
SF-U30,SF-L30-1,1,1,1,1,0,0,1.0,0.0,1.0,0.0
SF-U30,SF-K30-2,1,5,1,3,0,2,1.0,0.0,0.6,0.4
SF-U30,SF-H28,31,20,24,1,7,19,0.7741935483870968,0.22580645161290322,0.05,0.95
SF-U30,SF-S24,2,3,0,0,2,3,0.0,1.0,0.0,1.0
SF-U30,SF-R24,2,5,0,2,2,3,0.0,1.0,0.4,0.6
SF-U30,SF-Q26,1,1,1,0,0,1,1.0,0.0,0.0,1.0
SF-U30,SF-O25-2,2,2,0,0,2,2,0.0,1.0,0.0,1.0
SF-U30,SF-T22,1,1,1,0,0,1,1.0,0.0,0.0,1.0
SF-U30,SF-Q22-2,3,15,0,0,3,15,0.0,1.0,0.0,1.0
SF-U30,SF-Y27,1,2,0,0,1,2,0.0,1.0,0.0,1.0
SF-U30,SF-V29,1,1,0,1,1,0,0.0,1.0,1.0,0.0
SF-U30,SF-V30,3,3,3,0,0,3,1.0,0.0,0.0,1.0
SF-U30,SF-V31,5,4,0,3,5,1,0.0,1.0,0.75,0.25
SF-U30,SF-V32,7,2,6,2,1,0,0.8571428571428571,0.14285714285714285,1.0,0.0
SF-U30,SF-Y25,2,2,1,0,1,2,0.5,0.5,0.0,1.0
SF-W14,SF-M30,1,6,0,1,1,5,0.0,1.0,0.16666666666666666,0.8333333333333334
SF-W14,SF-J29,1,1,0,1,1,0,0.0,1.0,1.0,0.0
SF-W14,SF-M24,1,3,0,0,1,3,0.0,1.0,0.0,1.0
SF-W14,SF-L24,1,1,0,0,1,1,0.0,1.0,0.0,1.0
SF-W14,SF-N24-2,12,18,0,14,12,4,0.0,1.0,0.7777777777777778,0.2222222222222222
SF-W14,SF-K25,1,3,1,0,0,3,1.0,0.0,0.0,1.0
SF-W14,SF-H26,2,1,0,0,2,1,0.0,1.0,0.0,1.0
SF-W14,SF-G27,1,5,0,1,1,4,0.0,1.0,0.2,0.8
SF-W14,SF-M22-2,2,1,0,0,2,1,0.0,1.0,0.0,1.0
SF-W14,SF-N22-2,9,2,0,0,9,2,0.0,1.0,0.0,1.0
SF-W14,SF-M22-1,1,2,0,0,1,2,0.0,1.0,0.0,1.0
SF-W14,SF-O25-1,2,1,0,1,2,0,0.0,1.0,1.0,0.0
SF-W14,SF-G23,1,2,0,0,1,2,0.0,1.0,0.0,1.0
SF-W14,SF-G25,2,3,0,0,2,3,0.0,1.0,0.0,1.0
SF-W14,SF-E29-2,1,2,0,0,1,2,0.0,1.0,0.0,1.0
SF-W14,SF-E29-1,2,2,0,0,2,2,0.0,1.0,0.0,1.0
SF-W14,SF-F28-1,4,3,2,1,2,2,0.5,0.5,0.3333333333333333,0.6666666666666666
SF-W14,SF-E28-2,3,1,0,1,3,0,0.0,1.0,1.0,0.0
SF-W14,SF-J10,1,1,1,0,0,1,1.0,0.0,0.0,1.0
SF-W14,SF-A20,2,3,0,0,2,3,0.0,1.0,0.0,1.0
SF-W14,SF-K22-1,2,2,0,0,2,2,0.0,1.0,0.0,1.0
SF-W14,SF-J23-1,1,3,0,0,1,3,0.0,1.0,0.0,1.0
SF-W14,SF-J22-1,1,1,0,0,1,1,0.0,1.0,0.0,1.0
SF-W14,SF-I23-2,1,2,0,1,1,1,0.0,1.0,0.5,0.5
SF-W14,SF-M13,3,2,0,0,3,2,0.0,1.0,0.0,1.0
SF-W14,SF-M15,1,1,1,0,0,1,1.0,0.0,0.0,1.0
SF-W14,SF-L19,1,2,0,0,1,2,0.0,1.0,0.0,1.0
SF-W14,SF-K15-,4,2,2,0,2,2,0.5,0.5,0.0,1.0
SF-W14,SF-K19,2,2,0,0,2,2,0.0,1.0,0.0,1.0
SF-W14,SF-J18,1,1,0,0,1,1,0.0,1.0,0.0,1.0
SF-W14,SF-M12,3,3,1,0,2,3,0.3333333333333333,0.6666666666666666,0.0,1.0
SF-W14,SF-M11,2,1,0,0,2,1,0.0,1.0,0.0,1.0
SF-W14,SF-P21,3,5,0,0,3,5,0.0,1.0,0.0,1.0
SF-W14,SF-O19,6,6,0,0,6,6,0.0,1.0,0.0,1.0
SF-W14,SF-O21,4,11,0,5,4,6,0.0,1.0,0.45454545454545453,0.5454545454545454
SF-W14,SF-O22,17,12,0,8,17,4,0.0,1.0,0.6666666666666666,0.3333333333333333
SF-W14,SF-Q30,1,3,0,0,1,3,0.0,1.0,0.0,1.0
SF-W14,SF-P30,1,1,0,0,1,1,0.0,1.0,0.0,1.0
SF-W14,SF-N27,8,1,1,0,7,1,0.125,0.875,0.0,1.0
SF-W14,SF-N28,11,5,0,1,11,4,0.0,1.0,0.2,0.8
SF-W14,SF-S24,2,2,0,0,2,2,0.0,1.0,0.0,1.0
SF-W14,SF-R24,6,2,0,1,6,1,0.0,1.0,0.5,0.5
SF-W14,SF-R26,2,3,0,0,2,3,0.0,1.0,0.0,1.0
SF-W14,SF-Q26,1,1,0,0,1,1,0.0,1.0,0.0,1.0
SF-W14,SF-T21,6,7,1,3,5,4,0.16666666666666666,0.8333333333333334,0.42857142857142855,0.5714285714285714
SF-W14,SF-T22,6,4,0,3,6,1,0.0,1.0,0.75,0.25
SF-W14,SF-S22-2,4,5,2,2,2,3,0.5,0.5,0.4,0.6
SF-W14,SF-S22-1,4,2,0,2,4,0,0.0,1.0,1.0,0.0
SF-W14,SF-Q23-3,4,5,0,1,4,4,0.0,1.0,0.2,0.8
SF-W14,SF-Q22-1,12,1,0,0,12,1,0.0,1.0,0.0,1.0
SF-W14,SF-Q22-2,7,23,0,20,7,3,0.0,1.0,0.8695652173913043,0.13043478260869565
SF-W14,SF-P22,2,3,0,0,2,3,0.0,1.0,0.0,1.0
SF-W14,SF-W19,90,149,12,68,78,81,0.13333333333333333,0.8666666666666667,0.4563758389261745,0.5436241610738255
SF-W14,SF-W19-2,1,2,0,0,1,2,0.0,1.0,0.0,1.0
SF-W14,SF-U21,9,32,1,7,8,25,0.1111111111111111,0.8888888888888888,0.21875,0.78125
SF-W14,SF-T20,5,1,0,0,5,1,0.0,1.0,0.0,1.0
SF-W14,SF-S21,5,1,0,0,5,1,0.0,1.0,0.0,1.0
SF-W14,SF-Z6,3,1,3,1,0,0,1.0,0.0,1.0,0.0
SF-W14,SF-W8,3,5,0,4,3,1,0.0,1.0,0.8,0.2
SF-W14,SF-AA15,5,6,1,6,4,0,0.2,0.8,1.0,0.0
SF-W14,SF-Y14,25,26,12,15,13,11,0.48,0.52,0.5769230769230769,0.4230769230769231
SF-W14,SF-X14,24,15,15,9,9,6,0.625,0.375,0.6,0.4
SF-W14,SF-X19,1,1,1,1,0,0,1.0,0.0,1.0,0.0
SF-Z7,SF-H0,1,1,1,1,0,0,1.0,0.0,1.0,0.0
SF-Z7,SF-K20,11,5,0,0,11,5,0.0,1.0,0.0,1.0
SF-Z7,SF-J18,4,1,0,0,4,1,0.0,1.0,0.0,1.0
SF-Z7,SF-O21,1,1,1,1,0,0,1.0,0.0,1.0,0.0
SF-Z7,SF-N25,2,4,0,0,2,4,0.0,1.0,0.0,1.0
SF-Z7,SF-W19,5,3,4,0,1,3,0.8,0.2,0.0,1.0
SF-Z7,SF-Z6,11,21,8,15,3,6,0.7272727272727273,0.2727272727272727,0.7142857142857143,0.2857142857142857
SF-Z7,SF-W8,7,3,3,2,4,1,0.42857142857142855,0.5714285714285714,0.6666666666666666,0.3333333333333333
SF-Z7,SF-AA15,4,1,1,1,3,0,0.25,0.75,1.0,0.0
SF-Z7,SF-X14,1,1,0,0,1,1,0.0,1.0,0.0,1.0
SF-Z6,SF-K25,1,1,0,0,1,1,0.0,1.0,0.0,1.0
SF-Z6,SF-E18,1,1,1,0,0,1,1.0,0.0,0.0,1.0
SF-Z6,SF-J1,9,4,8,3,1,1,0.8888888888888888,0.1111111111111111,0.75,0.25
SF-Z6,SF-H0,4,5,2,3,2,2,0.5,0.5,0.6,0.4
SF-Z6,SF-M13,3,1,2,0,1,1,0.6666666666666666,0.3333333333333333,0.0,1.0
SF-Z6,SF-M11,3,2,3,1,0,1,1.0,0.0,0.5,0.5
SF-Z6,SF-W14,1,3,1,3,0,0,1.0,0.0,1.0,0.0
SF-Z6,SF-Z7,21,11,15,8,6,3,0.7142857142857143,0.2857142857142857,0.7272727272727273,0.2727272727272727
SF-Z6,SF-W8,8,6,4,4,4,2,0.5,0.5,0.6666666666666666,0.3333333333333333
SF-W8,SF-J12,1,1,0,0,1,1,0.0,1.0,0.0,1.0
SF-W8,SF-J1,19,17,17,14,2,3,0.8947368421052632,0.10526315789473684,0.8235294117647058,0.17647058823529413
SF-W8,SF-H0,5,5,3,3,2,2,0.6,0.4,0.6,0.4
SF-W8,SF-M13,2,1,2,1,0,0,1.0,0.0,1.0,0.0
SF-W8,SF-M15,4,5,0,0,4,5,0.0,1.0,0.0,1.0
SF-W8,SF-K20,2,1,2,1,0,0,1.0,0.0,1.0,0.0
SF-W8,SF-K15-,6,1,6,0,0,1,1.0,0.0,0.0,1.0
SF-W8,SF-M12,3,1,2,1,1,0,0.6666666666666666,0.3333333333333333,1.0,0.0
SF-W8,SF-M10,4,8,1,4,3,4,0.25,0.75,0.5,0.5
SF-W8,SF-W14,5,3,4,0,1,3,0.8,0.2,0.0,1.0
SF-W8,SF-Z7,3,7,2,3,1,4,0.6666666666666666,0.3333333333333333,0.42857142857142855,0.5714285714285714
SF-W8,SF-Z6,6,8,4,4,2,4,0.6666666666666666,0.3333333333333333,0.5,0.5
SF-W8,SF-AA15,4,3,3,0,1,3,0.75,0.25,0.0,1.0
SF-W8,SF-Z16,2,1,0,0,2,1,0.0,1.0,0.0,1.0
SF-W8,SF-Y14,7,4,1,2,6,2,0.14285714285714285,0.8571428571428571,0.5,0.5
SF-BB17,SF-L26,4,2,0,0,4,2,0.0,1.0,0.0,1.0
SF-BB17,SF-M22-2,2,1,0,0,2,1,0.0,1.0,0.0,1.0
SF-BB17,SF-G28-1,1,1,1,1,0,0,1.0,0.0,1.0,0.0
SF-BB17,SF-E29-3,1,1,1,1,0,0,1.0,0.0,1.0,0.0
SF-BB17,SF-O18,3,1,0,0,3,1,0.0,1.0,0.0,1.0
SF-BB17,SF-R26,3,5,3,4,0,1,1.0,0.0,0.8,0.2
SF-BB17,SF-P26,2,2,1,0,1,2,0.5,0.5,0.0,1.0
SF-BB17,SF-S22-1,2,1,2,0,0,1,1.0,0.0,0.0,1.0
SF-BB17,SF-AA15,16,11,9,9,7,2,0.5625,0.4375,0.8181818181818182,0.18181818181818182
SF-BB17,SF-Z16,3,10,1,9,2,1,0.3333333333333333,0.6666666666666666,0.9,0.1
SF-BB17,SF-X19,6,14,6,12,0,2,1.0,0.0,0.8571428571428571,0.14285714285714285
SF-AA15,SF-P24,1,1,1,1,0,0,1.0,0.0,1.0,0.0
SF-AA15,SF-I25,2,1,2,1,0,0,1.0,0.0,1.0,0.0
SF-AA15,SF-H26,2,1,2,1,0,0,1.0,0.0,1.0,0.0
SF-AA15,SF-M22-2,2,2,1,2,1,0,0.5,0.5,1.0,0.0
SF-AA15,SF-N22-2,1,6,0,6,1,0,0.0,1.0,1.0,0.0
SF-AA15,SF-G28-1,1,1,1,0,0,1,1.0,0.0,0.0,1.0
SF-AA15,SF-J17,1,1,1,1,0,0,1.0,0.0,1.0,0.0
SF-AA15,SF-J12,1,2,0,0,1,2,0.0,1.0,0.0,1.0
SF-AA15,SF-J23-1,2,1,2,1,0,0,1.0,0.0,1.0,0.0
SF-AA15,SF-M15,1,1,1,0,0,1,1.0,0.0,0.0,1.0
SF-AA15,SF-R19,1,1,0,0,1,1,0.0,1.0,0.0,1.0
SF-AA15,SF-Q21-1,2,3,2,3,0,0,1.0,0.0,1.0,0.0
SF-AA15,SF-N27,3,2,0,0,3,2,0.0,1.0,0.0,1.0
SF-AA15,SF-L31-1,1,13,0,3,1,10,0.0,1.0,0.23076923076923078,0.7692307692307693
SF-AA15,SF-T21,8,10,7,3,1,7,0.875,0.125,0.3,0.7
SF-AA15,SF-T22,2,3,1,1,1,2,0.5,0.5,0.3333333333333333,0.6666666666666666
SF-AA15,SF-S22-2,4,3,0,0,4,3,0.0,1.0,0.0,1.0
SF-AA15,SF-S22-1,2,4,0,0,2,4,0.0,1.0,0.0,1.0
SF-AA15,SF-Q22-2,2,1,1,0,1,1,0.5,0.5,0.0,1.0
SF-AA15,SF-W19,9,7,4,1,5,6,0.4444444444444444,0.5555555555555556,0.14285714285714285,0.8571428571428571
SF-AA15,SF-W19-2,10,11,1,2,9,9,0.1,0.9,0.18181818181818182,0.8181818181818182
SF-AA15,SF-U21,16,2,1,0,15,2,0.0625,0.9375,0.0,1.0
SF-AA15,SF-W14,6,5,6,1,0,4,1.0,0.0,0.2,0.8
SF-AA15,SF-Z7,1,4,1,1,0,3,1.0,0.0,0.25,0.75
SF-AA15,SF-W8,3,4,0,3,3,1,0.0,1.0,0.75,0.25
SF-AA15,SF-BB17,11,16,9,9,2,7,0.8181818181818182,0.18181818181818182,0.5625,0.4375
SF-AA15,SF-Z16,17,15,3,13,14,2,0.17647058823529413,0.8235294117647058,0.8666666666666667,0.13333333333333333
SF-AA15,SF-Y14,8,9,4,5,4,4,0.5,0.5,0.5555555555555556,0.4444444444444444
SF-AA15,SF-X14,1,3,1,1,0,2,1.0,0.0,0.3333333333333333,0.6666666666666666
SF-AA15,SF-X19,2,5,1,5,1,0,0.5,0.5,1.0,0.0
SF-Z16,SF-N22-2,3,2,0,0,3,2,0.0,1.0,0.0,1.0
SF-Z16,SF-B22,1,1,1,1,0,0,1.0,0.0,1.0,0.0
SF-Z16,SF-M20,11,8,0,0,11,8,0.0,1.0,0.0,1.0
SF-Z16,SF-N21,17,48,0,19,17,29,0.0,1.0,0.3958333333333333,0.6041666666666666
SF-Z16,SF-M21,17,4,0,0,17,4,0.0,1.0,0.0,1.0
SF-Z16,SF-T21,5,1,1,1,4,0,0.2,0.8,1.0,0.0
SF-Z16,SF-T22,5,1,0,0,5,1,0.0,1.0,0.0,1.0
SF-Z16,SF-S22-1,2,2,0,1,2,1,0.0,1.0,0.5,0.5
SF-Z16,SF-W19,8,7,3,2,5,5,0.375,0.625,0.2857142857142857,0.7142857142857143
SF-Z16,SF-U21,10,7,2,0,8,7,0.2,0.8,0.0,1.0
SF-Z16,SF-W8,1,2,0,0,1,2,0.0,1.0,0.0,1.0
SF-Z16,SF-BB17,10,3,9,1,1,2,0.9,0.1,0.3333333333333333,0.6666666666666666
SF-Z16,SF-AA15,15,17,13,3,2,14,0.8666666666666667,0.13333333333333333,0.17647058823529413,0.8235294117647058
SF-Z16,SF-X14,1,1,1,0,0,1,1.0,0.0,0.0,1.0
SF-Z16,SF-X19,2,2,2,2,0,0,1.0,0.0,1.0,0.0
SF-Y14,SF-G27,1,8,0,0,1,8,0.0,1.0,0.0,1.0
SF-Y14,SF-L22,3,1,0,0,3,1,0.0,1.0,0.0,1.0
SF-Y14,SF-F27,2,4,0,0,2,4,0.0,1.0,0.0,1.0
SF-Y14,SF-J23-2,1,1,0,0,1,1,0.0,1.0,0.0,1.0
SF-Y14,SF-G25,1,1,0,0,1,1,0.0,1.0,0.0,1.0
SF-Y14,SF-G20,9,7,0,0,9,7,0.0,1.0,0.0,1.0
SF-Y14,SF-G30-1,1,4,0,0,1,4,0.0,1.0,0.0,1.0
SF-Y14,SF-F30-2,4,5,0,0,4,5,0.0,1.0,0.0,1.0
SF-Y14,SF-E29-3,2,2,0,0,2,2,0.0,1.0,0.0,1.0
SF-Y14,SF-J1,2,1,2,0,0,1,1.0,0.0,0.0,1.0
SF-Y14,SF-I22,1,1,0,0,1,1,0.0,1.0,0.0,1.0
SF-Y14,SF-K15-,1,2,0,0,1,2,0.0,1.0,0.0,1.0
SF-Y14,SF-M12,4,1,2,1,2,0,0.5,0.5,1.0,0.0
SF-Y14,SF-Q21-2,1,1,0,1,1,0,0.0,1.0,1.0,0.0
SF-Y14,SF-O21,1,2,0,1,1,1,0.0,1.0,0.5,0.5
SF-Y14,SF-O22,2,3,0,0,2,3,0.0,1.0,0.0,1.0
SF-Y14,SF-R24,2,1,0,0,2,1,0.0,1.0,0.0,1.0
SF-Y14,SF-P26,2,2,0,0,2,2,0.0,1.0,0.0,1.0
SF-Y14,SF-T21,1,4,0,0,1,4,0.0,1.0,0.0,1.0
SF-Y14,SF-T22,4,2,2,1,2,1,0.5,0.5,0.5,0.5
SF-Y14,SF-Q22-2,4,4,0,1,4,3,0.0,1.0,0.25,0.75
SF-Y14,SF-P22,5,2,0,0,5,2,0.0,1.0,0.0,1.0
SF-Y14,SF-W19,26,20,3,6,23,14,0.11538461538461539,0.8846153846153846,0.3,0.7
SF-Y14,SF-W19-2,2,3,0,0,2,3,0.0,1.0,0.0,1.0
SF-Y14,SF-U21,54,66,0,0,54,66,0.0,1.0,0.0,1.0
SF-Y14,SF-T20,2,1,0,0,2,1,0.0,1.0,0.0,1.0
SF-Y14,SF-W14,26,25,15,12,11,13,0.5769230769230769,0.4230769230769231,0.48,0.52
SF-Y14,SF-W8,4,7,2,1,2,6,0.5,0.5,0.14285714285714285,0.8571428571428571
SF-Y14,SF-AA15,9,8,5,4,4,4,0.5555555555555556,0.4444444444444444,0.5,0.5
SF-Y14,SF-X14,5,15,2,8,3,7,0.4,0.6,0.5333333333333333,0.4666666666666667
SF-Y14,SF-X19,4,1,1,1,3,0,0.25,0.75,1.0,0.0
SF-X14,SF-M13,1,2,0,0,1,2,0.0,1.0,0.0,1.0
SF-X14,SF-N21,1,3,1,1,0,2,1.0,0.0,0.3333333333333333,0.6666666666666666
SF-X14,SF-S22-1,2,1,2,0,0,1,1.0,0.0,0.0,1.0
SF-X14,SF-W19,6,9,3,6,3,3,0.5,0.5,0.6666666666666666,0.3333333333333333
SF-X14,SF-W19-2,2,2,0,0,2,2,0.0,1.0,0.0,1.0
SF-X14,SF-U21,2,11,0,1,2,10,0.0,1.0,0.09090909090909091,0.9090909090909091
SF-X14,SF-W14,15,24,9,15,6,9,0.6,0.4,0.625,0.375
SF-X14,SF-Z7,1,1,0,0,1,1,0.0,1.0,0.0,1.0
SF-X14,SF-AA15,3,1,1,1,2,0,0.3333333333333333,0.6666666666666666,1.0,0.0
SF-X14,SF-Z16,1,1,0,1,1,0,0.0,1.0,1.0,0.0
SF-X14,SF-Y14,15,5,8,2,7,3,0.5333333333333333,0.4666666666666667,0.4,0.6
SF-X14,SF-X19,1,1,0,1,1,0,0.0,1.0,1.0,0.0
SF-X19,SF-M25,1,2,0,1,1,1,0.0,1.0,0.5,0.5
SF-X19,SF-H26-2,2,1,1,1,1,0,0.5,0.5,1.0,0.0
SF-X19,SF-P24,1,1,1,1,0,0,1.0,0.0,1.0,0.0
SF-X19,SF-M22-2,4,3,2,3,2,0,0.5,0.5,1.0,0.0
SF-X19,SF-L22,2,1,0,1,2,0,0.0,1.0,1.0,0.0
SF-X19,SF-N22-2,1,6,0,0,1,6,0.0,1.0,0.0,1.0
SF-X19,SF-G18,1,3,0,0,1,3,0.0,1.0,0.0,1.0
SF-X19,SF-B25,1,1,0,0,1,1,0.0,1.0,0.0,1.0
SF-X19,SF-J22-2,2,4,1,0,1,4,0.5,0.5,0.0,1.0
SF-X19,SF-F26,1,1,0,0,1,1,0.0,1.0,0.0,1.0
SF-X19,SF-M20,3,7,0,0,3,7,0.0,1.0,0.0,1.0
SF-X19,SF-R19,4,1,2,0,2,1,0.5,0.5,0.0,1.0
SF-X19,SF-P21,4,2,0,0,4,2,0.0,1.0,0.0,1.0
SF-X19,SF-O19,3,2,0,1,3,1,0.0,1.0,0.5,0.5
SF-X19,SF-O21,6,2,0,0,6,2,0.0,1.0,0.0,1.0
SF-X19,SF-O22,6,3,1,1,5,2,0.16666666666666666,0.8333333333333334,0.3333333333333333,0.6666666666666666
SF-X19,SF-N21,4,2,0,0,4,2,0.0,1.0,0.0,1.0
SF-X19,SF-S29,1,1,1,0,0,1,1.0,0.0,0.0,1.0
SF-X19,SF-R24,3,3,2,2,1,1,0.6666666666666666,0.3333333333333333,0.6666666666666666,0.3333333333333333
SF-X19,SF-R26,4,1,3,1,1,0,0.75,0.25,1.0,0.0
SF-X19,SF-T21,1,3,1,2,0,1,1.0,0.0,0.6666666666666666,0.3333333333333333
SF-X19,SF-T22,5,4,0,2,5,2,0.0,1.0,0.5,0.5
SF-X19,SF-S22-2,3,1,1,1,2,0,0.3333333333333333,0.6666666666666666,1.0,0.0
SF-X19,SF-S22-1,2,2,1,0,1,2,0.5,0.5,0.0,1.0
SF-X19,SF-Q22-1,1,1,0,1,1,0,0.0,1.0,1.0,0.0
SF-X19,SF-Q22-2,1,2,1,2,0,0,1.0,0.0,1.0,0.0
SF-X19,SF-P22,4,4,1,3,3,1,0.25,0.75,0.75,0.25
SF-X19,SF-W19,5,12,4,5,1,7,0.8,0.2,0.4166666666666667,0.5833333333333334
SF-X19,SF-U21,2,2,1,2,1,0,0.5,0.5,1.0,0.0
SF-X19,SF-T20,1,1,1,0,0,1,1.0,0.0,0.0,1.0
SF-X19,SF-V29,1,1,1,1,0,0,1.0,0.0,1.0,0.0
SF-X19,SF-W14,1,1,1,1,0,0,1.0,0.0,1.0,0.0
SF-X19,SF-BB17,14,6,12,6,2,0,0.8571428571428571,0.14285714285714285,1.0,0.0
SF-X19,SF-AA15,5,2,5,1,0,1,1.0,0.0,0.5,0.5
SF-X19,SF-Z16,2,2,2,2,0,0,1.0,0.0,1.0,0.0
SF-X19,SF-Y14,1,4,1,1,0,3,1.0,0.0,0.25,0.75
SF-X19,SF-X14,1,1,1,0,0,1,1.0,0.0,0.0,1.0
SF-Y25,SF-M25,1,5,1,5,0,0,1.0,0.0,1.0,0.0
SF-Y25,SF-M30,79,120,26,15,53,105,0.3291139240506329,0.6708860759493671,0.125,0.875
SF-Y25,SF-L26,1,6,0,6,1,0,0.0,1.0,1.0,0.0
SF-Y25,SF-M22-2,1,3,0,0,1,3,0.0,1.0,0.0,1.0
SF-Y25,SF-G19,1,1,0,0,1,1,0.0,1.0,0.0,1.0
SF-Y25,SF-H30,1,1,0,1,1,0,0.0,1.0,1.0,0.0
SF-Y25,SF-G30-2,4,4,0,0,4,4,0.0,1.0,0.0,1.0
SF-Y25,SF-E29-2,1,1,1,0,0,1,1.0,0.0,0.0,1.0
SF-Y25,SF-F29,4,3,0,0,4,3,0.0,1.0,0.0,1.0
SF-Y25,SF-F26,4,4,0,0,4,4,0.0,1.0,0.0,1.0
SF-Y25,SF-M20,5,6,0,0,5,6,0.0,1.0,0.0,1.0
SF-Y25,SF-P21,1,1,0,0,1,1,0.0,1.0,0.0,1.0
SF-Y25,SF-O18,2,3,0,1,2,2,0.0,1.0,0.3333333333333333,0.6666666666666666
SF-Y25,SF-N21,1,1,0,0,1,1,0.0,1.0,0.0,1.0
SF-Y25,SF-S30,13,1,0,0,13,1,0.0,1.0,0.0,1.0
SF-Y25,SF-Q30,8,1,2,0,6,1,0.25,0.75,0.0,1.0
SF-Y25,SF-O30-2,7,5,0,1,7,4,0.0,1.0,0.2,0.8
SF-Y25,SF-O30,39,3,0,0,39,3,0.0,1.0,0.0,1.0
SF-Y25,SF-N27,1,2,0,0,1,2,0.0,1.0,0.0,1.0
SF-Y25,SF-N28,1,2,0,0,1,2,0.0,1.0,0.0,1.0
SF-Y25,SF-L30-1,38,36,37,35,1,1,0.9736842105263158,0.02631578947368421,0.9722222222222222,0.027777777777777776
SF-Y25,SF-L31-1,1,3,0,3,1,0,0.0,1.0,1.0,0.0
SF-Y25,SF-L29,33,11,25,2,8,9,0.7575757575757576,0.24242424242424243,0.18181818181818182,0.8181818181818182
SF-Y25,SF-R26,2,2,2,2,0,0,1.0,0.0,1.0,0.0
SF-Y25,SF-Q26,2,1,0,0,2,1,0.0,1.0,0.0,1.0
SF-Y25,SF-O25-2,1,1,1,1,0,0,1.0,0.0,1.0,0.0
SF-Y25,SF-S22-1,1,2,1,1,0,1,1.0,0.0,0.5,0.5
SF-Y25,SF-Q23-3,2,1,2,1,0,0,1.0,0.0,1.0,0.0
SF-Y25,SF-W19,2,4,2,2,0,2,1.0,0.0,0.5,0.5
SF-Y25,SF-T20,1,1,0,0,1,1,0.0,1.0,0.0,1.0
SF-Y25,SF-Z28,3,1,2,1,1,0,0.6666666666666666,0.3333333333333333,1.0,0.0
SF-Y25,SF-Y29,1,1,1,1,0,0,1.0,0.0,1.0,0.0
SF-Y25,SF-Y27,1,13,0,9,1,4,0.0,1.0,0.6923076923076923,0.3076923076923077
SF-Y25,SF-V28,3,3,0,0,3,3,0.0,1.0,0.0,1.0
SF-Y25,SF-V29,14,3,1,0,13,3,0.07142857142857142,0.9285714285714286,0.0,1.0
SF-Y25,SF-U30,2,2,0,1,2,1,0.0,1.0,0.5,0.5
